"độ	do˨ˀ˩ʔ
-	-
a	a˧˥
a-di-đà	a˧˥-ji˧˥-da˦˨
a-lê	a˧˥-le˧˥
a-mi-nô	a˧˥-mi˧˥-no˧˥
a-rập	a˧˥-ʐɤ̆p˨ˀ˩ʔ
a-xê-ti-len	a˧˥-se˧˥-ti˧˥-lɛŋ˧˥
a-xít	a˧˥-sit˦˥
ai	aj˧˥
alo	ʔaːlo˧
am	am˧˥
am-pe	am˧˥-pɛ˧˥
an	aŋ˧˥
ang	aŋ˧˥
anh	an˧˥
ao	aw˧˥
au	ăw˧˥
ay	ăj˧˥
ba	baː˧
ba	ba˧˥
ba-trui	ba˧˥-ʈuj˧˥
ba-xí	ba˧˥-si˩˧
bai	baj˧˥
bam	bam˧˥
ban	ban˧
ban	baŋ˧˥
bang	baŋ˧˥
bao	baw˧˥
bay	băj˧˥
be	bɛ˧˥
bem	bɛm˧˥
beng	bɛŋ˧˥
beo	beo˧˥
bi	bi˧˥
bia	biə˧˥
bin	bin˧˥
binh	bin˧˥
biên	biəŋ˧˥
biêng	biəŋ˧˥
biếc	biək˦˥
biếm	biəm˩˧
biến	biəŋ˩˧
biếng	biəŋ˩˧
biết	biək˦˥
biếu	biəw˩˧
biền	biəŋ˦˨
biển	biəŋ˧˩˨
biểu	biəw˧˩˨
biện	biəŋ˨ˀ˩ʔ
biệt	biək˨ˀ˩ʔ
bo	bɔ˧˥
bom	bɔm˧˥
bon	bɔŋm˧˥
bong	bɔŋm˧˥
boong	bɔŋm˧˥
boóc	bɔkp˦˥
bu	bu˧˥
bui	buj˧˥
bum	bum˧˥
bun	buŋm˧˥
bung	buŋm˧˥
buôn	buəŋ˧˥
buông	buəŋ˧˥
buốt	buək˦˥
buồm	buəm˦˨
buồn	buəŋ˦˨
buồng	buəŋ˦˨
buổi	buəj˧˩˨
buộc	buək˨ˀ˩ʔ
buột	buək˨ˀ˩ʔ
bà	baː˧˨
bà	ba˦˨
bài	baj˦˨
bàm	bam˦˨
bàn	baŋ˦˨
bàng	baŋ˦˨
bành	ban˦˨
bào	baw˦˨
bàu	băw˦˨
bày	băj˦˨
bá	ba˩˧
bác	bak˦˥
bách	bak˦˥
bái	baj˩˧
bám	bam˩˧
bán	baŋ˩˧
báng	baŋ˩˧
bánh	ban˩˧
báo	baw˩˧
báo	baːw˧
bát	bak˦˥
bát-tràng	bak˦˥-ʈaŋ˦˨
báu	băw˩˧
bân	bɤ̆ŋ˧˥
bâng	bɤ̆ŋ˧˥
bâu	bɤ̆w˧˥
bây	bɤ̆j˧˥
bã	ba˧˩˨
bãi	baj˧˩˨
bão	baw˧˩˨
bè	bɛ˦˨
bèm	bɛm˦˨
bèn	bɛŋ˦˨
bèo	beo˦˨
bé	bɛ˧˥
bé	bɛ˩˧
béc	bɛk˦˥
bén	bɛŋ˩˧
béo	beo˩˧
bép	bɛp˦˥
bét	bɛk˦˥
bê	be˧˥
bê-tông	be˧˥-toŋm˧˥
bên	ben˧
bên	ben˧˥
bênh	ben˧˥
bêu	bɛu˧˥
bì	bi˦˨
bìa	biə˦˨
bìm	bim˦˨
bình	bin˦˨
bìu	biw˦˨
bí	bi˩˧
bích	bit˦˥
bích-câu	bit˦˥-kɤ̆w˧˥
bín	bin˩˧
bính	bin˩˧
bíp	bip˦˥
bít	bit˦˥
bíu	biw˩˧
bò	bɔ˦˨
bòi	bɔj˦˨
bòm	bɔm˦˨
bòn	bɔŋm˦˨
bòng	bɔŋm˦˨
bó	bo˧˥
bó	bɔ˩˧
bóc	bɔkp˦˥
bói	bɔj˩˧
bón	bɔŋm˩˧
bóng	bɔŋm˩˧
bóp	bɔp˦˥
bô	bo˧˥
bôi	boj˧˥
bôm	bom˧˥
bôn	boŋm˧˥
bôn-sê-vích	boŋm˧˥-ʂe˧˥-jit˦˥
bông	boŋm˧˥
bõ	bɔ˧˩˨
bù	bu˦˨
bùa	buə˦˨
bùi	buj˦˨
bùm	bum˦˨
bùn	bun˧
bùn	buŋm˦˨
bùng	buŋm˦˨
bú	bu˩˧
búa	buə˩˧
búi	buj˩˧
bún	buŋm˩˧
búng	buŋm˩˧
búp	bup˦˥
bút	bukp˦˥
băm	băm˧˥
băn	băŋ˧˥
băng	băŋ˧˥
băng-giô	băŋ˧˥-jo˧˥
bĩ	bi˧˩˨
bĩnh	bin˧˩˨
bĩu	biw˧˩˨
bơ	bɤ˧˥
bơi	bɤj˧˥
bơm	bɤm˧˥
bơn	bɤŋ˧˥
bư	bɯ˧˥
bưng	bɯŋ˧˥
bưu	bɯw˧˥
bươm	bɯəm˧˥
bươn	bɯəŋ˧˥
bương	bɯəŋ˧˥
bươu	bɯəw˧˥
bước	bɯək˦˥
bướm	bɯəm˩˧
bướng	bɯəŋ˩˧
bướu	bɯəw˩˧
bưởi	bɯəj˧˩˨
bạ	ba˨ˀ˩ʔ
bạc	bak˨ˀ˩ʔ
bạch	bak˨ˀ˩ʔ
bại	baj˨ˀ˩ʔ
bạn	ban˧˨
bạn	baŋ˨ˀ˩ʔ
bạng	baŋ˨ˀ˩ʔ
bạnh	ban˨ˀ˩ʔ
bạo	baw˨ˀ˩ʔ
bạt	bak˨ˀ˩ʔ
bạu	băw˨ˀ˩ʔ
bả	ba˧˩˨
bải	baj˧˩˨
bản	baŋ˧˩˨
bảng	baŋ˧˩˨
bảnh	ban˧˩˨
bảo	baw˧˩˨
bảu	băw˧˩˨
bảy	băj˧˩˨
bấc	bɤ̆k˦˥
bấm	bɤ̆m˩˧
bấn	bɤ̆ŋ˩˧
bấp	bɤ̆p˦˥
bất	bɤ̆k˦˥
bấu	bɤ̆w˩˧
bấy	bɤ̆j˩˧
bầm	bɤ̆m˦˨
bần	bɤ̆ŋ˦˨
bầng	bɤ̆ŋ˦˨
bầu	bɤ̆w˦˨
bầy	bɤ̆j˦˨
bẩm	bɤ̆m˧˩˨
bẩn	bɤ̆ŋ˧˩˨
bẩy	bɤ̆j˧˩˨
bẫm	bɤ̆m˧˩˨
bẫy	bɤ̆j˧˩˨
bậc	bɤ̆k˨ˀ˩ʔ
bậm	bɤ̆m˨ˀ˩ʔ
bận	ban˧˨
bận	bɤ̆ŋ˨ˀ˩ʔ
bập	bɤ̆p˨ˀ˩ʔ
bật	bɤ̆k˨ˀ˩ʔ
bậu	bɤ̆w˨ˀ˩ʔ
bậy	bɤ̆j˨ˀ˩ʔ
bắc	băk˦˥
bắn	băŋ˩˧
bắng	băŋ˩˧
bắp	băp˦˥
bắt	băk˦˥
bằn	băŋ˦˨
bằng	baŋ˧
bằng	băŋ˦˨
bẳn	băŋ˧˩˨
bẵng	băŋ˧˩˨
bặc	băk˨ˀ˩ʔ
bặm	băm˨ˀ˩ʔ
bặng	băŋ˨ˀ˩ʔ
bặt	băk˨ˀ˩ʔ
bẹ	bɛ˨ˀ˩ʔ
bẹp	bɛp˨ˀ˩ʔ
bẹt	bɛk˨ˀ˩ʔ
bẻ	bɛ˧˩˨
bẻm	bɛm˧˩˨
bẻo	beo˧˩˨
bẽ	bɛ˧˩˨
bẽn	bɛŋ˧˩˨
bế	be˩˧
bến	ben˩˧
bếp	bep˦˥
bết	bet˦˥
bề	be˦˨
bền	ben˦˨
bềnh	ben˦˨
bều	bɛu˦˨
bể	be˧˩˨
bệ	be˨ˀ˩ʔ
bệch	bet˨ˀ˩ʔ
bện	ben˨ˀ˩ʔ
bệnh	ben˨ˀ˩ʔ
bệt	bet˨ˀ˩ʔ
bệu	bɛu˨ˀ˩ʔ
bỉ	bi˧˩˨
bỉm	bim˧˩˨
bỉnh	bin˧˩˨
bị	bi˧˨
bị	bi˨ˀ˩ʔ
bịa	biə˨ˀ˩ʔ
bịn	bin˨ˀ˩ʔ
bịp	bip˨ˀ˩ʔ
bịt	bit˨ˀ˩ʔ
bọ	bɔ˨ˀ˩ʔ
bọc	bɔkp˨ˀ˩ʔ
bọn	bɔŋm˨ˀ˩ʔ
bọng	bɔŋm˨ˀ˩ʔ
bọp	bɔp˨ˀ˩ʔ
bọt	bɔkp˨ˀ˩ʔ
bỏ	bo˨˩
bỏ	bɔ˧˩˨
bỏm	bɔm˧˩˨
bỏn	bɔŋm˧˩˨
bỏng	bɔŋm˧˩˨
bố	bo˧˥
bố	bo˩˧
bốc	bokp˦˥
bối	boj˩˧
bốn	boŋm˩˧
bống	boŋm˩˧
bốp	bop˦˥
bồ	bo˦˨
bồi	boj˦˨
bồm	bom˦˨
bồn	boŋm˦˨
bồng	boŋm˦˨
bổ	bo˧˩˨
bổi	boj˧˩˨
bổn	boŋm˧˩˨
bổng	boŋm˧˩˨
bỗ	bo˧˩˨
bỗng	boŋm˧˩˨
bỗng	boŋ˨˩
bộ	bo˨ˀ˩ʔ
bộc	bokp˨ˀ˩ʔ
bội	boj˨ˀ˩ʔ
bộn	boŋm˨ˀ˩ʔ
bộng	boŋm˨ˀ˩ʔ
bộp	bop˨ˀ˩ʔ
bột	bokp˨ˀ˩ʔ
bớ	bɤ˩˧
bới	bɤj˩˧
bớp	bɤp˦˥
bớt	bɤk˦˥
bờ	bɤ˦˨
bời	bɤj˦˨
bờm	bɤm˦˨
bờn	bɤŋ˦˨
bở	bɤ˧˩˨
bởi	bɤj˧˩˨
bỡ	bɤ˧˩˨
bỡn	bɤŋ˧˩˨
bợ	bɤ˨ˀ˩ʔ
bợm	bɤm˨ˀ˩ʔ
bợn	bɤŋ˨ˀ˩ʔ
bợp	bɤp˨ˀ˩ʔ
bợt	bɤk˨ˀ˩ʔ
bụ	bu˨ˀ˩ʔ
bụi	buj˨ˀ˩ʔ
bụng	buŋm˨ˀ˩ʔ
bụt	bukp˨ˀ˩ʔ
bủ	bu˧˩˨
bủa	buə˧˩˨
bủn	buŋm˧˩˨
bủng	buŋm˧˩˨
bứ	bɯ˩˧
bức	bɯk˦˥
bứt	bɯk˦˥
bừa	bɯə˦˨
bừng	bɯŋ˦˨
bửng	bɯŋ˧˩˨
bửu	bɯw˧˩˨
bữa	bɯə˧˩˨
bự	bɯ˨ˀ˩ʔ
bực	bɯk˨ˀ˩ʔ
ca	ka˧˥
cai	kaj˧˥
cam	kam˧˥
can	kaŋ˧˥
cang	kaŋ˧˥
canh	kan˧˥
cao	kaw˧˥
cau	kăw˧˥
cay	kăj˧˥
cha	ca˧˥
chai	caj˧˥
cham	cam˧˥
chan	caŋ˧˥
chang	caŋ˧˥
chanh	can˧˥
chao	caw˧˥
chau	căw˧˥
chay	căj˧˥
che	cɛ˧˥
chem	cɛm˧˥
chen	cɛŋ˧˥
cheng	cɛŋ˧˥
cheo	ceo˧˥
chi	ci˧˥
chia	ciə˧˥
chim	cim˧˥
chin	cin˧˥
chinh	cin˧˥
chiu	ciw˧˥
chiêm	ciəm˧˥
chiên	ciəŋ˧˥
chiêng	ciəŋ˧˥
chiêu	ciəw˧˥
chiếc	ciək˦˥
chiếm	ciəm˩˧
chiến	ciəŋ˩˧
chiếng	ciəŋ˩˧
chiếp	ciəp˦˥
chiết	ciək˦˥
chiếu	ciəw˩˧
chiền	ciəŋ˦˨
chiềng	ciəŋ˦˨
chiều	ciəw˦˨
chiểu	ciəw˧˩˨
cho	cɔ˧
cho	cɔ˧˥
choai	cwaj˧˥
choang	cwaŋ˧˥
choe	cwe˧˥
choen	cwen˧˥
choi	cɔj˧˥
chon	cɔŋm˧˥
chong	cɔŋm˧˥
choàm	cwam˦˨
choàng	cwaŋ˦˨
choá	cwa˩˧
choác	cwak˦˥
choáng	cwaŋ˩˧
choèn	cwen˦˨
choăn	cwăŋ˧˥
choạc	cwak˨ˀ˩ʔ
choạng	cwaŋ˨ˀ˩ʔ
choắt	cwăk˦˥
chu	cu˧˥
chua	cuə˧˥
chui	cuj˧˥
chum	cum˧˥
chun	cuŋm˧˥
chung	cuŋm˧˥
chuyên	cwiəŋ˧˥
chuyến	cwiəŋ˩˧
chuyền	cwiəŋ˦˨
chuyển	cwiəŋ˧˩˨
chuyện	cwiəŋ˨ˀ˩ʔ
chuôi	cuəj˧˥
chuôm	cuəm˧˥
chuông	cuəŋ˧˥
chuẩn	cwɤ̆ŋ˧˩˨
chuế	cwe˩˧
chuếch	cwet˦˥
chuếnh	cwen˩˧
chuểnh	cwen˧˩˨
chuệch	cwet˨ˀ˩ʔ
chuệnh	cwen˨ˀ˩ʔ
chuốc	cuək˦˥
chuối	cuəj˩˧
chuốt	cuək˦˥
chuồi	cuəj˦˨
chuồn	cuəŋ˦˨
chuồng	cuəŋ˦˨
chuỗi	cuəj˧˩˨
chuộc	cuək˨ˀ˩ʔ
chuội	cuəj˨ˀ˩ʔ
chuộng	cuəŋ˨ˀ˩ʔ
chuột	cuək˨ˀ˩ʔ
chà	ca˦˨
chài	caj˦˨
chàm	cam˦˨
chàng	caŋ˦˨
chành	can˦˨
chào	caw˦˨
chàu	căw˦˨
chày	căj˦˨
chác	cak˦˥
chán	caŋ˩˧
chánh	can˩˧
cháo	caw˩˧
chát	cak˦˥
cháu	căw˩˧
cháy	căj˩˧
châm	cɤ̆m˧˥
chân	cɤ̆ŋ˧˥
châng	cɤ̆ŋ˧˥
châu	cɤ̆w˧˥
chây	cɤ̆j˧˥
chão	caw˧˩˨
chè	cɛ˦˨
chèm	cɛm˦˨
chèn	cɛŋ˦˨
chèo	ceo˦˨
chém	cɛm˩˧
chén	cɛŋ˩˧
chéo	ceo˩˧
chép	cɛp˦˥
chét	cɛk˦˥
chê	ce˧˥
chêm	cem˧˥
chênh	cen˧˥
chêu	cɛu˧˥
chì	ci˦˨
chìa	ciə˦˨
chìm	cim˦˨
chình	cin˦˨
chí	ci˩˧
chích	cit˦˥
chín	cin˩˧
chính	cin˩˧
chíp	cip˦˥
chít	cit˦˥
chíu	ciw˩˧
chò	cɔ˦˨
chòi	cɔj˦˨
chòm	cɔm˦˨
chòng	cɔŋm˦˨
chó	cɔ˩˧
chóc	cɔkp˦˥
chói	cɔj˩˧
chóng	cɔŋm˩˧
chóp	cɔp˦˥
chót	cɔkp˦˥
chô	co˧˥
chôm	com˧˥
chôn	coŋm˧˥
chông	coŋm˧˥
chõ	cɔ˧˩˨
chõm	cɔm˧˩˨
chù	cu˦˨
chùa	cuə˦˨
chùi	cuj˦˨
chùm	cum˦˨
chùn	cuŋm˦˨
chùng	cuŋm˦˨
chú	cu˩˧
chúa	cuə˩˧
chúc	cukp˦˥
chúi	cuj˩˧
chúm	cum˩˧
chúng	cuŋm˩˧
chút	cukp˦˥
chăm	căm˧˥
chăn	căŋ˧˥
chăng	căŋ˧˥
chĩa	ciə˧˩˨
chĩnh	cin˧˩˨
chũm	cum˧˩˨
chũn	cuŋm˧˩˨
chơ	cɤ˧˥
chơi	cɤj˧˥
chơm	cɤm˧˥
chơn	cɤŋ˧˥
chư	cɯ˧˥
chưa	cɯə˧˥
chưng	cɯŋ˧˥
chương	cɯəŋ˧˥
chước	cɯək˦˥
chướng	cɯəŋ˩˧
chưởng	cɯəŋ˧˩˨
chạ	ca˨ˀ˩ʔ
chạc	cak˨ˀ˩ʔ
chạch	cak˨ˀ˩ʔ
chạm	cam˨ˀ˩ʔ
chạng	caŋ˨ˀ˩ʔ
chạnh	can˨ˀ˩ʔ
chạo	caw˨ˀ˩ʔ
chạp	cap˨ˀ˩ʔ
chạy	căj˨ˀ˩ʔ
chả	ca˧˩˨
chải	caj˧˩˨
chảng	caŋ˧˩˨
chảnh	can˧˩˨
chảo	caw˧˩˨
chảu	căw˧˩˨
chảy	căj˧˩˨
chấm	cɤ̆m˩˧
chấn	cɤ̆ŋ˩˧
chấp	cəp˧˥
chấp	cɤ̆p˦˥
chất	cɤ̆k˦˥
chấu	cɤ̆w˩˧
chấy	cɤ̆j˩˧
chầm	cɤ̆m˦˨
chần	cɤ̆ŋ˦˨
chầu	cɤ̆w˦˨
chầy	cɤ̆j˦˨
chẩm	cɤ̆m˧˩˨
chẩn	cɤ̆ŋ˧˩˨
chẫu	cɤ̆w˧˩˨
chậc	cɤ̆k˨ˀ˩ʔ
chậm	cɤ̆m˨ˀ˩ʔ
chận	cɤ̆ŋ˨ˀ˩ʔ
chập	cɤ̆p˨ˀ˩ʔ
chật	cɤ̆k˨ˀ˩ʔ
chậu	cɤ̆w˨ˀ˩ʔ
chắc	cak˧˥
chắc	căk˦˥
chắn	căŋ˩˧
chắp	căp˦˥
chắt	căk˦˥
chằm	căm˦˨
chằn	căŋ˦˨
chằng	căŋ˦˨
chẳng	căŋ˧˩˨
chẵn	căŋ˧˩˨
chặc	căk˨ˀ˩ʔ
chặn	căŋ˨ˀ˩ʔ
chặng	căŋ˨ˀ˩ʔ
chặp	căp˨ˀ˩ʔ
chặt	căk˨ˀ˩ʔ
chẹn	cɛŋ˨ˀ˩ʔ
chẹp	cɛp˨ˀ˩ʔ
chẹt	cɛk˨ˀ˩ʔ
chẻ	cɛ˧˩˨
chẻm	cɛm˧˩˨
chẻn	cɛŋ˧˩˨
chẻo	ceo˧˩˨
chế	ce˩˧
chếch	cet˦˥
chếnh	cen˩˧
chết	cet˦˥
chề	ce˦˨
chềm	cem˦˨
chềnh	cen˦˨
chểnh	cen˧˩˨
chễm	cem˧˩˨
chễnh	cen˧˩˨
chệch	cet˨ˀ˩ʔ
chệnh	cen˨ˀ˩ʔ
chỉ	ci˧˩˨
chỉn	cin˧˩˨
chỉnh	cin˧˩˨
chị	ci˧˨
chị	ci˨ˀ˩ʔ
chịu	ciw˨ˀ˩ʔ
chọc	cɔkp˨ˀ˩ʔ
chọi	cɔj˨ˀ˩ʔ
chọn	cɔŋm˨ˀ˩ʔ
chỏm	cɔm˧˩˨
chỏn	cɔŋm˧˩˨
chỏng	cɔŋm˧˩˨
chốc	cokp˦˥
chối	coj˩˧
chốn	coŋm˩˧
chống	coŋm˩˧
chốt	cokp˦˥
chồi	coj˦˨
chồm	com˦˨
chồn	coŋm˦˨
chồng	coŋm˦˨
chổi	coj˧˩˨
chổng	coŋm˧˩˨
chỗ	co˧˩˨
chỗ	cə˨˩
chộn	coŋm˨ˀ˩ʔ
chộp	cop˨ˀ˩ʔ
chột	cokp˨ˀ˩ʔ
chớ	cɤ˩˧
chới	cɤj˩˧
chớm	cɤm˩˧
chớp	cɤp˦˥
chớt	cɤk˦˥
chờ	cɤ˦˨
chờm	cɤm˦˨
chờn	cɤŋ˦˨
chở	cɤ˧˩˨
chợ	cɤ˨ˀ˩ʔ
chợp	cɤp˨ˀ˩ʔ
chục	cukp˨ˀ˩ʔ
chụm	cum˨ˀ˩ʔ
chụp	cup˨ˀ˩ʔ
chụt	cukp˨ˀ˩ʔ
chủ	cu˧˩˨
chủn	cuŋm˧˩˨
chủng	cuŋm˧˩˨
chứ	cɨ˧˥
chứ	cɯ˩˧
chứa	cɯə˩˧
chức	cɯk˦˥
chứng	cɯŋ˩˧
chừ	cɯ˦˨
chừa	cɯə˦˨
chừng	cɯŋ˦˨
chửa	cɯə˧˩˨
chửi	cɯj˧˩˨
chữ	cɯ˧˩˨
chữa	cɯə˧˩˨
chững	cɯŋ˧˩˨
chực	cɯk˨ˀ˩ʔ
co	kɔ˧
co	kɔ˧˥
coi	kɔj˧˥
com	kɔm˧˥
con	kɔn˧
con	kɔŋm˧˥
cong	kɔŋm˧˥
coóc	kɔkp˦˥
cu	ku˧˥
cua	kuə˧˥
cui	kuj˧˥
cum	kum˧˥
cun	kuŋm˧˥
cung	kuŋm˧˥
cuốc	kuək˦˥
cuối	kuəj˩˧
cuốn	kuəŋ˩˧
cuống	kuəŋ˩˧
cuồn	kuəŋ˦˨
cuồng	kuəŋ˦˨
cuộc	kuək˨ˀ˩ʔ
cuội	kuəj˨ˀ˩ʔ
cuộn	kuəŋ˨ˀ˩ʔ
cuộng	kuəŋ˨ˀ˩ʔ
cà	ka˦˨
cà-phê	ka˦˨-fe˧˥
cài	kaj˦˨
càn	kaŋ˦˨
càng	kaŋ˦˨
cành	kan˦˨
cào	kaw˦˨
càu	kăw˦˨
cày	kăj˦˨
cá	ka˩˧
các	kak˦˥
các-tông	kak˦˥-toŋm˧˥
cách	kak˦˥
cách	kaːk˧˥
cái	kaj˩˧
cám	kam˩˧
cán	kaŋ˩˧
cáng	kaŋ˩˧
cánh	kan˩˧
cáo	kaw˩˧
cáp	kap˦˥
cát	kak˦˥
cáu	kăw˩˧
cáy	kăj˩˧
câm	kɤ̆m˧˥
cân	kɤ̆ŋ˧˥
câng	kɤ̆ŋ˧˥
câu	kɤ̆w˧˥
cây	kɤ̆j˧˥
cãi	kaj˧˩˨
cò	kɔ˦˨
còi	kɔj˦˨
còm	kɔm˦˨
còn	kɔn˧
còn	kɔŋm˦˨
còng	kɔŋm˦˨
có	kɔ˧˥
có	kɔ˩˧
cóc	kɔkp˦˥
cói	kɔj˩˧
cóm	kɔm˩˧
cóng	kɔŋm˩˧
cóp	kɔp˦˥
cót	kɔkp˦˥
cô	ko˧
cô	ko˧˥
cô-đê	ko˧˥-de˧˥
côi	koj˧˥
côm	kom˧˥
côn	koŋm˧˥
công	koŋm˧˥
công-xinh	koŋm˧˥-sin˧˥
cõi	kɔj˧˩˨
cõng	kɔŋm˧˩˨
cù	ku˦˨
cùi	kuj˦˨
cùm	kum˦˨
cùn	kuŋm˦˨
cùng	kuŋm˦˨
cú	ku˩˧
cúc	kukp˦˥
cúi	kuj˩˧
cúm	kum˩˧
cúng	kuŋm˩˧
cúp	kup˦˥
cút	kukp˦˥
căm	kăm˧˥
căn	kăŋ˧˥
căng	kăŋ˧˥
cũ	ku˧˩˨
cũ	ku˨˩
cũi	kuj˧˩˨
cũn	kuŋm˧˩˨
cũng	kuŋm˧˩˨
cơ	kɤ˧˥
cơi	kɤj˧˥
cơm	kɤm˧˥
cơn	kɤŋ˧˥
cư	kɯ˧˥
cưa	kɯə˧˥
cưng	kɯŋ˧˥
cưu	kɯw˧˥
cương	kɯəŋ˧˥
cước	kɯək˦˥
cưới	kɯəj˩˧
cướp	kɯəp˦˥
cười	kɯəj˦˨
cườm	kɯəm˦˨
cường	kɯəŋ˦˨
cưỡi	kɯəj˧˩˨
cưỡng	kɯəŋ˧˩˨
cạc	kak˨ˀ˩ʔ
cạch	kak˨ˀ˩ʔ
cạm	kam˨ˀ˩ʔ
cạn	kaŋ˨ˀ˩ʔ
cạnh	kan˨ˀ˩ʔ
cạo	kaw˨ˀ˩ʔ
cạp	kap˨ˀ˩ʔ
cạy	kăj˨ˀ˩ʔ
cả	ka˧˩˨
cải	kaj˧˩˨
cảm	kam˧˩˨
cản	kaŋ˧˩˨
cảng	kaŋ˧˩˨
cảnh	kan˧˩˨
cảo	kaw˧˩˨
cảu	kăw˧˩˨
cảy	kăj˧˩˨
cấc	kɤ̆k˦˥
cấm	kɤ̆m˩˧
cấn	kɤ̆ŋ˩˧
cấp	kɤ̆p˦˥
cất	kɤ̆k˦˥
cấu	kəu˧˥
cấu	kɤ̆w˩˧
cấy	kɤ̆j˩˧
cầm	kəm˧˥
cầm	kɤ̆m˦˨
cần	kɤ̆ŋ˦˨
cầu	kɤ̆w˦˨
cầy	kɤ̆j˦˨
cẩm	kɤ̆m˧˩˨
cẩn	kɤ̆ŋ˧˩˨
cẩu	kɤ̆w˧˩˨
cậm	kɤ̆m˨ˀ˩ʔ
cận	kɤ̆ŋ˨ˀ˩ʔ
cập	kɤ̆p˨ˀ˩ʔ
cật	kɤ̆k˨ˀ˩ʔ
cậu	kɤ̆w˨ˀ˩ʔ
cậy	kɤ̆j˨ˀ˩ʔ
cắc	kăk˦˥
cắm	kăm˩˧
cắn	kăŋ˩˧
cắp	kăp˦˥
cắt	kat˧˥
cắt	kăk˦˥
cằm	kăm˦˨
cằn	kăŋ˦˨
cẳn	kăŋ˧˩˨
cẳng	kăŋ˧˩˨
cặc	kăk˨ˀ˩ʔ
cặm	kăm˨ˀ˩ʔ
cặn	kăŋ˨ˀ˩ʔ
cặp	kăp˨ˀ˩ʔ
cọ	kɔ˨ˀ˩ʔ
cọc	kɔkp˨ˀ˩ʔ
cọm	kɔm˨ˀ˩ʔ
cọp	kɔp˨ˀ˩ʔ
cọt	kɔkp˨ˀ˩ʔ
cỏ	kɔ˧˩˨
cỏ	kɔ˨˩
cỏm	kɔm˧˩˨
cỏn	kɔŋm˧˩˨
cỏng	kɔŋm˧˩˨
cố	ko˧˥
cố	ko˩˧
cốc	kokp˦˥
cối	koj˧˥
cối	koj˩˧
cốm	kom˩˧
cống	koŋm˩˧
cốp	kop˦˥
cốt	kokp˦˥
cồ	ko˦˨
cồm	kom˦˨
cồn	koŋm˦˨
cồng	koŋm˦˨
cổ	ko˧˩˨
cổ	ko˨˩
cổi	koj˧˩˨
cổn	koŋm˧˩˨
cổng	koŋm˧˩˨
cỗ	ko˧˩˨
cỗi	koj˧˩˨
cộc	kokp˨ˀ˩ʔ
cội	koj˨ˀ˩ʔ
cộng	koŋm˨ˀ˩ʔ
cột	kokp˨ˀ˩ʔ
cớ	kɤ˩˧
cớn	kɤŋ˩˧
cớt	kɤk˦˥
cờ	kɤ˦˨
cời	kɤj˦˨
cờn	kɤŋ˦˨
cởi	kɤj˧˩˨
cỡn	kɤŋ˧˩˨
cợt	kɤk˨ˀ˩ʔ
cụ	ku˨ˀ˩ʔ
cục	kukp˨ˀ˩ʔ
cụi	kuj˨ˀ˩ʔ
cụm	kum˨ˀ˩ʔ
cụng	kuŋm˨ˀ˩ʔ
cụp	kup˨ˀ˩ʔ
cụt	kukp˨ˀ˩ʔ
củ	ku˧˩˨
của	kuə˧˩˨
củi	kuj˧˩˨
củng	kuŋm˧˩˨
cứ	kɨ˧˥
cứ	kɯ˩˧
cứa	kɯə˩˧
cức	kɯk˦˥
cứng	kɯŋ˩˧
cứt	kɯk˦˥
cứu	kɯw˩˧
cừ	kɯ˦˨
cừu	kɯw˦˨
cử	kɨ˧˥
cử	kɯ˧˩˨
cửa	kɯə˧˩˨
cửi	kɯj˧˩˨
cửu	kɯw˧˩˨
cự	kɯ˨ˀ˩ʔ
cựa	kɯə˨ˀ˩ʔ
cực	kɯk˨ˀ˩ʔ
cựu	kɯw˨ˀ˩ʔ
da	ja˧˥
da	zaː˧
dai	jaj˧˥
dan	jaŋ˧˥
dang	jaŋ˧˥
danh	jan˧˥
dao	jaw˧˥
day	jăj˧˥
de	jɛ˧˥
deo	jeo˧˥
di	ji˧˥
dinh	jin˧˥
diêm	jiəm˧˥
diên	jiəŋ˧˥
diếc	jiək˦˥
diếp	jiəp˦˥
diềm	jiəm˦˨
diều	jiəw˦˨
diễm	jiəm˧˩˨
diễn	jiəŋ˧˩˨
diễu	jiəw˧˩˨
diệc	jiək˨ˀ˩ʔ
diệm	jiəm˨ˀ˩ʔ
diện	jiəŋ˨ˀ˩ʔ
diệp	jiəp˨ˀ˩ʔ
diệt	jiək˨ˀ˩ʔ
diệu	jiəw˨ˀ˩ʔ
do	jɔ˧˥
doanh	jwan˧˥
doi	jɔj˧˥
dong	jɔŋm˧˥
doạ	jwa˨ˀ˩ʔ
du	ju˧˥
dua	juə˧˥
dun	juŋm˧˥
dung	juŋm˧˥
duy	jwi˧˥
duyên	jwiəŋ˧˥
duyệt	jwiək˨ˀ˩ʔ
duật	jwɤ̆k˨ˀ˩ʔ
duềnh	jwen˦˨
duốc	juək˦˥
duỗi	juəj˧˩˨
dà	ja˦˨
dài	jaj˦˨
dàn	jaŋ˦˨
dàng	jaŋ˦˨
dành	jan˦˨
dào	jaw˦˨
dàu	jăw˦˨
dày	jăj˦˨
dái	jaj˩˧
dám	jam˩˧
dán	jaŋ˩˧
dáng	jaŋ˩˧
dáo	jaw˩˧
dát	jak˦˥
dáu	jăw˩˧
dâm	jɤ̆m˧˥
dân	jɤ̆ŋ˧˥
dâng	jɤ̆ŋ˧˥
dâu	jɤ̆w˧˥
dây	jɤ̆j˧˥
dã	ja˧˩˨
dãi	jaj˧˩˨
dãn	jaŋ˧˩˨
dãy	jăj˧˩˨
dè	jɛ˦˨
dèn	jɛŋ˦˨
dé	jɛ˩˧
dép	jɛp˦˥
dê	je˧˥
dì	ji˦˨
dìu	jiw˦˨
dí	ji˩˧
dích	jit˦˥
dính	jin˩˧
díp	jip˦˥
díu	jiw˩˧
dò	jɔ˦˨
dòi	jɔj˦˨
dòm	jɔm˦˨
dòng	jɔŋm˦˨
dó	jɔ˩˧
dóc	jɔkp˦˥
dóng	jɔŋm˩˧
dô	jo˧˥
dôi	joj˧˥
dông	joŋm˧˥
dõi	jɔj˧˩˨
dõng	jɔŋm˧˩˨
dù	du˧˨
dù	ju˦˨
dùi	juj˦˨
dùng	juŋm˦˨
dúi	juj˩˧
dúm	jum˩˧
dún	juŋm˩˧
dúng	juŋm˩˧
dút	jukp˦˥
dăm	jăm˧˥
dăn	jăŋ˧˥
dăng	jăŋ˧˥
dĩ	ji˧˩˨
dĩnh	jin˧˩˨
dũ	ju˧˩˨
dũng	juŋm˧˩˨
dơ	jɤ˧˥
dơi	jɤj˧˥
dư	jɯ˧˥
dưa	jɯə˧˥
dưng	jɯŋ˧˥
dương	jɯəŋ˧˥
dưới	jɯəj˩˧
dường	jɯəŋ˦˨
dưỡng	jɯəŋ˧˩˨
dược	jɯək˨ˀ˩ʔ
dạ	ja˨ˀ˩ʔ
dạc	jak˨ˀ˩ʔ
dại	jaj˨ˀ˩ʔ
dạm	jam˨ˀ˩ʔ
dạn	jaŋ˨ˀ˩ʔ
dạng	jaŋ˨ˀ˩ʔ
dạo	jaw˨ˀ˩ʔ
dạt	dat˧˥
dạt	jak˨ˀ˩ʔ
dạy	jăj˨ˀ˩ʔ
dải	jaj˧˩˨
dảy	jăj˧˩˨
dấm	jɤ̆m˩˧
dấn	jɤ̆ŋ˩˧
dấp	jɤ̆p˦˥
dấu	jɤ̆w˩˧
dấy	jɤ̆j˩˧
dầm	jɤ̆m˦˨
dần	jɤ̆ŋ˦˨
dầu	jɤ̆w˦˨
dẫm	jɤ̆m˧˩˨
dẫn	jɤ̆ŋ˧˩˨
dẫu	jɤ̆w˧˩˨
dẫy	jɤ̆j˧˩˨
dậm	jɤ̆m˨ˀ˩ʔ
dận	jɤ̆ŋ˨ˀ˩ʔ
dập	jɤ̆p˨ˀ˩ʔ
dật	jɤ̆k˨ˀ˩ʔ
dậu	jɤ̆w˨ˀ˩ʔ
dậy	jɤ̆j˨ˀ˩ʔ
dậy	zəj˧˥
dắm	jăm˩˧
dắt	jăk˦˥
dằn	jăŋ˦˨
dằng	jăŋ˦˨
dẳn	jăŋ˧˩˨
dẳng	jăŋ˧˩˨
dặc	jăk˨ˀ˩ʔ
dặm	jăm˨ˀ˩ʔ
dặn	jăŋ˨ˀ˩ʔ
dặng	jăŋ˨ˀ˩ʔ
dặt	jăk˨ˀ˩ʔ
dẹp	jɛp˨ˀ˩ʔ
dẹt	jɛk˨ˀ˩ʔ
dẻ	jɛ˧˩˨
dẻo	jeo˧˩˨
dẽ	jɛ˧˩˨
dế	je˩˧
dề	je˦˨
dền	jen˦˨
dềnh	jen˦˨
dể	je˧˩˨
dễ	je˧˩˨
dệnh	jen˨ˀ˩ʔ
dệt	jet˨ˀ˩ʔ
dỉ	ji˧˩˨
dị	ji˨ˀ˩ʔ
dịch	jit˨ˀ˩ʔ
dịch	zɪk˧˥
dịp	jip˨ˀ˩ʔ
dịu	jiw˨ˀ˩ʔ
dọ	jɔ˨ˀ˩ʔ
dọa	jwa˨ˀ˩ʔ
dọc	jɔkp˨ˀ˩ʔ
dọn	jɔŋm˨ˀ˩ʔ
dốc	jokp˦˥
dối	joj˩˧
dốt	jokp˦˥
dồi	joj˦˨
dồn	joŋm˦˨
dồng	joŋm˦˨
dỗ	jo˧˩˨
dội	joj˨ˀ˩ʔ
dộng	joŋm˨ˀ˩ʔ
dột	jokp˨ˀ˩ʔ
dớ	jɤ˩˧
dớn	jɤŋ˩˧
dời	jɤj˦˨
dờn	jɤŋ˦˨
dở	jɤ˧˩˨
dỡ	jɤ˧˩˨
dụ	ju˨ˀ˩ʔ
dụ	zu˧˨
dục	jukp˨ˀ˩ʔ
dụm	jum˨ˀ˩ʔ
dụng	juŋm˨ˀ˩ʔ
dứa	jɯə˩˧
dức	jɯk˦˥
dứt	jɯk˦˥
dứt	zɨt˧˥
dừ	jɯ˦˨
dừa	jɯə˦˨
dừng	jɯŋ˦˨
dử	jɯ˧˩˨
dửng	jɯŋ˧˩˨
dữ	jɯ˧˩˨
dự	jɯ˨ˀ˩ʔ
dựa	jɯə˨ˀ˩ʔ
dựng	jɯŋ˨ˀ˩ʔ
e	ɛ˧˥
em	ɛm˧
em	ɛm˧˥
en	ɛŋ˧˥
eng	ɛŋ˧˥
eo	eo˧˥
ga	ɣa˧˥
gai	ɣaj˧˥
gan	ɣaŋ˧˥
gang	ɣaŋ˧˥
ganh	ɣan˧˥
gau	ɣăw˧˥
gay	ɣăj˧˥
ghe	ɣɛ˧˥
ghen	ɣɛŋ˧˥
ghi	ɣi˧˥
ghim	ɣim˧˥
ghiền	ɣiəŋ˦˨
ghè	ɣɛ˦˨
ghèn	ɣɛŋ˦˨
ghé	ɣɛ˩˧
ghép	ɣɛp˦˥
ghét	ɣɛk˦˥
ghê	ɣe˧˥
ghẹ	ɣɛ˨ˀ˩ʔ
ghẹo	ɣeo˨ˀ˩ʔ
ghẻ	ɣɛ˧˩˨
ghế	ɣe˩˧
ghểnh	ɣen˧˩˨
gi	ji˧˥
gia	ja˧˥
giai	jaj˧˥
giam	jam˧˥
gian	jaŋ˧˥
giang	jaŋ˧˥
giao	jaw˧˥
giau	jăw˧˥
gieo	jeo˧˥
gio	jɔ˧˥
gion	jɔŋm˧˥
giong	jɔŋm˧˥
giu	ju˧˥
giun	juŋm˧˥
già	ja˦˨
già	zaː˧
giàn	jaŋ˦˨
giàng	jaŋ˦˨
giành	jan˦˨
giàu	jăw˦˨
giày	jăj˦˨
giá	ja˩˧
giá	zaː˧˥
giác	jak˦˥
giám	jam˩˧
gián	jaŋ˩˧
giáng	jaŋ˩˧
giáo	jaw˩˧
giáp	jap˦˥
giát	jak˦˥
giâu	jɤ̆w˧˥
giây	jɤ̆j˧˥
giã	ja˧˩˨
giãi	jaj˧˩˨
giãn	jaŋ˧˩˨
giãy	jăj˧˩˨
gièm	jɛm˦˨
giéo	jeo˩˧
giêng	jen˧˥
giò	jɔ˦˨
giòi	jɔj˦˨
giòn	jɔŋm˦˨
gió	jɔ˩˧
gió	zɔ˧˥
gióng	jɔŋm˩˧
giôn	joŋm˧˥
giông	joŋm˧˥
giùi	juj˦˨
giùm	jum˦˨
giúi	juj˩˧
giúp	jup˦˥
giúp	zup˧˥
giăm	jăm˧˥
giăng	jăŋ˧˥
giũ	ju˧˩˨
giũa	juə˧˩˨
giơ	jɤ˧˥
giương	jɯəŋ˧˥
giường	jɯəŋ˦˨
giạc	jak˨ˀ˩ʔ
giạng	jaŋ˨ˀ˩ʔ
giạt	jak˨ˀ˩ʔ
giả	ja˧˩˨
giải	jaj˧˩˨
giảm	jam˧˩˨
giản	jaŋ˧˩˨
giảng	jaŋ˧˩˨
giảo	jaw˧˩˨
giảu	jăw˧˩˨
giấc	jɤ̆k˦˥
giấc	zək˧˥
giấm	jɤ̆m˩˧
giấn	jɤ̆ŋ˩˧
giấp	jɤ̆p˦˥
giấu	jɤ̆w˩˧
giấy	jɤ̆j˩˧
giầm	jɤ̆m˦˨
giần	jɤ̆ŋ˦˨
giầu	jɤ̆w˦˨
giầy	jɤ̆j˦˨
giẫm	jɤ̆m˧˩˨
giẫy	jɤ̆j˧˩˨
giậm	jɤ̆m˨ˀ˩ʔ
giận	jɤ̆ŋ˨ˀ˩ʔ
giập	jɤ̆p˨ˀ˩ʔ
giật	jɤ̆k˨ˀ˩ʔ
giật	zət˧˥
giậu	jɤ̆w˨ˀ˩ʔ
giắm	jăm˩˧
giắng	jăŋ˩˧
giắt	jăk˦˥
giằn	jăŋ˦˨
giằng	jăŋ˦˨
giặc	jăk˨ˀ˩ʔ
giặt	jăk˨ˀ˩ʔ
giẹo	jeo˨ˀ˩ʔ
giẹp	jɛp˨ˀ˩ʔ
giẻ	jɛ˧˩˨
giếc	jet˦˥
giếng	jen˩˧
giết	jet˦˥
giền	jen˦˨
giềng	jen˦˨
giễu	jɛu˧˩˨
giọng	jɔŋm˨ˀ˩ʔ
giọt	jɔkp˨ˀ˩ʔ
giỏ	jɔ˧˩˨
giỏi	jɔj˧˩˨
giỏng	jɔŋm˧˩˨
giối	joj˩˧
giống	joŋm˩˧
giồi	joj˦˨
giồng	joŋm˦˨
giỗ	jo˧˩˨
giội	joj˨ˀ˩ʔ
giới	jɤj˩˧
giờ	jɤ˦˨
giời	jɤj˦˨
giở	jɤ˧˩˨
giục	jukp˨ˀ˩ʔ
giữ	jɯ˧˩˨
giữa	jɯə˧˩˨
gom	ɣɔm˧˥
goá	ɣwa˩˧
goòng	ɣɔŋm˦˨
guốc	ɣuək˦˥
guồng	ɣuəŋ˦˨
guột	ɣuək˨ˀ˩ʔ
gà	ɣa˦˨
gài	ɣaj˦˨
gàn	ɣaŋ˦˨
gào	ɣaw˦˨
gàu	ɣăw˦˨
gày	ɣăj˦˨
gá	ɣa˩˧
gác	ɣak˦˥
gái	ɣaj˩˧
gán	ɣaŋ˩˧
gánh	ɣan˩˧
gáo	ɣaw˩˧
gáy	ɣăj˩˧
gâm	ɣɤ̆m˧˥
gân	ɣɤ̆ŋ˧˥
gâu	ɣɤ̆w˧˥
gây	ɣɤ̆j˧˥
gãi	ɣaj˧˩˨
gãy	ɣăj˧˩˨
gì	ɣi˦˨
gìn	zin˦˨
gò	ɣɔ˦˨
gòn	ɣɔŋm˦˨
gòn-gia	ɣɔŋm˦˨-ja˧˥
góa	ɣwa˩˧
góc	ɣɔkp˦˥
gói	ɣɔj˩˧
góp	ɣɔp˦˥
gót	ɣɔkp˦˥
gô	ɣo˧˥
gôm	ɣom˧˥
gông	ɣoŋm˧˥
gõ	ɣɔ˧˩˨
gùn	ɣuŋm˦˨
gút	ɣukp˦˥
găm	ɣăm˧˥
găn	ɣăŋ˧˥
găng	ɣăŋ˧˥
gươm	ɣɯəm˧˥
gương	ɣɯəŋ˧˥
gườm	ɣɯəm˦˨
gường	ɣɯəŋ˦˨
gượng	ɣɯəŋ˨ˀ˩ʔ
gạ	ɣa˨ˀ˩ʔ
gạc	ɣak˨ˀ˩ʔ
gạch	ɣak˨ˀ˩ʔ
gạn	ɣaŋ˨ˀ˩ʔ
gạo	ɣaw˨ˀ˩ʔ
gạt	ɣak˨ˀ˩ʔ
gả	ɣa˧˩˨
gảy	ɣăj˧˩˨
gấm	ɣɤ̆m˩˧
gấp	ɣɤ̆p˦˥
gấu	ɣɤ̆w˩˧
gấy	ɣɤ̆j˩˧
gầm	ɣɤ̆m˦˨
gần	ɣɤ̆ŋ˦˨
gầu	ɣɤ̆w˦˨
gầy	ɣɤ̆j˦˨
gẩy	ɣɤ̆j˧˩˨
gẫu	ɣɤ̆w˧˩˨
gẫy	ɣɤ̆j˧˩˨
gậm	ɣɤ̆m˨ˀ˩ʔ
gập	ɣɤ̆p˨ˀ˩ʔ
gật	ɣɤ̆k˨ˀ˩ʔ
gậy	ɣɤ̆j˨ˀ˩ʔ
gắm	ɣăm˩˧
gắn	ɣăŋ˩˧
gắng	ɣăŋ˩˧
gắp	ɣăp˦˥
gắt	ɣăk˦˥
gằm	ɣăm˦˨
gằn	ɣăŋ˦˨
gặc	ɣăk˨ˀ˩ʔ
gặm	ɣăm˨ˀ˩ʔ
gặng	ɣăŋ˨ˀ˩ʔ
gặp	ɣăp˨ˀ˩ʔ
gặt	ɣăk˨ˀ˩ʔ
gỉ	ɣi˧˩˨
gọ	ɣɔ˨ˀ˩ʔ
gọi	ɣɔj˨ˀ˩ʔ
gọn	ɣɔŋm˨ˀ˩ʔ
gọng	ɣɔŋm˨ˀ˩ʔ
gọt	ɣɔkp˨ˀ˩ʔ
gỏi	ɣɔj˧˩˨
gốc	ɣokp˦˥
gối	ɣoj˩˧
gồ	ɣo˦˨
gồng	ɣoŋm˦˨
gỗ	ɣo˧˩˨
gội	ɣoj˨ˀ˩ʔ
gộp	ɣop˨ˀ˩ʔ
gột	ɣokp˨ˀ˩ʔ
gớm	ɣɤm˩˧
gờ	ɣɤ˦˨
gờm	ɣɤm˦˨
gờn	ɣɤŋ˦˨
gở	ɣɤ˧˩˨
gởi	ɣɤj˧˩˨
gỡ	ɣɤ˧˩˨
gợi	ɣɤj˨ˀ˩ʔ
gợn	ɣɤŋ˨ˀ˩ʔ
gục	ɣukp˨ˀ˩ʔ
gừ	ɣɯ˦˨
gừng	ɣɯŋ˦˨
gửi	ɣɯj˧˩˨
ha	ha˧˥
hai	haj˧˥
ham	ham˧˥
han	haŋ˧˥
hang	haŋ˧˥
hanh	han˧˥
hao	haw˧˥
hau	hăw˧˥
hay	hăj˧˥
hen	hɛŋ˧˥
heo	heo˧˥
hi	hi˧˥
him	him˧˥
hinh	hin˧˥
hiu	hiw˧˥
hiên	hiəŋ˧˥
hiêng	hiəŋ˧˥
hiếm	hiəm˩˧
hiến	hiəŋ˩˧
hiếp	hiəp˦˥
hiếu	hiəw˩˧
hiềm	hiəm˦˨
hiền	hiəŋ˦˨
hiểm	hiəm˧˩˨
hiển	hiəŋ˧˩˨
hiểu	hiəw˧˩˨
hiện	hiəŋ˨ˀ˩ʔ
hiệp	hiəp˨ˀ˩ʔ
hiệu	hiəw˨ˀ˩ʔ
ho	hɔ˧˥
hoa	hwa˧˥
hoan	hwaŋ˧˥
hoang	hwaŋ˧˥
hoay	hwăj˧˥
hoe	hwe˧˥
hoen	hwen˧˥
hoi	hɔj˧˥
hom	hɔm˧˥
hon	hɔŋm˧˥
hong	hɔŋm˧˥
hoà	hwa˦˨
hoài	hwaj˦˨
hoàn	hwaŋ˦˨
hoàng	hwaŋ˦˨
hoành	hwan˦˨
hoá	hwa˩˧
hoác	hwak˦˥
hoán	hwaŋ˩˧
hoãn	hwaŋ˧˩˨
hoè	hwe˦˨
hoăm	hwăm˧˥
hoăng	hwăŋ˧˥
hoạ	hwa˨ˀ˩ʔ
hoạch	hwak˨ˀ˩ʔ
hoại	hwaj˨ˀ˩ʔ
hoạn	hwaŋ˨ˀ˩ʔ
hoạnh	hwan˨ˀ˩ʔ
hoạt	hwak˨ˀ˩ʔ
hoả	hwa˧˩˨
hoải	hwaj˧˩˨
hoảng	hwaŋ˧˩˨
hoắc	hwăk˦˥
hoắm	hwăm˩˧
hoặc	hwăk˨ˀ˩ʔ
hoặc	hɔək˧˥
hoặn	hwăŋ˨ˀ˩ʔ
hu	hu˧˥
hui	huj˧˥
hum	hum˧˥
hun	huŋm˧˥
hung	huŋm˧˥
huy	hwi˧˥
huynh	hwin˧˥
huyên	hwiəŋ˧˥
huyết	hwiək˦˥
huyền	hwiəŋ˦˨
huyễn	hwiəŋ˧˩˨
huyện	hwiəŋ˨ˀ˩ʔ
huyệt	hwiək˨ˀ˩ʔ
huân	hwɤ̆ŋ˧˥
huê	hwe˧˥
huênh	hwen˧˥
huý	hwi˩˧
huých	hwit˦˥
huýt	hwit˦˥
huơ	huə˧˥
huấn	hwɤ̆ŋ˩˧
huếch	hwet˦˥
huề	hwe˦˨
huệ	hwe˨ˀ˩ʔ
huống	huəŋ˩˧
huỳnh	hwin˦˨
huỵch	hwit˨ˀ˩ʔ
huỷ	hwi˧˩˨
hy	hi˧˥
hà	haː˧˨
hà	ha˦˨
hà-đông	ha˦˨-doŋm˧˥
hài	haj˦˨
hàm	ham˦˨
hàn	haŋ˦˨
hàng	haŋ˦˨
hàng	haːŋ˧
hành	han˦˨
hào	haw˦˨
há	ha˩˧
hách	hak˦˥
hái	haj˩˧
hám	ham˩˧
hán	haŋ˩˧
hánh	han˩˧
háo	haw˩˧
hát	hak˦˥
háu	hăw˩˧
háy	hăj˩˧
hâm	hɤ̆m˧˥
hân	hɤ̆ŋ˧˥
hây	hɤ̆j˧˥
hãi	haj˧˩˨
hãm	ham˧˩˨
hãn	haŋ˧˩˨
hãng	haŋ˧˩˨
hãnh	han˧˩˨
hão	haw˧˩˨
hãy	hăj˧˩˨
hè	hɛ˦˨
hèm	hɛm˦˨
hèn	hɛŋ˦˨
hèo	heo˦˨
hé	hɛ˩˧
héc	hɛk˦˥
héo	heo˩˧
hét	hɛk˦˥
hên	hen˧˥
hênh	hen˧˥
hì	hi˦˨
hình	hin˦˨
hí	hi˩˧
híp	hip˦˥
hít	hit˦˥
hò	hɔ˦˨
hòa	hwa˦˨
hòm	hɔm˦˨
hòn	hɔŋm˦˨
hòng	hɔŋm˦˨
hó	hɔ˩˧
hóa	hwa˩˧
hóc	hɔkp˦˥
hói	hɔj˩˧
hóm	hɔm˩˧
hóng	hɔŋm˩˧
hóp	hɔp˦˥
hót	hɔkp˦˥
hô	ho˧˥
hôi	hoj˧˥
hôm	hom˧˥
hôn	hoŋm˧˥
hông	hoŋm˧˥
hù	hu˦˨
hùi	huj˦˨
hùm	hum˦˨
hùn	huŋm˦˨
hùng	huŋm˦˨
hú	hu˩˧
húc	hukp˦˥
húng	huŋm˩˧
húp	hup˦˥
hút	hukp˦˥
húy	huj˩˧
hăm	hăm˧˥
hăng	hăŋ˧˥
hũ	hu˧˩˨
hũ	hu˨˩
hơ	hɤ˧˥
hơi	hɤj˧˥
hơn	hɤŋ˧˥
hư	hɯ˧˥
hưng	hɯŋ˧˥
hưu	hɯw˧˥
hương	hɯəŋ˧˥
hươu	hɯəw˧˥
hướng	hɯəŋ˩˧
hưởng	hɯəŋ˧˩˨
hạ	ha˨ˀ˩ʔ
hạc	hak˨ˀ˩ʔ
hạch	hak˨ˀ˩ʔ
hại	haj˨ˀ˩ʔ
hạm	ham˨ˀ˩ʔ
hạn	haŋ˨ˀ˩ʔ
hạng	haŋ˨ˀ˩ʔ
hạnh	han˨ˀ˩ʔ
hạo	haw˨ˀ˩ʔ
hạp	hap˨ˀ˩ʔ
hạt	hak˨ˀ˩ʔ
hả	ha˧˩˨
hải	haj˧˩˨
hảo	haw˧˩˨
hấm	hɤ̆m˩˧
hấn	hɤ̆ŋ˩˧
hấp	hɤ̆p˦˥
hất	hɤ̆k˦˥
hầm	hɤ̆m˦˨
hầu	hɤ̆w˦˨
hẩm	hɤ̆m˧˩˨
hẩu	hɤ̆w˧˩˨
hẫng	hɤ̆ŋ˧˩˨
hậm	hɤ̆m˨ˀ˩ʔ
hận	hɤ̆ŋ˨ˀ˩ʔ
hậu	hɤ̆w˨ˀ˩ʔ
hắc	hăk˦˥
hắn	hăŋ˩˧
hắng	hăŋ˩˧
hắt	hăk˦˥
hằm	hăm˦˨
hằn	hăŋ˦˨
hằng	hăŋ˦˨
hẳn	hăŋ˧˩˨
hặc	hăk˨ˀ˩ʔ
hặm	hăm˨ˀ˩ʔ
hẹn	hɛŋ˨ˀ˩ʔ
hẹp	hɛp˨ˀ˩ʔ
hẻm	hɛm˧˩˨
hẻo	heo˧˩˨
hếch	het˦˥
hết	het˦˥
hề	he˦˨
hề	he˧
hềnh	hen˦˨
hể	he˧˩˨
hểnh	hen˧˩˨
hểu	hɛu˧˩˨
hệ	he˨ˀ˩ʔ
hệch	het˨ˀ˩ʔ
hỉ	hi˧˩˨
hỉnh	hin˧˩˨
hịch	hit˨ˀ˩ʔ
họ	hɔ˨ˀ˩ʔ
họa	hwa˨ˀ˩ʔ
học	hɔkp˨ˀ˩ʔ
họng	hɔŋm˨ˀ˩ʔ
họp	hɔp˨ˀ˩ʔ
hỏa	hwa˧˩˨
hỏi	hɔj˧˩˨
hỏm	hɔm˧˩˨
hỏn	hɔŋm˧˩˨
hỏng	hɔŋm˧˩˨
hố	ho˩˧
hốc	hokp˦˥
hối	hoj˩˧
hống	hoŋm˩˧
hốt	hokp˦˥
hồ	ho˦˨
hồ	ho˧
hồi	hoj˦˨
hồn	hoŋm˦˨
hồng	hoŋm˦˨
hổ	ho˧˩˨
hổi	hoj˧˩˨
hổm	hom˧˩˨
hổn	hoŋm˧˩˨
hổng	hoŋm˧˩˨
hỗ	ho˧˩˨
hỗn	hoŋm˧˩˨
hỗng	hoŋm˧˩˨
hộ	ho˨ˀ˩ʔ
hộc	hokp˨ˀ˩ʔ
hội	hoj˨ˀ˩ʔ
hộn	hoŋm˨ˀ˩ʔ
hộp	hop˨ˀ˩ʔ
hột	hokp˨ˀ˩ʔ
hớ	hɤ˩˧
hớn	hɤŋ˩˧
hớp	hɤp˦˥
hớt	hɤk˦˥
hờ	hɤ˦˨
hời	hɤj˦˨
hờn	hɤŋ˦˨
hở	hɤ˧˩˨
hởi	hɤj˧˩˨
hỡi	hɤj˧˩˨
hợm	hɤm˨ˀ˩ʔ
hợp	hɤp˨ˀ˩ʔ
hục	hukp˨ˀ˩ʔ
hụp	hup˨ˀ˩ʔ
hụt	hukp˨ˀ˩ʔ
hủ	hu˧˩˨
hủn	huŋm˧˩˨
hủng	huŋm˧˩˨
hủy	huj˧˩˨
hứa	hɯə˩˧
hứng	hɯŋ˩˧
hừ	hɯ˦˨
hừng	hɯŋ˦˨
hửng	hɯŋ˧˩˨
hững	hɯŋ˧˩˨
hữu	hɯw˧˩˨
hực	hɯk˨ˀ˩ʔ
i	i˧˥
i-ôn	i˧˥-oŋm˧˥
ic	it˧˥
im	im˧˥
in	in˧
in	in˧˥
inh	in˧˥
iu	iw˧˥
ka	ka˧˥
ka-li	ka˧˥-li˧˥
ke	kɛ˧˥
kem	kɛm˧˥
ken	kɛŋ˧˥
keng	kɛŋ˧˥
keo	keo˧˥
kha	xa˧˥
khai	xaj˧˥
kham	xam˧˥
khan	xaŋ˧˥
khang	xaŋ˧˥
khanh	xan˧˥
khao	xaw˧˥
khay	xăj˧˥
khe	xɛ˧˥
khem	xɛm˧˥
khen	xɛŋ˧˥
kheo	xeo˧˥
khi	xi˧
khi	xi˧˥
khin	xin˧˥
khinh	xin˧˥
khiêm	xiəm˧˥
khiên	xiəŋ˧˥
khiêng	xiəŋ˧˥
khiêu	xiəw˧˥
khiếm	xiəm˩˧
khiếp	xiəp˦˥
khiếu	xiəw˩˧
khiển	xiəŋ˧˩˨
kho	xɔ˧˥
khoa	xwa˧˥
khoai	xwaj˧˥
khoan	xwaŋ˧˥
khoang	xwaŋ˧˥
khoanh	xwan˧˥
khoe	xwe˧˥
khoen	xwen˧˥
khoeo	xwew˧˥
khom	xɔm˧˥
khoành	xwan˦˨
khoá	xwa˩˧
khoác	xwak˦˥
khoái	xwaj˩˧
khoán	xwaŋ˩˧
khoáng	xwaŋ˩˧
khoát	xwak˦˥
khoèo	xwew˦˨
khoé	xwe˩˧
khoét	xwet˦˥
khoăm	xwăm˧˥
khoả	xwa˧˩˨
khoản	xwaŋ˧˩˨
khoảng	xwaŋ˧˩˨
khoảnh	xwan˧˩˨
khoằm	xwăm˦˨
khoẻ	xwe˧˩˨
khu	xu˧˥
khua	xuə˧˥
khum	xum˧˥
khung	xuŋm˧˥
khuy	xwi˧˥
khuya	xwiə˧˥
khuynh	xwin˧˥
khuyên	xwiəŋ˧˥
khuyến	xwiəŋ˩˧
khuyết	xwiək˦˥
khuyển	xwiəŋ˧˩˨
khuân	xwɤ̆ŋ˧˥
khuây	xwɤ̆j˧˥
khuê	xwe˧˥
khuôn	xuəŋ˧˥
khuông	xuəŋ˧˥
khuất	xwɤ̆k˦˥
khuấy	xwɤ̆j˩˧
khuẩn	xwɤ̆ŋ˧˩˨
khuếch	xwet˦˥
khuờ	xuə˦˨
khuỳnh	xwin˦˨
khyển	xiɛŋ˧˩˨
khà	xa˦˨
khàn	xaŋ˦˨
khành	xan˦˨
khá	xa˩˧
khác	xak˦˥
khác	xak˧˥
khách	xak˦˥
khái	xaj˩˧
khám	xam˩˧
khán	xaŋ˩˧
kháng	xaŋ˩˧
khánh	xan˩˧
khánh-hạ	xan˩˧-ha˨ˀ˩ʔ
khát	xak˦˥
kháu	xăw˩˧
khâm	xɤ̆m˧˥
khâng	xɤ̆ŋ˧˥
khâu	xɤ̆w˧˥
khè	xɛ˦˨
khèn	xɛŋ˦˨
khèng	xɛŋ˦˨
khé	xɛ˩˧
khéo	xeo˩˧
khép	xɛp˦˥
khét	xɛk˦˥
khê	xe˧˥
khêu	xɛu˧˥
khì	xi˦˨
khìn	xin˦˨
khí	xi˩˧
khía	xiə˩˧
khích	xit˦˥
khít	xit˦˥
khò	xɔ˦˨
khòe	xwe˦˨
khòm	xɔm˦˨
khòng	xɔŋm˦˨
khó	xɔ˧˥
khó	xɔ˩˧
khóa	xwa˩˧
khóc	xɔkp˦˥
khóe	xwe˩˧
khói	xɔj˩˧
khô	xo˧˥
khôi	xoj˧˥
khôn	xoŋm˧˥
không	xoŋm˧˥
khù	xu˦˨
khùng	xuŋm˦˨
khú	xu˩˧
khúc	xukp˦˥
khúm	xum˩˧
khúng	xuŋm˩˧
khăm	xăm˧˥
khăn	xăŋ˧˥
khăng	xăŋ˧˥
khơ	xɤ˧˥
khơ-me	xɤ˧˥-mɛ˧˥
khơ-mú	xɤ˧˥-mu˩˧
khơi	xɤj˧˥
khư	xɯ˧˥
khươm	xɯəm˧˥
khước	xɯək˦˥
khướt	xɯək˦˥
khướu	xɯəw˩˧
khạ	xa˨ˀ˩ʔ
khạc	xak˨ˀ˩ʔ
khạng	xaŋ˨ˀ˩ʔ
khả	xa˧˩˨
khảch	xak˧˩˨
khải	xaj˧˩˨
khảm	xam˧˩˨
khản	xaŋ˧˩˨
khảng	xaŋ˧˩˨
khảnh	xan˧˩˨
khảo	xaw˧˩˨
khấm	xɤ̆m˩˧
khấn	xɤ̆ŋ˩˧
khấp	xɤ̆p˦˥
khất	xɤ̆k˦˥
khấu	xɤ̆w˩˧
khầng	xɤ̆ŋ˦˨
khẩn	xɤ̆ŋ˧˩˨
khẩu	xɤ̆w˧˩˨
khậm	xɤ̆m˨ˀ˩ʔ
khập	xɤ̆p˨ˀ˩ʔ
khật	xɤ̆k˨ˀ˩ʔ
khắc	xăk˦˥
khắm	xăm˩˧
khắn	xăŋ˩˧
khắng	xăŋ˩˧
khắp	xăp˦˥
khắt	xăk˦˥
khằng	xăŋ˦˨
khẳn	xăŋ˧˩˨
khẳng	xăŋ˧˩˨
khặc	xăk˨ˀ˩ʔ
khẻ	xɛ˧˩˨
khẽ	xɛ˧˩˨
khế	xe˩˧
khề	xe˦˨
khềnh	xen˦˨
khều	xɛu˦˨
khểnh	xen˧˩˨
khễnh	xen˧˩˨
khệ	xe˨ˀ˩ʔ
khệnh	xen˨ˀ˩ʔ
khỉ	xi˧˩˨
khịt	xit˨ˀ˩ʔ
khọm	xɔm˨ˀ˩ʔ
khỏa	xwa˧˩˨
khỏe	xwe˧˩˨
khỏi	xɔj˧˩˨
khố	xo˩˧
khốc	xokp˦˥
khối	xoj˩˧
khốn	xoŋm˩˧
khống	xoŋm˩˧
khổ	xo˧˩˨
khổn	xoŋm˧˩˨
khổng	xoŋm˧˩˨
khớp	xɤp˦˥
khờ	xɤ˦˨
khởi	xɤj˧˩˨
khụ	xu˨ˀ˩ʔ
khục	xukp˨ˀ˩ʔ
khụng	xuŋm˨ˀ˩ʔ
khụt	xukp˨ˀ˩ʔ
khủ	xu˧˩˨
khủng	xuŋm˧˩˨
khứ	xɯ˩˧
khứu	xɯw˩˧
khừ	xɯ˦˨
khử	xɯ˧˩˨
khự	xɯ˨ˀ˩ʔ
ki	ki˧˥
ki-lô	ki˧˥-lo˧˥
ki-lô-oát	ki˧˥-lo˧˥-wak˦˥
ki-tô	ki˧˥-to˧˥
kia	kiə˧˥
kim	kim˧˥
kin	kin˧˥
kinh	kin˧˥
kiêm	kiəm˧˥
kiên	kiəŋ˧˥
kiêng	kiəŋ˧˥
kiêu	kiəw˧˥
kiếm	kiəm˩˧
kiến	kiəŋ˩˧
kiếp	kiəp˦˥
kiết	kiək˦˥
kiếu	kiəw˩˧
kiềm	kiəm˦˨
kiền	kiəŋ˦˨
kiềng	kiəŋ˦˨
kiều	kiəw˦˨
kiểm	kiəm˧˩˨
kiểu	kiəw˧˩˨
kiệm	kiəm˨ˀ˩ʔ
kiện	kiəŋ˨ˀ˩ʔ
kiệt	kiək˨ˀ˩ʔ
kiệu	kiəw˨ˀ˩ʔ
ky	ki˧˥
kè	kɛ˦˨
kèm	kɛm˦˨
kèn	kɛŋ˦˨
kèo	keo˦˨
ké	kɛ˩˧
kém	kɛm˩˧
kén	kɛŋ˩˧
kéo	keo˩˧
kép	kɛp˦˥
két	kɛk˦˥
kê	ke˧˥
kên	ken˧˥
kênh	ken˧˥
kêu	kɛu˧˥
kì	ki˦˨
kìa	kiə˦˨
kìm	kim˦˨
kìn	kin˦˨
kình	kin˦˨
kí	ki˩˧
kích	kit˦˥
kín	kin˩˧
kính	kin˩˧
kíp	kip˦˥
kíu	kiw˩˧
ký	ki˧˥
ký	ki˩˧
kĩ	ki˧˩˨
kĩu	kiw˧˩˨
kẹn	kɛŋ˨ˀ˩ʔ
kẹo	keo˨ˀ˩ʔ
kẹp	kɛp˨ˀ˩ʔ
kẹt	kɛk˨ˀ˩ʔ
kẻ	kɛ˧˩˨
kẻm	kɛm˧˩˨
kẻo	keo˧˩˨
kẽ	kɛ˧˩˨
kẽm	kɛm˧˩˨
kẽo	keo˧˩˨
kế	ke˩˧
kếch	ket˦˥
kết	ket˦˥
kề	ke˦˨
kềm	kem˦˨
kền	ken˦˨
kềnh	ken˦˨
kể	ke˧˩˨
kễnh	ken˧˩˨
kệ	ke˨ˀ˩ʔ
kệch	ket˨ˀ˩ʔ
kỉ	ki˧˩˨
kị	ki˨ˀ˩ʔ
kịch	kit˨ˀ˩ʔ
kịp	kip˨ˀ˩ʔ
kỳ	ki˦˨
kỵ	ki˨ˀ˩ʔ
kỷ	ki˧˩˨
kỹ	ki˧˩˨
la	la˧˥
la-mã	la˧˥-ma˧˩˨
la-tinh	la˧˥-tin˧˥
la-tê-rít	la˧˥-te˧˥-ʐit˦˥
lai	laj˧˥
lai-ly	laj˧˥-li˧˥
lai-đa	laj˧˥-da˧˥
lam	lam˧˥
lan	laŋ˧˥
lang	laŋ˧˥
lanh	lan˧˥
lao	law˧˥
lao	laːw˧
lau	lăw˧˥
lay	lăj˧˥
le	lɛ˧˥
lem	lɛm˧˥
len	lɛŋ˧˥
leng	lɛŋ˧˥
leo	leo˧˥
li	li˧˥
lia	liə˧˥
lim	lim˧˥
linh	lin˧˥
linh	liŋ˧
liu	liw˧˥
liêm	liəm˧˥
liên	liəŋ˧˥
liêng	liəŋ˧˥
liêu	liəw˧˥
liếc	liək˦˥
liếm	liəm˩˧
liến	liəŋ˩˧
liếp	liəp˦˥
liếu	liəw˩˧
liềm	liəm˦˨
liền	liəŋ˦˨
liều	liəw˦˨
liểng	liəŋ˧˩˨
liễu	liəw˧˩˨
liệm	liəm˨ˀ˩ʔ
liệt	liək˨ˀ˩ʔ
liệu	liəw˨ˀ˩ʔ
lo	lo˧
lo	lɔ˧˥
loa	lwa˧˥
loai	lwaj˧˥
loan	lwaŋ˧˥
loang	lwaŋ˧˥
loanh	lwan˧˥
loay	lwăj˧˥
loe	lwe˧˥
loen	lwen˧˥
loi	lɔj˧˥
lom	lɔm˧˥
lon	lɔŋm˧˥
long	lɔŋm˧˥
loong	lɔŋm˧˥
loà	lwa˦˨
loài	lwaj˦˨
loàng	lwaŋ˦˨
loá	lwa˩˧
loáng	lwaŋ˩˧
loáo	lwaw˩˧
loát	lwak˦˥
loáy	lwăj˩˧
loã	lwa˧˩˨
loãng	lwaŋ˧˩˨
loè	lwe˦˨
loé	lwe˩˧
loét	lwet˦˥
loăn	lwăŋ˧˥
loăng	lwăŋ˧˥
loạc	lwak˨ˀ˩ʔ
loạch	lwak˨ˀ˩ʔ
loại	lwaj˨ˀ˩ʔ
loạn	lwaŋ˨ˀ˩ʔ
loạng	lwaŋ˨ˀ˩ʔ
loạt	lwak˨ˀ˩ʔ
loả	lwa˧˩˨
loảng	lwaŋ˧˩˨
loắn	lwăŋ˩˧
loắt	lwăk˦˥
loằn	lwăŋ˦˨
loằng	lwăŋ˦˨
loẹt	lwet˨ˀ˩ʔ
loẻng	lwen˧˩˨
loẻo	lwew˧˩˨
lu	lu˧˥
lua	luə˧˥
lui	luj˧˥
lum	lum˧˥
lung	luŋm˧˥
luy	lwi˧˥
luyên	lwiəŋ˧˥
luyến	lwiəŋ˩˧
luyện	lwiəŋ˨ˀ˩ʔ
luân	lwɤ̆ŋ˧˥
luôm	luəm˧˥
luôn	luəŋ˧˥
luông	luəŋ˧˥
luýnh	lwin˩˧
luấn	lwɤ̆ŋ˩˧
luẩn	lwɤ̆ŋ˧˩˨
luận	lwɤ̆ŋ˨ˀ˩ʔ
luật	lwɤ̆k˨ˀ˩ʔ
luống	luəŋ˩˧
luốt	luək˦˥
luồn	luəŋ˦˨
luồng	luəŋ˦˨
luộm	luəm˨ˀ˩ʔ
luỵ	lwi˨ˀ˩ʔ
luỹ	lwi˧˩˨
ly	li˧˥
là	laː˧˨
là	la˦˨
lài	laj˦˨
làm	lam˦˨
làn	laŋ˦˨
làng	laŋ˦˨
lành	lan˦˨
lào	law˦˨
làu	lăw˦˨
lày	lăj˦˨
lá	la˩˧
lác	lak˦˥
lách	lak˦˥
lái	laj˩˧
lán	laŋ˩˧
láng	laŋ˩˧
lánh	lan˩˧
láo	law˩˧
láp	lap˦˥
lát	lak˦˥
láu	lăw˩˧
láy	lăj˩˧
lâm	lɤ̆m˧˥
lân	lɤ̆ŋ˧˥
lâng	lɤ̆ŋ˧˥
lâp	lɤ̆p˧˥
lâu	lɤ̆w˧˥
lây	lɤ̆j˧˥
lã	la˧˩˨
lãi	laj˧˩˨
lãm	lam˧˩˨
lãn	laŋ˧˩˨
lãng	laŋ˧˩˨
lãnh	lan˧˩˨
lão	law˧˩˨
lè	lɛ˦˨
lèm	lɛm˦˨
lèn	lɛŋ˦˨
lèo	leo˦˨
lé	lɛ˩˧
lém	lɛm˩˧
lén	lɛŋ˩˧
léng	lɛŋ˩˧
léo	leo˩˧
lép	lɛp˦˥
lét	lɛk˦˥
lê	le˧˥
lên	len˧˥
lênh	len˧˥
lêu	lɛu˧˥
lì	li˦˨
lìa	liə˦˨
lìm	lim˦˨
lình	lin˦˨
lí	li˩˧
lích	lit˦˥
lính	lin˩˧
líp	lip˦˥
lít	lit˦˥
líu	liw˩˧
lò	lɔ˦˨
lòa	lwa˦˨
lòe	lwe˦˨
lòi	lɔj˦˨
lòm	lɔm˦˨
lòn	lɔŋm˦˨
lòng	lɔŋm˦˨
ló	lɔ˩˧
lóc	lɔkp˦˥
lóm	lɔm˩˧
lóng	lɔŋm˩˧
lóp	lɔp˦˥
lót	lɔkp˦˥
lô	lo˧˥
lô-gích	lo˧˥-ɣit˦˥
lôi	loj˧˥
lôm	lom˧˥
lông	loŋm˧˥
lõ	lɔ˧˩˨
lõa	lwa˧˩˨
lõi	lɔj˧˩˨
lõm	lɔm˧˩˨
lõng	lɔŋm˧˩˨
lù	lu˦˨
lùi	luj˦˨
lùm	lum˦˨
lùn	luŋm˦˨
lùng	luŋm˦˨
lú	lu˩˧
lúa	luə˩˧
lúc	lukp˦˥
lúi	luj˩˧
lúm	lum˩˧
lún	luŋm˩˧
lúng	luŋm˩˧
lúp	lup˦˥
lút	lukp˦˥
lý	li˩˧
lăm	lăm˧˥
lăn	lăŋ˧˥
lăng	lăŋ˧˥
lĩnh	lin˧˩˨
lũ	lu˧˩˨
lũ	lu˨˩
lũm	lum˧˩˨
lũn	luŋm˧˩˨
lũng	luŋm˧˩˨
lũy	luj˧˩˨
lơ	lɤ˧˥
lơi	lɤj˧˥
lơn	lɤŋ˧˥
lư	lɯ˧˥
lưa	lɯə˧˥
lưng	lɯŋ˧˥
lưu	lɯw˧˥
lươm	lɯəm˧˥
lươn	lɯəŋ˧˥
lương	lɯəŋ˧˥
lưới	lɯəj˩˧
lướng	lɯəŋ˩˧
lướp	lɯəp˦˥
lướt	lɯək˦˥
lướu	lɯəw˩˧
lười	lɯəj˦˨
lườm	lɯəm˦˨
lường	lɯəŋ˦˨
lưởi	lɯəj˧˩˨
lưỡi	lɯəj˧˩˨
lưỡng	lɯəŋ˧˩˨
lược	lɯək˨ˀ˩ʔ
lượm	lɯəm˨ˀ˩ʔ
lượn	lɯəŋ˨ˀ˩ʔ
lượng	lɯəŋ˨ˀ˩ʔ
lượt	lɯək˨ˀ˩ʔ
lạ	laː˧˨
lạ	la˨ˀ˩ʔ
lạc	lak˨ˀ˩ʔ
lạch	lak˨ˀ˩ʔ
lại	laj˨ˀ˩ʔ
lạm	lam˨ˀ˩ʔ
lạng	laŋ˨ˀ˩ʔ
lạnh	lan˨ˀ˩ʔ
lạo	law˨ˀ˩ʔ
lạp	lap˨ˀ˩ʔ
lạt	lak˨ˀ˩ʔ
lạt	lat˧˥
lạu	lăw˨ˀ˩ʔ
lạy	lăj˨ˀ˩ʔ
lả	la˧˩˨
lải	laj˧˩˨
lảm	lam˧˩˨
lảng	laŋ˧˩˨
lảnh	lan˧˩˨
lảo	law˧˩˨
lảu	lăw˧˩˨
lảy	lăj˧˩˨
lấc	lɤ̆k˦˥
lấm	lɤ̆m˩˧
lấn	lɤ̆ŋ˩˧
lấp	lɤ̆p˦˥
lất	lɤ̆k˦˥
lấu	lɤ̆w˩˧
lấy	lɤ̆j˩˧
lầm	lɤ̆m˦˨
lần	lɤ̆ŋ˦˨
lầu	lɤ̆w˦˨
lầy	lɤ̆j˦˨
lẩm	lɤ̆m˧˩˨
lẩn	lɤ̆ŋ˧˩˨
lẩu	lɤ̆w˧˩˨
lẩy	lɤ̆j˧˩˨
lẫm	lɤ̆m˧˩˨
lẫn	lɤ̆ŋ˧˩˨
lẫy	lɤ̆j˧˩˨
lận	lɤ̆ŋ˨ˀ˩ʔ
lập	lɤ̆p˨ˀ˩ʔ
lật	lɤ̆k˨ˀ˩ʔ
lậu	lɤ̆w˨ˀ˩ʔ
lậy	lɤ̆j˨ˀ˩ʔ
lắc	lak˧˥
lắc	lăk˦˥
lắm	lăm˩˧
lắng	lăŋ˩˧
lắp	lăp˦˥
lắt	lăk˦˥
lằm	lăm˦˨
lằn	lăŋ˦˨
lằng	lăŋ˦˨
lẳn	lăŋ˧˩˨
lẳng	lăŋ˧˩˨
lẵng	lăŋ˧˩˨
lặc	lăk˨ˀ˩ʔ
lặn	lăŋ˨ˀ˩ʔ
lặng	lăŋ˨ˀ˩ʔ
lặp	lăp˨ˀ˩ʔ
lặt	lăk˨ˀ˩ʔ
lẹ	lɛ˨ˀ˩ʔ
lẹm	lɛm˨ˀ˩ʔ
lẹo	leo˨ˀ˩ʔ
lẹp	lɛp˨ˀ˩ʔ
lẹt	lɛk˨ˀ˩ʔ
lẻ	lɛ˧˩˨
lẻn	lɛŋ˧˩˨
lẻng	lɛŋ˧˩˨
lẻo	leo˧˩˨
lẽ	lɛ˧˩˨
lẽo	leo˧˩˨
lếch	let˦˥
lết	let˦˥
lếu	lɛu˩˧
lề	le˦˨
lềnh	len˦˨
lều	lɛu˦˨
lể	le˧˩˨
lểu	lɛu˧˩˨
lễ	le˧˩˨
lễu	lɛu˧˩˨
lệ	le˨ˀ˩ʔ
lệch	let˨ˀ˩ʔ
lệnh	len˨ˀ˩ʔ
lệt	let˨ˀ˩ʔ
lỉnh	lin˧˩˨
lị	li˨ˀ˩ʔ
lịch	lit˨ˀ˩ʔ
lịu	liw˨ˀ˩ʔ
lọ	lɔ˨ˀ˩ʔ
lọc	lɔkp˨ˀ˩ʔ
lọi	lɔj˨ˀ˩ʔ
lọm	lɔm˨ˀ˩ʔ
lọn	lɔŋm˨ˀ˩ʔ
lọng	lɔŋm˨ˀ˩ʔ
lọp	lɔp˨ˀ˩ʔ
lọt	lɔkp˨ˀ˩ʔ
lỏa	lwa˧˩˨
lỏm	lɔm˧˩˨
lỏn	lɔŋm˧˩˨
lỏng	lɔŋm˧˩˨
lố	lo˩˧
lốc	lokp˦˥
lối	loj˩˧
lốm	lom˩˧
lốn	loŋm˩˧
lốp	lop˦˥
lốt	lokp˦˥
lồ	lo˦˨
lồi	loj˦˨
lồm	lom˦˨
lồn	loŋm˦˨
lồng	loŋm˦˨
lổ	lo˧˩˨
lổm	lom˧˩˨
lổn	loŋm˧˩˨
lổng	loŋm˧˩˨
lỗ	lo˧˩˨
lỗi	loj˧˩˨
lỗm	lom˧˩˨
lộ	lo˨ˀ˩ʔ
lộc	lokp˨ˀ˩ʔ
lội	loj˨ˀ˩ʔ
lộm	lom˨ˀ˩ʔ
lộn	loŋm˨ˀ˩ʔ
lộng	loŋm˨ˀ˩ʔ
lộp	lop˨ˀ˩ʔ
lột	lokp˨ˀ˩ʔ
lớ	lɤ˩˧
lớn	lɤŋ˩˧
lớp	lɤp˦˥
lớt	lɤk˦˥
lờ	lɤ˦˨
lời	lɤj˦˨
lờm	lɤm˦˨
lờn	lɤŋ˦˨
lở	lɤ˧˩˨
lởm	lɤm˧˩˨
lởn	lɤŋ˧˩˨
lỡ	lə˨˩
lỡ	lɤ˧˩˨
lợ	lɤ˨ˀ˩ʔ
lợi	lɤj˨ˀ˩ʔ
lợm	lɤm˨ˀ˩ʔ
lợn	lɤŋ˨ˀ˩ʔ
lợp	lɤp˨ˀ˩ʔ
lợt	lɤk˨ˀ˩ʔ
lụ	lu˨ˀ˩ʔ
lụa	luə˨ˀ˩ʔ
lục	lukp˨ˀ˩ʔ
lụi	luj˨ˀ˩ʔ
lụm	lum˨ˀ˩ʔ
lụn	luŋm˨ˀ˩ʔ
lụng	luŋm˨ˀ˩ʔ
lụp	lup˨ˀ˩ʔ
lụt	lukp˨ˀ˩ʔ
lụy	luj˨ˀ˩ʔ
lủ	lu˧˩˨
lủa	luə˧˩˨
lủi	luj˧˩˨
lủm	lum˧˩˨
lủn	luŋm˧˩˨
lủng	luŋm˧˩˨
lứa	lɯə˩˧
lừ	lɯ˦˨
lừa	lɯə˦˨
lừng	lɯŋ˦˨
lử	lɯ˧˩˨
lửa	lɯə˧˩˨
lửng	lɯŋ˧˩˨
lữ	lɯ˧˩˨
lững	lɯŋ˧˩˨
lự	lɯ˨ˀ˩ʔ
lựa	lɯə˨ˀ˩ʔ
lực	lɯk˨ˀ˩ʔ
lựng	lɯŋ˨ˀ˩ʔ
lựu	lɯw˨ˀ˩ʔ
lỵ	li˨ˀ˩ʔ
ma	maː˧
ma	ma˧˥
ma-cà-bông	ma˧˥-ka˦˨-boŋm˧˥
mai	maj˧˥
man	maŋ˧˥
mang	maŋ˧˥
manh	man˧˥
mao	maw˧˥
mau	măw˧˥
may	măj˧˥
me	mɛ˧˥
men	mɛŋ˧˥
meo	meo˧˥
mi	mi˧˥
mim	mim˧˥
minh	min˧˥
miên	miəŋ˧˥
miêu	miəw˧˥
miếng	miəŋ˩˧
miếu	miəw˩˧
miền	miəŋ˦˨
miều	miəw˦˨
miễn	miəŋ˧˩˨
miệng	miəŋ˨ˀ˩ʔ
miệt	miək˨ˀ˩ʔ
mo	mɔ˧˥
moay	mwăj˧˥
moi	mɔj˧˥
mon	mɔŋm˧˥
mong	mɔŋm˧˥
moóc	mɔkp˦˥
mua	muə˧˥
mui	muj˧˥
mum	mum˧˥
mun	muŋm˧˥
mung	muŋm˧˥
muôn	muəŋ˧˥
muông	muəŋ˧˥
muối	muəj˩˧
muốn	muən˧˥
muốn	muəŋ˩˧
muống	muəŋ˩˧
muồm	muəm˦˨
muỗi	muəj˧˩˨
muội	muəj˨ˀ˩ʔ
muộn	muəŋ˨ˀ˩ʔ
mà	maː˧˨
mà	ma˦˨
mài	maj˦˨
màn	maŋ˦˨
màng	maŋ˦˨
mành	man˦˨
mào	maw˦˨
màu	măw˦˨
mày	măj˦˨
má	ma˩˧
mác	mak˦˥
mác-xít	mak˦˥-sit˦˥
mách	mak˦˥
mái	maj˩˧
mán	maŋ˩˧
máng	maŋ˩˧
mánh	man˩˧
mát	mak˦˥
máu	măw˩˧
máy	măj˩˧
mâm	mɤ̆m˧˥
mân	mɤ̆ŋ˧˥
mâng	mɤ̆ŋ˧˥
mâu	mɤ̆w˧˥
mây	mɤ̆j˧˥
mã	ma˧˩˨
mãi	maj˧˩˨
mãn	maŋ˧˩˨
mãng	maŋ˧˩˨
mãnh	man˧˩˨
mè	mɛ˦˨
mèo	meo˦˨
méo	meo˩˧
mép	mɛp˦˥
mét	mɛk˦˥
mê	me˧˥
mên	men˧˥
mênh	men˧˥
mì	mi˦˨
mìn	min˦˨
mình	min˦˨
mía	miə˩˧
mích	mit˦˥
mít	mit˦˥
mò	mɔ˦˨
mòi	mɔj˦˨
mòm	mɔm˦˨
mòn	mɔŋm˦˨
mòng	mɔŋm˦˨
mó	mɔ˩˧
móc	mɔkp˦˥
móm	mɔm˩˧
món	mɔŋm˩˧
móng	mɔŋm˩˧
móp	mɔp˦˥
mót	mɔkp˦˥
mô	mo˧˥
mô-bin	mo˧˥-bin˧˥
mô-men	mo˧˥-mɛŋ˧˥
mô-tô	mo˧˥-to˧˥
môi	moj˧˥
môn	moŋm˧˥
mông	moŋm˧˥
mõ	mɔ˧˩˨
mõm	mɔm˧˩˨
mù	mu˦˨
mùa	muə˦˨
mùi	muj˦˨
mùn	muŋm˦˨
mùng	muŋm˦˨
mú	mu˩˧
múa	muə˩˧
múi	muj˩˧
múm	mum˩˧
múp	mup˦˥
mút	mukp˦˥
măm	măm˧˥
măn	măŋ˧˥
măng	măŋ˧˥
mĩ	mi˧˩˨
mũ	mu˧˩˨
mũi	muj˧˩˨
mũm	mum˧˩˨
mơ	mɤ˧˥
mơn	mɤŋ˧˥
mưa	mɯə˧˥
mưng	mɯŋ˧˥
mưu	mɯw˧˥
mươi	mɯəj˧˥
mươn	mɯəŋ˧˥
mương	mɯəŋ˧˥
mướn	mɯəŋ˩˧
mướp	mɯəp˦˥
mướt	mɯək˦˥
mười	mɯəj˦˨
mườn	mɯəŋ˦˨
mường	mɯəŋ˦˨
mượn	mɯəŋ˨ˀ˩ʔ
mượt	mɯək˨ˀ˩ʔ
mạ	ma˨ˀ˩ʔ
mạc	mak˨ˀ˩ʔ
mạc-sê	mak˨ˀ˩ʔ-ʂe˧˥
mạch	mak˨ˀ˩ʔ
mại	maj˨ˀ˩ʔ
mạn	maŋ˨ˀ˩ʔ
mạng	maŋ˨ˀ˩ʔ
mạnh	man˨ˀ˩ʔ
mạo	maw˨ˀ˩ʔ
mạt	mak˨ˀ˩ʔ
mạy	măj˨ˀ˩ʔ
mả	ma˧˩˨
mải	maj˧˩˨
mảng	maŋ˧˩˨
mảnh	man˧˩˨
mảy	măj˧˩˨
mấn	mɤ̆ŋ˩˧
mấp	mɤ̆p˦˥
mất	mət˧˥
mất	mɤ̆k˦˥
mấu	mɤ̆w˩˧
mấy	mɤ̆j˩˧
mầm	mɤ̆m˦˨
mần	mɤ̆ŋ˦˨
mầu	mɤ̆w˦˨
mầy	mɤ̆j˦˨
mẩm	mɤ̆m˧˩˨
mẩn	mɤ̆ŋ˧˩˨
mẩy	mɤ̆j˧˩˨
mẫm	mɤ̆m˧˩˨
mẫn	mɤ̆ŋ˧˩˨
mẫu	mɤ̆w˧˩˨
mận	mɤ̆ŋ˨ˀ˩ʔ
mập	mɤ̆p˨ˀ˩ʔ
mật	mɤ̆k˨ˀ˩ʔ
mậu	mɤ̆w˨ˀ˩ʔ
mắc	mak˧˥
mắc	măk˦˥
mắm	măm˩˧
mắn	măŋ˩˧
mắng	măŋ˩˧
mắt	mat˧˥
mắt	măk˦˥
mằn	măŋ˦˨
mẵm	măm˧˩˨
mặc	mak˧˥
mặc	măk˨ˀ˩ʔ
mặn	măŋ˨ˀ˩ʔ
mặt	mat˧˥
mặt	măk˨ˀ˩ʔ
mẹ	mɛ˨ˀ˩ʔ
mẹo	meo˨ˀ˩ʔ
mẻ	mɛ˧˩˨
mẽ	mɛ˧˩˨
mếch	met˦˥
mến	men˩˧
mếu	mɛu˩˧
mề	me˦˨
mềm	mem˦˨
mền	men˦˨
mễ	me˧˩˨
mệnh	men˨ˀ˩ʔ
mệt	met˨ˀ˩ʔ
mỉ	mi˧˩˨
mỉa	miə˧˩˨
mỉm	mim˧˩˨
mỉu	miw˧˩˨
mị	mi˨ˀ˩ʔ
mịn	min˨ˀ˩ʔ
mịt	mit˨ˀ˩ʔ
mọc	mɔkp˨ˀ˩ʔ
mọi	mɔj˨ˀ˩ʔ
mọng	mɔŋm˨ˀ˩ʔ
mọt	mɔkp˨ˀ˩ʔ
mỏ	mɔ˧˩˨
mỏi	mɔj˧˩˨
mỏm	mɔm˧˩˨
mỏng	mɔŋm˧˩˨
mố	mo˩˧
mốc	mokp˦˥
mối	moj˩˧
mống	moŋm˩˧
mốt	mokp˦˥
mồ	mo˦˨
mồ	mo˧
mồi	moj˦˨
mồm	mom˦˨
mồn	moŋm˦˨
mồng	moŋm˦˨
mổ	mo˧˩˨
mỗi	moj˧˩˨
mộ	mo˨ˀ˩ʔ
mộc	mokp˨ˀ˩ʔ
mộng	moŋm˨ˀ˩ʔ
một	mokp˨ˀ˩ʔ
mớ	mɤ˩˧
mới	mɤj˩˧
mớm	mɤm˩˧
mớn	mɤŋ˩˧
mờ	mɤ˦˨
mời	mɤj˦˨
mở	mɤ˧˩˨
mởn	mɤŋ˧˩˨
mỡ	mɤ˧˩˨
mụ	mu˨ˀ˩ʔ
mục	mukp˨ˀ˩ʔ
mục	muk˧˥
mụn	muŋm˨ˀ˩ʔ
mụt	mukp˨ˀ˩ʔ
mủ	mu˧˩˨
mủi	muj˧˩˨
mủm	mum˧˩˨
mủng	muŋm˧˩˨
mức	mɯk˦˥
mứn	mɯŋ˩˧
mứt	mɯk˦˥
mừng	mɯŋ˦˨
mửa	mɯə˧˩˨
mực	mɯk˨ˀ˩ʔ
mỹ	mi˧˩˨
na	naː˧
na	na˧˥
nai	naj˧˥
nam	nam˧
nam	nam˧˥
nam-hạ	nam˧˥-ha˨ˀ˩ʔ
nam-sang	nam˧˥-ʂaŋ˧˥
nam-đà	nam˧˥-da˦˨
nan	naŋ˧˥
nang	naŋ˧˥
nanh	nan˧˥
nao	naw˧˥
nay	năj˧˥
ne	nɛ˧˥
nem	nɛm˧˥
nen	nɛŋ˧˥
neo	neo˧˥
nga	ŋa˧˥
ngai	ŋaj˧˥
ngam	ŋam˧˥
ngan	ŋaŋ˧˥
ngang	ŋaŋ˧˥
ngao	ŋaw˧˥
ngau	ŋăw˧˥
ngay	ŋăj˧˥
nghe	ŋɛ˧˥
nghi	ŋi˧˥
nghim	ŋim˧˥
nghinh	ŋin˧˥
nghiêm	ŋiəm˧˥
nghiên	ŋiəŋ˧˥
nghiêng	ŋiəŋ˧˥
nghiêu	ŋiəw˧˥
nghiến	ŋiəŋ˩˧
nghiền	ŋiəŋ˦˨
nghiễm	ŋiəm˧˩˨
nghiệm	ŋiəm˨ˀ˩ʔ
nghiện	ŋiəŋ˨ˀ˩ʔ
nghiệp	ŋiəp˨ˀ˩ʔ
nghiệt	ŋiək˨ˀ˩ʔ
nghè	ŋɛ˦˨
nghèn	ŋɛŋ˦˨
nghèo	ŋeo˦˨
nghé	ŋɛ˩˧
nghê	ŋe˧˥
nghênh	ŋen˧˥
nghêu	ŋɛu˧˥
nghì	ŋi˦˨
nghìn	ŋin˦˨
nghí	ŋi˩˧
nghĩ	ŋi˧˩˨
nghĩa	ŋiə˧˩˨
nghẹn	ŋɛŋ˨ˀ˩ʔ
nghẹt	ŋɛk˨ˀ˩ʔ
nghẽn	ŋɛŋ˧˩˨
nghếch	ŋet˦˥
nghề	ŋe˦˨
nghền	ŋen˦˨
nghềnh	ŋen˦˨
nghều	ŋɛu˦˨
nghể	ŋe˧˩˨
nghển	ŋen˧˩˨
nghễnh	ŋen˧˩˨
nghễu	ŋɛu˧˩˨
nghệ	ŋe˨ˀ˩ʔ
nghệch	ŋet˨ˀ˩ʔ
nghệt	ŋet˨ˀ˩ʔ
nghỉ	ŋi˧˩˨
nghỉu	ŋiw˧˩˨
nghị	ŋi˨ˀ˩ʔ
nghịch	ŋit˨ˀ˩ʔ
ngo	ŋɔ˧˥
ngoa	ŋwa˧˥
ngoai	ŋwaj˧˥
ngoam	ŋwam˧˥
ngoan	ŋwaŋ˧˥
ngoang	ŋwaŋ˧˥
ngoao	ŋwaw˧˥
ngoay	ŋwăj˧˥
ngoe	ŋwe˧˥
ngoem	ŋwem˧˥
ngoen	ŋwen˧˥
ngoeo	ŋwew˧˥
ngoi	ŋɔj˧˥
ngon	ŋɔŋm˧˥
ngong	ŋɔŋm˧˥
ngoài	ŋwaj˦˨
ngoái	ŋwaj˩˧
ngoáo	ŋwaw˩˧
ngoã	ŋwa˧˩˨
ngoèo	ŋwew˦˨
ngoéo	ŋwew˩˧
ngoăn	ŋwăŋ˧˥
ngoạ	ŋwa˨ˀ˩ʔ
ngoạch	ŋwak˨ˀ˩ʔ
ngoại	ŋwaj˨ˀ˩ʔ
ngoạn	ŋwaŋ˨ˀ˩ʔ
ngoảnh	ŋwan˧˩˨
ngoắc	ŋwăk˦˥
ngoắt	ŋwăk˦˥
ngoằn	ŋwăŋ˦˨
ngoằng	ŋwăŋ˦˨
ngoặc	ŋwăk˨ˀ˩ʔ
ngoặt	ŋwăk˨ˀ˩ʔ
ngoẻo	ŋwew˧˩˨
ngu	ŋu˧˥
ngun	ŋuŋm˧˥
nguy	ŋwi˧˥
nguyên	ŋwiəŋ˧˥
nguyền	ŋwiəŋ˦˨
nguyện	ŋwiəŋ˨ˀ˩ʔ
nguyệt	ŋwiək˨ˀ˩ʔ
nguây	ŋwɤ̆j˧˥
nguôi	ŋuəj˧˥
nguých	ŋwit˦˥
nguýt	ŋwit˦˥
nguầy	ŋwɤ̆j˦˨
nguẩy	ŋwɤ̆j˧˩˨
nguếch	ŋwet˦˥
nguệch	ŋwet˨ˀ˩ʔ
nguồi	ŋuəj˦˨
nguồn	ŋuəŋ˦˨
nguội	ŋuəj˨ˀ˩ʔ
nguỵ	ŋwi˨ˀ˩ʔ
ngà	ŋa˦˨
ngài	ŋaj˦˨
ngàm	ŋam˦˨
ngàn	ŋaŋ˦˨
ngành	ŋan˦˨
ngào	ŋaw˦˨
ngàu	ŋăw˦˨
ngày	ŋăj˦˨
ngác	ŋak˦˥
ngái	ŋaj˩˧
ngán	ŋaŋ˩˧
ngáng	ŋaŋ˩˧
ngáo	ŋaw˩˧
ngáp	ŋap˦˥
ngát	ŋak˦˥
ngáy	ŋăj˩˧
ngâm	ŋɤ̆m˧˥
ngân	ŋɤ̆ŋ˧˥
ngâu	ŋɤ̆w˧˥
ngây	ŋɤ̆j˧˥
ngã	ŋa˧˩˨
ngãi	ŋaj˧˩˨
ngãng	ŋaŋ˧˩˨
ngò	ŋɔ˦˨
ngòi	ŋɔj˦˨
ngòm	ŋɔm˦˨
ngòn	ŋɔŋm˦˨
ngòng	ŋɔŋm˦˨
ngó	ŋɔ˩˧
ngóc	ŋɔkp˦˥
ngóeo	ŋwew˩˧
ngói	ŋɔj˩˧
ngón	ŋɔŋm˩˧
ngóng	ŋɔŋm˩˧
ngót	ŋɔkp˦˥
ngô	ŋo˧˥
ngôi	ŋoj˧˥
ngôn	ŋoŋm˧˥
ngông	ŋoŋm˧˥
ngõ	ŋɔ˧˩˨
ngù	ŋu˦˨
ngùi	ŋuj˦˨
ngùn	ŋuŋm˦˨
ngú	ŋu˩˧
ngúc	ŋukp˦˥
ngúng	ŋuŋm˩˧
ngút	ŋukp˦˥
ngăm	ŋăm˧˥
ngăn	ŋăŋ˧˥
ngũ	ŋu˧˩˨
ngũn	ŋuŋm˧˩˨
ngũng	ŋuŋm˧˩˨
ngơ	ŋɤ˧˥
ngơi	ŋɤj˧˥
ngơm	ŋɤm˧˥
ngơn	ŋɤŋ˧˥
ngư	ŋɯ˧˥
ngưa	ŋɯə˧˥
ngưng	ŋɯŋ˧˥
ngưu	ŋɯw˧˥
ngươi	ŋɯəj˧˥
ngước	ŋɯək˦˥
ngườ	ŋɯə˦˨
người	ŋɯəj˦˨
ngường	ŋɯəŋ˦˨
ngưỡng	ŋɯəŋ˧˩˨
ngược	ŋɯək˨ˀ˩ʔ
ngượng	ŋɯəŋ˨ˀ˩ʔ
ngạc	ŋak˨ˀ˩ʔ
ngạch	ŋak˨ˀ˩ʔ
ngại	ŋaj˨ˀ˩ʔ
ngạn	ŋaŋ˨ˀ˩ʔ
ngạo	ŋaw˨ˀ˩ʔ
ngạt	ŋak˨ˀ˩ʔ
ngả	ŋa˧˩˨
ngải	ŋaj˧˩˨
ngảnh	ŋan˧˩˨
ngấc	ŋɤ̆k˦˥
ngấm	ŋɤ̆m˩˧
ngấn	ŋɤ̆ŋ˩˧
ngấp	ŋɤ̆p˦˥
ngất	ŋɤ̆k˦˥
ngấu	ŋɤ̆w˩˧
ngấy	ŋɤ̆j˩˧
ngầm	ŋɤ̆m˦˨
ngần	ŋɤ̆ŋ˦˨
ngầu	ŋɤ̆w˦˨
ngầy	ŋɤ̆j˦˨
ngẩm	ŋɤ̆m˧˩˨
ngẩn	ŋɤ̆ŋ˧˩˨
ngẩng	ŋɤ̆ŋ˧˩˨
ngẫm	ŋɤ̆m˧˩˨
ngẫu	ŋɤ̆w˧˩˨
ngậm	ŋɤ̆m˨ˀ˩ʔ
ngận	ŋɤ̆ŋ˨ˀ˩ʔ
ngập	ŋɤ̆p˨ˀ˩ʔ
ngật	ŋɤ̆k˨ˀ˩ʔ
ngậu	ŋɤ̆w˨ˀ˩ʔ
ngắc	ŋăk˦˥
ngắm	ŋăm˩˧
ngắn	ŋăŋ˩˧
ngắt	ŋăk˦˥
ngằn	ŋăŋ˦˨
ngẳng	ŋăŋ˧˩˨
ngặt	ŋăk˨ˀ˩ʔ
ngọ	ŋɔ˨ˀ˩ʔ
ngọc	ŋɔkp˨ˀ˩ʔ
ngọn	ŋɔŋm˨ˀ˩ʔ
ngọng	ŋɔŋm˨ˀ˩ʔ
ngọt	ŋɔkp˨ˀ˩ʔ
ngỏ	ŋɔ˧˩˨
ngỏm	ŋɔm˧˩˨
ngỏn	ŋɔŋm˧˩˨
ngỏng	ŋɔŋm˧˩˨
ngốc	ŋokp˦˥
ngốn	ŋoŋm˩˧
ngốt	ŋokp˦˥
ngồ	ŋo˦˨
ngồi	ŋoj˦˨
ngồm	ŋom˦˨
ngồn	ŋoŋm˦˨
ngồng	ŋoŋm˦˨
ngổ	ŋo˧˩˨
ngổm	ŋom˧˩˨
ngổn	ŋoŋm˧˩˨
ngổng	ŋoŋm˧˩˨
ngỗ	ŋo˧˩˨
ngỗng	ŋoŋm˧˩˨
ngộ	ŋo˨ˀ˩ʔ
ngộc	ŋokp˨ˀ˩ʔ
ngột	ŋokp˨ˀ˩ʔ
ngớ	ŋɤ˩˧
ngớt	ŋɤk˦˥
ngờ	ŋɤ˦˨
ngời	ŋɤj˦˨
ngờm	ŋɤm˦˨
ngỡ	ŋɤ˧˩˨
ngợi	ŋɤj˨ˀ˩ʔ
ngợm	ŋɤm˨ˀ˩ʔ
ngợp	ŋɤp˨ˀ˩ʔ
ngụ	ŋu˨ˀ˩ʔ
ngục	ŋukp˨ˀ˩ʔ
ngụp	ŋup˨ˀ˩ʔ
ngụy	ŋuj˨ˀ˩ʔ
ngủ	ŋu˧˩˨
ngủn	ŋuŋm˧˩˨
ngủng	ŋuŋm˧˩˨
ngứa	ŋɯə˩˧
ngừng	ŋɯŋ˦˨
ngửa	ŋɯə˧˩˨
ngửi	ŋɯj˧˩˨
ngửng	ŋɯŋ˧˩˨
ngữ	ŋɯ˧˩˨
ngự	ŋɯ˨ˀ˩ʔ
ngựa	ŋɯə˨ˀ˩ʔ
ngực	ŋɯk˨ˀ˩ʔ
nha	ɲa˧˥
nhai	ɲaj˧˥
nham	ɲam˧˥
nhan	ɲaŋ˧˥
nhang	ɲaŋ˧˥
nhanh	ɲan˧˥
nhao	ɲaw˧˥
nhau	ɲăw˧˥
nhay	ɲăj˧˥
nhe	ɲɛ˧˥
nhem	ɲɛm˧˥
nhen	ɲɛŋ˧˥
nheo	ɲeo˧˥
nhi	ɲi˧˥
nhinh	ɲin˧˥
nhiu	ɲiw˧˥
nhiên	ɲiəŋ˧˥
nhiêu	ɲiəw˧˥
nhiếc	ɲiək˦˥
nhiếp	ɲiəp˦˥
nhiều	ɲiəw˦˨
nhiễm	ɲiəm˧˩˨
nhiễu	ɲiəw˧˩˨
nhiệm	ɲiəm˨ˀ˩ʔ
nhiệt	ɲiək˨ˀ˩ʔ
nho	ɲɔ˧˥
nhoang	ɲwaŋ˧˥
nhoay	ɲwăj˧˥
nhoe	ɲwe˧˥
nhoen	ɲwen˧˥
nhoi	ɲɔj˧˥
nhom	ɲɔm˧˥
nhon	ɲɔŋm˧˥
nhong	ɲɔŋm˧˥
nhoáng	ɲwaŋ˩˧
nhoè	ɲwe˦˨
nhoét	ɲwet˦˥
nhoẻn	ɲwen˧˩˨
nhu	ɲu˧˥
nhun	ɲuŋm˧˥
nhung	ɲuŋm˧˥
nhuyễn	ɲwiəŋ˧˩˨
nhuôm	ɲuəm˧˥
nhuần	ɲwɤ̆ŋ˦˨
nhuận	ɲwɤ̆ŋ˨ˀ˩ʔ
nhuế	ɲwe˩˧
nhuệ	ɲwe˨ˀ˩ʔ
nhuốc	ɲuək˦˥
nhuốm	ɲuəm˩˧
nhuộm	ɲuəm˨ˀ˩ʔ
nhà	ɲaː˧˨
nhà	ɲa˦˨
nhài	ɲaj˦˨
nhàm	ɲam˦˨
nhàn	ɲaŋ˦˨
nhàng	ɲaŋ˦˨
nhào	ɲaw˦˨
nhàu	ɲăw˦˨
nhày	ɲăj˦˨
nhá	ɲa˩˧
nhác	ɲak˦˥
nhái	ɲaj˩˧
nhám	ɲam˩˧
nháo	ɲaw˩˧
nhát	ɲak˦˥
nháy	ɲăj˩˧
nhâm	ɲɤ̆m˧˥
nhân	ɲɤ̆ŋ˧˥
nhâng	ɲɤ̆ŋ˧˥
nhâu	ɲɤ̆w˧˥
nhây	ɲɤ̆j˧˥
nhã	ɲa˧˩˨
nhãi	ɲaj˧˩˨
nhãn	ɲaŋ˧˩˨
nhãng	ɲaŋ˧˩˨
nhão	ɲaw˧˩˨
nhè	ɲɛ˦˨
nhèm	ɲɛm˦˨
nhèn	ɲɛŋ˦˨
nhèo	ɲeo˦˨
nhênh	ɲen˧˥
nhì	ɲi˦˨
nhìn	ɲin˦˨
nhí	ɲi˩˧
nhím	ɲim˩˧
nhíp	ɲip˦˥
nhòe	ɲwe˦˨
nhòm	ɲɔm˦˨
nhóc	ɲɔkp˦˥
nhóm	ɲɔm˩˧
nhón	ɲɔŋm˩˧
nhóng	ɲɔŋm˩˧
nhóp	ɲɔp˦˥
nhót	ɲɔkp˦˥
nhôm	ɲom˧˥
nhôn	ɲoŋm˧˥
nhông	ɲoŋm˧˥
nhõng	ɲɔŋm˧˩˨
nhù	ɲu˦˨
nhùn	ɲuŋm˦˨
nhùng	ɲuŋm˦˨
nhúc	ɲukp˦˥
nhúm	ɲum˩˧
nhún	ɲuŋm˩˧
nhúng	ɲuŋm˩˧
nhút	ɲukp˦˥
nhăm	ɲăm˧˥
nhăn	ɲăŋ˧˥
nhăng	ɲăŋ˧˥
nhĩ	ɲi˧˩˨
nhũ	ɲu˧˩˨
nhũn	ɲuŋm˧˩˨
nhũng	ɲuŋm˧˩˨
nhơ	ɲɤ˧˥
nhơm	ɲɤm˧˥
nhơn	ɲɤŋ˧˥
như	ɲɯ˧˥
nhưng	ɲɯŋ˧˥
nhường	ɲɯəŋ˦˨
nhưỡng	ɲɯəŋ˧˩˨
nhược	ɲɯək˨ˀ˩ʔ
nhượng	ɲɯəŋ˨ˀ˩ʔ
nhạc	ɲak˨ˀ˩ʔ
nhạn	ɲaŋ˨ˀ˩ʔ
nhạo	ɲaw˨ˀ˩ʔ
nhạt	ɲak˨ˀ˩ʔ
nhạy	ɲăj˨ˀ˩ʔ
nhả	ɲa˧˩˨
nhảm	ɲam˧˩˨
nhảu	ɲăw˧˩˨
nhảy	ɲăj˧˩˨
nhấc	ɲɤ̆k˦˥
nhấm	ɲɤ̆m˩˧
nhấn	ɲɤ̆ŋ˩˧
nhấp	ɲɤ̆p˦˥
nhất	ɲɤ̆k˦˥
nhầm	ɲɤ̆m˦˨
nhần	ɲɤ̆ŋ˦˨
nhầu	ɲɤ̆w˦˨
nhầy	ɲɤ̆j˦˨
nhẩn	ɲɤ̆ŋ˧˩˨
nhẩy	ɲɤ̆j˧˩˨
nhẫn	ɲɤ̆ŋ˧˩˨
nhậm	ɲɤ̆m˨ˀ˩ʔ
nhận	ɲɤ̆ŋ˨ˀ˩ʔ
nhập	ɲɤ̆p˨ˀ˩ʔ
nhật	ɲɤ̆k˨ˀ˩ʔ
nhậu	ɲɤ̆w˨ˀ˩ʔ
nhắc	ɲak˧˥
nhắc	ɲăk˦˥
nhắm	ɲam˧˥
nhắm	ɲăm˩˧
nhắn	ɲăŋ˩˧
nhắng	ɲăŋ˩˧
nhắp	ɲăp˦˥
nhằm	ɲăm˦˨
nhằng	ɲăŋ˦˨
nhẳn	ɲăŋ˧˩˨
nhẳng	ɲăŋ˧˩˨
nhẵn	ɲăŋ˧˩˨
nhặm	ɲăm˨ˀ˩ʔ
nhặng	ɲăŋ˨ˀ˩ʔ
nhặt	ɲăk˨ˀ˩ʔ
nhẹ	ɲɛ˨ˀ˩ʔ
nhẻ	ɲɛ˧˩˨
nhẻm	ɲɛm˧˩˨
nhẽ	ɲɛ˧˩˨
nhẽo	ɲeo˧˩˨
nhếch	ɲet˦˥
nhếu	ɲɛu˩˧
nhều	ɲɛu˦˨
nhễ	ɲe˧˩˨
nhện	ɲen˨ˀ˩ʔ
nhệu	ɲɛu˨ˀ˩ʔ
nhị	ɲi˨ˀ˩ʔ
nhịn	ɲin˨ˀ˩ʔ
nhịp	ɲip˨ˀ˩ʔ
nhịu	ɲiw˨ˀ˩ʔ
nhọ	ɲɔ˨ˀ˩ʔ
nhọc	ɲɔkp˨ˀ˩ʔ
nhọn	ɲɔŋm˨ˀ˩ʔ
nhọt	ɲɔkp˨ˀ˩ʔ
nhỏ	ɲɔ˧˩˨
nhỏ	ɲɔ˨˩
nhỏm	ɲɔm˧˩˨
nhỏn	ɲɔŋm˧˩˨
nhỏng	ɲɔŋm˧˩˨
nhố	ɲo˩˧
nhốn	ɲoŋm˩˧
nhồi	ɲoj˦˨
nhồm	ɲom˦˨
nhồn	ɲoŋm˦˨
nhổ	ɲo˧˩˨
nhộn	ɲoŋm˨ˀ˩ʔ
nhộng	ɲoŋm˨ˀ˩ʔ
nhột	ɲokp˨ˀ˩ʔ
nhớ	ɲɤ˩˧
nhớn	ɲɤŋ˩˧
nhớp	ɲɤp˦˥
nhớt	ɲɤk˦˥
nhờ	ɲɤ˦˨
nhời	ɲɤj˦˨
nhờn	ɲɤŋ˦˨
nhởn	ɲɤŋ˧˩˨
nhỡ	ɲɤ˧˩˨
nhỡn	ɲɤŋ˧˩˨
nhợt	ɲɤk˨ˀ˩ʔ
nhục	ɲukp˨ˀ˩ʔ
nhụng	ɲuŋm˨ˀ˩ʔ
nhụt	ɲukp˨ˀ˩ʔ
nhủ	ɲu˧˩˨
nhủn	ɲuŋm˧˩˨
nhủng	ɲuŋm˧˩˨
nhức	ɲɯk˦˥
nhừ	ɲɯ˦˨
nhửng	ɲɯŋ˧˩˨
nhữ	ɲɯ˧˩˨
những	ɲɯŋ˧˩˨
nhựa	ɲɯə˨ˀ˩ʔ
nhựt	ɲɯk˨ˀ˩ʔ
ni	ni˧
ni	ni˧˥
nin	nin˧˥
ninh	nin˧˥
niu	niw˧˥
niêm	niəm˧˥
niên	niəŋ˧˥
niêu	niəw˧˥
niết	niək˦˥
niềm	niəm˦˨
niềng	niəŋ˦˨
niệm	niəm˨ˀ˩ʔ
niệu	niəw˨ˀ˩ʔ
no	nɔ˧˥
no,	nɔ˧
noi	nɔj˧˥
non	nɔŋm˧˥
nong	nɔŋm˧˥
noong	nɔŋm˧˥
noãn	nwaŋ˧˩˨
nu	nu˧˥
nua	nuə˧˥
num	num˧˥
nung	nuŋm˧˥
nuôi	nuəj˧˥
nuông	nuəŋ˧˥
nuối	nuəj˩˧
nuốt	nuək˦˥
nuột	nuək˨ˀ˩ʔ
nà	na˦˨
nài	naj˦˨
nàng	naŋ˦˨
nào	naw˦˨
này	năj˦˨
ná	na˩˧
nách	nak˦˥
nái	naj˩˧
náo	naw˩˧
náp	nap˦˥
nát	nak˦˥
náu	năw˩˧
nân	nɤ̆ŋ˧˥
nâng	nɤ̆ŋ˧˥
nâu	nɤ̆w˧˥
nây	nɤ̆j˧˥
não	naw˧˩˨
nãy	năj˧˩˨
né	nɛ˩˧
ném	nɛm˩˧
nén	nɛŋ˩˧
néo	neo˩˧
nét	nɛk˦˥
nê	ne˧˥
nêm	nem˧˥
nên	nen˧
nên	nen˧˥
nêu	nɛu˧˥
nì	ni˦˨
nình	nin˦˨
ních	nit˦˥
nín	nin˩˧
níu	niw˩˧
nòi	nɔj˦˨
nòng	nɔŋm˦˨
nó	nɔ˧˥
nó	nɔ˩˧
nóc	nɔkp˦˥
nói	nɔj˧˥
nói	nɔj˩˧
nón	nɔŋm˩˧
nóng	nɔŋm˩˧
nót	nɔkp˦˥
nô	no˧˥
nôm	nom˧˥
nôn	noŋm˧˥
nông	noŋm˧˥
nõ	nɔ˧˩˨
nõn	nɔŋm˧˩˨
nùng	nuŋm˦˨
núa	nuə˩˧
núc	nukp˦˥
núi	nuj˩˧
núm	num˩˧
núng	nuŋm˩˧
núp	nup˦˥
nút	nukp˦˥
năm	năm˧˥
năn	năŋ˧˥
năng	năŋ˧˥
nũng	nuŋm˧˩˨
nơ	nɤ˧˥
nơi	nɤj˧˥
nơm	nɤm˧˥
nưng	nɯŋ˧˥
nương	nɯəŋ˧˥
nước	nɯək˦˥
nướng	nɯəŋ˩˧
nườm	nɯəm˦˨
nạ	na˨ˀ˩ʔ
nạc	nak˨ˀ˩ʔ
nại	naj˨ˀ˩ʔ
nạm	nam˨ˀ˩ʔ
nạn	naŋ˨ˀ˩ʔ
nạng	naŋ˨ˀ˩ʔ
nạo	naw˨ˀ˩ʔ
nạp	nap˨ˀ˩ʔ
nạt	nak˨ˀ˩ʔ
nản	naŋ˧˩˨
nảo	naw˧˩˨
nảy	năj˧˩˨
nấc	nɤ̆k˦˥
nấm	nɤ̆m˩˧
nấn	nɤ̆ŋ˩˧
nấp	nɤ̆p˦˥
nấu	nɤ̆w˩˧
nấy	nɤ̆j˩˧
nầm	nɤ̆m˦˨
nần	nɤ̆ŋ˦˨
nẩy	nɤ̆j˧˩˨
nẫng	nɤ̆ŋ˧˩˨
nẫu	nɤ̆w˧˩˨
nắc	năk˦˥
nắm	năm˩˧
nắn	năŋ˩˧
nắng	năŋ˩˧
nắng	n˧aŋ˧˥
nắp	năp˦˥
nằm	năm˦˨
nằn	năŋ˦˨
nằng	năŋ˦˨
nặc	năk˨ˀ˩ʔ
nặn	năŋ˨ˀ˩ʔ
nặng	năŋ˨ˀ˩ʔ
nẹp	nɛp˨ˀ˩ʔ
nẹt	nɛk˨ˀ˩ʔ
nẻ	nɛ˧˩˨
nẻo	neo˧˩˨
nếm	nem˩˧
nến	nen˩˧
nếp	nep˦˥
nết	net˦˥
nếu	nɛu˩˧
nếu	nɨək˧˥
nề	ne˦˨
nền	nen˦˨
nể	ne˧˩˨
nệ	ne˨ˀ˩ʔ
nệm	nem˨ˀ˩ʔ
nỉ	ni˧˩˨
nịch	nit˨ˀ˩ʔ
nịnh	nin˨ˀ˩ʔ
nịt	nit˨ˀ˩ʔ
nọ	nɔ˨ˀ˩ʔ
nọc	nɔkp˨ˀ˩ʔ
nỏ	nɔ˧˩˨
nốc	nokp˦˥
nối	noj˩˧
nốt	nokp˦˥
nồi	noj˦˨
nồng	noŋm˦˨
nổ	no˧˩˨
nổi	noj˧˩˨
nỗ	no˧˩˨
nỗi	noj˧˩˨
nộ	no˨ˀ˩ʔ
nội	noj˨ˀ˩ʔ
nộn	noŋm˨ˀ˩ʔ
nộp	nop˨ˀ˩ʔ
nới	nɤj˩˧
nớp	nɤp˦˥
nờm	nɤm˦˨
nở	nɤ˧˩˨
nỡ	nɤ˧˩˨
nợ	nɤ˨ˀ˩ʔ
nụ	nu˧˨
nụ	nu˨ˀ˩ʔ
nục	nukp˨ˀ˩ʔ
nứa	nɯə˩˧
nức	nɯk˦˥
nứt	nɯk˦˥
nử	nɯ˧˩˨
nửa	nɯə˧˩˨
nữ	nɯ˧˩˨
nữa	nɯə˧˩˨
nực	nɯk˨ˀ˩ʔ
nựng	nɯŋ˨ˀ˩ʔ
o	ɔ˧˥
o-xi	ɔ˧˥-si˧˥
o-xy	ɔ˧˥-si˧˥
o-xít	ɔ˧˥-sit˦˥
oa	wa˧˥
oai	waj˧˥
oan	waŋ˧˥
oang	waŋ˧˥
oanh	wan˧˥
oe	we˧˥
oeng	wen˧˥
oi	ɔj˧˥
om	ɔm˧˥
ong	ɔŋm˧˥
oong	ɔŋm˧˥
oàm	wam˦˨
oàng	waŋ˦˨
oành	wan˦˨
oác	wak˦˥
oái	waj˩˧
oán	waŋ˩˧
oát	wak˦˥
oé	we˩˧
oăn	wăŋ˧˥
oăng	wăŋ˧˥
oải	waj˧˩˨
oản	waŋ˧˩˨
oắt	wăk˦˥
oằn	wăŋ˦˨
oẳn	wăŋ˧˩˨
oặt	wăk˨ˀ˩ʔ
oẻ	we˧˩˨
pa	pa˧˥
pe-man-ga-nát	pɛ˧˥-maŋ˧˥-ɣa˧˥-nak˦˥
pen	pɛŋ˧˥
pha	fa˧˥
phai	faj˧˥
phang	faŋ˧˥
phanh	fan˧˥
phao	faw˧˥
phau	făw˧˥
phay	făj˧˥
phe	fɛ˧˥
phi	fi˧˥
phim	fim˧˥
phin	fin˧˥
phinh	fin˧˥
phiên	fiəŋ˧˥
phiêu	fiəw˧˥
phiếm	fiəm˩˧
phiến	fiəŋ˩˧
phiếu	fiəw˩˧
phiền	fiəŋ˦˨
phiệt	fiək˨ˀ˩ʔ
pho	fɔ˧˥
phong	fɔŋm˧˥
phoóc	fɔkp˦˥
phu	fu˧˥
phui	fuj˧˥
phun	fuŋm˧˥
phung	fuŋm˧˥
phà	fa˦˨
phàm	fam˦˨
phàn	faŋ˦˨
phành	fan˦˨
phá	fa˩˧
phác	fak˦˥
phách	fak˦˥
phái	faj˩˧
phán	faŋ˩˧
pháo	faw˩˧
pháp	fap˦˥
phát	fak˦˥
phân	fɤ̆ŋ˧˥
phây	fɤ̆j˧˥
phè	fɛ˦˨
phèn	fɛŋ˦˨
phèng	fɛŋ˦˨
phéc	fɛk˦˥
phép	fɛp˦˥
phét	fɛk˦˥
phê	fe˧˥
phên	fen˧˥
phì	fi˦˨
phìa	fiə˦˨
phìn	fin˦˨
phình	fin˦˨
phí	fi˩˧
phím	fim˩˧
phò	fɔ˦˨
phòi	fɔj˦˨
phòng	fɔŋm˦˨
phó	fɔ˩˧
phóng	fɔŋm˩˧
phô	fo˧˥
phôi	foj˧˥
phôm	fom˧˥
phông	foŋm˧˥
phù	fu˦˨
phùn	fuŋm˦˨
phùng	fuŋm˦˨
phú	fu˩˧
phúc	fukp˦˥
phún	fuŋm˩˧
phúng	fuŋm˩˧
phút	fukp˦˥
phăm	făm˧˥
phăn	făŋ˧˥
phăng	făŋ˧˥
phĩnh	fin˧˩˨
phũ	fu˧˩˨
phơ	fɤ˧˥
phơi	fɤj˧˥
phơn	fɤŋ˧˥
phưng	fɯŋ˧˥
phương	fɯəŋ˧˥
phước	fɯək˦˥
phướn	fɯəŋ˩˧
phường	fɯəŋ˦˨
phượng	fɯəŋ˨ˀ˩ʔ
phạch	fak˨ˀ˩ʔ
phạm	fam˨ˀ˩ʔ
phạn	faŋ˨ˀ˩ʔ
phạt	fak˨ˀ˩ʔ
phả	fa˧˩˨
phải	faj˧˩˨
phản	faŋ˧˩˨
phảng	faŋ˧˩˨
phấn	fɤ̆ŋ˩˧
phấp	fɤ̆p˦˥
phất	fɤ̆k˦˥
phầm	fɤ̆m˦˨
phần	fɤ̆ŋ˦˨
phẩm	fɤ̆m˧˩˨
phẩy	fɤ̆j˧˩˨
phẫn	fɤ̆ŋ˧˩˨
phẫu	fɤ̆w˧˩˨
phận	fɤ̆ŋ˨ˀ˩ʔ
phập	fɤ̆p˨ˀ˩ʔ
phật	fɤ̆k˨ˀ˩ʔ
phắc	făk˦˥
phắt	făk˦˥
phẳng	făŋ˧˩˨
phẹt	fɛk˨ˀ˩ʔ
phế	fe˩˧
phề	fe˦˨
phềnh	fen˦˨
phều	fɛu˦˨
phệ	fe˨ˀ˩ʔ
phệnh	fen˨ˀ˩ʔ
phỉ	fi˧˩˨
phỉnh	fin˧˩˨
phịu	fiw˨ˀ˩ʔ
phọng	fɔŋm˨ˀ˩ʔ
phọt	fɔkp˨ˀ˩ʔ
phỏng	fɔŋm˧˩˨
phố	fo˩˧
phốc	fokp˦˥
phối	foj˩˧
phốp	fop˦˥
phốt	fokp˦˥
phồm	fom˦˨
phồn	foŋm˦˨
phồng	foŋm˦˨
phổ	fo˧˩˨
phổi	foj˧˩˨
phổng	foŋm˧˩˨
phỗng	foŋm˧˩˨
phộng	foŋm˨ˀ˩ʔ
phới	fɤj˩˧
phớn	fɤŋ˩˧
phớt	fɤk˦˥
phờ	fɤ˦˨
phở	fɤ˧˩˨
phởn	fɤŋ˧˩˨
phụ	fu˨ˀ˩ʔ
phục	fukp˨ˀ˩ʔ
phụng	fuŋm˨ˀ˩ʔ
phủ	fu˧˩˨
phủi	fuj˧˩˨
phứa	fɯə˩˧
phức	fɯk˦˥
phừn	fɯŋ˦˨
phừng	fɯŋ˦˨
pi	pi˧˥
pin	pin˧˥
pom	pɔm˧˥
pu	pu˧˥
puốc	puək˦˥
pà	pa˦˨
pác	pak˦˥
pát	pak˦˥
pâu	pɤ̆w˧˥
pê	pe˧˥
pít	pit˦˥
pô	po˧˥
pô-li-me	po˧˥-li˧˥-mɛ˧˥
pơ	pɤ˧˥
qua	kwa˧
qua	wa˧˥
quai	waj˧˥
quan	waŋ˧˥
quang	waŋ˧˥
quanh	wan˧˥
quau	wăw˧˥
quay	wăj˧˥
que	wɛ˧˥
quen	wɛŋ˧˥
queng	wɛŋ˧˥
queo	weo˧˥
qui	wi˧˥
quy	wi˧˥
quyên	wiɛŋ˧˥
quyến	wiɛŋ˩˧
quyết	wiɛk˦˥
quyền	wiɛŋ˦˨
quyển	wiɛŋ˧˩˨
quà	wa˦˨
quài	waj˦˨
quàng	waŋ˦˨
quành	wan˦˨
quàu	wăw˦˨
quày	wăj˦˨
quá	wa˩˧
quác	wak˦˥
quách	wak˦˥
quái	waj˩˧
quán	waŋ˩˧
quáng	waŋ˩˧
quánh	wan˩˧
quát	wak˦˥
quân	wɤ̆ŋ˧˥
quây	wɤ̆j˧˥
quãng	waŋ˧˩˨
què	wɛ˦˨
quèn	wɛŋ˦˨
quèo	weo˦˨
quét	wɛk˦˥
quê	we˧˥
quên	wen˧˥
quì	wi˦˨
quình	win˦˨
quí	wi˩˧
quít	wit˦˥
quý	wi˩˧
quýnh	win˩˧
quýt	wit˦˥
quăm	wăm˧˥
quăn	wăŋ˧˥
quăng	wăŋ˧˥
quĩ	wi˧˩˨
quơ	wɤ˧˥
quạ	wa˨ˀ˩ʔ
quạc	wak˨ˀ˩ʔ
quạnh	wan˨ˀ˩ʔ
quạt	wak˨ˀ˩ʔ
quạu	wăw˨ˀ˩ʔ
quả	wa˧˩˨
quải	waj˧˩˨
quản	waŋ˧˩˨
quảng	waŋ˧˩˨
quảy	wăj˧˩˨
quấn	wɤ̆ŋ˩˧
quất	wɤ̆k˦˥
quấy	wɤ̆j˩˧
quần	wɤ̆ŋ˦˨
quầng	wɤ̆ŋ˦˨
quầy	wɤ̆j˦˨
quẩn	wɤ̆ŋ˧˩˨
quẩng	wɤ̆ŋ˧˩˨
quẫn	wɤ̆ŋ˧˩˨
quận	wɤ̆ŋ˨ˀ˩ʔ
quật	wɤ̆k˨ˀ˩ʔ
quậy	wɤ̆j˨ˀ˩ʔ
quắc	wăk˦˥
quắp	wăp˦˥
quắt	wăk˦˥
quằm	wăm˦˨
quằn	wăŋ˦˨
quẳng	wăŋ˧˩˨
quặm	wăm˨ˀ˩ʔ
quặn	wăŋ˨ˀ˩ʔ
quặp	wăp˨ˀ˩ʔ
quặt	wăk˨ˀ˩ʔ
quẹo	weo˨ˀ˩ʔ
quẹt	wɛk˨ˀ˩ʔ
quẻ	wɛ˧˩˨
quế	we˩˧
quếch	wet˦˥
quến	wen˩˧
quếnh	wen˩˧
quết	wet˦˥
quếu	wɛu˩˧
quề	we˦˨
quềnh	wen˦˨
quều	wɛu˦˨
quệch	wet˨ˀ˩ʔ
quệnh	wen˨ˀ˩ʔ
quỉ	wi˧˩˨
quị	wi˨ˀ˩ʔ
quốc	wokp˦˥
quới	wɤj˩˧
quờ	wɤ˦˨
quờn	wɤŋ˦˨
quở	wɤ˧˩˨
quỳ	wi˦˨
quỳnh	win˦˨
quỵ	wi˨ˀ˩ʔ
quỷ	wi˧˩˨
quỹ	wi˧˩˨
ra	ʐa˧˥
ra-đi-ô	ʐa˧˥-di˧˥-o˧˥
ram	ʐam˧˥
ran	ʐaŋ˧˥
rang	ʐaŋ˧˥
ranh	ʐan˧˥
rao	ʐaw˧˥
rau	ʐăw˧˥
ray	ʐăj˧˥
re	ʐɛ˧˥
ren	ʐɛŋ˧˥
reng	ʐɛŋ˧˥
reo	ʐeo˧˥
ri	ʐi˧˥
rin	ʐin˧˥
rinh	ʐin˧˥
riu	ʐiw˧˥
riêng	ʐiəŋ˧˥
riêu	ʐiəw˧˥
riết	ʐiək˦˥
riềng	ʐiəŋ˦˨
ro	ʐɔ˧˥
roi	ʐɔj˧˥
rong	ʐɔŋm˧˥
ru	ʐu˧˥
run	ʐuŋm˧˥
rung	ʐuŋm˧˥
ruôn	ʐuəŋ˧˥
ruốc	ʐuək˦˥
ruồi	ʐuəj˦˨
ruồng	ʐuəŋ˦˨
ruổi	ʐuəj˧˩˨
ruỗng	ʐuəŋ˧˩˨
ruộng	ʐuəŋ˨ˀ˩ʔ
ruột	ʐuək˨ˀ˩ʔ
rà	ʐa˦˨
ràn	ʐaŋ˦˨
ràng	ʐaŋ˦˨
rành	ʐan˦˨
rào	ʐaw˦˨
rày	ʐăj˦˨
rá	ʐa˩˧
rác	ʐak˦˥
rách	ʐak˦˥
rái	ʐaj˩˧
rám	ʐam˩˧
rán	ʐaŋ˩˧
ráng	ʐaŋ˩˧
ráo	ʐaw˩˧
ráp	ʐap˦˥
rát	ʐak˦˥
ráu	ʐăw˩˧
ráy	ʐăj˩˧
râm	ʐɤ̆m˧˥
rân	ʐɤ̆ŋ˧˥
râu	ʐɤ̆w˧˥
rã	ʐa˧˩˨
rãi	ʐaj˧˩˨
rãnh	ʐan˧˩˨
rè	ʐɛ˦˨
rèn	ʐɛŋ˦˨
rèo	ʐeo˦˨
ré	ʐɛ˩˧
rén	ʐɛŋ˩˧
réo	ʐeo˩˧
rét	ʐɛk˦˥
rên	ʐen˧˥
rêu	ʐɛu˧˥
rì	ʐi˦˨
rìa	ʐiə˦˨
rình	ʐin˦˨
rìu	ʐiw˦˨
rí	ʐi˩˧
rích	ʐit˦˥
rít	ʐit˦˥
ríu	ʐiw˩˧
rò	ʐɔ˦˨
ròm	ʐɔm˦˨
ròn	ʐɔŋm˦˨
ròng	ʐɔŋm˦˨
ró	ʐɔ˩˧
róc	ʐɔkp˦˥
rón	ʐɔŋm˩˧
rót	ʐɔkp˦˥
rô	ʐo˧˥
rôm	ʐom˧˥
rôn	ʐoŋm˧˥
rông	ʐoŋm˧˥
rõ	ʐɔ˧˩˨
rù	ʐu˦˨
rùa	ʐuə˦˨
rùm	ʐum˦˨
rùng	ʐuŋm˦˨
rú	ʐu˩˧
rúc	ʐukp˦˥
rúi	ʐuj˩˧
rúm	ʐum˩˧
rún	ʐuŋm˩˧
rúng	ʐuŋm˩˧
rút	ʐukp˦˥
răm	ʐăm˧˥
răn	ʐăŋ˧˥
răng	ʐăŋ˧˥
rĩ	ʐi˧˩˨
rũ	ʐu˧˩˨
rơ	ʐɤ˧˥
rơi	ʐɤj˧˥
rơm	ʐɤm˧˥
rơn	ʐɤŋ˧˥
rưa	ʐɯə˧˥
rưng	ʐɯŋ˧˥
rươi	ʐɯəj˧˥
rươm	ʐɯəm˧˥
rương	ʐɯəŋ˧˥
rước	ʐɯək˦˥
rướn	ʐɯəŋ˩˧
rười	ʐɯəj˦˨
rườm	ʐɯəm˦˨
rườn	ʐɯəŋ˦˨
rường	ʐɯəŋ˦˨
rượn	ʐɯəŋ˨ˀ˩ʔ
rượu	ʐɯəw˨ˀ˩ʔ
rạ	ʐa˨ˀ˩ʔ
rạc	ʐak˨ˀ˩ʔ
rạch	ʐak˨ˀ˩ʔ
rạn	ʐaŋ˨ˀ˩ʔ
rạng	ʐaŋ˨ˀ˩ʔ
rạo	ʐaw˨ˀ˩ʔ
rạp	ʐap˨ˀ˩ʔ
rả	ʐa˧˩˨
rải	ʐaj˧˩˨
rảnh	ʐan˧˩˨
rảo	ʐaw˧˩˨
rấm	ʐɤ̆m˩˧
rấn	ʐɤ̆ŋ˩˧
rấp	ʐɤ̆p˦˥
rất	zət˧˥
rất	ʐɤ̆k˦˥
rầm	ʐɤ̆m˦˨
rần	ʐɤ̆ŋ˦˨
rầu	ʐɤ̆w˦˨
rầy	ʐɤ̆j˦˨
rẫy	ʐɤ̆j˧˩˨
rậm	ʐɤ̆m˨ˀ˩ʔ
rận	ʐɤ̆ŋ˨ˀ˩ʔ
rập	ʐɤ̆p˨ˀ˩ʔ
rắc	ʐăk˦˥
rắm	ʐăm˩˧
rắn	ʐăŋ˩˧
rắp	ʐăp˦˥
rằm	zam˧
rằm	ʐăm˦˨
rằn	ʐăŋ˦˨
rằng	ʐăŋ˦˨
rặm	ʐăm˨ˀ˩ʔ
rặt	ʐăk˨ˀ˩ʔ
rẹo	ʐeo˨ˀ˩ʔ
rẻ	ʐɛ˧˩˨
rẻo	ʐeo˧˩˨
rẽ	ʐɛ˧˩˨
rế	ʐe˩˧
rếch	ʐet˦˥
rết	ʐet˦˥
rề	ʐe˦˨
rền	ʐen˦˨
rềnh	ʐen˦˨
rể	ʐe˧˩˨
rểnh	ʐen˧˩˨
rễ	ʐe˧˩˨
rệp	ʐep˨ˀ˩ʔ
rệu	ʐɛu˨ˀ˩ʔ
rỉ	ʐi˧˩˨
rỉa	ʐiə˧˩˨
rị	ʐi˨ˀ˩ʔ
rịa-vũng	ʐiə˨ˀ˩ʔ-juŋm˧˩˨
rịch	ʐit˨ˀ˩ʔ
rọ	ʐɔ˨ˀ˩ʔ
rọc	ʐɔkp˨ˀ˩ʔ
rọt	ʐɔkp˨ˀ˩ʔ
rỏ	ʐɔ˧˩˨
rốc	ʐokp˦˥
rối	ʐoj˩˧
rốn	ʐoŋm˩˧
rống	ʐoŋm˩˧
rốt	rot˧˥
rốt	ʐokp˦˥
rồ	ro˧
rồ	ʐo˦˨
rồi	ʐoj˦˨
rồm	ʐom˦˨
rồn	ʐoŋm˦˨
rồng	ʐoŋm˦˨
rổ	ʐo˧˩˨
rổn	ʐoŋm˧˩˨
rỗ	ʐo˧˩˨
rỗi	ʐoj˧˩˨
rỗng	ʐoŋm˧˩˨
rộ	ʐo˨ˀ˩ʔ
rộc	ʐokp˨ˀ˩ʔ
rộn	ʐoŋm˨ˀ˩ʔ
rộng	ʐoŋm˨ˀ˩ʔ
rột	ʐokp˨ˀ˩ʔ
rớt	ʐɤk˦˥
rờ	ʐɤ˦˨
rời	ʐɤj˦˨
rờm	ʐɤm˦˨
rờn	ʐɤŋ˦˨
rởm	ʐɤm˧˩˨
rởn	ʐɤŋ˧˩˨
rỡ	ʐɤ˧˩˨
rợ	ʐɤ˨ˀ˩ʔ
rợn	ʐɤŋ˨ˀ˩ʔ
rợp	ʐɤp˨ˀ˩ʔ
rụ	ʐu˨ˀ˩ʔ
rục	ʐukp˨ˀ˩ʔ
rụng	ʐuŋm˨ˀ˩ʔ
rụp	ʐup˨ˀ˩ʔ
rụt	ʐukp˨ˀ˩ʔ
rủ	ʐu˧˩˨
rủa	ʐuə˧˩˨
rủi	ʐuj˧˩˨
rủn	ʐuŋm˧˩˨
rủng	ʐuŋm˧˩˨
rứt	ʐɯk˦˥
rừng	ʐɯŋ˦˨
rửa	ʐɯə˧˩˨
rửng	ʐɯŋ˧˩˨
rữa	ʐɯə˧˩˨
rựa	ʐɯə˨ˀ˩ʔ
rực	ʐɯk˨ˀ˩ʔ
sa	ʂa˧˥
sai	ʂaj˧˥
sam	ʂam˧˥
san	ʂaŋ˧˥
sang	ʂaŋ˧˥
sanh	ʂan˧˥
sao	ʂaw˧˥
sau	ʂăw˧˥
say	ʂăj˧˥
se	ʂɛ˧˥
sen	ʂɛŋ˧˥
seo	ʂeo˧˥
si	ʂi˧˥
sim	ʂim˧˥
sin	ʂin˧˥
sinh	ʂin˧˥
siêng	ʂiəŋ˧˥
siêu	ʂiəw˧˥
siết	ʂiək˦˥
siểm	ʂiəm˧˩˨
so	ʂɔ˧˥
soi	ʂɔj˧˥
son	ʂɔŋm˧˥
song	ʂɔŋm˧˥
soàm	ʂwam˦˨
soàn	ʂwaŋ˦˨
soái	ʂwaj˩˧
soán	ʂwaŋ˩˧
soát	ʂwak˦˥
soạn	ʂwaŋ˨ˀ˩ʔ
su	ʂu˧˥
sui	ʂuj˧˥
sum	ʂum˧˥
sun	ʂuŋm˧˥
sun-phát	ʂuŋm˧˥-fak˦˥
sung	ʂuŋm˧˥
suy	ʂwi˧˥
suôn	ʂuəŋ˧˥
suông	ʂuəŋ˧˥
suý	ʂwi˩˧
suýt	ʂwit˦˥
suất	ʂwɤ̆k˦˥
suối	ʂuəj˩˧
suốt	suət˧˥
suốt	ʂuək˦˥
suồng	ʂuəŋ˦˨
suỵt	ʂwit˨ˀ˩ʔ
sà	ʂa˦˨
sài	ʂaj˦˨
sàm	ʂam˦˨
sàn	ʂaŋ˦˨
sàng	ʂaŋ˦˨
sành	ʂan˦˨
sào	ʂaw˦˨
sá	ʂa˩˧
sách	ʂak˦˥
sái	ʂaj˩˧
sám	ʂam˩˧
sán	ʂaŋ˩˧
sáng	ʂaŋ˩˧
sánh	ʂan˩˧
sáo	ʂaw˩˧
sáp	ʂap˦˥
sát	ʂak˦˥
sáu	ʂăw˩˧
sâm	ʂɤ̆m˧˥
sân	ʂɤ̆ŋ˧˥
sâu	ʂɤ̆w˧˥
sây	ʂɤ̆j˧˥
sã	ʂa˧˩˨
sãi	ʂaj˧˩˨
sè	ʂɛ˦˨
sém	ʂɛm˩˧
sét	ʂɛk˦˥
sê	ʂe˧˥
sên	ʂen˧˥
sênh	ʂen˧˥
sêu	ʂɛu˧˥
sì	ʂi˦˨
sìn	ʂin˦˨
sình	ʂin˦˨
sín	ʂin˩˧
sính	ʂin˩˧
sít	ʂit˦˥
sò	ʂɔ˦˨
sòm	ʂɔm˦˨
sòn	ʂɔŋm˦˨
sòng	ʂɔŋm˦˨
sóc	ʂɔkp˦˥
sói	ʂɔj˩˧
sóm	ʂɔm˩˧
sóng	ʂɔŋm˩˧
sót	ʂɔkp˦˥
sô	ʂo˧˥
sô-vanh	ʂo˧˥-jan˧˥
sôi	ʂoj˧˥
sông	ʂoŋm˧˥
sõi	ʂɔj˧˩˨
sõng	ʂɔŋm˧˩˨
sù	ʂu˦˨
sùi	ʂuj˦˨
sùm	ʂum˦˨
sùng	ʂuŋm˦˨
sú	ʂu˩˧
súc	ʂukp˦˥
sún	ʂuŋm˩˧
súng	ʂuŋm˩˧
súp	ʂup˦˥
sút	ʂukp˦˥
súy	ʂuj˩˧
săm	ʂăm˧˥
săn	ʂăŋ˧˥
săng	ʂăŋ˧˥
sĩ	ʂi˧˩˨
sơ	ʂɤ˧˥
sơm	ʂɤm˧˥
sơn	ʂɤŋ˧˥
sư	ʂɯ˧˥
sưng	ʂɯŋ˧˥
sưu	ʂɯw˧˥
sương	ʂɯəŋ˧˥
sướng	ʂɯəŋ˩˧
sướt	ʂɯək˦˥
sườn	ʂɯəŋ˦˨
sường	ʂɯəŋ˦˨
sưởi	ʂɯəj˧˩˨
sượng	ʂɯəŋ˨ˀ˩ʔ
sạch	ʂak˨ˀ˩ʔ
sạm	ʂam˨ˀ˩ʔ
sạn	ʂaŋ˨ˀ˩ʔ
sạo	ʂaw˨ˀ˩ʔ
sạp	ʂap˨ˀ˩ʔ
sạt	ʂak˨ˀ˩ʔ
sả	ʂa˧˩˨
sải	ʂaj˧˩˨
sản	ʂaŋ˧˩˨
sảng	ʂaŋ˧˩˨
sảnh	ʂan˧˩˨
sảo	ʂaw˧˩˨
sảy	ʂăj˧˩˨
sấm	ʂɤ̆m˩˧
sấn	ʂɤ̆ŋ˩˧
sấp	ʂɤ̆p˦˥
sấy	ʂɤ̆j˩˧
sầm	ʂɤ̆m˦˨
sần	ʂɤ̆ŋ˦˨
sầu	ʂɤ̆w˦˨
sầy	ʂɤ̆j˦˨
sẩm	ʂɤ̆m˧˩˨
sẩy	ʂɤ̆j˧˩˨
sậm	ʂɤ̆m˨ˀ˩ʔ
sập	ʂɤ̆p˨ˀ˩ʔ
sắc	ʂăk˦˥
sắm	ʂăm˩˧
sắn	ʂăŋ˩˧
sắp	ʂăp˦˥
sắt	ʂăk˦˥
sằng	ʂăŋ˦˨
sẵn	ʂăŋ˧˩˨
sẵp	ʂăp˧˩˨
sặc	ʂăk˨ˀ˩ʔ
sặm	ʂăm˨ˀ˩ʔ
sặt	ʂăk˨ˀ˩ʔ
sẹo	ʂeo˨ˀ˩ʔ
sẻ	ʂɛ˧˩˨
sẻn	ʂɛŋ˧˩˨
sẽ	ʂɛ˧˩˨
sến	ʂen˩˧
sếp	ʂep˦˥
sếu	ʂɛu˩˧
sề	ʂe˦˨
sền	ʂen˦˨
sềnh	ʂen˦˨
sểnh	ʂen˧˩˨
sệ	ʂe˨ˀ˩ʔ
sỉ	ʂi˧˩˨
sỉa	ʂiə˧˩˨
sịt	ʂit˨ˀ˩ʔ
sọ	ʂɔ˨ˀ˩ʔ
sọm	ʂɔm˨ˀ˩ʔ
sọt	ʂɔkp˨ˀ˩ʔ
sỏi	ʂɔj˧˩˨
số	ʂo˩˧
sống	ʂoŋm˩˧
sốp	ʂop˦˥
sốt	ʂokp˦˥
sồ	ʂo˦˨
sồi	ʂoj˦˨
sồn	ʂoŋm˦˨
sồng	ʂoŋm˦˨
sổ	ʂo˧˩˨
sổng	ʂoŋm˧˩˨
sỗ	ʂo˧˩˨
sộc	ʂokp˨ˀ˩ʔ
sột	ʂokp˨ˀ˩ʔ
sớ	ʂɤ˩˧
sớm	ʂɤm˩˧
sớn	ʂɤŋ˩˧
sờ	ʂɤ˦˨
sờm	ʂɤm˦˨
sờn	ʂɤŋ˦˨
sở	ʂɤ˧˩˨
sởn	ʂɤŋ˧˩˨
sợ	sə˧˨
sợ	ʂɤ˨ˀ˩ʔ
sợi	ʂɤj˨ˀ˩ʔ
sụ	ʂu˨ˀ˩ʔ
sục	ʂukp˨ˀ˩ʔ
sụm	ʂum˨ˀ˩ʔ
sụn	ʂuŋm˨ˀ˩ʔ
sụp	ʂup˨ˀ˩ʔ
sụt	ʂukp˨ˀ˩ʔ
sủ	ʂu˧˩˨
sủa	ʂuə˧˩˨
sủi	ʂuj˧˩˨
sủng	ʂuŋm˧˩˨
sứ	ʂɯ˩˧
sứa	ʂɯə˩˧
sức	sɨk˧˥
sức	ʂɯk˦˥
sứt	ʂɯk˦˥
sừn	ʂɯŋ˦˨
sừng	ʂɯŋ˦˨
sử	ʂɯ˧˩˨
sửa	ʂɯə˧˩˨
sửng	ʂɯŋ˧˩˨
sữa	ʂɯə˧˩˨
sững	ʂɯŋ˧˩˨
sự	su˧˨
sự	ʂɯ˨ˀ˩ʔ
sực	ʂɯk˨ˀ˩ʔ
sựng	ʂɯŋ˨ˀ˩ʔ
sỹ	ʂi˧˩˨
ta	taː˧
ta	ta˧˥
tai	taj˧˥
tam	tam˧˥
tan	taŋ˧˥
tang	taŋ˧˥
tanh	tan˧˥
tao	taw˧˥
tao	taːw˧
tay	tăj˧˥
te	tɛ˧˥
tem	tɛm˧˥
ten	tɛŋ˧˥
teng	tɛŋ˧˥
teo	teo˧˥
tha	tʰa˧˥
thai	tʰaj˧˥
tham	tʰam˧˥
than	tʰaŋ˧˥
thang	tʰaŋ˧˥
thanh	tʰan˧˥
thao	tʰaw˧˥
thau	tʰăw˧˥
thay	tʰăj˧˥
the	tʰɛ˧˥
then	tʰɛŋ˧˥
theo	tʰeo˧˥
thi	tʰi˧˥
thia	tʰiə˧˥
thin	tʰin˧˥
thinh	tʰin˧˥
thiu	tʰiw˧˥
thiêm	tʰiəm˧˥
thiên	tʰiəŋ˧˥
thiêng	tʰiəŋ˧˥
thiêu	tʰiəw˧˥
thiếc	tʰiək˦˥
thiếp	tʰiəp˦˥
thiết	tʰiək˦˥
thiếu	tʰiəw˩˧
thiềm	tʰiəm˦˨
thiền	tʰiəŋ˦˨
thiều	tʰiəw˦˨
thiểm	tʰiəm˧˩˨
thiển	tʰiəŋ˧˩˨
thiểu	tʰiəw˧˩˨
thiện	tʰiəŋ˨ˀ˩ʔ
thiệp	tʰiəp˨ˀ˩ʔ
thiệt	tʰiək˨ˀ˩ʔ
thiệu	tʰiəw˨ˀ˩ʔ
thoa	tʰwa˧˥
thoai	tʰwaj˧˥
thoang	tʰwaŋ˧˥
thoi	tʰɔj˧˥
thom	tʰɔm˧˥
thon	tʰɔŋm˧˥
thong	tʰɔŋm˧˥
thoá	tʰwa˩˧
thoái	tʰwaj˩˧
thoán	tʰwaŋ˩˧
thoáng	tʰwaŋ˩˧
thoát	tʰwak˦˥
thoòng	tʰɔŋm˦˨
thoăn	tʰwăŋ˧˥
thoại	tʰwaj˨ˀ˩ʔ
thoạt	tʰwak˨ˀ˩ʔ
thoả	tʰwa˧˩˨
thoải	tʰwaj˧˩˨
thoảng	tʰwaŋ˧˩˨
thoắt	tʰwăk˦˥
thu	tʰu˧˥
thua	tʰuə˧˥
thui	tʰuj˧˥
thum	tʰum˧˥
thun	tʰuŋm˧˥
thung	tʰuŋm˧˥
thuyên	tʰwiəŋ˧˥
thuyết	tʰwiək˦˥
thuyền	tʰwiəŋ˦˨
thuê	tʰwe˧˥
thuôn	tʰuəŋ˧˥
thuông	tʰuəŋ˧˥
thuý	tʰwi˩˧
thuần	tʰwɤ̆ŋ˦˨
thuận	tʰwɤ̆ŋ˨ˀ˩ʔ
thuật	tʰwɤ̆k˨ˀ˩ʔ
thuế	tʰwe˩˧
thuể	tʰwe˧˩˨
thuốc	tʰuək˦˥
thuồi	tʰuəj˦˨
thuồn	tʰuəŋ˦˨
thuồng	tʰuəŋ˦˨
thuộc	tʰuək˨ˀ˩ʔ
thuở	tʰuə˧˩˨
thuỳ	tʰwi˦˨
thuỵ	tʰwi˨ˀ˩ʔ
thuỷ	tʰwi˧˩˨
thà	tʰa˦˨
thài	tʰaj˦˨
thàm	tʰam˦˨
thành	tʰan˦˨
thào	tʰaw˦˨
thày	tʰăj˦˨
thác	tʰak˦˥
thách	tʰak˦˥
thái	tʰaj˩˧
thám	tʰam˩˧
thán	tʰaŋ˩˧
tháng	tʰaŋ˩˧
thánh	tʰan˩˧
tháo	tʰaw˩˧
tháp	tʰap˦˥
thát	tʰak˦˥
tháu	tʰăw˩˧
tháy	tʰăj˩˧
thâm	tʰɤ̆m˧˥
thân	tʰɤ̆ŋ˧˥
thâu	tʰɤ̆w˧˥
thây	tʰɤ̆j˧˥
thè	tʰɛ˦˨
thèm	tʰɛm˦˨
thèn	tʰɛŋ˦˨
thèo	tʰeo˦˨
thép	tʰɛp˦˥
thét	tʰɛk˦˥
thê	tʰe˧˥
thêm	tʰem˧˥
thênh	tʰen˧˥
thêu	tʰɛu˧˥
thì	tʰi˦˨
thìa	tʰiə˦˨
thình	tʰin˦˨
thí	tʰi˩˧
thích	tʰit˦˥
thính	tʰin˩˧
thít	tʰit˦˥
thò	tʰɔ˦˨
thòi	tʰɔj˦˨
thòm	tʰɔm˦˨
thòng	tʰɔŋm˦˨
thóa	tʰwa˩˧
thóc	tʰɔkp˦˥
thói	tʰɔj˩˧
thô	tʰo˧˥
thôi	tʰoj˧˥
thôn	tʰoŋm˧˥
thông	tʰoŋm˧˥
thõng	tʰɔŋm˧˩˨
thù	tʰu˦˨
thùa	tʰuə˦˨
thùi	tʰuj˦˨
thùm	tʰum˦˨
thùn	tʰuŋm˦˨
thùng	tʰuŋm˦˨
thùy	tʰuj˦˨
thú	tʰu˩˧
thúc	tʰukp˦˥
thúng	tʰuŋm˩˧
thút	tʰukp˦˥
thăm	tʰăm˧˥
thăn	tʰăŋ˧˥
thăng	tʰăŋ˧˥
thũng	tʰuŋm˧˩˨
thơ	tʰɤ˧˥
thơm	tʰɤm˧˥
thơn	tʰɤŋ˧˥
thư	tʰɯ˧˥
thưa	tʰɯə˧˥
thưng	tʰɯŋ˧˥
thương	tʰɯəŋ˧˥
thước	tʰɯək˦˥
thướt	tʰɯək˦˥
thười	tʰɯəj˦˨
thườn	tʰɯəŋ˦˨
thường	tʰɯəŋ˦˨
thưởng	tʰɯəŋ˧˩˨
thưỡn	tʰɯəŋ˧˩˨
thược	tʰɯək˨ˀ˩ʔ
thượng	tʰɯəŋ˨ˀ˩ʔ
thạc	tʰak˨ˀ˩ʔ
thạch	tʰak˨ˀ˩ʔ
thạnh	tʰan˨ˀ˩ʔ
thạo	tʰaw˨ˀ˩ʔ
thả	tʰa˧˩˨
thải	tʰaj˧˩˨
thảm	tʰam˧˩˨
thản	tʰaŋ˧˩˨
thảng	tʰaŋ˧˩˨
thảnh	tʰan˧˩˨
thảo	tʰaw˧˩˨
thảy	tʰăj˧˩˨
thấm	tʰɤ̆m˩˧
thấp	tʰɤ̆p˦˥
thất	tʰɤ̆k˦˥
thấu	tʰɤ̆w˩˧
thấy	tʰɤ̆j˩˧
thầm	tʰɤ̆m˦˨
thần	tʰɤ̆ŋ˦˨
thầu	tʰɤ̆w˦˨
thầy	tʰɤ̆j˦˨
thẩm	tʰɤ̆m˧˩˨
thẩn	tʰɤ̆ŋ˧˩˨
thẩu	tʰɤ̆w˧˩˨
thẫn	tʰɤ̆ŋ˧˩˨
thậm	tʰɤ̆m˨ˀ˩ʔ
thận	tʰɤ̆ŋ˨ˀ˩ʔ
thập	tʰɤ̆p˨ˀ˩ʔ
thật	tʰət˧˥
thật	tʰɤ̆k˨ˀ˩ʔ
thắc	tʰăk˦˥
thắm	tʰăm˩˧
thắng	tʰăŋ˩˧
thắp	tʰăp˦˥
thắt	tʰăk˦˥
thằn	tʰăŋ˦˨
thằng	tʰăŋ˦˨
thẳm	tʰăm˧˩˨
thẳng	tʰăŋ˧˩˨
thặng	tʰăŋ˨ˀ˩ʔ
thẹn	tʰɛŋ˨ˀ˩ʔ
thẹp	tʰɛp˨ˀ˩ʔ
thẻ	tʰɛ˧˩˨
thẽ	tʰɛ˧˩˨
thế	tʰe˩˧
thếp	tʰep˦˥
thết	tʰet˦˥
thề	tʰe˦˨
thềm	tʰem˦˨
thều	tʰɛu˦˨
thể	tʰe˧˩˨
thệ	tʰe˨ˀ˩ʔ
thỉ	tʰi˧˩˨
thỉnh	tʰin˧˩˨
thị	tʰi˨ˀ˩ʔ
thịch	tʰit˨ˀ˩ʔ
thịnh	tʰin˨ˀ˩ʔ
thịt	tʰit˨ˀ˩ʔ
thọ	tʰɔ˨ˀ˩ʔ
thọc	tʰɔkp˨ˀ˩ʔ
thỏ	tʰɔ˧˩˨
thỏa	tʰwa˧˩˨
thố	tʰo˩˧
thốc	tʰokp˦˥
thối	tʰoj˩˧
thốn	tʰoŋm˩˧
thống	tʰoŋm˩˧
thốt	tʰokp˦˥
thồ	tʰo˦˨
thồm	tʰom˦˨
thồn	tʰoŋm˦˨
thổ	tʰo˧˩˨
thổi	tʰoj˧˩˨
thổn	tʰoŋm˧˩˨
thỗn	tʰoŋm˧˩˨
thộp	tʰop˨ˀ˩ʔ
thớ	tʰɤ˩˧
thới	tʰɤj˩˧
thớt	tʰɤk˦˥
thờ	tʰɤ˦˨
thời	tʰɤj˦˨
thờn	tʰɤŋ˦˨
thở	tʰɤ˧˩˨
thợ	tʰɤ˨ˀ˩ʔ
thụ	tʰu˨ˀ˩ʔ
thục	tʰukp˨ˀ˩ʔ
thụng	tʰuŋm˨ˀ˩ʔ
thụp	tʰup˨ˀ˩ʔ
thụt	tʰukp˨ˀ˩ʔ
thụy	tʰuj˨ˀ˩ʔ
thủ	tʰu˧˩˨
thủa	tʰuə˧˩˨
thủi	tʰuj˧˩˨
thủng	tʰuŋm˧˩˨
thủy	tʰuj˧˩˨
thứ	tʰɨ˧˥
thứ	tʰɯ˩˧
thức	tʰɯk˦˥
thừa	tʰɯə˦˨
thừng	tʰɯŋ˦˨
thử	tʰɯ˧˩˨
thự	tʰɯ˨ˀ˩ʔ
thực	tʰɯk˨ˀ˩ʔ
ti	ti˧˥
tia	tiə˧˥
tim	tim˧˥
tin	tin˧˥
tinh	tin˧˥
tiu	tiw˧˥
tiêm	tiəm˧˥
tiên	tiəŋ˧˥
tiêng	tiəŋ˧˥
tiêu	tiəw˧˥
tiếc	tiək˦˥
tiếm	tiəm˩˧
tiến	tiəŋ˩˧
tiếng	tiəŋ˩˧
tiếp	tiəp˦˥
tiết	tiək˦˥
tiếu	tiəw˩˧
tiềm	tiəm˦˨
tiền	tiəŋ˦˨
tiều	tiəw˦˨
tiểu	tiəw˧˩˨
tiễn	tiəŋ˧˩˨
tiễu	tiəw˧˩˨
tiệc	tiək˨ˀ˩ʔ
tiệm	tiəm˨ˀ˩ʔ
tiện	tiəŋ˨ˀ˩ʔ
tiệp	tiəp˨ˀ˩ʔ
tiệt	tiək˨ˀ˩ʔ
to	tɔ˧˥
toa	twa˧˥
toan	twaŋ˧˥
toang	twaŋ˧˥
toe	twe˧˥
toen	twen˧˥
toi	tɔj˧˥
tom	tɔm˧˥
ton	tɔŋm˧˥
tong	tɔŋm˧˥
toong	tɔŋm˧˥
top	tɔp˧˥
toà	twa˦˨
toàn	twaŋ˦˨
toá	twa˩˧
toác	twak˦˥
toán	twaŋ˩˧
toát	twak˦˥
toèn	twen˦˨
toé	twe˩˧
toét	twet˦˥
toòng	tɔŋm˦˨
toạ	twa˨ˀ˩ʔ
toạc	twak˨ˀ˩ʔ
toại	twaj˨ˀ˩ʔ
toả	twa˧˩˨
tra	ʈa˧˥
trai	ʈaj˧˥
trang	ʈaŋ˧˥
tranh	ʈan˧˥
trao	ʈaw˧˥
trau	ʈăw˧˥
tre	ʈɛ˧˥
treo	ʈeo˧˥
tri	ʈi˧˥
trinh	ʈin˧˥
triêu	ʈiəw˧˥
triết	ʈiək˦˥
triền	ʈiəŋ˦˨
triều	ʈiəw˦˨
triển	ʈiəŋ˧˩˨
triệt	ʈiək˨ˀ˩ʔ
triệu	ʈiəw˨ˀ˩ʔ
tro	ʈɔ˧˥
trong	ʈɔŋm˧˥
tru	ʈu˧˥
trui	ʈuj˧˥
trung	ʈuŋm˧˥
truy	ʈwi˧˥
truyền	ʈwiəŋ˦˨
truyện	ʈwiəŋ˨ˀ˩ʔ
truân	ʈwɤ̆ŋ˧˥
truông	ʈuəŋ˧˥
truất	ʈwɤ̆k˦˥
truồng	ʈuəŋ˦˨
truỵ	ʈwi˨ˀ˩ʔ
trà	ʈa˦˨
trài	ʈaj˦˨
tràm	ʈam˦˨
tràn	ʈaŋ˦˨
tràng	ʈaŋ˦˨
trào	ʈaw˦˨
trày	ʈăj˦˨
trá	ʈa˩˧
trác	ʈak˦˥
trách	ʈak˦˥
trái	ʈaj˩˧
trám	ʈam˩˧
trán	ʈaŋ˩˧
tráng	ʈaŋ˩˧
tránh	ʈan˩˧
tráo	ʈaw˩˧
trát	ʈak˦˥
trâm	ʈɤ̆m˧˥
trân	ʈɤ̆ŋ˧˥
trâng	ʈɤ̆ŋ˧˥
trâu	ʈɤ̆w˧˥
trây	ʈɤ̆j˧˥
trèn	ʈɛŋ˦˨
trèo	ʈeo˦˨
tréc	ʈɛk˦˥
trém	ʈɛm˩˧
tréo	ʈeo˩˧
trét	ʈɛk˦˥
trê	ʈe˧˥
trên	ʈen˧˥
trêu	ʈɛu˧˥
trì	ʈi˦˨
trình	ʈin˦˨
trìu	ʈiw˦˨
trí	ʈi˩˧
trích	ʈit˦˥
trò	ʈɔ˦˨
tròi	ʈɔj˦˨
tròm	ʈɔm˦˨
tròn	ʈɔŋm˦˨
tròng	ʈɔŋm˦˨
tróc	ʈɔkp˦˥
trói	ʈɔj˩˧
tróm	ʈɔm˩˧
tróng	ʈɔŋm˩˧
trót	ʈɔkp˦˥
trô	ʈo˧˥
trôi	ʈoj˧˥
trôn	ʈoŋm˧˥
trông	ʈoŋm˧˥
trù	ʈu˦˨
trùi	ʈuj˦˨
trùm	ʈum˦˨
trùng	ʈuŋm˦˨
trú	ʈu˩˧
trúc	ʈukp˦˥
trúng	ʈuŋm˩˧
trút	ʈukp˦˥
trăm	ʈăm˧˥
trăn	ʈăŋ˧˥
trăng	ʈăŋ˧˥
trĩ	ʈi˧˩˨
trĩu	ʈiw˧˩˨
trơ	ʈɤ˧˥
trơn	ʈɤŋ˧˥
trưa	ʈɯə˧˥
trưng	ʈɯŋ˧˥
trương	ʈɯəŋ˧˥
trước	ʈɯək˦˥
trướng	ʈɯəŋ˩˧
trường	ʈɯəŋ˦˨
trưởng	ʈɯəŋ˧˩˨
trượng	ʈɯəŋ˨ˀ˩ʔ
trượt	ʈɯək˨ˀ˩ʔ
trạch	ʈak˨ˀ˩ʔ
trại	ʈaj˨ˀ˩ʔ
trạm	ʈam˨ˀ˩ʔ
trạng	ʈaŋ˨ˀ˩ʔ
trả	ʈa˧˩˨
trải	ʈaj˧˩˨
trảm	ʈam˧˩˨
trảng	ʈaŋ˧˩˨
trảo	ʈaw˧˩˨
trấn	ʈɤ̆ŋ˩˧
trất	ʈɤ̆k˦˥
trấu	ʈɤ̆w˩˧
trầm	ʈɤ̆m˦˨
trần	ʈɤ̆ŋ˦˨
trầu	ʈɤ̆w˦˨
trầy	ʈɤ̆j˦˨
trẩu	ʈɤ̆w˧˩˨
trẩy	ʈɤ̆j˧˩˨
trẫm	ʈɤ̆m˧˩˨
trậm	ʈɤ̆m˨ˀ˩ʔ
trận	ʈɤ̆ŋ˨ˀ˩ʔ
trập	ʈɤ̆p˨ˀ˩ʔ
trật	ʈɤ̆k˨ˀ˩ʔ
trắc	ʈăk˦˥
trắm	ʈăm˩˧
trắng	ʈăŋ˩˧
trằm	ʈăm˦˨
trằn	ʈăŋ˦˨
trằng	ʈăŋ˦˨
trẹo	ʈeo˨ˀ˩ʔ
trẹt	ʈɛk˨ˀ˩ʔ
trẻ	ʈɛ˧˩˨
trẽn	ʈɛŋ˧˩˨
trẽo	ʈeo˧˩˨
trết	ʈet˦˥
trếu	ʈɛu˩˧
trề	ʈe˦˨
trễ	ʈe˧˩˨
trệ	ʈe˨ˀ˩ʔ
trệt	ʈet˨ˀ˩ʔ
trệu	ʈɛu˨ˀ˩ʔ
trị	ʈi˨ˀ˩ʔ
trịch	ʈit˨ˀ˩ʔ
trịnh	ʈin˨ˀ˩ʔ
trọ	ʈɔ˨ˀ˩ʔ
trọc	ʈɔkp˨ˀ˩ʔ
trọi	ʈɔj˨ˀ˩ʔ
trọn	ʈɔŋm˨ˀ˩ʔ
trọng	ʈɔŋm˨ˀ˩ʔ
trỏ	ʈɔ˧˩˨
trốc	ʈokp˦˥
trối	ʈoj˩˧
trốn	ʈoŋm˩˧
trống	ʈoŋm˩˧
trồng	ʈoŋm˦˨
trổ	ʈo˧˩˨
trổi	ʈoj˧˩˨
trỗ	ʈo˧˩˨
trỗi	ʈoj˧˩˨
trộc	ʈokp˨ˀ˩ʔ
trội	ʈoj˨ˀ˩ʔ
trộm	ʈom˨ˀ˩ʔ
trộn	ʈoŋm˨ˀ˩ʔ
trớ	ʈɤ˩˧
trớn	ʈɤŋ˩˧
trớt	ʈɤk˦˥
trờ	ʈɤ˦˨
trời	ʈɤj˦˨
trờn	ʈɤŋ˦˨
trở	ʈɤ˧˩˨
trợ	ʈɤ˨ˀ˩ʔ
trợn	ʈɤŋ˨ˀ˩ʔ
trợt	ʈɤk˨ˀ˩ʔ
trụ	ʈu˨ˀ˩ʔ
trục	ʈukp˨ˀ˩ʔ
trụi	ʈuj˨ˀ˩ʔ
trụy	ʈuj˨ˀ˩ʔ
trủng	ʈuŋm˧˩˨
trứ	ʈɯ˩˧
trứng	ʈɯŋ˩˧
trừ	ʈɯ˦˨
trừng	ʈɯŋ˦˨
trừu	ʈɯw˦˨
trữ	ʈɯ˧˩˨
trực	ʈɯk˨ˀ˩ʔ
tu	tu˧˥
tua	tuə˧˥
tum	tum˧˥
tun	tuŋm˧˥
tung	tuŋm˧˥
tuy	twi˧
tuy	twi˧˥
tuyên	twiəŋ˧˥
tuyến	twiəŋ˩˧
tuyết	twiək˦˥
tuyền	twiəŋ˦˨
tuyển	twiəŋ˧˩˨
tuyệt	twiək˨ˀ˩ʔ
tuân	twɤ̆ŋ˧˥
tuôn	tuəŋ˧˥
tuý	twi˩˧
tuýt	twit˦˥
tuấn	twɤ̆ŋ˩˧
tuần	twɤ̆ŋ˦˨
tuẫn	twɤ̆ŋ˧˩˨
tuế	twe˩˧
tuếch	twet˦˥
tuềnh	twen˦˨
tuệ	twe˨ˀ˩ʔ
tuệch	twet˨ˀ˩ʔ
tuốt	tuək˦˥
tuồn	tuəŋ˦˨
tuồng	tuəŋ˦˨
tuổi	tuəj˧˩˨
tuột	tuək˨ˀ˩ʔ
tuỳ	twi˦˨
tuỷ	twi˧˩˨
ty	ti˧˥
tà	ta˦˨
tài	taj˦˨
tàm	tam˦˨
tàn	tan˧
tàn	taŋ˦˨
tàng	taŋ˦˨
tành	tan˦˨
tào	taw˦˨
tàu	tăw˦˨
tày	tăj˦˨
tá	ta˩˧
tác	tak˦˥
tách	tak˦˥
tái	taj˩˧
tám	tam˩˧
tán	taŋ˩˧
táng	taŋ˩˧
tánh	tan˩˧
táo	taw˩˧
táp	tap˦˥
tát	tak˦˥
táy	tăj˩˧
tâm	tɤ̆m˧˥
tân	tɤ̆ŋ˧˥
tâng	tɤ̆ŋ˧˥
tâu	tɤ̆w˧˥
tây	tɤ̆j˧˥
tã	ta˧˩˨
tè	tɛ˦˨
tèm	tɛm˦˨
tèn	tɛŋ˦˨
tèng	tɛŋ˦˨
tèo	teo˦˨
té	tɛ˩˧
tén	tɛŋ˩˧
tép	tɛp˦˥
tê	te˧˥
têm	tem˧˥
tên	ten˧˥
tên	tən˧
tênh	ten˧˥
tì	ti˦˨
tìm	tim˦˨
tình	tin˦˨
tình	tiŋ˧˥
tí	ti˩˧
tía	tiə˩˧
tích	tit˦˥
tím	tim˩˧
tín	tin˩˧
tính	tin˩˧
típ	tip˦˥
tít	tit˦˥
tíu	tiw˩˧
tò	tɔ˦˨
tò	tɔ˧
tòa	twa˦˨
tòm	tɔm˦˨
tòn	tɔŋm˦˨
tòng	tɔŋm˦˨
tóc	tɔkp˦˥
tóe	twe˩˧
tóm	tɔm˩˧
tóp	tɔp˦˥
tót	tɔkp˦˥
tô	to˧˥
tô-pô	to˧˥-po˧˥
tô-tem	to˧˥-tɛm˧˥
tôi	toj˧
tôi	toj˧˥
tôm	tom˧˥
tôn	toŋm˧˥
tông	toŋm˧˥
tù	tu˦˨
tùm	tum˦˨
tùng	tuŋm˦˨
tùy	tuj˦˨
tú	tu˩˧
túc	tukp˦˥
túi	tuj˩˧
túm	tum˩˧
túng	tuŋm˩˧
túp	tup˦˥
túy	tuj˩˧
tăm	tăm˧˥
tăng	tăŋ˧˥
tĩnh	tin˧˩˨
tơ	tɤ˧˥
tơi	tɤj˧˥
tư	tɨ˧
tư	tɯ˧˥
tưng	tɯŋ˧˥
tươi	tɯəj˧˥
tươm	tɯəm˧˥
tương	tɯəŋ˧˥
tước	tɯək˦˥
tưới	tɯəj˩˧
tướng	tɯəŋ˩˧
tướt	tɯək˦˥
tườm	tɯəm˦˨
tường	tɯəŋ˦˨
tườu	tɯəw˦˨
tưởng	tɯəŋ˧˩˨
tượng	tɯəŋ˨ˀ˩ʔ
tạ	ta˨ˀ˩ʔ
tạc	tak˨ˀ˩ʔ
tại	taj˨ˀ˩ʔ
tạm	tam˧˨
tạm	tam˨ˀ˩ʔ
tạng	taŋ˨ˀ˩ʔ
tạnh	tan˨ˀ˩ʔ
tạo	taw˨ˀ˩ʔ
tạp	tap˨ˀ˩ʔ
tạt	tak˨ˀ˩ʔ
tả	ta˧˩˨
tải	taj˧˩˨
tản	taŋ˧˩˨
tảng	taŋ˧˩˨
tảo	taw˧˩˨
tấc	tɤ̆k˦˥
tấm	tɤ̆m˩˧
tấn	tɤ̆ŋ˩˧
tấp	tɤ̆p˦˥
tất	tət˧˥
tất	tɤ̆k˦˥
tấu	tɤ̆w˩˧
tầm	təm˧
tầm	tɤ̆m˦˨
tần	tɤ̆ŋ˦˨
tầng	tɤ̆ŋ˦˨
tầu	tɤ̆w˦˨
tầy	tɤ̆j˦˨
tẩm	tɤ̆m˧˩˨
tẩn	tɤ̆ŋ˧˩˨
tẩu	tɤ̆w˧˩˨
tẩy	tɤ̆j˧˩˨
tậm	tɤ̆m˨ˀ˩ʔ
tận	tɤ̆ŋ˨ˀ˩ʔ
tập	tɤ̆p˨ˀ˩ʔ
tật	tɤ̆k˨ˀ˩ʔ
tậu	tɤ̆w˨ˀ˩ʔ
tắc	tăk˦˥
tắm	tăm˩˧
tắp	tăp˦˥
tắt	tat˧˥
tắt	tăk˦˥
tằm	tăm˦˨
tằn	tăŋ˦˨
tằng	tăŋ˦˨
tẳn	tăŋ˧˩˨
tặc	tăk˨ˀ˩ʔ
tặng	tăŋ˨ˀ˩ʔ
tẹp	tɛp˨ˀ˩ʔ
tẹt	tɛk˨ˀ˩ʔ
tẻ	tɛ˧˩˨
tẻo	teo˧˩˨
tẽn	tɛŋ˧˩˨
tế	te˩˧
tếch	tet˦˥
tết	tet˦˥
tếu	tɛu˩˧
tề	te˦˨
tềnh	ten˦˨
tể	te˧˩˨
tễ	te˧˩˨
tệ	te˨ˀ˩ʔ
tỉ	ti˧˩˨
tỉa	tiə˧˩˨
tỉm	tim˧˩˨
tỉnh	tin˧˩˨
tỉu	tiw˧˩˨
tị	ti˨ˀ˩ʔ
tịch	tit˨ˀ˩ʔ
tịnh	tin˨ˀ˩ʔ
tịt	tit˨ˀ˩ʔ
tọa	twa˨ˀ˩ʔ
tọc	tɔkp˨ˀ˩ʔ
tọt	tɔkp˨ˀ˩ʔ
tỏ	tɔ˧˩˨
tỏa	twa˧˩˨
tỏi	tɔj˧˩˨
tỏm	tɔm˧˩˨
tỏng	tɔŋm˧˩˨
tố	to˩˧
tốc	tokp˦˥
tối	toj˩˧
tốn	toŋm˩˧
tống	toŋm˩˧
tốp	top˦˥
tốt	tokp˦˥
tốt	tot˧˥
tồ	to˦˨
tồi	toj˦˨
tồm	tom˦˨
tồn	toŋm˦˨
tồng	toŋm˦˨
tổ	to˧˩˨
tổn	toŋm˧˩˨
tổng	toŋm˧˩˨
tộc	tokp˨ˀ˩ʔ
tộc-ngôn	tokp˨ˀ˩ʔ-ŋoŋm˧˥
tội	toj˨ˀ˩ʔ
tột	tokp˨ˀ˩ʔ
tớ	tɤ˩˧
tới	tɤj˩˧
tớn	tɤŋ˩˧
tờ	tɤ˦˨
tở	tɤ˧˩˨
tởm	tɤm˧˩˨
tợn	tɤŋ˨ˀ˩ʔ
tụ	tu˨ˀ˩ʔ
tục	tukp˨ˀ˩ʔ
tụi	tuj˨ˀ˩ʔ
tụm	tum˨ˀ˩ʔ
tụng	tuŋm˨ˀ˩ʔ
tụt	tukp˨ˀ˩ʔ
tụy	tuj˨ˀ˩ʔ
tủ	tu˧˩˨
tủa	tuə˧˩˨
tủi	tuj˧˩˨
tủm	tum˧˩˨
tủn	tuŋm˧˩˨
tủng	tuŋm˧˩˨
tủy	tuj˧˩˨
tứ	tɯ˩˧
tức	tɯk˦˥
từ	tɨ˧˨
từ	tɯ˦˨
từa	tɯə˦˨
từng	tɯŋ˦˨
tử	tɯ˧˩˨
tửu	tɯw˧˩˨
tự	tɯ˨ˀ˩ʔ
tựa	tɯə˨ˀ˩ʔ
tựu	tɯw˨ˀ˩ʔ
tỳ	ti˦˨
tỵ	ti˨ˀ˩ʔ
tỷ	ti˧˩˨
u	u˧˥
ui	uj˧˥
um	um˧˥
un	uŋm˧˥
ung	uŋm˧˥
uy	wi˧˥
uyên	wiəŋ˧˥
uyển	wiəŋ˧˩˨
uôm	uəm˧˥
uông	uəŋ˧˥
uý	wi˩˧
uất	wɤ̆k˦˥
uẩn	wɤ̆ŋ˧˩˨
uế	we˩˧
uể	we˧˩˨
uốn	uəŋ˩˧
uống	uəŋ˩˧
uổng	uəŋ˧˩˨
uỳnh	win˦˨
uỷ	wi˧˩˨
va	ja˧˥
vai	jaj˧˥
van	jaŋ˧˥
vang	jaŋ˧˥
vang	vaŋ˧
vanh	jan˧˥
vay	jăj˧˥
ve	jɛ˧˥
ven	jɛŋ˧˥
veo	jeo˧˥
vi	ji˧˥
vi-rút	ji˧˥-ʐukp˦˥
vi-đê-ô	ji˧˥-de˧˥-o˧˥
vin	jin˧˥
vinh	jin˧˥
viêm	jiəm˧˥
viên	jiəŋ˧˥
viên	viən˧
viêng	jiəŋ˧˥
viêt	vɪət˧˥
viếng	jiəŋ˩˧
viết	jiək˦˥
viển	jiəŋ˧˩˨
viễn	jiəŋ˧˩˨
việc	jiək˨ˀ˩ʔ
viện	jiəŋ˨ˀ˩ʔ
việt	jiək˨ˀ˩ʔ
việt-nam	jiək˨ˀ˩ʔ-nam˧˥
vo	jɔ˧˥
voi	jɔj˧˥
von	jɔŋm˧˥
vong	jɔŋm˧˥
voọc	jɔkp˨ˀ˩ʔ
vu	ju˧˥
vua	juə˧˥
vui	juj˧˥
vun	juŋm˧˥
vung	juŋm˧˥
vuông	juəŋ˧˥
vuốt	juək˦˥
vuột	juək˨ˀ˩ʔ
vy	ji˧˥
và	ja˦˨
và	vaː˧˨
vài	jaj˦˨
vàm	jam˦˨
vàn	jaŋ˦˨
vàng	jaŋ˦˨
vành	jan˦˨
vào	jaw˦˨
vày	jăj˦˨
vá	ja˩˧
vác	jak˦˥
vách	jak˦˥
vái	jaj˩˧
ván	jaŋ˩˧
váng	jaŋ˩˧
váy	jăj˩˧
vân	jɤ̆ŋ˧˥
vâng	jɤ̆ŋ˧˥
vây	jɤ̆j˧˥
vã	ja˧˩˨
vãi	jaj˧˩˨
vãn	jaŋ˧˩˨
vãng	jaŋ˧˩˨
vè	jɛ˦˨
vèo	jeo˦˨
vé	jɛ˩˧
véc	jɛk˦˥
vén	jɛŋ˩˧
véo	jeo˩˧
vét	jɛk˦˥
vê	je˧˥
vên	jen˧˥
vênh	jen˧˥
vêu	jɛu˧˥
vì	ji˦˨
vì	vi˧˨
ví	ji˩˧
vía	jiə˩˧
vò	jɔ˦˨
vòi	jɔj˦˨
vòm	jɔm˦˨
vòn	jɔŋm˦˨
vòng	jɔŋm˦˨
vó	jɔ˩˧
vóc	jɔkp˦˥
vót	jɔkp˦˥
vô	jo˧˥
vôi	joj˧˥
vôn	joŋm˧˥
vông	joŋm˧˥
võ	jɔ˧˩˨
võng	jɔŋm˧˩˨
vù	ju˦˨
vùa	juə˦˨
vùi	juj˦˨
vùn	juŋm˦˨
vùng	juŋm˦˨
vú	ju˩˧
vúc	jukp˦˥
vút	jukp˦˥
văn	jăŋ˧˥
văng	jăŋ˧˥
vĩ	ji˧˩˨
vĩnh	jin˧˩˨
vũ	ju˧˩˨
vũ	vu˨˩
vũng	juŋm˧˩˨
vơ	jɤ˧˥
vơi	jɤj˧˥
vưu	jɯw˧˥
vươn	jɯəŋ˧˥
vương	jɯəŋ˧˥
vướng	jɯəŋ˩˧
vườn	jɯəŋ˦˨
vượn	jɯəŋ˨ˀ˩ʔ
vượng	jɯəŋ˨ˀ˩ʔ
vượt	jɯək˨ˀ˩ʔ
vạ	ja˨ˀ˩ʔ
vạc	jak˨ˀ˩ʔ
vạch	jak˨ˀ˩ʔ
vạm	jam˨ˀ˩ʔ
vạn	jaŋ˨ˀ˩ʔ
vạt	jak˨ˀ˩ʔ
vạy	jăj˨ˀ˩ʔ
vả	ja˧˩˨
vải	jaj˧˩˨
vảy	jăj˧˩˨
vấn	jɤ̆ŋ˩˧
vấp	jɤ̆p˦˥
vất	jɤ̆k˦˥
vấy	jɤ̆j˩˧
vần	jɤ̆ŋ˦˨
vầng	jɤ̆ŋ˦˨
vầy	jɤ̆j˦˨
vẩn	jɤ̆ŋ˧˩˨
vẫn	jɤ̆ŋ˧˩˨
vẫn	van˧˨
vẫy	jɤ̆j˧˩˨
vậm	jɤ̆m˨ˀ˩ʔ
vận	jɤ̆ŋ˨ˀ˩ʔ
vập	jɤ̆p˨ˀ˩ʔ
vật	jɤ̆k˨ˀ˩ʔ
vậy	jɤ̆j˨ˀ˩ʔ
vắn	jăŋ˩˧
vắng	jăŋ˩˧
vắt	jăk˦˥
vằm	jăm˦˨
vằn	jăŋ˦˨
vằng	jăŋ˦˨
vặc	jăk˨ˀ˩ʔ
vặn	jăŋ˨ˀ˩ʔ
vặt	jăk˨ˀ˩ʔ
vẹc	jɛk˨ˀ˩ʔ
vẹn	jɛŋ˨ˀ˩ʔ
vẹo	jeo˨ˀ˩ʔ
vẹt	jɛk˨ˀ˩ʔ
vẻ	jɛ˧˩˨
vẻn	jɛŋ˧˩˨
vẽ	jɛ˧˩˨
vết	jet˦˥
về	je˦˨
vền	jen˦˨
vểnh	jen˧˩˨
vệ	je˨ˀ˩ʔ
vỉ	ji˧˩˨
vỉa	jiə˧˩˨
vị	ji˨ˀ˩ʔ
vị	vi˧˨
vịt	jit˨ˀ˩ʔ
vọ	jɔ˨ˀ˩ʔ
vọc	jɔkp˨ˀ˩ʔ
vọng	jɔŋm˨ˀ˩ʔ
vọp	jɔp˨ˀ˩ʔ
vọt	jɔkp˨ˀ˩ʔ
vỏ	jɔ˧˩˨
vỏn	jɔŋm˧˩˨
vốn	joŋm˩˧
vồ	jo˦˨
vồi	joj˦˨
vồn	joŋm˦˨
vỗ	jo˧˩˨
vội	joj˨ˀ˩ʔ
vớ	jɤ˩˧
với	jɤj˩˧
vớt	jɤk˦˥
vờ	jɤ˦˨
vời	jɤj˦˨
vở	jɤ˧˩˨
vỡ	jɤ˧˩˨
vợ	jɤ˨ˀ˩ʔ
vợ	və˨˩
vụ	ju˨ˀ˩ʔ
vụ	vu˧˨
vụn	juŋm˨ˀ˩ʔ
vụng	juŋm˨ˀ˩ʔ
vụt	jukp˨ˀ˩ʔ
vứt	jɯk˦˥
vừa	jɯə˦˨
vừng	jɯŋ˦˨
vữa	jɯə˧˩˨
vững	jɯŋ˧˩˨
vựa	jɯə˨ˀ˩ʔ
vực	jɯk˨ˀ˩ʔ
vựng	jɯŋ˨ˀ˩ʔ
xa	saː˧
xa	sa˧˥
xa,	saː˧
xam	sam˧˥
xanh	san˧˥
xao	saw˧˥
xay	săj˧˥
xe	sɛ˧
xe	sɛ˧˥
xem	sɛm˧
xem	sɛm˧˥
xen	sɛŋ˧˥
xeo	seo˧˥
xi	si˧˥
xin	sin˧
xin	sin˧˥
xinh	sin˧˥
xiêm	siəm˧˥
xiên	siəŋ˧˥
xiêu	siəw˧˥
xiết	siək˦˥
xiếu	siəw˩˧
xiềng	siəŋ˦˨
xiểm	siəm˧˩˨
xiển	siəŋ˧˩˨
xiểng	siəŋ˧˩˨
xo	sɔ˧˥
xoa	swa˧˥
xoai	swaj˧˥
xoan	swaŋ˧˥
xoang	swaŋ˧˥
xoay	swăj˧˥
xoen	swen˧˥
xoi	sɔj˧˥
xom	sɔm˧˥
xon	sɔŋm˧˥
xong	sɔŋm˧˥
xoong	sɔŋm˧˥
xoài	swaj˦˨
xoàn	swaŋ˦˨
xoàng	swaŋ˦˨
xoành	swan˦˨
xoá	swa˩˧
xoáy	swăj˩˧
xoèn	swen˦˨
xoăn	swăŋ˧˥
xoạc	swak˨ˀ˩ʔ
xoắn	swăŋ˩˧
xoẳn	swăŋ˧˩˨
xu	su˧˥
xua	suə˧˥
xui	suj˧˥
xum	sum˧˥
xun	suŋm˧˥
xung	suŋm˧˥
xuy	swi˧˥
xuyên	swiəŋ˧˥
xuân	swɤ̆ŋ˧˥
xuê	swe˧˥
xuôi	suəj˧˥
xuý	swi˩˧
xuýt	swit˦˥
xuất	swɤ̆k˦˥
xuẩn	swɤ̆ŋ˧˩˨
xuề	swe˦˨
xuềnh	swen˦˨
xuệch	swet˨ˀ˩ʔ
xuống	suəŋ˩˧
xuồng	suəŋ˦˨
xà	sa˦˨
xài	saj˦˨
xàm	sam˦˨
xàng	saŋ˦˨
xành	san˦˨
xào	saw˦˨
xá	sa˩˧
xác	sak˦˥
xách	sak˦˥
xái	saj˩˧
xám	sam˩˧
xán	saŋ˩˧
xáo	saw˩˧
xáp	sap˦˥
xát	sak˦˥
xâm	sɤ̆m˧˥
xâu	sɤ̆w˧˥
xây	sɤ̆j˧˥
xã	sa˧˩˨
xè	sɛ˦˨
xèn	sɛŋ˦˨
xèo	seo˦˨
xé	sɛ˩˧
xén	sɛŋ˩˧
xéo	seo˩˧
xép	sɛp˦˥
xét	sɛk˦˥
xê	se˧˥
xênh	sen˧˥
xì	si˦˨
xình	sin˦˨
xìu	siw˦˨
xí	si˩˧
xích	sit˦˥
xín	sin˩˧
xính	sin˩˧
xít	sit˦˥
xíu	siw˩˧
xòm	sɔm˦˨
xòng	sɔŋm˦˨
xó	sɔ˩˧
xóc	sɔkp˦˥
xói	sɔj˩˧
xóm	sɔm˩˧
xóp	sɔp˦˥
xót	sɔkp˦˥
xô	so˧˥
xô-viết	so˧˥-jiək˦˥
xôi	soj˧˥
xôm	som˧˥
xôn	son˧
xôn	soŋm˧˥
xông	soŋm˧˥
xõng	sɔŋm˧˩˨
xù	su˦˨
xùm	sum˦˨
xùng	suŋm˦˨
xú	su˩˧
xúc	sukp˦˥
xúi	suj˩˧
xúm	sum˩˧
xúng	suŋm˩˧
xúp	sup˦˥
xăm	săm˧˥
xăn	săŋ˧˥
xăng	săŋ˧˥
xơ	sɤ˧˥
xơi	sɤj˧˥
xơn	sɤŋ˧˥
xưa	sɯə˧˥
xưng	sɯŋ˧˥
xương	sɯəŋ˧˥
xước	sɯək˦˥
xướng	sɯəŋ˩˧
xười	sɯəj˦˨
xường	sɯəŋ˦˨
xưởng	sɯəŋ˧˩˨
xạ	sa˨ˀ˩ʔ
xạc	sak˨ˀ˩ʔ
xạch	sak˨ˀ˩ʔ
xạu	săw˨ˀ˩ʔ
xả	sa˧˩˨
xảo	saw˧˩˨
xảy	săj˧˩˨
xấc	sɤ̆k˦˥
xấp	sɤ̆p˦˥
xấu	sɤ̆w˩˧
xầm	sɤ̆m˦˨
xầu	sɤ̆w˦˨
xẩm	sɤ̆m˧˩˨
xẩn	sɤ̆ŋ˧˩˨
xẩy	sɤ̆j˧˩˨
xậm	sɤ̆m˨ˀ˩ʔ
xập	sɤ̆p˨ˀ˩ʔ
xắc	săk˦˥
xắm	săm˩˧
xắn	săŋ˩˧
xằng	săŋ˦˨
xẵng	săŋ˧˩˨
xẹo	seo˨ˀ˩ʔ
xẹp	sɛp˨ˀ˩ʔ
xẻ	sɛ˧˩˨
xẻn	sɛŋ˧˩˨
xẻng	sɛŋ˧˩˨
xế	se˩˧
xếch	set˦˥
xếp	sep˦˥
xề	se˦˨
xềm	sem˦˨
xềnh	sen˦˨
xều	sɛu˦˨
xệch	set˨ˀ˩ʔ
xệu	sɛu˨ˀ˩ʔ
xỉ	si˧˩˨
xỉa	siə˧˩˨
xỉu	siw˧˩˨
xị	si˨ˀ˩ʔ
xịu	siw˨ˀ˩ʔ
xọ	sɔ˨ˀ˩ʔ
xọc	sɔkp˨ˀ˩ʔ
xỏ	sɔ˧˩˨
xỏng	sɔŋm˧˩˨
xốc	sokp˦˥
xối	soj˩˧
xốn	soŋm˩˧
xống	soŋm˩˧
xốp	sop˦˥
xốt	sokp˦˥
xồm	som˦˨
xồn	soŋm˦˨
xồng	soŋm˦˨
xổ	so˧˩˨
xổi	soj˧˩˨
xổn	soŋm˧˩˨
xổng	soŋm˧˩˨
xộc	sokp˨ˀ˩ʔ
xộn	soŋm˨ˀ˩ʔ
xớ	sɤ˩˧
xới	sɤj˩˧
xớn	sɤŋ˩˧
xớt	sɤk˦˥
xờ	sɤ˦˨
xờm	sɤm˦˨
xởi	sɤj˧˩˨
xợp	sɤp˨ˀ˩ʔ
xụ	su˨ˀ˩ʔ
xục	sukp˨ˀ˩ʔ
xụi	suj˨ˀ˩ʔ
xủ	su˧˩˨
xủng	suŋm˧˩˨
xứ	sɯ˩˧
xức	sɯk˦˥
xứng	sɯŋ˩˧
xử	sɯ˧˩˨
xửa	sɯə˧˩˨
xửng	sɯŋ˧˩˨
y	i˧˥
yêm	iɛm˧˥
yên	iɛŋ˧˥
yêng	iɛŋ˧˥
yêu	iəw˧˥
yếm	iɛm˩˧
yến	iɛŋ˩˧
yết	iɛk˦˥
yếu	iəw˩˧
yểm	iɛm˧˩˨
yểng	iɛŋ˧˩˨
yểu	iəw˧˩˨
à	a˦˨
ành	an˦˨
ào	aw˦˨
á	a˩˧
ác	ak˦˥
ác-bít	ak˦˥-bit˦˥
ác-ten	ak˦˥-tɛŋ˧˥
ách	ak˦˥
ái	aj˩˧
ám	am˩˧
án	aŋ˩˧
áng	aŋ˩˧
ánh	an˩˧
áo	aw˩˧
áp	ap˦˥
át	ak˦˥
áy	ăj˩˧
â	ɤ̆˧˥
âm	ɤ̆m˧˥
ân	ɤ̆ŋ˧˥
âu	ɤ̆w˧˥
è	ɛ˦˨
èng	ɛŋ˦˨
èo	eo˦˨
é	ɛ˩˧
éc	ɛk˦˥
ém	ɛm˩˧
én	ɛŋ˩˧
éo	eo˩˧
ép	ɛp˦˥
ét	ɛk˦˥
ê	e˧˥
êm	em˧˥
êu	ɛu˧˥
ì	i˦˨
ìn	in˦˨
ình	in˦˨
í	i˩˧
ích	it˦˥
ít	it˦˥
ò	ɔ˦˨
òi	ɔj˦˨
òm	ɔm˦˨
òng	ɔŋm˦˨
ó	ɔ˩˧
óc	ɔkp˦˥
ói	ɔj˩˧
óng	ɔŋm˩˧
óp	ɔp˦˥
ót	ɔkp˦˥
ô	o˧˥
ô-tô	o˧˥-to˧˥
ôi	oj˧˥
ôm	om˧˥
ôn	oŋm˧˥
ông	oŋm˧˥
õng	ɔŋm˧˩˨
ù	u˦˨
ùa	uə˦˨
ùm	um˦˨
ùn	uŋm˦˨
ùng	uŋm˦˨
ú	u˩˧
úa	uə˩˧
úc	ukp˦˥
úi	uj˩˧
úm	um˩˧
úng	uŋm˩˧
úp	up˦˥
út	ukp˦˥
ý	i˩˧
ý	ʔi˧˥
ăm	ăm˧˥
ăn	ăŋ˧˥
ăng	ăŋ˧˥
đa	da˧˥
đai	daj˧˥
đam	dam˧˥
đan	daŋ˧˥
đang	daŋ˧˥
đanh	dan˧˥
đao	daw˧˥
đau	dăw˧˥
đay	dăj˧˥
đe	dɛ˧˥
đem	dɛm˧˥
đen	dɛŋ˧˥
đeo	deo˧˥
đi	di˧
đi	di˧˥
đinh	din˧˥
điên	diəŋ˧˥
điêu	diəw˧˥
điếc	diək˦˥
điếm	diəm˩˧
điếu	diəw˩˧
điềm	diəm˦˨
điền	diəŋ˦˨
điều	diəw˦˨
điểm	diəm˧˩˨
điển	diəŋ˧˩˨
điểu	diəw˧˩˨
điện	diəŋ˨ˀ˩ʔ
điệp	diəp˨ˀ˩ʔ
điệu	diəw˨ˀ˩ʔ
đo	dɔ˧˥
đoan	dwaŋ˧˥
đoi	dɔj˧˥
đom	dɔm˧˥
đon	dɔŋm˧˥
đong	dɔŋm˧˥
đoàn	dwaŋ˦˨
đoàng	dwaŋ˦˨
đoành	dwan˦˨
đoái	dwaj˩˧
đoán	dwaŋ˩˧
đoạ	dwa˨ˀ˩ʔ
đoạn	dwaŋ˨ˀ˩ʔ
đoạt	dwak˨ˀ˩ʔ
đoản	dwaŋ˧˩˨
đoảng	dwaŋ˧˩˨
đu	du˧˥
đua	duə˧˥
đui	duj˧˥
đum	dum˧˥
đun	duŋm˧˥
đung	duŋm˧˥
đuôi	duəj˧˥
đuềnh	dwen˦˨
đuểnh	dwen˧˩˨
đuễnh	dwen˧˩˨
đuốc	duək˦˥
đuối	duəj˩˧
đuồn	duəŋ˦˨
đuổi	duəj˧˩˨
đà	da˦˨
đài	daj˦˨
đàm	dam˦˨
đàn	daŋ˦˨
đàng	daŋ˦˨
đành	dan˦˨
đào	daw˦˨
đày	dăj˦˨
đá	da˩˧
đách	dak˦˥
đái	daj˩˧
đám	dam˩˧
đáng	daŋ˩˧
đánh	dan˩˧
đáo	daw˩˧
đáp	dap˦˥
đáy	dăj˩˧
đâm	dɤ̆m˧˥
đâu	dɤ̆w˧˥
đây	dɤ̆j˧˥
đã	da˧˩˨
đãi	daj˧˩˨
đãng	daŋ˧˩˨
đè	dɛ˦˨
đèm	dɛm˦˨
đèn	dɛŋ˦˨
đèo	deo˦˨
đéo	deo˩˧
đê	de˧˥
đêm	dem˧
đêm	dem˧˥
đì	di˦˨
đình	din˦˨
đìu	diw˦˨
đí	di˩˧
đích	dit˦˥
đính	din˩˧
đít	dit˦˥
đò	dɔ˦˨
đòi	dɔj˦˨
đòm	dɔm˦˨
đòn	dɔŋm˦˨
đòng	dɔŋm˦˨
đó	dɔ˩˧
đói	dɔj˩˧
đóm	dɔm˩˧
đón	dɔŋm˩˧
đóng	dɔŋm˩˧
đô	do˧˥
đôi	doj˧
đôi	doj˧˥
đôm	dom˧˥
đôn	doŋm˧˥
đông	doŋm˧˥
đông-nam	doŋm˧˥-nam˧˥
đù	du˦˨
đùa	duə˦˨
đùi	duj˦˨
đùm	dum˦˨
đùn	duŋm˦˨
đùng	duŋm˦˨
đú	du˩˧
đúc	dukp˦˥
đún	duŋm˩˧
đúng	duŋm˩˧
đút	dukp˦˥
đăm	dăm˧˥
đăng	dăŋ˧˥
đĩ	di˧˩˨
đĩa	diə˧˩˨
đĩnh	din˧˩˨
đũa	duə˧˩˨
đũng	duŋm˧˩˨
đơm	dɤm˧˥
đơn	dɤŋ˧˥
đưa	dɯə˧˥
đương	dɯəŋ˧˥
đười	dɯəj˦˨
đườn	dɯəŋ˦˨
đường	dɯəŋ˦˨
được	dɨək˧˥
được	dɯək˨ˀ˩ʔ
đượm	dɯəm˨ˀ˩ʔ
đạc	dak˨ˀ˩ʔ
đại	daj˨ˀ˩ʔ
đạm	dam˨ˀ˩ʔ
đạn	daŋ˨ˀ˩ʔ
đạo	daw˨ˀ˩ʔ
đạp	dap˨ˀ˩ʔ
đạt	dak˨ˀ˩ʔ
đạt-lai	dak˨ˀ˩ʔ-laj˧˥
đả	da˧˩˨
đảm	dam˧˩˨
đản	daŋ˧˩˨
đảng	daŋ˧˩˨
đảo	daw˧˩˨
đấm	dɤ̆m˩˧
đấng	dɤ̆ŋ˩˧
đất	dɤ̆k˦˥
đấu	dɤ̆w˩˧
đấy	dɤ̆j˩˧
đầm	dɤ̆m˦˨
đần	dɤ̆ŋ˦˨
đầu	dɤ̆w˦˨
đầy	dɤ̆j˦˨
đẩu	dɤ̆w˧˩˨
đẩy	dɤ̆j˧˩˨
đẫm	dɤ̆m˧˩˨
đẫn	dɤ̆ŋ˧˩˨
đẫy	dɤ̆j˧˩˨
đậm	dɤ̆m˨ˀ˩ʔ
đận	dɤ̆ŋ˨ˀ˩ʔ
đập	dɤ̆p˨ˀ˩ʔ
đậu	dɤ̆w˨ˀ˩ʔ
đậy	dɤ̆j˨ˀ˩ʔ
đắc	dăk˦˥
đắm	dăm˩˧
đắn	dăŋ˩˧
đắng	dăŋ˩˧
đắp	dăp˦˥
đắt	dăk˦˥
đằm	dăm˦˨
đằng	dăŋ˦˨
đẳng	dăŋ˧˩˨
đẵm	dăm˧˩˨
đặc	dăk˨ˀ˩ʔ
đặm	dăm˨ˀ˩ʔ
đặt	dăk˨ˀ˩ʔ
đẹn	dɛŋ˨ˀ˩ʔ
đẹp	dɛp˨ˀ˩ʔ
đẹt	dɛk˨ˀ˩ʔ
đẻ	dɛ˧˩˨
đẽo	deo˧˩˨
đế	de˩˧
đếch	det˦˥
đếm	dem˩˧
đến	den˩˧
đề	de˦˨
đền	den˦˨
đềnh	den˦˨
đều	dɛu˦˨
để	de˧˩˨
đểnh	den˧˩˨
đểu	dɛu˧˩˨
đễnh	den˧˩˨
đệ	de˨ˀ˩ʔ
đệm	dem˨ˀ˩ʔ
đỉa	diə˧˩˨
đỉnh	din˧˩˨
địa	diə˨ˀ˩ʔ
địch	dit˨ˀ˩ʔ
định	din˨ˀ˩ʔ
địt	dit˨ˀ˩ʔ
đọ	dɔ˨ˀ˩ʔ
đọa	dwa˨ˀ˩ʔ
đọc	dɔkp˨ˀ˩ʔ
đọi	dɔj˨ˀ˩ʔ
đọng	dɔŋm˨ˀ˩ʔ
đỏ	dɔ˧˩˨
đỏm	dɔm˧˩˨
đỏng	dɔŋm˧˩˨
đố	do˩˧
đốc	dokp˦˥
đốc-tơ	dokp˦˥-tɤ˧˥
đối	doj˩˧
đốm	dom˩˧
đốn	doŋm˩˧
đống	doŋm˩˧
đốp	dop˦˥
đốt	dokp˦˥
đồ	do˦˨
đồi	doj˦˨
đồm	dom˦˨
đồn	doŋm˦˨
đồng	doŋm˦˨
đổ	do˧˩˨
đổi	doj˧˩˨
đổng	doŋm˧˩˨
đỗ	do˧˩˨
đỗ	do˨˩
độ	do˨ˀ˩ʔ
độc	dokp˨ˀ˩ʔ
đội	doj˨ˀ˩ʔ
độn	doŋm˨ˀ˩ʔ
động	doŋm˨ˀ˩ʔ
độp	dop˨ˀ˩ʔ
đột	dokp˨ˀ˩ʔ
đớ	dɤ˩˧
đới	dɤj˩˧
đớn	dɤŋ˩˧
đớp	dɤp˦˥
đờ	dɤ˦˨
đờ-mi	dɤ˦˨-mi˧˥
đời	dɤj˦˨
đờn	dɤŋ˦˨
đởm	dɤm˧˩˨
đỡ	də˨˩
đỡ	dɤ˧˩˨
đợ	dɤ˨ˀ˩ʔ
đợi	dɤj˨ˀ˩ʔ
đụ	du˨ˀ˩ʔ
đục	dukp˨ˀ˩ʔ
đụn	duŋm˨ˀ˩ʔ
đụng	duŋm˨ˀ˩ʔ
đủ	du˧˩˨
đủng	duŋm˧˩˨
đứ	dɯ˩˧
đứa	dɯə˩˧
đức	dɨk˧˥
đức	dɯk˦˥
đứng	dɯŋ˩˧
đứt	dɯk˦˥
đừng	dɯŋ˦˨
đử	dɯ˧˩˨
đực	dɯk˨ˀ˩ʔ
đựng	dɯŋ˨ˀ˩ʔ
ĩnh	in˧˩˨
ơ	ɤ˧˥
ơi	ɤj˧˥
ơn	ɤŋ˧˥
ư	ɯ˧˥
ưa	ɯə˧˥
ưng	ɯŋ˧˥
ưu	ɯw˧˥
ươi	ɯəj˧˥
ươm	ɯəm˧˥
ươn	ɯəŋ˧˥
ương	ɯəŋ˧˥
ước	ɯək˦˥
ướm	ɯəm˩˧
ướp	ɯəp˦˥
ướt	ɯək˦˥
ưỡn	ɯəŋ˧˩˨
ạ	a˨ˀ˩ʔ
ạ	ɑ˨˩
ạch	ak˨ˀ˩ʔ
ạo	aw˨ˀ˩ʔ
ả	a˧˩˨
ải	aj˧˩˨
ảm	am˧˩˨
ảnh	an˧˩˨
ảo	aw˧˩˨
ấm	ɤ̆m˩˧
ấm	ʔəm˧˥
ấn	ɤ̆ŋ˩˧
ấp	ɤ̆p˦˥
ấp	ʔəp˧˥
ất	ɤ̆k˦˥
ấu	ɤ̆w˩˧
ấy	ɤ̆j˩˧
ầm	ɤ̆m˦˨
ầu	ɤ̆w˦˨
ẩm	ɤ̆m˧˩˨
ẩn	ɤ̆ŋ˧˩˨
ẩn	ʔən˧
ẩu	ɤ̆w˧˩˨
ẫm	ɤ̆m˧˩˨
ậm	ɤ̆m˨ˀ˩ʔ
ập	ɤ̆p˨ˀ˩ʔ
ắc	ăk˦˥
ắc-coóc	ăk˦˥-kɔkp˦˥
ắng	ăŋ˩˧
ắt	ăk˦˥
ằng	ăŋ˦˨
ẳng	ăŋ˧˩˨
ẵm	ăm˧˩˨
ặc	ăk˨ˀ˩ʔ
ẹ	ɛ˨ˀ˩ʔ
ẹc	ɛk˨ˀ˩ʔ
ẹo	eo˨ˀ˩ʔ
ẻo	eo˧˩˨
ẽo	eo˧˩˨
ế	e˩˧
ếch	et˦˥
ề	e˦˨
ềnh	en˦˨
ễng	en˧˩˨
ễnh	en˧˩˨
ỉ	i˧˩˨
ỉa	iə˧˩˨
ỉm	im˧˩˨
ỉu	iw˧˩˨
ị	i˨ˀ˩ʔ
ịt	it˨ˀ˩ʔ
ọ	ɔ˨ˀ˩ʔ
ọc	ɔkp˨ˀ˩ʔ
ọp	ɔp˨ˀ˩ʔ
ọt	ɔkp˨ˀ˩ʔ
ỏe	we˧˩˨
ỏi	ɔj˧˩˨
ỏm	ɔm˧˩˨
ỏn	ɔŋm˧˩˨
ỏng	ɔŋm˧˩˨
ố	o˩˧
ốc	okp˦˥
ối	oj˩˧
ốm	om˩˧
ốm	ʔom˧
ống	oŋm˩˧
ốp	op˦˥
ốt	okp˦˥
ồ	o˦˨
ồi	oj˦˨
ồm	om˦˨
ồn	oŋm˦˨
ồng	oŋm˦˨
ổ	o˧˩˨
ổi	oj˧˩˨
ổm	om˧˩˨
ổn	oŋm˧˩˨
ộ	o˨ˀ˩ʔ
ộc	okp˨ˀ˩ʔ
ộn	oŋm˨ˀ˩ʔ
ộp	op˨ˀ˩ʔ
ớ	ɤ˩˧
ớn	ɤŋ˩˧
ớt	ɤk˦˥
ờ	ɤ˦˨
ời	ɤj˦˨
ờn	ɤŋ˦˨
ở	ɤ˧˩˨
ỡm	ɤm˧˩˨
ợ	ɤ˨ˀ˩ʔ
ụ	u˨ˀ˩ʔ
ụa	uə˨ˀ˩ʔ
ục	ukp˨ˀ˩ʔ
ụt	ukp˨ˀ˩ʔ
ủ	u˧˩˨
ủi	uj˧˩˨
ủn	uŋm˧˩˨
ủng	uŋm˧˩˨
ủy	uj˧˩˨
ứ	ɯ˩˧
ứa	ɯə˩˧
ức	ɯk˦˥
ứng	ɯŋ˩˧
ừ	ɯ˦˨
ừng	ɯŋ˦˨
ửng	ɯŋ˧˩˨
ỷ	i˧˩˨
