á	a
á	a
à	a
à	á
à	á
ă	a
ă	a
ȧ	ă
ȁ	á
á	aː
á	áː
á	àː
à	áː
à	àː
ă	aː
ă	aː
ā	áː
ā	àː
ȃ	áː
ä	ɐ
ä	ɐ
abak	áːbak
abstrakcija	apstràːktsija
abstraktno	apstráːktnɔ
absurden	apsúːrdən
absurdnejši	apsúːrdnɛjʃi
aceton	atsɛtóːn
adaptacija	adaptàːtsija
adijo	adíːjɔ
adjektiven	adjɛktíːʋən
adut	adúːt
ä	éː
ä	éː
ä	èː
ä	èː
aerodinamika	áːɛrɔdinàːmika
aerodinamika	aɛ́ːrɔdinàːmika
aerolit	aɛrɔlíːt
ä	ɛ́ː
ä	ɛ́ː
ä	ɛ̀ː
ä	ɛ̀ː
ă	ɤ
ă	ɤ
afganistan	aʋɡáːnistan
afna	àːfna
afrika	áːfrika
aglomeracija	aɡlɔmɛràːtsija
agrumi	aɡrúːmi
ahil	axíːl
ahoj	axóːj
ajd	àːjt
ajd	ájt
ajnštajnij	áːjnʃtajnij
aksiom	aksijóːm
aktinij	aktìːnij
aktualizacija	aktualizàːtsija
aktualizirati	aktualizíːrati
akuzativ	áːkuzatiʋ
akvarij	akʋàːrij
albanec	albáːnəts
albanija	albàːnija
albanka	albáːnka
albanščina	albáːnʃtʃina
albanski	albáːnski
albansko	albáːnskɔ
aleksander	alɛksàːndər
ali	áːli
ali	ali
ali	áli
aligator	aliɡáːtɔr
aljaska	aljáːska
alkohol	alkɔxóːl
alpaka	alpáːka
aluminij	alumìːnij
alžirija	alʒíːrija
aman	áːman
amarant	amaráːnt
amarant	amaràːnt
ambasador	ambasáːdɔr
ambrozija	ambròːzija
americij	amɛrìːtsij
amerika	amɛ́ːrika
ameriški	amɛ́ːriʃki
amfiteater	amfitɛàːtər
ampak	ámpak
amper	ampɛ́ːr
amputirati	amputíːrati
amulet	amuléːt
ana	àːna
anakonda	anakóːnda
analen	anáːlən
analogija	analɔɡíːja
ananas	áːnanas
anarhist	anarxíːst
anarhizem	anarxìːzəm
anatomija	anatɔmíːja
andaluzija	andalùːzija
andora	andóːra
andreaš	andrɛàːʃ
andrej	andrɛ̀ːj
angel	àːnɡɛl
angleščina	anɡléːʃtʃina
angleški	anɡléːʃki
angleško	anɡléːʃkɔ
anglež	anɡléːʃ
angležinja	anɡléːʒinja
anglija	áːnɡlija
anomalija	anɔmalíːja
antarktika	antàːrktika
antilopa	antilóːpa
antimon	antimóːn
anton	antóːn
antonim	antɔníːm
apartma	apartmáː
apnenec	apnéːnəts
apnenec	apnèːnəts
apokalipsa	apɔkalíːpsa
apostrof	apɔstróːf
april	apríːl
arabski	aráːpski
aragonit	araɡɔníːt
arašid	araʃíːt
argon	áːrɡɔn
argon	arɡóːn
arh	áːrx
arhangel	arxàːnɡɛl
arhitektura	arxitɛktúːra
arhivar	arxiʋàːr
aristokracija	aristɔkratsíːja
aristotel	aristóːtɛl
armada	armáːda
armenija	armèːnija
artefakt	artɛfáːkt
arterija	artɛ̀ːrija
arzen	arzéːn
as	áːs
asimetrija	ásimɛtríːja
asklepij	asklèːpij
astat	astáːt
asteroid	astɛrɔíːt
astrofizika	áːstrɔfìːzika
astrologija	astrɔlɔɡíːja
astronomija	astrɔnɔmíːja
ateizem	atɛìːzəm
atena	atéːna
atene	atéːnɛ
atol	atóːl
atomski	atóːmski
atonalen	átɔnáːlən
atrij	àːtrij
autokracija	autɔkratsíːja
avgust	aʋɡúːst
avstralija	aʋstràːlija
avstrija	áːʋstrija
avstrijec	aʋstríːjəts
avstrijka	aʋstríːjka
avstrijski	aʋstríːjski
avtizem	aʋtìːzɛm
avto	áːʋtɔ
avtobus	áːʋtɔbus
avtocesta	áːʋtɔtsèːsta
avtomehanik	áːʋtɔmɛxàːnik
avtopralnica	áːʋtɔpráːlnitsa
avtor	áːʋtɔr
avtor	àːʋtɔr
avtosedež	áːʋtɔséːdɛʃ
avtošola	áːʋtɔʃóːla
avtosugestija	áːʋtɔsuɡɛstíːja
azerbajdžan	azɛrbajdʒáːn
azija	àːzija
azil	azíːl
baba	bàːba
babica	bàːbitsa
bager	bàːɡər
bagrist	baɡríːst
bahami	baxáːmi
bahrajn	baxráːjn
bajen	báːjən
bajonet	bajɔnéːt
bajta	báːjta
baker	bàːkər
bakla	báːkla
baklonosec	baklɔnóːsɛts
balet	baléːt
bambus	báːmbus
banja	bàːnja
banka	báːnka
barantati	barantàːti
bar	báːr
barcelona	bartsɛlóːna
barij	bàːrij
barion	báːrijɔn
barion	barijóːn
barka	báːrka
barva	báːrʋa
basati	bàːsati
bas	báːs
bask	báːsk
baskovščina	báːskɔʋʃtʃina
baskovski	báːskɔʋski
baterija	batɛríːja
bati	bàːti
batiskaf	batiskáːf
baza	báːza
baza	bàːza
bazalt	bazáːlt
bazen	bazéːn
b	b
b	b
b	béː
b	béː
b	bèː
b	bèː
b	bə
b	bə́
b	bə́
be	béː
beda	bèːda
bedak	bɛdàːk
beden	bèːdən
bednejši	bèːdnɛjʃi
bedro	bɛ̀ːdrɔ
beg	béːk
begunec	bɛɡúːnəts
bel	bèːʋ
belejši	bɛlɛ́ːjʃi
belgija	bèːlɡija
belgijski	bèːlɡijski
belina	bɛlìːna
beljak	bɛljàːk
beloruščina	bɛlɔrúːʃtʃina
belorusija	bɛlɔrúːsija
beloruski	bɛlɔrúːski
benetke	bɛnéːtkɛ
benzen	bɛnzéːn
beograd	béːɔɡrat
bergla	béːrɡla
berilij	bɛrìːlij
berkelij	bɛrkèːlij
beseda	bɛséːda
beseden	bɛséːdən
besedilo	bɛsɛdìːlɔ
besedotvoren	bɛsɛdɔtʋóːrən
besedotvoren	bɛsɛdɔtʋòːrən
besedotvorje	bɛsɛdɔtʋóːrjɛ
betežen	bɛtèːʒən
betežnejši	bɛtèːʒnɛjʃi
betlehem	béːtlɛxɛm
beton	bɛtóːn
bežati	bɛʒàːti
bezeg	bəzə́k
bezeg	bə̀zək
bezjak	bɛzjáːk
bič	bíːtʃ
bič	bìːtʃ
bič	bítʃ
bik	bík
binom	binóːm
biokemija	bíːjɔkɛmíːja
biološki	biɔlóːʃki
birtija	birtíːja
bisaga	bisáːɡa
bisaga	bisàːɡa
biseksualnost	bíːsɛksuáːlnɔst
biser	bíːsɛr
bistvo	bíːstʋɔ
biti	bìːti
bitje	bíːtjɛ
bitje	bìːtjɛ
bivol	bíːʋɔl
bivši	bíːʋʃi
bizantinski	bizantíːnski
bizgec	bíːzɡəts
bizmut	bíːzmut
bizon	bíːzɔn
blagajna	blaɡáːjna
blag	bláːk
blago	blaɡóː
blagosloviti	blaɡɔslɔʋíːti
blagosloviti	blaɡɔslɔʋìːti
blatnik	bláːtnik
blato	blàːtɔ
blazen	blàːzən
blaznik	bláːznik
bled	bléːt
blesteti	blɛstèːti
blesti	blɛ̀ːsti
bliže	blíːʒɛ
blizek	blìːzək
bližje	blíːʒjɛ
bližnjica	blíːʒnjitsa
blizu	blìːzu
boben	bóːbən
bober	bòːbər
bober	bɔ̀ːbər
bo	bóː
bodi	bòːdi
bodimo	bòːdimɔ
bodimo	bɔdíːmɔ
bodita	bòːdita
bodita	bɔdíːta
bodite	bòːditɛ
bodite	bɔdíːtɛ
bodiva	bòːdiʋa
bodiva	bɔdíːʋa
bodo	bóːdɔ
bogastvo	bɔɡáːstʋɔ
bogat	bɔ̀ːɡat
bogat	bɔɡát
bogatejši	bɔɡatɛ́ːjʃi
bog	bóːk
bog	bóːk
boginja	bɔɡìːnja
bogomolka	bɔɡɔmóːlka
bogoslužje	bɔɡɔslúːʒjɛ
boja	bóːja
bojazen	bɔjáːzən
bojo	bóːjɔ
bokal	bɔkáːl
bokal	bɔkáːʋ
bolan	bɔláːn
bolečina	bɔlɛtʃìːna
boleti	bɔlèːti
bolezen	bɔléːzən
bolgar	bɔlɡáːr
bolgarija	bɔlɡàːrija
bolgarka	bɔlɡáːrka
bolgarščina	bɔlɡáːrʃtʃina
bolgarščina	bɔlɡàːrʃtʃina
bolgarski	bɔlɡáːrski
bolgarski	bɔlɡàːrski
bolgarsko	bɔlɡáːrskɔ
bolgarsko	bɔlɡàːrskɔ
bolha	bɔ̀ːʋxa
bolj	bɔ́l
bolje	bóːljɛ
boljše	bóːlʃɛ
boljši	bóːlʃi
bolnica	bóːlnitsa
bolnik	bɔʋnìːk
bolnišnica	bɔʋníːʃnitsa
bomba	bóːmba
bombardirati	bɔmbardíːrati
bombaž	bɔmbáːʃ
bombnik	bóːmbnik
bom	bóːm
bomo	bóːmɔ
bon	bóːn
borba	bóːrba
bor	bóːr
bor	bɔ́r
borec	bóːrəts
boriti	bɔríːti
boriti	bɔrìːti
borka	bóːrka
borka	bòːrka
borovnica	bɔrɔʋnìːtsa
borša	bóːrʃa
borut	bóːrut
borza	bóːrza
bosanščina	bɔsáːnʃtʃina
bosanščina	bɔsàːnʃtʃina
bosanski	bɔsáːnski
bosanski	bɔsàːnski
bos	bóːs
boš	bóːʃ
bos	bɔ́s
bosenski	bóːsənski
bosna	bóːsna
bosta	bóːsta
boste	bóːstɛ
bosti	bɔ̀ːsti
bova	bóːʋa
božanski	bɔʒáːnski
božanstvo	bɔʒáːnstʋɔ
božati	bóːʒati
božič	bɔ̀ːʒitʃ
bozon	bɔzóːn
božur	bɔʒúːr
božur	bɔʒùːr
brada	bràːda
bradat	bradát
bradatejši	bradàːtɛjʃi
bradavica	bradaʋìːtsa
bralnik	bráːlnik
brana	bràːna
bran	bráːn
branik	branìːk
braniti	bràːniti
braniti	braníːti
braniti	branìːti
brat	brát
brati	bràːti
bratranec	bràːtranəts
bratranec	bratráːnəts
brazda	bràːzda
brazgotina	brazɡɔtìːna
brazilija	brazìːlija
brazilski	brazíːlski
brca	bə́rtsa
brcniti	bə̀rtsniti
brdavs	bərdáːʋs
breg	bréːk
breskev	bréːskəʋ
brest	bréːst
brest	brèːst
brest	brɛ́st
bresti	brɛ̀ːsti
bretanja	brɛtàːnja
bretonec	brɛtóːnəts
bretonka	brɛtóːnka
bretonščina	brɛtóːnʃtʃina
bretonski	brɛtóːnski
bretonsko	brɛtóːnskɔ
breza	brèːza
brez	brɛs
brezčustven	brɛstʃúːstʋɛn
brezoseben	brɛzɔséːbən
brglez	bə́rɡlɛs
briga	bríːɡa
brihten	brìːxtən
brihtnejši	brìːxtnɛjʃi
brin	brín
brisača	brisàːtʃa
britanija	britàːnija
britanski	britáːnski
briti	brìːti
britof	bríːtɔf
brivec	bríːʋəts
brki	bə́rki
brlog	bərlɔ́k
brod	bróːt
brom	bróːm
brom	brɔ́m
bron	brɔ́n
brskati	bə́rskati
brskati	bə̀rskati
bršljan	bərʃljáːn
bruc	brúːts
bruselj	brùːsəl
brusnica	brúːsnitsa
bruto	brúːtɔ
brv	bə́rʋ
buča	bùːtʃa
buda	búːda
budala	budàːla
budalo	budàːlɔ
buden	bùːdən
budimpešta	búːdimpɛʃta
budist	budíːst
budnejši	bùːdnɛjʃi
bukarešta	bukaréːʃta
bukev	búːkəʋ
bukselj	bùːksəl
bukva	búːkʋa
buldog	búːldɔk
bunda	búːnda
burek	búːrɛk
burja	búrja
butan	butáːn
butara	bùːtara
buteljka	butéːlka
čad	tʃáːt
čajnica	tʃáːjnitsa
čaj	tʃáːj
čakalnica	tʃakáːlnitsa
čakati	tʃàːkati
čao	tʃáːɔ
čaplja	tʃáːplja
carica	tsarìːtsa
čarovnica	tʃarɔ́ːʋnitsa
čarovnik	tʃarɔ́ːʋnik
carstvo	tsáːrstʋɔ
car	tsáːr
car	tsàːr
čaša	tʃàːʃa
časnik	tʃáːsnik
časopis	tʃasɔpíːs
častnik	tʃáːstnik
čas	tʃás
čast	tʃáːst
c	cə
c	cə
čebela	tʃəbéːla
čebela	tʃɛbéːla
čebula	tʃəbùːla
čebula	tʃɛbùːla
čefur	tʃɛfùːr
čefur	tʃɛfùːr
čehinja	tʃéːxinja
ceh	tséːx
čeh	tʃéːx
cekin	tsɛkíːn
ček	tʃéːk
celina	tsɛlìːna
celota	tsɛlɔ̀ːta
celo	tsɛlóː
čelo	tʃéːlɔ
čelo	tʃɛ̀ːlɔ
cel	tséːʋ
čemaž	tʃèːmaʃ
čemaž	tʃɛmáːʃ
čembalo	tʃéːmbalɔ
cena	tsèːna
cenzura	tsɛnzúːra
čeprav	tʃɛpráʋ
cerij	tsɛ̀ːrij
cerkev	tsèːrkəʋ
čer	tʃéːr
cesarica	tsɛsarìːtsa
cesarstvo	tsɛsáːrstʋɔ
cesar	tsɛ̀ːsar
češčina	tʃéːʃtʃina
česen	tʃɛ̀ːsən
češka	tʃéːʃka
češki	tʃéːʃki
češkoslovaška	tʃéːʃkɔslɔʋáːʃka
češko	tʃéːʃkɔ
česmina	tʃɛsmìːna
češnja	tʃéːʃnja
češplja	tʃéːʃplja
cesta	tsèːsta
četrtek	tʃɛtə̀rtək
četrtinka	tʃɛtərtíːnka
če	tʃɛ
čevelj	tʃéːʋəl
čevljekljun	tʃéːʋljɛkljúːn
cev	tséːʋ
cezij	tsèːzij
čifut	tʃìːfut
cigara	tsiɡáːra
cigara	tsiɡàːra
cigareta	tsiɡaréːta
čigar	tʃíːɡar
čigav	tʃiɡàːʋ
ciklon	tsiklóːn
čile	tʃíːlɛ
cilj	tsíːl
cimet	tsíːmɛt
cimet	tsìːmɛt
cink	tsíːnk
ciper	tsìːpər
čiraj	tʃiráːj
cirilica	tsiríːlitsa
cirkonij	tsirkòːnij
čistiti	tʃìːstiti
čistota	tʃistɔ̀ːta
čist	tʃíːst
čitati	tʃíːtati
čitati	tʃìːtati
citre	tsíːtrɛ
čivava	tʃiʋáːʋa
čižek	tʃíːʒɛk
članek	tʃláːnək
član	tʃláːn
človek	tʃlɔ̀ːʋɛk
človeški	tʃlɔʋèːʃki
človeštvo	tʃlɔʋéːʃtʋɔ
čmrlj	tʃmə̀rl
čober	tʃòːbər
cokla	tsóːkla
čokolada	tʃɔkɔláːda
čoln	tʃɔ́ːʋn
cona	tsóːna
čopič	tʃóːpitʃ
čopič	tʃɔ́ːpitʃ
črevce	tʃrèːʋtsɛ
črevo	tʃrɛʋóː
čriček	tʃríːtʃək
črka	tʃə̀rka
crkljati	tsərkljàːti
črkovati	tʃərkɔʋàːti
črnilo	tʃərnìːlɔ
črnogorski	tʃərnɔɡóːrski
črn	tʃə̀rn
črv	tʃə́rʋ
ć	tɕ
ć	tɕ
č	tɕ
č	tɕ
ć	tɕéː
ć	tɕéː
ć	tɕèː
ć	tɕèː
ć	tɕə́
ć	tɕə́
c	ts
c	ts
c	tséː
c	tséː
c	tsèː
c	tsèː
c	tsə́
c	tsə́
ć	tʃ
ć	tʃ
č	tʃ
č	tʃ
č	tʃéː
č	tʃéː
č	tʃèː
č	tʃèː
ć	tʃə
ć	tʃə
č	tʃə
č	tʃə
č	tʃə́
č	tʃə́
cula	tsùːla
čustven	tʃúːstʋən
čustvo	tʃúːstʋɔ
čutiti	tʃùːtiti
čutiti	tʃutíːti
čutiti	tʃutìːti
čuti	tʃùːti
čut	tʃúːt
cvek	tsʋɛ́k
cvesti	tsʋəstí
cvesti	tsʋə̀sti
cvesti	tsʋɛ̀ːsti
cveten	tsʋéːtən
cvetje	tsʋèːtjɛ
cvet	tsʋéːt
cviliti	tsʋìːliti
cvrček	tsʋə́rtʃək
cvreti	tsʋrèːti
dajalec	dajáːləts
dajalnik	dajáːlnik
dajati	dajàːti
daleč	dàːlɛtʃ
dalek	dáːlɛk
dalija	dàːlija
dalj	dál
daljšati	dáːlʃati
daljši	dáːlʃi
dama	dàːma
damask	damáːsk
damjak	dáːmjak
dan	dáːn
dan	dàːn
dandanes	dáːndàːnəs
danec	dáːnəts
danes	dàːnəs
danka	dáːnka
danščina	dáːnʃtʃina
danska	dáːnska
danski	dáːnski
dansko	dáːnskɔ
dar	dáːr
darilo	darìːlɔ
darovati	darɔʋàːti
datelj	dàːtəl
dati	dàːti
dativ	dáːtiʋ
datum	dáːtum
datum	dàːtum
davek	dàːʋək
daven	dàːʋən
d	d
d	d
ḍ	d
ḍ	d
d	déː
d	déː
d	dèː
d	dèː
d	də
d	də́
d	də́
đ	dʑ
đ	dʑ
đ	dʑéː
đ	dʑéː
đ	dʑèː
đ	dʑèː
đ	dʑə
đ	dʑə́
đ	dʑə́
đ	dʒ
đ	dʒ
đ	dʒə
ḍ	dˤ
ḍ	dˤ
debel	dɛ̀ːbɛʋ
debelejši	dɛbɛlɛ́ːjʃi
deber	déːbər
deber	dèːbər
deber	dəbə́r
deblo	dɛ̀ːblɔ
deček	déːtʃək
december	dɛtsɛ̀ːmbər
ded	déːt
ded	dɛ́t
dedovati	déːdɔʋati
dedovati	dèːdɔʋati
dedovati	dɛdɔʋàːti
dejanje	dɛjáːnjɛ
dejati	dɛjàːti
dejaven	dɛjáːʋən
dejaven	dɛjàːʋən
dejavnejši	dɛjáːʋnɛjʃi
dejavnejši	dɛjàːʋnɛjʃi
dejavnost	dɛjáːʋnɔst
dejavnost	dɛjàːʋnɔst
dekle	dɛklɛ́
delati	dèːlati
delavec	dèːlaʋəts
del	déːl
del	dèːl
del	déːʋ
del	dèːʋ
deležnik	dɛléːʒnik
delfin	dɛlfíːn
delo	dèːlɔ
demiurg	dɛmijúːrk
demografija	dɛmɔɡrafíːja
demokracija	dɛmɔkratsíːja
denar	dɛnàːr
denarnica	dɛnáːrnitsa
dendrokronologija	dɛndrɔkrɔnɔlɔɡìːja
depo	dɛpɔ
depresija	dɛprɛsíːja
desetarka	dɛsɛtàːrka
deset	dɛséːt
desetletje	dɛsɛtléːtjɛ
desetnica	dɛséːtnitsa
deska	dəská
deska	də̀ska
detel	dèːtəl
deti	dèːti
deva	déːʋa
deverbativen	dɛʋɛrbatíːʋən
devetdeset	dɛʋéːddɛsɛt
devet	dɛʋéːt
devetnajst	dɛʋéːtnajst
devetnajst	dɛʋɛtnàːjst
devica	dɛʋìːtsa
dež	də́ʃ
dežela	dɛʒɛ̀ːla
deževati	dəʒɛʋàːti
dežnik	dəʒnìːk
diamant	dijamáːnt
diamant	dijamàːnt
diamanten	diamáːntən
dihati	dìːxati
dihur	dixúːr
dihur	dixùːr
dijak	dijàːk
dim	dím
dimlje	díːmljɛ
dimlje	dìːmljɛ
dimnik	díːmnik
dinastija	dinastíːja
dinozaver	dinɔzàːʋər
dirigent	diriɡɛ́nt
dirka	díːrka
diskriminacija	diskriminàːtsija
disprozij	dispròːzij
diti	dìːti
divizija	diʋizíːja
divjak	dìːʋjak
divji	dìːʋji
dlaka	dlàːka
dlan	dláːn
dleto	dlèːtɔ
dnevnik	dnéːʋnik
dninar	dníːnar
dno	dnɔ́
doba	dɔ̀ːba
dob	dóːp
dober	dòːbər
dobiti	dɔbíːti
dobiti	dɔbìːti
dobrava	dɔbráːʋa
dobrodošel	dɔbrɔdɔ̀ːʃəʋ
dobro	dɔ̀ːbrɔ
do	dɔ
dogajati	dɔɡáːjati
dogajati	dɔɡàːjati
dogodek	dɔɡóːdək
dogovor	dɔɡɔ́ːʋɔr
dojenček	dɔjɛ̀ːntʃək
dojilja	dɔjìːlja
dokler	dóːklɛr
dokler	dɔklɛ́r
dokler	dɔ́klɛr
dol	dóːʋ
dol	dɔ̀ːl
dol	dɔ́ːʋ
dolg	dɔ́ːʋk
dolgočasen	dɔʋɡɔtʃàːsən
dolgočasnejši	dɔlɡɔtʃàːsnɛjʃi
dolgovaloven	dɔʋɡɔʋalɔ́ːʋən
dolina	dɔlìːna
dolžina	dɔʋʒìːna
doma	dɔmáː
dom	dóːm
domišljija	dɔmiʃljíːja
domoljub	dɔmɔljúːp
domov	dɔmɔ́ːʋ
domov	dɔmɔ̀ːʋ
domovina	dɔmɔʋìːna
donava	dóːnaʋa
dopoldan	dɔpɔ́ːʋdan
dotakniti	dɔtàːkniti
dotakniti	dɔtakníːti
dotakniti	dɔtaknìːti
dovolj	dɔʋɔ́l
dovoljenje	dɔʋɔljɛ̀ːnjɛ
dovršen	dɔʋə́rʃən
dovtip	dɔʋtíːp
doživeti	dɔʒiʋèːti
drag	dráːk
drago	dráːɡɔ
dragulj	draɡúːl
dragulj	draɡùːl
dražji	dráːʒji
drek	drɛ́k
dren	drɛ́n
dreti	drèːti
drevo	drɛʋóː
drka	də́rka
drkaj	də́rkaj
drkajmo	də́rkajmɔ
drkajo	də́rkajɔ
drkajta	də́rkajta
drkajte	də́rkajtɛ
drkajva	də́rkajʋa
drkam	də́rkam
drkamo	də́rkamɔ
drkanje	də́rkanjɛ
drkaš	də́rkaʃ
drkata	də́rkata
drkate	də́rkatɛ
drkati	də́rkati
drkava	də́rkaʋa
droben	drɔ̀ːbən
drobiž	drɔbìːʃ
drobnjak	drɔbnjàːk
drog	dróːk
dromedar	drɔmɛdàːr
dromlja	dróːmlja
drozd	dróːst
drozg	dróːsk
drseti	dərsèːti
drug	drúːk
drugi	drúːɡi
drugi	drùːɡi
drugoten	druɡɔ̀ːtən
družba	drúːʒba
družina	druʒìːna
drva	dərʋá
drva	də̀rʋa
država	dərʒáːʋa
državljan	dərʒaʋljáːn
ducat	dúːtsat
ducat	dùːtsat
duda	dúːda
duda	dùːda
dude	dúːdɛ
dude	dùːdɛ
duh	dúːx
dunaj	dùːnaj
dunajski	dùːnajski
duša	dùːʃa
dušik	duʃíːk
dva	dʋáː
dvajset	dʋáːjsɛt
dvanajst	dʋáːnajst
dvanajst	dʋanàːjst
dve	dʋéː
dvigniti	dʋìːɡniti
dvojček	dʋóːjtʃək
dvojček	dʋòːjtʃək
dvojina	dʋɔjìːna
dvojka	dʋóːjka
dvom	dʋóːm
dvom	dʋɔ́m
dvomiti	dʋóːmiti
dvomiti	dʋòːmiti
dvomiti	dʋɔmíːti
dvomiti	dʋɔmìːti
dvopičje	dʋóːpíːtʃjɛ
dvovidski	dʋóːʋíːtski
dvoživka	dʋɔʒíːʋka
džamija	dʒàːmija
dz	déːzè
dz	dèːzè
dz	déːzèː
dz	dèːzèː
dž	də́ʃ
dz	də́zə́
dz	dz
dz	dz
dz	dz
dz	dzéː
dz	dzéː
dz	dzéː
dz	dzèː
dz	dzèː
dz	dzèː
dz	dzə́
dz	dzə́
dz	dzə́
dž	dʒ
dž	dʒ
dž	dʒ
dž	dʒéː
dž	dʒéː
dž	dʒéː
dž	dʒèː
dž	dʒèː
dž	dʒèː
dž	dʒə́
dž	dʒə́
dž	dʒə́
džez	dʒéːs
džihad	dʒíːxat
džihad	dʒixáːt
džungla	dʒúːnɡla
eden	ɛ̀ːdən
ednina	ɛdnìːna
edvard	éːdʋart
e	e
e	e
ė	ĕ
e	éː
e	éː
e	èː
e	èː
é	éː
é	éː
é	èː
é	èː
ē	eː
ē	eː
ẹ	éː
ẹ	èː
e	ə́
e	ə́
e	ə̀
e	ə̀
ë	ə
ë	ə
e	ɛ
e	ɛ
e	ɛ́
e	ɛ́
e	ɛ̆
e	ɛ̆
é	ɛ
é	ɛ
è	ɛ
è	ɛ
è	ɛ́
ȩ	ɛ
ȅ	ɛ́
e	ɛː
e	ɛː
e	ɛ́ː
e	ɛ́ː
e	ɛ̀ː
e	ɛ̀ː
é	ɛ́ː
é	ɛ̀ː
ê	ɛ́ː
ê	ɛ́ː
ê	ɛ̀ː
ê	ɛ̀ː
ē	ɛː
ē	ɛː
ē	ɛ́ː
ē	ɛ̀ː
ȇ	ɛ́ː
egipt	ɛɡíːpt
è	ɪ
ejakulacija	ɛjakulàːtsija
ë	joː
ë	joː
ë	jɔ
ë	jɔ
ekologija	ɛkɔlɔɡíːja
ekonomija	ɛkɔnɔmíːja
ekonomist	ɛkɔnɔmíːst
ekosistem	éːkɔsistéːm
eksodus	éːksɔdus
elektromagnetski	ɛléːktrɔmaɡnéːtski
elektron	ɛléːktrɔn
elektron	ɛlɛktròːn
emigracija	ɛmiɡràːtsija
enačaj	ɛnatʃáːj
enačba	ɛnáːdʒba
ena	ɛ̀ːna
enaindvajset	ɛ́ːnaindʋáːjsɛt
enaindvajset	ɛ̀ːnaindʋáːjsɛt
enajst	ɛnàːjst
enakonočje	ɛnakɔnóːtʃjɛ
energija	ɛnɛrɡíːja
en	ɛn
en	ɛ́n
enkrat	ɛ̀ːnkrat
enkrat	ɛnkrát
enota	ɛnɔ̀ːta
entomologija	ɛntɔmɔlɔɡíːja
epicenter	ɛpitséːntər
epicenter	ɛpitsèːntər
epicenter	ɛpitsɛ́ːntər
epicenter	ɛpitsɛ̀ːntər
epir	ɛpíːr
epistemologija	ɛpistɛmɔlɔɡìːja
erbij	ɛ̀ːrbij
erekcija	ɛrèːktsija
erik	ɛ́ːrik
eritreja	ɛritrɛ́ːja
erotičen	ɛròːtitʃən
eržen	ɛrʒéːn
esej	ɛsɛ́ːj
estonec	ɛstóːnəts
estonija	ɛstòːnija
estonka	ɛstóːnka
estonščina	ɛstóːnʃtʃina
estonski	ɛstóːnski
estonsko	ɛstóːnskɔ
estuarij	ɛstuàːrij
etimologija	ɛtimɔlɔɡíːja
etiopija	ɛtijòːpija
eto	éːtɔ
eto	ɛ́tɔ
evo	éːʋɔ
evo	ɛ́ʋɔ
evro	ɛʋrɔ
evropa	ɛʋróːpa
evropij	ɛʋròːpij
ə	ə́
ə	ə̀
ə	ə̀ː
ə	pɔʋɡláːsnik
ɛ	ɛ
fagot	faɡóːt
fakulteta	fakultéːta
falzet	falzéːt
fant	fánt
fašizem	faʃíːzɛm
fašizem	faʃìːzɛm
fazan	fazáːn
februar	féːbruar
federacija	fɛdɛràːtsija
felicijan	fɛlitsijáːn
feminizem	fɛminíːzɛm
feminizem	fɛminìːzɛm
feniks	féːniks
fermij	fɛ̀ːrmij
f	f
f	f
f	fə
f	fə
figa	fìːɡa
file	filéː
filipini	filipíːni
filozof	filɔzóːf
finec	fíːnəts
fin	fíːn
finka	fíːnka
finščina	fíːnʃtʃina
finska	fíːnska
finski	fíːnski
finsko	fíːnskɔ
fizika	fìːzika
fižol	fiʒɔ́ʋ
flavta	fláːʋta
fluor	flúːɔr
fonetika	fɔnèːtika
fosfor	fóːsfɔr
fotograf	fɔtɔɡráːf
fotografija	fɔtɔɡrafíːja
franc	fránts
francija	fràːntsija
francij	fràːntsij
francoščina	frantsóːʃtʃina
francoski	frantsóːski
francosko	frantsóːskɔ
francoz	frantsóːs
francozinja	frantsóːzinja
frekvenca	frɛkʋéːntsa
friz	fríːs
fukajoč	fukajóːtʃ
fukajoč	fukajòːtʃ
fukati	fúːkati
funt	fúːnt
gabez	ɡáːbɛs
gadolinij	ɡadɔlìːnij
galeb	ɡaléːp
galicija	ɡalìːtsija
galij	ɡàːlij
gambija	ɡàːmbija
gams	ɡàːms
gams	ɡáms
gana	ɡáːna
gasa	ɡáːsa
gaziti	ɡàːziti
gejzir	ɡɛjzíːr
gejzir	ɡɛjzìːr
generacija	ɡɛnɛràːtsija
genij	ɡèːnij
genitiv	ɡéːnitiʋ
genocid	ɡɛnɔtsíːt
geodezija	ɡɛɔdɛzíːja
geografija	ɡɛɔɡrafíːja
geologija	ɡɛɔlɔɡíːja
gepard	ɡéːpart
germanij	ɡɛrmàːnij
geslo	ɡɛ̀ːslɔ
g	ɡ
g	ɡ
gibanje	ɡìːbanjɛ
gimnazija	ɡimnàːzija
ginekologija	ɡinɛkɔlɔɡíːja
glad	ɡláːt
gladilka	ɡladíːlka
glagol	ɡlàːɡɔl
glagolica	ɡlaɡóːlitsa
glagolnik	ɡlàːɡɔlnik
glagolski	ɡlàːɡɔlski
glasba	ɡláːzba
glasben	ɡláːzbɛn
glasbenik	ɡláːzbɛnik
glasen	ɡlàːsən
glas	ɡláːs
glasnejši	ɡlasnɛ́ːjʃi
glasoslovje	ɡlasɔslɔ́ːʋjɛ
glava	ɡlàːʋa
glaven	ɡláːʋən
glaven	ɡlàːʋən
glavnik	ɡlaʋnìːk
glavonožec	ɡlaʋɔnóːʒɛts
glazba	ɡláːzba
gledališče	ɡlɛdalìːʃtʃɛ
gledati	ɡlèːdati
gleženj	ɡlèːʒən
glina	ɡlìːna
globina	ɡlɔbìːna
globlji	ɡlóːblji
globok	ɡlɔbɔ́k
glodalec	ɡlɔdáːləts
glodavec	ɡlɔdáːʋɛts
glog	ɡlóːk
glog	ɡlɔ́k
gluh	ɡlúːx
glup	ɡlúːp
glušji	ɡlúːʃji
gnati	ɡnàːti
gnesti	ɡnɛ̀ːsti
gnezdo	ɡnèːzdɔ
gnil	ɡníːʋ
gniti	ɡnìːti
gnoj	ɡnóːj
gnostičen	ɡnòːstitʃən
gnosticizem	ɡnɔstitsìːzəm
goba	ɡòːba
godba	ɡóːdba
god	ɡóːt
gol	ɡóːl
gol	ɡɔ́ːʋ
gol	ɡɔ́ʋ
golibar	ɡɔlíːbar
golk	ɡɔ́ːʋk
golob	ɡɔlóːp
golob	ɡɔlóːp
golobica	ɡɔlɔbìːtsa
golobrad	ɡɔlɔbráːt
golobrad	ɡɔlɔbrát
golt	ɡɔ́ːʋt
gonoreja	ɡɔnɔrɛ́ːja
gora	ɡɔ̀ːra
gorčica	ɡóːrtʃitsa
gorčica	ɡɔrtʃìːtsa
gorek	ɡɔ̀ːrək
gorek	ɡɔ̀ːrɛk
goreti	ɡɔrèːti
gor	ɡɔ̀ːr
gorica	ɡɔrìːtsa
gorica	ɡɔrìːtsa
gorivo	ɡɔrìːʋɔ
gosar	ɡɔsàːr
gosenica	ɡɔséːnitsa
gos	ɡóːs
gospa	ɡɔspàː
gospodar	ɡɔspɔdàːr
gospod	ɡɔspóːt
gospodična	ɡɔspɔdíːtʃna
gost	ɡóːst
gost	ɡɔ́st
gosti	ɡòːsti
gostilna	ɡɔstíːlna
gostitelj	ɡɔstíːtɛl
govedina	ɡɔʋéːdina
govedo	ɡɔʋéːdɔ
govno	ɡɔ̀ːʋnɔ
govorec	ɡɔʋóːrəts
govor	ɡɔ́ːʋɔr
govoriti	ɡɔʋɔríːti
govoriti	ɡɔʋɔrìːti
gozdar	ɡɔzdàːr
gozdarstvo	ɡɔzdáːrstʋɔ
gozden	ɡóːzdən
gozden	ɡɔ̀ːzdən
gozd	ɡóːst
gozd	ɡɔ́st
grablje	ɡràːbljɛ
gradec	ɡráːdəts
grad	ɡráːt
grah	ɡráx
granica	ɡráːnitsa
grapa	ɡràːpa
gravitacija	ɡraʋitàːtsija
gravitacijski	ɡraʋitatsíːjski
grba	ɡə̀rba
grb	ɡə́rp
grča	ɡə̀rtʃa
grčija	ɡə́rtʃija
grd	ɡə́rt
greben	ɡrɛbéːn
grebsti	ɡrɛ̀ːpsti
gregorič	ɡrèːɡɔritʃ
greh	ɡrèːx
grenak	ɡrɛnáːk
grenek	ɡrɛ̀ːnək
grenivka	ɡrɛníːʋka
grenlandija	ɡréːnláːndija
grešiti	ɡrɛʃíːti
grešiti	ɡrɛʃìːti
greti	ɡrèːti
gripa	ɡrìːpa
gristi	ɡrìːsti
griva	ɡrìːʋa
griža	ɡríːʒa
grji	ɡə́rji
grk	ɡə́rk
grkinja	ɡə́rkinja
grlica	ɡə̀rlitsa
grlo	ɡə̀rlɔ
grm	ɡə́rm
grob	ɡrɔ́p
grof	ɡrɔ́f
grofica	ɡrɔfìːtsa
grofija	ɡrɔfíːja
grom	ɡrɔ́m
gros	ɡróː
grozdje	ɡròːzdjɛ
groziti	ɡrɔzíːti
groziti	ɡrɔzìːti
grozljivejši	ɡrɔzljìːʋɛjʃi
grozljiv	ɡrɔzljìːʋ
grozljivka	ɡrɔzljíːʋka
grščina	ɡə́rʃtʃina
grši	ɡə́rʃi
grški	ɡə́rʃki
grško	ɡə́rʃkɔ
gruden	ɡrùːdən
gruzija	ɡrúːzija
gruzijski	ɡrúːzijski
gruzinski	ɡruzíːnski
guba	ɡùːba
gubiti	ɡubíːti
gubiti	ɡubìːti
gumb	ɡúːmp
gvajana	ɡʋajáːna
gvineja	ɡʋinɛ́ːja
haag	xáːk
habakuk	xabakúːk
hadron	xadróːn
hafnij	xàːfnij
haitijski	xaíːtijski
halucinacija	xalutsinàːtsija
harfa	xáːrfa
harmonika	xarmòːnika
hasidizem	xasidíːzəm
hašiš	xáːʃiʃ
ha	xá
ha	xáː
hči	xtʃíː
heksagon	xɛksaɡóːn
hektoliter	xéːktɔlìːtər
helij	xèːlij
hematologija	xɛmatɔlɔɡíːja
heraldika	xɛràːldika
herbivor	xɛrbiʋóːr
hercegovina	xɛrtsɛɡɔʋìːna
hermelin	xɛrmɛlíːn
herodot	xɛróːdɔt
heteroseksualnost	xɛtɛrɔsɛksuáːlnɔst
heziod	xɛzijóːt
hiba	xìːba
hidrat	xidráːt
hidrologija	xidrɔlɔɡíːja
hidrolog	xidrɔlóːk
hidroplan	xidrɔpláːn
hidžra	xíːdʒra
higrometer	xiɡrɔméːtɛr
higrometer	xiɡrɔmèːtɛr
hijena	xijéːna
hinavski	xináːʋski
hip	xíːp
hiša	xìːʃa
hišen	xíːʃən
historičen	xistòːritʃən
hitreje	xitrɛ̀ːjɛ
hitrejše	xitrɛ̀ːjʃɛ
hitrost	xitróːst
hitro	xìːtrɔ
hlače	xlàːtʃɛ
hladen	xláːdən
hladilnik	xladíːlnik
hleb	xléːp
hleb	xlɛ́p
hlev	xléːʋ
hlev	xlèːʋ
hmelj	xméːl
hmelj	xmɛ́l
hobotnica	xɔbóːtnitsa
hoditi	xɔdíːti
hoditi	xɔdìːti
holandski	xɔláːntski
holmij	xòːlmij
holm	xóːlm
holm	xòːlm
homeopatija	xɔmɛɔpatíːja
homoseksualec	xɔmɔsɛksuáːləts
homoseksualen	xɔmɔsɛksuáːlən
homoseksualnost	xɔmɔsɛksuáːlnɔst
horvat	xɔ́ːrʋat
hosta	xóːsta
hostnik	xóːstnik
hotel	xɔtɛ̀ːl
hoteti	xɔtèːti
hrana	xràːna
hraniti	xràːniti
hraniti	xraníːti
hraniti	xranìːti
hrast	xràːst
hrbet	xərbə́t
hrbet	xə̀rbət
hrbtenica	xərptɛnìːtsa
hrbtenjača	xərptɛnjàːtʃa
hrček	xə́rtʃək
hren	xrɛ́n
hrib	xrìːp
hripav	xrìːpaʋ
hropsti	xrɔ̀ːpsti
hrošč	xrɔ́ʃtʃ
hrupen	xrúːpən
hrupen	xrùːpən
hrup	xrúːp
hruška	xrúːʃka
hrvaščina	xərʋáːʃtʃina
hrvaška	xərʋáːʃka
hrvaški	xərʋáːʃki
hudič	xudìːtʃ
hud	xúːt
hujši	xúːjʃi
hurija	xùːrija
huriska	xuríːska
husit	xusíːt
hvala	xʋàːla
hvaliti	xʋàːliti
hvaliti	xʋalíːti
hvaliti	xʋalìːti
hvošč	xʋóːʃtʃ
h	x
h	x
ideologija	idɛɔlɔɡíːja
idila	idíːla
igla	íːɡla
iglica	íːɡlitsa
iglokožec	iɡlɔkóːʒəts
igo	iɡóː
igrača	iɡràːtʃa
igra	íːɡra
igralec	iɡráːləts
igrati	iɡràːti
igrišče	iɡrìːʃtʃɛ
ihan	ixán
i	i
i	i
i	î
i	î
ì	i
ì	i
ì	î
ì	î
ȉ	i
ȉ	î
ȋ	í
i	iː
i	iː
i	íː
i	íː
i	ìː
i	ìː
í	iː
í	iː
í	íː
í	íː
í	ìː
í	ìː
ī	iː
ī	íː
ī	ìː
ȋ	iː
ȋ	íː
ikona	ikóːna
ime	iméː
imenovalnik	imɛnɔʋáːlnik
imenovati	imɛnɔʋàːti
imeti	imèːti
indija	ìːndija
indijec	íːndijəts
indij	ìːndij
indijka	ìːndijka
indijski	ìːndijski
indonezija	indɔnèːzija
inflacija	inflàːtsija
informatik	infɔrmàːtik
ingver	íːnɡʋɛr
ingver	ìːnɡʋɛr
insekt	inséːkt
inštitut	inʃtitúːt
instrumentalen	instrumɛntáːlən
instrumental	íːnstrumɛntal
instrumental	instrumɛntáːl
invazija	inʋazíːja
irak	iráːk
irec	íːrəts
iridij	irìːdij
irka	íːrka
ironija	irɔníːja
irščina	íːrʃtʃina
irska	íːrska
irski	íːrski
irsko	íːrskɔ
iskati	iskàːti
iskra	ìːskra
islam	íːslam
islandija	islàːndija
islandski	isláːntski
istanbul	íːstanbul
isti	íːsti
istra	íːstra
italija	itàːlija
italijan	italijáːn
italijan	italiján
italijanka	italijáːnka
italijanščina	italijáːnʃtʃina
italijanski	italijáːnski
italijansko	italijáːnskɔ
iterbij	itɛ̀ːrbij
iti	íːti
iti	ìːti
itrij	ìːtrij
ivan	íːʋan
izbira	izbíːra
izboljšava	izbɔlʃáːʋa
izbrati	izbràːti
izdajalec	izdajáːləts
izdati	izdàːti
izglagolski	izɡlàːɡɔlski
izgovoriti	izɡɔʋɔríːti
izgovoriti	izɡɔʋɔrìːti
izgovorjava	izɡɔʋɔrjáːʋa
izgubiti	izɡubíːti
izgubiti	izɡubìːti
iz	is
izključiti	iskljùːtʃiti
izklopiti	isklóːpiti
izklopiti	isklòːpiti
izklopiti	isklɔpíːti
izklopiti	isklɔpìːti
izkrcanje	íːskərtsàːnjɛ
izložba	izlóːʒba
izmena	izmɛ́ːna
izmolsti	izmɔ̀ːʋsti
izpeljanka	ispɛljàːnka
izpeljati	ispɛljàːti
izposoditi	ispɔsòːditi
izposoditi	ispɔsɔdíːti
izposoditi	ispɔsɔdìːti
izpuščaj	ispuʃtʃáːj
izrael	íːzraɛl
izraz	izrás
izsiljevalski	issiljɛʋáːlski
izsiljevalski	issiljɛʋáːʋski
izuti	izùːti
izvijač	izʋijàːtʃ
izvir	izʋíːr
jablana	jáːblana
jablana	jàːblana
jabolko	jàːbɔʋkɔ
jadro	jáːdrɔ
jadro	jàːdrɔ
jagnjec	jáːɡnjəts
jagnjec	jàːɡnjəts
jagnje	jàːɡnjɛ
jagnjetina	jàːɡnjɛtina
jagnjetina	jaɡnjɛtìːna
jagoda	jàːɡɔda
jahati	jáːxati
jahati	jàːxati
ja	jáː
ja	jàː
jajce	jàːjtsɛ
jajčevec	jáːjtʃɛʋəts
jajčevec	jàːjtʃɛʋəts
jajčnik	jáːjtʃnik
jakac	jáːkats
jak	jáːk
jama	jàːma
jamajka	jamáːjka
jamar	jáːmar
janez	jàːnɛs
janež	jàːnɛʃ
janšizem	janʃizɛm
jantar	jáːntar
jantar	jàːntar
januar	jáːnuar
japonska	japóːnska
jarek	jáːrək
jarek	jàːrək
jarem	jàːrəm
jasen	jàːsən
jasna	jáːsna
jasnejši	jàːsnɛjʃi
jasnejši	jasnɛ́ːjʃi
jasniti	jasníːti
jasniti	jasnìːti
jaspisen	jáːspisən
jaspis	jáːspis
jastreb	jáːstrɛp
javiti	jàːʋiti
javor	jàːʋɔr
jazbec	jáːzbəts
jaz	jás
jazon	jáːzɔn
jebati	jéːbati
jebati	jɛ́ːbati
ječmen	jɛ̀ːtʃmɛn
jedec	jéːdəts
jegulja	jɛɡùːlja
je	jèː
je	jɛ́
jeklo	jɛ̀ːklɔ
jelena	jɛléːna
jelen	jɛ̀ːlɛn
jelka	jèːlka
jelša	jèːʋʃa
jemati	jɛmàːti
jemen	jèːmən
jerebica	jɛrɛbìːtsa
jereb	jɛréːp
jeremija	jɛrɛmíːja
jeruzalem	jɛrúːzalɛm
jesen	jɛ̀ːsɛn
jesen	jɛséːn
jesika	jɛsìːka
jesti	jèːsti
jeti	jèːti
jetika	jèːtika
jetra	jèːtra
jezen	jèːzən
jezero	jéːzɛrɔ
ježevec	jéːʒɛʋəts
ježevec	jèːʒɛʋəts
jezik	jɛ̀ːzik
jezikoslovec	jɛzikɔslɔ́ːʋəts
jezikoslovje	jɛzikɔslɔ́ːʋjɛ
jež	jéːʃ
jež	jéːʃ
jež	jèːʃ
jež	jèːʃ
jeznejši	jèːznɛjʃi
jezus	jéːzus
jod	jóːt
joga	jóːɡa
jogurt	jóːɡurt
jokati	jòːkati
jokati	jɔkàːti
jordanija	jɔrdàːnija
jordanski	jɔrdáːnski
jožef	jóːʒɛf
jože	jóːʒɛ
judovstvo	jùːdɔʋstʋɔ
jug	júːk
jug	júk
jugoslavija	juɡɔslàːʋija
juha	jùːxa
julij	jùːlij
junak	junàːk
junij	jùːnij
jupiter	júːpitər
jurij	jùːrij
jur	jùːr
jutri	júːtri
jutro	jùːtrɔ
juvan	júːʋan
južen	jùːʒən
južina	jùːʒina
južnejši	jùːʒnɛjʃi
južnoameriški	juʒnɔamɛ́ːriʃki
južnoslovanski	juʒnɔslɔʋáːnski
kača	kàːtʃa
kadar	kádar
kadilo	kadìːlɔ
kaditi	kadíːti
kaditi	kadìːti
kad	kát
kadmij	kàːdmij
kajak	káːjak
kaj	kàːj
kaj	káj
kako	kakóː
kako	kakòː
kakor	kákɔr
kakovost	kakɔ̀ːʋɔst
kakšen	káːkʃən
kakšen	kàːkʃən
kalcij	kàːltsij
kalifornija	kalifòːrnija
kalifornij	kalifòːrnij
kalij	kàːlij
kaliti	kalíːti
kaliti	kalìːti
kamela	kaméːla
kamen	kàːmən
kamerun	káːmɛrun
kamin	kamíːn
kamion	kamijóːn
kanada	káːnada
kanal	kanàːl
kanjon	káːnjɔn
kapati	kàːpati
kapela	kapɛ̀ːla
kapetanka	kapéːtanka
kapetan	kapéːtan
kapitalist	kapitalíːst
kapitalizem	kapitalìːzəm
kaplja	kàːplja
kapsula	káːpsula
karamela	karaméːla
kardinal	kardináːl
karel	kàːrəl
kartagina	kartáːɡina
kašča	kàːʃtʃa
kašelj	kàːʃəl
kašljati	káːʃljati
kastelic	kastéːlits
katalonija	katalòːnija
katalonščina	katalóːnʃtʃina
katalonski	katalóːnski
katedrala	katɛdráːla
kategorialen	katɛɡɔrijáːlən
kategorija	katɛɡɔríːja
kateter	katèːtər
kava	kàːʋa
kavarna	kaʋáːrna
kavčič	káːʋtʃitʃ
kavka	káːʋka
kavkaz	kaʋkáːs
kavsati	káːʋsati
kazahstan	káːzaxstan
kazalec	kazáːləts
kazati	kàːzati
kazati	kazàːti
kazen	káːzən
kaznovati	kaznɔʋàːti
kdaj	ɡdáːj
kdaj	ɡdàːj
kdaj	ɡdáj
kdo	ɡdóː
kdo	ɡdòː
kdor	ɡdóːr
kdor	ɡdɔ́r
kelih	kèːlix
kelt	kéːlt
kemija	kɛmíːja
kenguru	kɛnɡurúː
kenija	kèːnija
kenta	kéːnta
ker	kɛr
kern	kɛ́ːrn
kersnik	kɛrsnìːk
ki	ki
kikiriki	kikirikíː
kilometer	kilɔmèːtər
kinin	kiníːn
kino	kíːnɔ
kip	kíːp
kirij	kirìːj
kisel	kìːsəʋ
kisik	kisíːk
kis	kíːs
kislina	kislìːna
kitajec	kitáːjəts
kitajka	kitáːjka
kitajščina	kitáːjʃtʃina
kitajska	kitáːjska
kitajski	kitáːjski
kita	kìːta
kitara	kitáːra
kit	kíːt
kje	kjéː
kje	kjèː
kjer	kjéːr
kladivce	klàːdiʋtsɛ
kladivce	kladíːʋtsɛ
kladivce	kladìːʋtsɛ
kladivo	klàːdiʋɔ
kladivo	kladìːʋɔ
klarinet	klarinéːt
klasičen	klàːsitʃən
klas	kláːs
klasti	klàːsti
klati	klàːti
klavir	klaʋíːr
klečati	klɛtʃàːti
klen	kléːn
klen	klèn
klen	klɛ̀n
kleopatra	klɛóːpatra
klepati	klɛpàːti
klepec	klɛ̀ːpəts
kleptokracija	klɛptɔkratsíːja
klešče	klèːʃtʃɛ
klicaj	klitsáːj
klicati	klìːtsati
klic	klíːts
klima	klíːma
klima	klìːma
klitoris	klíːtɔris
ključavnica	kljutʃáːʋnitsa
ključiti	kljùːtʃiti
ključ	kljùːtʃ
kljukica	kljùːkitsa
kljunaš	kljunàːʃ
kljun	kljúːn
klobasa	klɔbàːsa
klobučar	klɔbutʃàːr
klobuk	klɔbùːk
klofuta	klɔfùːta
klokan	klóːkan
klop	klóːp
klop	klɔ́p
klopotača	klɔpɔtàːtʃa
klor	klóːr
klorofil	klɔrɔfíːl
klošar	klóːʃar
klošar	klɔʃàːr
klošč	klɔ́ʃtʃ
klovn	klɔ̀ːʋn
kmalu	kmáːlu
kmetija	kmɛtíːja
kmet	kmɛ́t
kmet	kmɛ́t
kneginja	knéːɡinja
knez	knéːs
knjiga	knjìːɡa
knjigarna	knjiɡáːrna
knjigovez	knjiɡɔʋéːs
književnost	knjiʒéːʋnɔst
knjižnica	kníːʒnjitsa
kobalt	kóːbalt
kobarid	kɔbaríːt
kobila	kɔbìːla
kobilar	kɔbíːlar
kobilica	kɔbìːlitsa
kočija	kɔtʃíːja
kocka	kóːtska
kockati	kóːtskati
koder	kòːdər
koder	kòːdər
kokalj	kòːkal
kokalj	kòːkal
kokolj	kòːkɔl
kokoš	kɔkóːʃ
kokot	kɔkóːt
ko	kɔ
kola	kóːla
kola	kɔ̀ːla
kolcanje	kɔ́ːu̯tsanjɛ
kolcanje	kɔ̀ːu̯tsanjɛ
kolc	kɔ́ːʋts
koledar	kɔlɛdàːr
koledž	kóːlɛtʃ
koleno	kɔlèːnɔ
kolesariti	kɔlɛsàːriti
količina	kɔlitʃìːna
kolidž	kóːlitʃ
kol	kɔ́ʋ
kolo	kóːlɔ
kolo	kɔlóː
komaj	kóːmaj
komarček	kɔmáːrtʃək
komarček	kɔmàːrtʃək
komar	kɔmàːr
komet	kɔméːt
komolec	kɔmóːləts
komori	kɔmóːri
kompas	kóːmpas
kompas	kɔmpáːs
komunizem	kɔmunìːzəm
končati	kɔntʃàːti
končen	kɔ̀ːntʃən
končno	kɔ̀ːntʃnɔ
kondom	kɔndóːm
konec	kɔ̀ːnəts
konjar	kɔnjàːr
konj	kɔ́n
konjuh	kɔnjúːx
konjuh	kɔnjùːx
konkreten	kɔnkréːtən
konkretno	kɔnkréːtnɔ
kontinent	kɔntinɛ́nt
kontrabas	kóːntrabáːs
konzulka	kóːnzulka
konzul	kóːnzul
kopalnica	kɔpáːlnitsa
kopati	kòːpati
kopati	kɔpàːti
kopel	kòːpɛʋ
kopel	kɔpéːl
koper	kòːpər
koper	kɔ̀ːpər
kopina	kɔpìːna
kopito	kɔpìːtɔ
kopje	kòːpjɛ
kop	kóːp
kopno	kóːpnɔ
kopno	kɔ́ːpnɔ
kopno	kɔ̀ːpnɔ
korak	kɔráːk
koreja	kɔrɛ́ːja
korenina	kɔrɛnìːna
korenje	kɔréːnjɛ
korenje	kɔrɛ̀ːnjɛ
koren	kɔréːn
koren	kɔréːn
korošec	kɔróːʃəts
koroška	kɔróːʃka
koruza	kɔrùːza
košara	kɔʃáːra
košarka	kɔʃáːrka
kosilo	kɔsìːlɔ
kosinus	kóːsinus
kosinus	kóːzinus
kosinus	kɔ́síːnus
kositer	kɔsìːtər
kositi	kòːsiti
kositi	kɔsíːti
kositi	kɔsìːti
kos	kóːs
koš	kɔ́ʃ
kosmulja	kɔsmùːlja
kostanj	kɔ̀ːstan
kost	kóːst
kostnica	kóːstnitsa
kot	kòːt
kot	kɔt
kotnik	kóːtnik
kovač	kɔʋàːtʃ
kovač	kɔʋàːtʃ
kovanec	kɔʋàːnəts
kovati	kɔʋàːti
kovinski	kɔʋíːnski
kovnica	kɔ́ːʋnitsa
koža	kòːʒa
koza	kɔ̀ːza
kozarec	kɔzáːrəts
kozel	kɔ̀ːzəʋ
kozmologija	kɔzmɔlɔɡíːja
kozorog	kɔzɔróːk
kozorog	kɔzɔróːk
krajina	kráːjina
krajina	kràːjina
kraj	kráj
krajšava	krajʃáːʋa
krajši	kráːjʃi
kraljestvo	kraljéːstʋɔ
kraljevina	kraljɛʋìːna
kraljica	kraljìːtsa
kralj	kràːl
kralj	kràːl
krap	kráp
kras	kráːs
kras	krás
krastača	krastàːtʃa
krasti	kràːsti
kratek	kràːtək
krater	kràːtɛr
kratica	kratìːtsa
kratkovaloven	kratkɔʋalɔ́ːʋən
krava	kràːʋa
kravžati	kráːʋʒati
krč	kə́rtʃ
krč	kə̀rtʃ
kreda	kréːda
krema	kréːma
krempelj	krèːmpəl
kreniti	krɛníːti
kreniti	krɛnìːti
kres	kréːs
kreta	kréːta
krik	kríːk
kri	kríː
krilo	krìːlɔ
kripton	kríːptɔn
kristalizacija	kristalizàːtsija
kristal	kristáːl
kristjan	kristjáːn
kristus	kríːstus
kriti	krìːti
krivda	kríːʋda
krivoverec	kriʋɔʋéːrəts
križanje	kríːʒanjɛ
križanje	krìːʒanjɛ
križanka	kríːʒanka
križ	krìːʃ
krma	kə̀rma
krog	króːk
krog	krɔk
krogla	króːɡla
krojač	krɔjàːtʃ
krokar	króːkar
krom	króːm
krom	krɔ́m
krompir	krɔmpíːr
krompir	krɔmpìːr
krona	króːna
kronati	króːnati
krožnik	króːʒnik
krščanstvo	kərʃtʃáːnstʋɔ
krsta	kə̀rsta
krst	kə́rst
krt	kə́rt
krutejši	krúːtɛjʃi
krutejši	krùːtɛjʃi
krut	krúːt
krvaveti	kərʋaʋèːti
krzno	kə́rznɔ
ksenofobija	ksɛnɔfɔbíːja
ksenon	kséːnɔn
ksilofon	ksilɔfóːn
kuba	kúːba
kuga	kùːɡa
kuhar	kúːxar
kuhati	kùːxati
kuhinja	kùːxinja
kukavica	kùːkaʋitsa
kuna	kùːna
kunec	kúːnəts
kunec	kùːnəts
kupa	kùːpa
kupiti	kùːpiti
kupiti	kupíːti
kupiti	kupìːti
kup	kúp
kupovati	kupɔʋàːti
kura	kùːra
kurba	kúːrba
kurdščina	kúːrtʃtʃina
kurec	kúːrəts
kurva	kúːrʋa
kuščar	kúːʃtʃar
kuščar	kùːʃtʃar
kuža	kúːʒa
kvadrat	kʋadráːt
kvark	kʋáːrk
kvar	kʋáːr
kvartet	kʋartéːt
kvas	kʋáːs
labod	labóːt
lačen	làːtʃən
ladja	làːdja
lagati	laɡàːti
lahek	làːxək
lahko	laxkóː
lajati	láːjati
lakota	làːkɔta
lama	làːma
lani	làːni
lantan	lantáːn
las	láːs
lasten	làːstən
last	láːst
lastnina	lastnìːna
lastnost	lastnóːst
lastovica	làːstɔʋitsa
lastovka	làːstɔʋka
latinica	latíːnitsa
latinščina	latíːnʃtʃina
latinski	latíːnski
latvija	làːtʋija
latvijec	làːtʋijəts
latvijka	làːtʋijka
latvijščina	làːtʋijʃtʃina
latvijski	làːtʋijski
latvijsko	làːtʋijskɔ
lavrencij	laʋrèːntsij
lažji	láːʒji
laž	láːʃ
lažnivec	laʒníːʋəts
leči	lèːtʃi
ledenik	lɛdɛnìːk
led	léːt
ledolomilec	lɛdɔlɔmíːlɛts
ledvica	lɛdʋìːtsa
legendaren	lɛɡɛndáːrən
leha	lèːxa
lek	léːk
le	lɛ́
lemež	léːmɛʃ
lemež	lɛ̀ːmɛʃ
lenivec	lɛníːʋəts
len	léːn
len	lɛ́n
leon	léːɔn
lepiti	lèːpiti
lepiti	lɛpíːti
lepiti	lɛpìːti
lep	léːp
lepota	lɛpɔ̀ːta
lepši	léːpʃi
leska	lèːska
lesketati	lɛskɛtàːti
les	léːs
lešnik	lèːʃnik
lesti	lèːsti
lestvica	lèːstʋitsa
letališče	lɛtalìːʃtʃɛ
letalo	lɛtàːlɔ
leten	léːtən
leteti	lɛtèːti
let	lɛ́t
leto	lèːtɔ
levinja	lɛ́ːʋinja
levinja	lɛ̀ːʋinja
levinja	lɛʋìːnja
lev	lɛ́ʋ
ležaj	lɛʒáːj
ležati	lɛʒàːti
lezbijka	lèːzbijka
libanon	líːbanɔn
liberija	libɛ̀ːrija
libidinozen	libidinóːzən
libija	lìːbija
lice	líːtsɛ
lice	lìːtsɛ
ličinka	litʃíːnka
ličnica	líːtʃnitsa
liga	lìːɡa
lijak	lijàːk
likalnik	likáːlnik
likati	líːkati
limonada	limɔnáːda
limona	limóːna
lipa	lìːpa
lipovec	lìːpɔʋəts
lira	líːra
lišaj	liʃáːj
lisica	lisìːtsa
lisička	lisìːtʃka
list	líːst
literatura	litɛratúːra
liter	lìːtər
litij	lìːtij
liti	lìːti
litovec	lìːtɔʋəts
litovka	lìːtɔʋka
litovščina	lìːtɔʋʃtʃina
litovski	líːtɔʋski
litovsko	líːtɔʋskɔ
liturgija	liturɡíːja
litva	líːtʋa
lizati	lìːzati
lizati	lizàːti
lizbona	lizbóːna
ljubeč	ljubɛ́tʃ
ljubezen	ljubéːzən
ljubiti	ljúːbiti
ljubiti	ljùːbiti
ljubiti	ljubíːti
ljubiti	ljubìːti
ljubit	ljùːbit
ljubljana	ljubljàːna
ljubljenje	ljúːbljɛnjɛ
ljubljenje	ljùːbljɛnjɛ
ljubosumen	ljubɔsùːmən
ljubosumnejši	ljubɔsùːmnɛjʃi
ljubosumnost	ljubɔsùːmnɔst
ljudski	ljúːtski
lobanja	lɔbàːnja
ločevati	lɔtʃɛʋàːti
ločiti	lòːtʃiti
ločiti	lɔtʃíːti
ločiti	lɔtʃìːti
log	lóːk
lokacija	lɔkàːtsija
lokativ	lóːkatiʋ
lok	lóːk
lokomotiva	lɔkɔmɔtíːʋa
lombardija	lɔmbardíːja
lomiti	lɔmíːti
lomiti	lɔmìːti
lom	lɔ́m
lonec	lɔ̀ːnəts
lopata	lɔpàːta
lopov	lóːpɔʋ
lopov	lɔ́ːpɔʋ
los	lóːs
losos	lóːsɔs
lotos	lóːtɔs
lovec	lɔ̀ːʋəts
loviti	lɔʋíːti
loviti	lɔʋìːti
lovka	lɔ́ːʋka
loza	lòːza
loza	lɔ̀ːza
lubenica	lúːbɛnitsa
lubje	lùːbjɛ
luč	lúːtʃ
luč	lùːtʃ
lug	lúːk
lug	lùːk
luka	lùːka
luka	lùːka
luknja	lúːknja
luksemburg	lúːksɛmburk
luksemburški	lúːksɛmburʃki
luksemburški	luksɛmbúːrʃki
lulček	lúːltʃək
lunah	lùːnax
luna	lùːna
lunama	lùːnama
lunami	lùːnami
lunam	lùːnam
lunaren	lunáːrən
lune	lùːnɛ
luni	lùːni
lun	lùːn
luno	lùːnɔ
luska	lùːska
lutecij	lutèːtsij
luteranec	lutɛráːnəts
lutnja	lúːtnja
mačeha	màːtʃɛxa
maček	màːtʃək
macesen	matsɛ̀ːsən
mačka	máːtʃka
madžarka	madʒáːrka
madžar	madʒáːr
madžarščina	madʒáːrʃtʃina
madžarska	madʒáːrska
madžarski	madʒáːrski
madžarsko	madʒáːrskɔ
mafija	màːfija
magnet	maɡnéːt
magnezij	maɡnéːzij
mah	máːx
mah	máx
maja	màːja
majati	màːjati
majati	majàːti
majhen	máːjxən
maj	màːj
majoneza	majɔnéːza
majorka	majóːrka
makedonec	makɛdóːnəts
makedonija	makɛdòːnija
makedonka	makɛdóːnka
makedonščina	makɛdóːnʃtʃina
makedonski	makɛdóːnski
maklen	maklɛ́n
mak	máːk
mak	mák
malarija	malàːrija
maldivi	maldíːʋi
malezija	malèːzija
malina	malìːna
malo	màːlɔ
malte	máːltɛ
malteščina	maltéːʃtʃina
malteški	maltéːʃki
malteško	maltéːʃkɔ
maltežanka	maltɛʒáːnka
maltežan	maltɛʒáːn
maltežan	maltɛʒán
malti	máːlti
malto	máːltɔ
mamilo	mamìːlɔ
mamut	máːmut
mandolina	mandɔlíːna
mangan	manɡáːn
manjkati	máːnkati
manjšalnica	manʃáːlnitsa
manjši	máːnʃi
marec	màːrəts
marelica	maréːlitsa
marija	maríːja
marjan	máːrjan
marjeta	marjɛ̂ta
marko	màːrkɔ
maroko	maróːkɔ
mars	máːrs
masa	máːsa
maša	màːʃa
maslen	masléːn
maslen	maslèːn
maslo	màːslɔ
masturbacija	masturbàːtsija
masturbirati	masturbíːrati
matej	matɛ́ːj
matematika	matɛmàːtika
materen	máːtɛrən
maternica	máːtɛrnitsa
matica	máːtitsa
mati	màːti
mavec	màːʋəts
mavretanija	maʋrɛtàːnija
mavrica	máːʋritsa
mečji	méːtʃji
meč	mɛ́tʃ
medenica	mɛdɛnìːtsa
meden	mɛdéːn
medicina	mɛditsíːna
med	méːt
med	mɛt
medvedka	mɛdʋéːtka
medved	mɛ̀ːdʋɛt
megavat	méːɡaʋáːt
megla	məɡlá
megla	mə̀ɡla
meglica	məɡlìːtsa
mehaničen	mɛxàːnitʃən
mehek	mɛ̀ːxək
meher	mexɛ̀ːr
mehika	méːxika
mehir	mexìːr
mehkužec	mɛxkúːʒəts
meh	méːx
mehur	mexùːr
mejak	mɛjàːk
meja	mɛ̀ːja
mejiti	mɛjíːti
mejiti	mɛjìːti
meka	mèːka
melancana	mɛlantsáːna
melodija	mɛlɔdíːja
melona	mɛlóːna
me	méː
mendelevij	mɛndɛlèːʋij
menih	mənìːx
menih	mɛnìːx
meniti	mèːniti
meniti	mɛníːti
meniti	mɛnìːti
menjati	mèːnjati
menjati	mɛnjàːti
menstruacija	mɛnstruàːtsija
meriti	mèːriti
merjasec	mɛrjàːsəts
merkur	mɛrkúːr
mesar	mɛsàːr
mešati	mèːʃati
mešati	mɛʃàːti
mesec	méːsəts
mesec	méːsəts
mesija	mɛsíːja
mesojedec	mɛsɔjéːdəts
meso	mɛsóː
mesti	mèːsti
mesti	mɛ̀ːsti
mestnik	méːstnik
mesto	mèːstɔ
metafizika	mɛtafìːzika
meta	méːta
metati	mɛtàːti
metež	méːtɛʃ
meti	mèːti
metla	mɛ̀ːtla
met	mɛ́t
metulj	mɛtùːl
mezeg	məzə́k
mezeg	mə̀zək
mezinec	mɛzíːnəts
mezon	mɛzóːn
m	ɛm
mihaela	míːxaɛla
mihael	míːxaɛl
miha	mìːxa
miličnica	milíːtʃnitsa
miličnik	milíːtʃnik
milijon	milijóːn
milimeter	milimèːtər
milisekunda	míːlisɛkúːnda
militi	míːliti
militi	mìːliti
mil	míːl
milo	mìːlɔ
mi	míː
mina	míːna
mineralogija	minɛralɔɡíːja
miniti	miníːti
miniti	minìːti
minuta	minúːta
mir	míːr
mirna	míːrna
mirna	mìːrna
mirta	mìːrta
misel	míːsəʋ
mišica	míːʃitsa
mišičen	míːʃitʃən
mišjak	míːʃjak
miška	míːʃka
misliti	mìːsliti
miš	míʃ
miti	mìːti
mitologija	mitɔlɔɡíːja
mitološki	mitɔlóːʃki
miza	mìːza
mizantropija	mizantrɔpíːja
mjanmar	mjanmáːr
mladič	mladítʃ
mladina	mladìːna
mlad	mláːt
mladost	mladóːst
mlajši	mláːjʃi
mlečen	mlèːtʃən
mleko	mlèːkɔ
mlesti	mlèːsti
mleti	mlèːti
mlin	mlíːn
moča	mòːtʃa
močerad	mɔtʃɛrát
moči	mɔ̀ːtʃi
moč	móːtʃ
močvirje	mɔtʃʋíːrjɛ
moder	mòːdər
modernizirati	mɔdɛrnizíːrati
modnik	móːdnik
modo	móːdɔ
modo	mòːdɔ
modrec	móːdrəts
modrejši	mòːdrɛjʃi
modrejši	mɔdrɛ́ːjʃi
modrost	mòːdrɔst
modrost	mɔdróːst
mogoče	mɔɡòːtʃɛ
mohamed	mòːxamɛt
mohar	mɔ̀ːxar
moj	mòːj
mojzes	móːjzɛs
moka	mòːka
moker	mòːkər
molčati	mɔʋtʃàːti
moldavija	mɔldàːʋija
molekula	mɔléːkula
molibden	mɔlibdéːn
molitev	mɔlíːtəʋ
moliti	mɔlíːti
moliti	mɔlìːti
molk	mɔ́ːʋk
molsti	mɔ̀ːʋsti
monako	mɔnáːkɔ
monarhija	mɔnarxíːja
monarh	mɔnárx
monom	mɔnóːm
monoteizem	mɔnɔtɛìːzəm
morati	móːrati
moravec	mɔràːʋəts
morda	mɔrdá
moriti	mɔríːti
moriti	mɔrìːti
morje	móːrjɛ
morje	mɔrjéː
mornarica	mɔrnáːritsa
mornarka	mɔrnàːrka
morski	mɔ̀ːrski
mošeja	mɔʃɛ́ːja
moški	mɔ̀ːʃki
moskva	móːskʋa
most	móːst
mošt	mɔ́ʃt
motika	mɔtíːka
motor	móːtɔr
možen	mòːʒən
možgani	mɔʒɡáːni
mož	móːʃ
možnar	mòːʒnar
možnost	mòːʒnɔst
mravlja	mráːʋlja
mravlja	mràːʋlja
mraz	mrás
mreti	mrèːti
mreža	mrèːʒa
mrhovina	mərxɔʋìːna
mrkev	mə̀rkəʋ
mrkva	mə̀rkʋa
mrož	mróːʃ
mrtev	mə̀rtəʋ
muditi	mudíːti
muditi	mudìːti
muflon	muflóːn
muha	mùːxa
mujezin	mujɛzíːn
mula	mùːla
mulj	múːl
mungo	múːnɡɔ
murva	múːrʋa
muskularen	muskuláːrən
muslimanka	muslimáːnka
musliman	muslimáːn
muslimanski	muslimáːnski
mušnica	múːʃnitsa
muzej	muzɛ́ːj
muzikalen	muzikáːlən
muzikologija	muzikɔlɔɡíːja
načelo	natʃɛ́ːlɔ
načelo	natʃɛ̀ːlɔ
načeti	natʃèːti
nacizem	natsíːzɛm
nacizem	natsìːzɛm
načrt	natʃə́rt
nadlegovati	nadlɛɡɔʋàːti
nad	nat
nadporočnica	natpɔróːtʃnitsa
nadporočnik	natpɔróːtʃnik
nadzorovati	nadzɔrɔʋàːti
naenkrat	naɛ̀ːnkrat
nafta	náːfta
nagelj	nàːɡəl
nagel	nàːɡəʋ
naglas	naɡlás
naglejši	nàːɡlɛjʃi
nag	náːk
najabsurdnejši	nájapsúːrdnɛjʃi
najbednejši	nájbèːdnɛjʃi
najbelejši	nájbɛlɛ́ːjʃi
najbetežnejši	nájbɛtèːʒnɛjʃi
najbliže	nájblíːʒɛ
najbližje	nájblíːʒjɛ
najbogatejši	nájbɔɡatɛ́ːjʃi
najbolje	nájbóːljɛ
najbolj	nájbɔl
najboljše	nájbóːlʃɛ
najboljši	nájbóːlʃi
najbradatejši	nájbradàːtɛjʃi
najbrihtnejši	nájbrìːxtnɛjʃi
najbudnejši	nájbùːdnɛjʃi
najdalj	nájdál
najdaljši	nájdáːlʃi
najdebelejši	nájdɛbɛlɛ́ːjʃi
najdejavnejši	nájdɛjáːʋnɛjʃi
najdejavnejši	nájdɛjàːʋnɛjʃi
najdolgočasnejši	nájdɔlɡɔtʃàːsnɛjʃi
najdražji	nájdráːʒji
najglasnejši	nájɡlasnɛ́ːjʃi
najglušji	nájɡlúːʃji
najgrji	nájɡə́rji
najgrozljivejši	nájɡrɔzljìːʋɛjʃi
najgrši	nájɡə́rʃi
najhitreje	nájxitrɛ̀ːjɛ
najhitrejše	nájxitrɛ̀ːjʃɛ
najhujši	nájxúːjʃi
najin	náːjin
najjasnejši	nájjàːsnɛjʃi
najjasnejši	nájjasnɛ́ːjʃi
najjeznejši	nájjèːznɛjʃi
najkrajši	nájkráːjʃi
najkrutejši	nájkrúːtɛjʃi
najkrutejši	nájkrùːtɛjʃi
najlažji	nájláːʒji
najlepši	nájléːpʃi
najljubosumnejši	nájljubɔsùːmnɛjʃi
najmanjši	nájmáːnʃi
najmečji	nájméːtʃji
najmlajši	nájmláːjʃi
najmodrejši	nájmòːdrɛjʃi
najmodrejši	nájmɔdrɛ́ːjʃi
najnaglejši	nájnàːɡlɛjʃi
najnaravnejši	nájnaràːʋnɛjʃi
najnepotrpežljivejši	nájnɛ́pɔtərpɛʒljìːʋɛjʃi
najneumnejši	nájnɛùːmnɛjʃi
najnevarnejši	nájnɛʋàːrnɛjʃi
najobčutljivejši	nájɔptʃutljìːʋɛjʃi
najočitnejši	nájɔtʃìːtnɛjʃi
najodličnejši	nájɔdlìːtʃnɛjʃi
najokusnejši	nájɔkùːsnɛjʃi
najosnovnejši	nájɔsnɔ́ːʋnɛjʃi
najožji	nájóːʒji
najpestrejši	nájpèːstrɛjʃi
najplodnejši	nájplòːdnɛjʃi
najpočasneje	nájpɔtʃàːsnɛjɛ
najpočasneje	nájpɔtʃasnɛ́ːjɛ
najpodlejši	nájpɔ̀ːdlɛjʃi
najpodobnejši	nájpɔdòːbnɛjʃi
najpodrobnejši	nájpɔdróːbnɛjʃi
najpogosteje	nájpɔɡóːstɛjɛ
najpogostejše	nájpɔɡóːstɛjʃɛ
najpogumnejši	nájpɔɡùːmnɛjʃi
najpolnejši	nájpɔ̀ːlnɛjʃi
najpomembnejši	nájpɔméːmbnɛjʃi
najpomembnejši	nájpɔmèːmbnɛjʃi
najpotrebnejši	nájpɔtrèːbnɛjʃi
najpotrpežljivejši	nájpɔtərpɛʒljìːʋɛjʃi
najpravilneje	nájpraʋíːlnɛjɛ
najpravilnejše	nájpraʋíːlnɛjʃɛ
najpridnejši	nájprìːdnɛjʃi
najprijaznejši	nájprijàːznɛjʃi
najpustejši	nájpùːstɛjʃi
najpustejši	nájpustɛ́ːjʃi
najranejši	nájràːnɛjʃi
najravnejši	nájràːʋnɛjʃi
najrazličnejši	nájrazlìːtʃnɛjʃi
najredkejši	nájrèːtkɛjʃi
najredkejši	nájrɛtkɛ́ːjʃi
najresničnejši	nájrɛsníːtʃnɛjʃi
najresničnejši	nájrɛsnìːtʃnɛjʃi
najrevnejši	nájrèːʋnɛjʃi
najskrivnejši	nájskríːʋnɛjʃi
najskrivnostnejši	nájskriʋnóːstnɛjʃi
najskromnejši	nájskrɔ̀ːmnɛjʃi
najslabše	nájsláːpʃɛ
najslabši	nájsláːpʃi
najsladejši	nájsladɛ́ːjʃi
najslajši	nájsláːjʃi
najsmelejši	nájsmèːlɛjʃi
najsodobnejši	nájsɔdɔ̀ːbnɛjʃi
najsončnejši	nájsóːntʃnɛjʃi
najsplošnejši	nájsplɔ̀ːʃnɛjʃi
najspodobnejši	nájspɔdòːbnɛjʃi
najsrečnejše	nájsrèːtʃnɛjʃɛ
najsrečnejše	nájsrɛtʃnɛ́ːjʃɛ
najsrečnejši	nájsrèːtʃnɛjʃi
najsrečnejši	nájsrɛtʃnɛ́ːjʃi
najstarejši	nájstarɛ́ːjʃi
najstrastnejši	nájstràːstnɛjʃi
najsvobodnejši	nájsʋɔbɔ̀ːdnɛjʃi
najtežji	nájtéːʒji
najti	nàːjti
najtrši	nájtə́rʃi
najusodnejši	nájusòːdnɛjʃi
najustreznejši	nájustrèːznɛjʃi
najvarnejši	nájʋàːrnɛjʃi
največji	nájʋéːtʃji
največ	nájʋɛtʃ
največ	nájʋɛ́tʃ
najvišji	nájʋíːʃji
najzanimivejši	nájzanimìːʋɛjʃi
najživahnejši	nájʒiʋàːxnɛjʃi
najznačilnejši	nájznatʃíːlnɛjʃi
najzrelejši	nájzrèːlɛjʃi
najzrelejši	nájzrɛlɛ́ːjʃi
naključje	nakljúːtʃjɛ
namenilnik	namɛníːlnik
namera	naméːra
namibija	namìːbija
namigovati	namiɡɔʋàːti
nanašati	nanáːʃati
nanositi	nanɔsíːti
nanositi	nanɔsìːti
napačen	náːpatʃən
napačen	napáːtʃən
napad	napát
napaka	napáːka
napisati	napìːsati
napisati	napisàːti
naprava	napráːʋa
naprstnik	napə́rstnik
narava	naráːʋa
naraven	naràːʋən
naravnejši	naràːʋnɛjʃi
naravnost	naràːʋnɔst
narečje	naréːtʃjɛ
narediti	narɛdíːti
narediti	narɛdìːti
narkolepsija	narkɔlɛpsíːja
narod	nàːrɔt
naslednji	nasléːdnji
nasmeh	nasméːx
nasmeh	nasmɛ́x
nasmehniti	nasmèːxniti
naš	náʃ
nastati	nastàːti
nastroj	nastrɔ́j
nasvidenje	nasʋíːdɛnjɛ
nataša	natáːʃa
natrij	nàːtrij
navada	naʋáːda
navdih	naʋdíːx
nazaj	nazàːj
neapelj	nɛàːpəl
nebesa	nɛbèːsa
nebo	nɛbóː
nebotičnik	nɛbɔtíːtʃnik
nečakinja	nɛtʃàːkinja
nečak	nɛtʃàːk
nedelja	nɛdèːlja
nedoločnik	nɛ́dɔlóːtʃnik
nedoločnik	nɛ́dɔlòːtʃnik
nedovršen	nɛ́dɔʋə́rʃən
neenakost	nɛ́ɛnáːkɔst
neenakost	nɛ́ɛnàːkɔst
nehati	néːxati
nehemija	nɛxɛmíːja
nekaj	néːkaj
nekaj	nèːkaj
nekam	nèːkam
nekdo	néːɡdɔ
nekdo	nɛɡdóː
nekdo	nɛɡdòː
nekje	nɛkjéː
nekje	nɛkjèː
nekrofilija	nɛkrɔfilíːja
nekropola	nɛkróːpɔla
nemčija	néːmtʃija
nemec	nèːməts
nemka	nèːmka
nem	néːm
nemogoč	nɛ́mɔɡòːtʃ
nemščina	nèːmʃtʃina
nemški	nèːmʃki
ne	nɛ
ne	nɛ́
neodim	nɛɔdíːm
neodvisen	nɛ́ɔdʋìːsən
neonacizem	néːɔnatsíːzɛm
neonacizem	néːɔnatsìːzɛm
neon	néːɔn
neplodnost	nɛ́plòːdnɔst
neposreden	nɛ́pɔsréːdən
neposredno	nɛ́pɔsréːdnɔ
nepotrpežljivejši	nɛ́pɔtərpɛʒljìːʋɛjʃi
nepotrpežljiv	nɛ́pɔtərpɛʒljíːʋ
nepotrpežljiv	nɛ́pɔtərpɛʒljìːʋ
nepredvidljiv	nɛ́prɛdʋidljíːʋ
nepredvidljiv	nɛ́prɛdʋidljìːʋ
neptunij	nɛptùːnij
neptun	nɛptúːn
nesti	nɛ̀ːsti
netopir	nɛtɔpíːr
netopir	nɛtɔpìːr
neumen	nɛùːmən
neumnejši	nɛùːmnɛjʃi
nevaren	nɛʋàːrən
nevarnejši	nɛʋàːrnɛjʃi
nevihta	nɛʋíːxta
nič	nítʃ
nihče	níːxtʃɛ
nihče	nixtʃɛ́
nikamor	nikáːmɔr
nikelj	nìːkəl
nikjer	nikjéːr
nikolaj	nikɔláːj
nikoli	nikóːli
nindža	níːndʒa
niobij	nijòːbij
niša	níːʃa
niša	nìːʃa
nisem	nìːsɛm
nisi	nìːsi
nismo	nìːsmɔ
niso	nìːsɔ
nista	nìːsta
niste	nìːstɛ
nisva	nìːsʋa
nit	nít
nizek	nìːzək
nizozemec	nizɔzéːməts
nizozemka	nizɔzéːmka
nizozemščina	nizɔzéːmʃtʃina
nizozemska	nizɔzéːmska
nizozemski	nizɔzéːmski
nizozemsko	nizɔzéːmskɔ
njegov	njɛɡɔ̀ːʋ
njegov	njɛɡɔ́ʋ
njen	njèːn
njihov	njíːxɔʋ
njihov	njìːxɔʋ
njun	njùːn
nlp	nələpə́
nobelij	nɔbèːlij
noč	nóːtʃ
nocoj	nɔtsòːj
noga	nɔ̀ːɡa
nogavica	nɔɡaʋìːtsa
nogomet	nɔɡɔmɛ́t
noht	nóːxt
noj	nóːj
noj	nɔ́j
nominativ	nóːminatiʋ
nor	nɔ́r
norveščina	nɔrʋéːʃtʃina
norveška	nɔrʋéːʃka
norveški	nɔrʋéːʃki
norveško	nɔrʋéːʃkɔ
norvežanka	nɔrʋɛʒáːnka
norvežan	nɔrʋɛʒáːn
norvežan	nɔrʋɛʒán
nosečnica	nɔséːtʃnitsa
nosečnost	nɔsèːtʃnɔst
nosilec	nɔsíːləts
nositi	nɔsíːti
nositi	nɔsìːti
nos	nóːs
nosorog	nɔsɔróːk
nota	nóːta
noter	nóːtɛr
noter	nòːtɛr
notri	nóːtri
notri	nòːtri
novak	nɔʋàːk
november	nɔʋɛ̀ːmbər
novina	nɔʋìːna
novinec	nɔʋíːnəts
nov	nɔ́ʋ
nož	nɔ́ʃ
nuna	nùːna
občinstvo	ɔptʃíːnstʋɔ
občutljivejši	ɔptʃutljìːʋɛjʃi
občutljiv	ɔptʃutljíːʋ
občutljiv	ɔptʃutljìːʋ
obed	ɔbɛ́t
obesiti	ɔbèːsiti
obiskati	ɔbiskàːti
obiskovati	ɔbiskɔʋàːti
objaviti	ɔbjàːʋiti
objem	ɔbjɛ́m
objeti	ɔbjèːti
oblak	ɔbláːk
oblak	ɔbláːk
oblast	ɔbláːst
obleka	ɔbléːka
oblika	ɔblíːka
oblikosloven	ɔblikɔslɔ́ːʋən
oblikoslovje	ɔblikɔslɔ́ːʋjɛ
obljuba	ɔbljúːba
obljubiti	ɔbljúːbiti
obljubiti	ɔbljùːbiti
obljubiti	ɔbljubíːti
obljubiti	ɔbljubìːti
obmodek	ɔbmóːdək
oboa	óːbɔa
obramba	ɔbráːmba
obraniti	ɔbraníːti
obraniti	ɔbranìːti
obrazen	ɔbráːzən
obrazilo	ɔbrazìːlɔ
obraz	ɔbrás
obrezovanje	ɔbrɛzɔʋàːnjɛ
obrv	ɔbə́rʋ
obsečnica	ɔpséːtʃnitsa
obsedenost	ɔpséːdɛnɔst
observatorij	ɔpsɛrʋatɔ́ːrij
obuti	ɔbùːti
očala	ɔtʃáːla
ocean	ɔtsɛàːn
oče	ɔ̀ːtʃɛ
očim	óːtʃim
očim	òːtʃim
očiten	ɔtʃìːtən
očitnejši	ɔtʃìːtnɛjʃi
oddajnik	ɔddáːjnik
odeja	ɔdɛ́ːja
odgovoriti	ɔdɡɔʋɔríːti
odgovoriti	ɔdɡɔʋɔrìːti
odgovor	ɔdɡɔ́ːʋɔr
oditi	ɔdìːti
odjaviti	ɔdjàːʋiti
odličen	ɔdlìːtʃən
odličnejši	ɔdlìːtʃnɛjʃi
odločba	ɔdlóːdʒba
odnos	ɔdnɔ́s
odpreti	ɔtprèːti
odprt	ɔtpə́rt
odrešenik	ɔdrɛʃɛnìːk
odvetnik	ɔdʋéːtnik
odvisen	ɔdʋìːsən
odvreti	ɔdʋrèːti
ogal	ɔɡáːʋ
ogel	óːɡəʋ
ogel	òːɡəʋ
ogenj	ɔ̀ːɡən
oglas	ɔɡlás
ogledalo	ɔɡlɛdàːlɔ
oglje	óːɡljɛ
ogljik	ɔɡljíːk
ognjenik	ɔɡnjɛnìːk
ogor	óːɡɔr
ogor	ɔɡóːr
ograja	ɔɡráːja
ograja	ɔɡràːja
ogrožati	ɔɡròːʒati
ogroziti	ɔɡrɔzíːti
ogroziti	ɔɡrɔzìːti
ogrska	óːɡərska
ogrska	òːɡərska
oje	ɔjéː
okarina	ɔkaríːna
oklepaj	ɔklɛpáːj
okno	ɔ̀ːknɔ
oko	ɔ́ːkɔ
oko	ɔkóː
okopati	ɔkòːpati
okopati	ɔkɔpàːti
okopavati	ɔkɔpáːʋati
okostje	ɔkóːstjɛ
okrogel	ɔkròːɡəʋ
oktober	ɔktòːbər
okusen	ɔkúːsən
okusen	ɔkùːsən
okusnejši	ɔkùːsnɛjʃi
okus	ɔkúːs
oligarhija	ɔliɡarxíːja
olje	òːljɛ
ol	óːl
ol	óːʋ
oltar	ɔltàːr
omaka	ɔmáːka
oman	óːman
oman	óːman
ona	ɔ̀ːna
one	ɔ̀ːnɛ
oni	ɔ̀ːni
ono	ɔ̀ːnɔ
ono	ɔnóː
opatija	ɔpatíːja
opatinja	ɔpáːtinja
opat	ɔpáːt
opazovati	ɔpazɔʋàːti
opeka	ɔpéːka
opeklina	ɔpɛklìːna
opereta	ɔpɛréːta
opica	óːpitsa
opomba	ɔpóːmba
oporoka	ɔpɔróːka
oprostite	ɔprɔstíːtɛ
optičen	òːptitʃən
optika	òːptika
opuščaj	ɔpuʃtʃáːj
orakelj	ɔràːkəl
oranža	ɔráːnʒa
oranžen	ɔráːnʒən
oreh	ɔ̀ːrɛx
orel	ɔ̀ːrəʋ
organizacija	ɔrɡanizàːtsija
orgazem	ɔrɡàːzəm
orgazmičen	ɔrɡàːzmitʃən
orgiastičen	ɔrɡiàːstitʃən
orgija	òːrɡija
orgle	óːrɡlɛ
orhideja	ɔrxidɛ́ːja
orjak	ɔrjàːk
orlič	ɔrlítʃ
orodje	ɔróːdjɛ
orodnik	ɔróːdnik
osa	ɔ̀ːsa
oseba	ɔséːba
oseben	ɔséːbən
osebnost	ɔséːbnɔst
osel	ɔ̀ːsəʋ
osemdeset	òːsəmdɛsɛt
osemnajst	óːsəmnajst
osemnajst	òːsəmnajst
osemnajst	ɔsəmnàːjst
osem	òːsəm
ošiliti	ɔʃìːliti
osmij	òːsmij
osnoven	ɔsnɔ́ːʋən
osnovnejši	ɔsnɔ́ːʋnɛjʃi
osončje	ɔsóːntʃjɛ
ostati	ɔstàːti
oster	òːstər
ost	óːst
ostriga	ɔstríːɡa
ostriga	ɔstrìːɡa
ostrivec	ɔstríːʋəts
otava	ɔtàːʋa
oteti	ɔtèːti
otok	ɔ̀ːtɔk
otomanski	ɔtɔmáːnski
otor	ɔtɔ́r
otroče	ɔtrɔtʃɛ́
otročji	ɔtròːtʃji
otrok	ɔtrɔ́k
otrpniti	ɔtə̀rpniti
otvoriti	ɔtʋóːriti
otvoriti	ɔtʋòːriti
ovca	ɔ̀ːʋtsa
ovčar	ɔʋtʃàːr
oven	ɔ̀ːʋən
oves	ɔ̀ːʋəs
ovratnik	ɔʋráːtnik
ozek	òːzək
ožemati	ɔʒéːmati
ožeti	ɔʒèːti
oziroma	ɔzíːrɔma
ožji	óːʒji
oznaka	ɔznáːka
ozvezdje	ɔzʋéːzdjɛ
pač	pátʃ
padalo	padàːlɔ
padati	páːdati
padati	pàːdati
padec	páːdəts
paglavec	pàːɡlaʋəts
pahor	pàːxɔr
pajek	páːjək
palača	palàːtʃa
paladij	palàːdij
paladin	paladíːn
palčnik	páːʋtʃnik
palec	páːləts
paleolitik	palɛɔlìːtik
palestina	palɛstíːna
palindrom	palindróːm
palma	páːlma
pamet	pàːmɛt
panj	páːn
pa	pa
papagaj	papaɡáːj
papež	páːpɛʃ
papiga	páːpiɡa
papir	papíːr
paradižnik	paradíːʒnik
paradoks	paradóːks
paranoja	paranóːja
parfum	parfúːm
pariz	paríːs
par	pàːr
pasti	pàːsti
pastir	pastìːr
past	páːst
patologija	patɔlɔɡíːja
patološki	patɔlóːʃki
pavel	páːʋəl
pav	páːʋ
pazderje	pazdéːrjɛ
pazder	pazdéːr
pazder	pazdèːr
pazduha	páːzduxa
pečat	pɛtʃáːt
peči	pɛ̀ːtʃi
peč	péːtʃ
pedagogika	pɛdaɡòːɡika
pegatka	pɛɡáːtka
pehati	péːxati
pehati	pəxàːti
pekel	pəkə́ʋ
pekel	pə̀kəʋ
pek	péːk
pek	pèːk
peljati	pɛljàːti
pena	pèːna
penis	péːnis
pepelka	pɛpéːlka
pepel	pɛpéːʋ
pereti	pɛrèːti
peron	pɛróːn
pero	pɛróː
perutnina	pɛrutnìːna
perut	pɛrúːt
perverzija	pɛrʋɛ̀ːrzija
perverzija	pɛrʋɛrzíːja
pesek	pèːsək
pesem	péːsəm
pesnik	péːsnik
pesništvo	péːsniʃtʋɔ
pes	pə́s
pes	pɛ́s
pester	pèːstər
pestič	pɛstítʃ
pestrejši	pèːstrɛjʃi
peta	pɛ̀ːta
petdeset	péːddɛsɛt
petek	pèːtək
petek	pèːtɛk
petelin	pɛtɛ̀ːlin
peter	pèːtər
peteršilj	pɛtɛrʃíːl
peteršilj	pɛtɛrʃíl
peti	pèːti
peti	pɛ̀ːti
petnajst	péːtnajst
petnajst	pɛtnàːjst
pet	péːt
pet	pɛ́ːt
pevec	pèːʋəts
pezdir	pɛzdíːr
pezdir	pɛzdìːr
phati	pxàːti
pianist	pijaníːst
pica	píːtsa
pica	pìːtsa
pihati	pìːxati
pijača	pijàːtʃa
pijavka	pijáːʋka
pikapolonica	pikapɔlóːnitsa
pila	píːla
pila	pìːla
pil	píːl
pil	pìːl
pil	píːʋ
pingvin	pinɡʋíːn
pintarič	pìːntaritʃ
pipa	pìːpa
pi	píː
piramida	piramíːda
pira	pìːra
pisarna	pisáːrna
pisatelj	pisáːtɛl
pisati	pìːsati
pisati	pisàːti
piščanec	piʃtʃàːnəts
pismo	pìːsmɔ
pistacija	pistàːtsija
pištola	piʃtóːla
pitagora	pitàːɡɔra
pita	pìːta
piti	pìːti
piton	pitóːn
pivo	pìːʋɔ
pizda	píːzda
pizda	pìːzda
plačati	plàːtʃati
plačati	platʃàːti
plamenec	plaméːnəts
plamenec	plamèːnəts
plamen	plàːmɛn
planet	planéːt
plašč	plàːʃtʃ
platana	platáːna
platina	pláːtina
platno	plàːtnɔ
plavati	pláːʋati
plaža	plàːʒa
plazilec	plazíːlɛts
plaz	pláːs
plesati	plèːsati
plesati	plɛsàːti
plesen	pléːsən
ples	pléːs
plesti	plɛ̀ːsti
pleti	plèːti
pleva	plèːʋa
pljuča	pljùːtʃa
pljučnica	pljúːtʃnitsa
pločevinka	plɔtʃɛʋíːnka
ploden	plòːdən
plodnejši	plòːdnɛjʃi
plod	plóːt
plosk	plɔ́sk
plug	plúːk
plug	plúk
pluta	plùːta
pluti	plùːti
plutokracija	plutɔkratsíːja
plutonij	plutòːnij
pluton	plúːtɔn
počasi	pɔtʃáːsi
počasneje	pɔtʃàːsnɛjɛ
počasneje	pɔtʃasnɛ́ːjɛ
počasno	pɔtʃàːsnɔ
poceni	pɔtsèːni
počitek	pɔtʃíːtək
počiti	pòːtʃiti
počiti	pɔtʃìːti
počivati	pɔtʃìːʋati
podaljšati	pɔdáːlʃati
podaljšava	pɔdalʃáːʋa
podcelina	pɔ̀ttsɛlìːna
podel	pɔ̀ːdəʋ
pode	pɔ̂dɛ
podgana	pɔdɡàːna
podkev	pɔ̀ːtkəʋ
podkovati	pɔtkɔʋàːti
podla	pɔ̀ːdla
podlasica	pɔdlàːsitsa
podleči	pɔdlèːtʃi
podlejši	pɔ̀ːdlɛjʃi
podmornica	pɔdmóːrnitsa
podnebje	pɔdnéːbjɛ
podoba	pɔdóːba
podoben	pɔdòːbən
podobnejši	pɔdòːbnɛjʃi
podpičje	pɔ́tpíːtʃjɛ
pod	pɔ́t
podroben	pɔdróːbən
podrobnejši	pɔdróːbnɛjʃi
podrobnost	pɔdróːbnɔst
pofukan	pɔfúːkan
pofukati	pɔfúːkati
pogača	pɔɡàːtʃa
pogačar	pɔɡáːtʃar
pogodba	pɔɡóːdba
pogojnik	pɔɡóːjnik
pogoj	pɔɡɔ́j
pogoltniti	pɔɡɔ̀ːʋtniti
pogosteje	pɔɡóːstɛjɛ
pogostejše	pɔɡóːstɛjʃɛ
pogosto	pɔɡóːstɔ
pogovarjati	pɔɡɔʋáːrjati
pogovoren	pɔɡɔ́ːʋɔrən
pogovoriti	pɔɡɔʋɔríːti
pogovoriti	pɔɡɔʋɔrìːti
pogovor	pɔɡɔ́ːʋɔr
pogrešati	pɔɡrèːʃati
pogumen	pɔɡùːmən
pogumnejši	pɔɡùːmnɛjʃi
pogum	pɔɡúːm
pohištvo	pɔxíːʃtʋɔ
pohorje	póːxɔrjɛ
pojasniti	pɔjáːsniti
pojasniti	pɔjàːsniti
pojasniti	pɔjasníːti
pojasniti	pɔjasnìːti
pojutrišnjem	pɔjúːtriʃnjɛm
pokazati	pɔkàːzati
pokazati	pɔkazàːti
poker	pòːkər
poklekniti	pɔklèːkniti
poklekniti	pɔklɛkníːti
poklekniti	pɔklɛknìːti
poklicati	pɔklìːtsati
poklic	pɔklíːts
pokol	pɔkɔ́l
pokopališče	pɔkɔpalìːʃtʃɛ
pokop	pɔkɔ́p
pokrov	pɔkrɔ́ʋ
polbrat	pɔ́ːʋbrát
poldan	pɔ́ːʋdan
polenovka	pɔlèːnɔʋka
poletje	pɔléːtjɛ
polglasnik	pɔʋɡláːsnik
polh	pɔ́ːʋx
polh	pɔ̀ːʋx
polica	pɔlìːtsa
policija	pɔlitsíːja
policistka	pɔlitsíːstka
policist	pɔlitsíːst
politeizem	pɔlitɛìːzəm
polizati	pɔlìːzati
polizati	pɔlizàːti
poljakinja	pɔljàːkinja
poljak	pɔljàːk
poljanšek	pɔljàːnʃək
poljedelstvo	pɔljɛdéːlstʋɔ
polje	póːljɛ
polje	pɔljéː
poljščina	póːlʃtʃina
poljska	póːlska
poljski	póːlski
poljsko	póːlskɔ
poljubiti	pɔljúːbiti
poljubiti	pɔljùːbiti
poljubiti	pɔljubíːti
poljubiti	pɔljubìːti
poljub	pɔljúːp
polkovnica	pɔlkɔ́ːʋnitsa
polkrog	pɔ́ːlkróːk
polmer	pɔlméːr
polmer	pɔʋméːr
polmesec	pɔ́ːlméːsɛts
polnejši	pɔ̀ːʋnɛjʃi
polnoč	pɔ́ːʋnɔtʃ
poln	pɔ́ːʋn
polonij	pɔlòːnij
polotok	póːlɔtɔk
polotok	pɔlɔtɔ́k
polovica	pɔlɔʋìːtsa
položaj	pɔlɔʒáːj
polzeti	pɔʋzèːti
polž	pɔ́ːʋʃ
polž	pɔ̀ːʋʃ
pomagati	pɔmàːɡati
pomagati	pɔmaɡàːti
pomaranča	pɔmaráːntʃa
pomemben	pɔméːmbən
pomemben	pɔmèːmbən
pomembnejši	pɔméːmbnɛjʃi
pomembnejši	pɔmèːmbnɛjʃi
pomembnost	pɔméːmbnɔst
pomembnost	pɔmèːmbnɔst
pomenoslovje	pɔmɛnɔslɔ́ːʋjɛ
pomen	pɔmɛ́n
pomenski	pɔméːnski
pomlad	pɔmláːt
pomniti	póːmniti
pomočnik	pɔmɔtʃnìːk
pomoč	pɔmóːtʃ
ponarediti	pɔnarɛdíːti
ponarediti	pɔnarɛdìːti
ponedeljek	pɔnɛdéːljək
ponos	pɔnɔ́s
popačenka	pɔpáːtʃɛnka
popek	póːpək
poper	pɔ̀ːpər
poplava	pɔpláːʋa
popoldan	pɔpɔ́ːʋdan
popolnoma	pɔpɔ́ːʋnɔma
popoln	pɔpɔ́ːʋn
po	pɔ
porcelan	pɔrtsɛláːn
pornografija	pɔrnɔɡrafíːja
pornograf	pɔrnɔɡráːf
pornografski	pɔrnɔɡráːfski
poročen	pɔróːtʃən
poročen	pɔrɔtʃɛ́n
poročilo	pɔrɔtʃìːlɔ
poročnica	pɔróːtʃnitsa
poročnik	pɔróːtʃnik
porod	pɔ̀ːrɔt
porod	pɔrɔ́t
por	póːr
por	pɔ́r
portfelj	pɔrtféːl
portoriko	pɔrtɔríːkɔ
portret	pɔrtréːt
portugalec	pɔrtuɡáːləts
portugalka	pɔrtuɡáːlka
portugalščina	pɔrtuɡáːlʃtʃina
portugalska	pɔrtuɡáːlska
portugalski	pɔrtuɡáːlski
portugalsko	pɔrtuɡáːlskɔ
posameznik	pɔsáːmɛznik
posebej	pɔséːbɛj
posel	pɔ̀ːsəʋ
poskušati	pɔskùːʃati
poskusiti	pɔskùːsiti
poslati	pɔslàːti
poslušati	pɔslùːʃati
poslušati	pɔsluʃàːti
posoditi	pɔsòːditi
posoditi	pɔsɔdíːti
posoditi	pɔsɔdìːti
posodobiti	pɔsɔdɔ́ːbiti
posodobiti	pɔsɔdɔ̀ːbiti
pospešek	pɔspéːʃək
postaja	pɔstáːja
postati	pɔstàːti
postelja	pòːstɛlja
posteljica	pòːstɛljitsa
post	pɔ́st
postrv	pɔstə́rʋ
potegovati	pɔtɛɡɔʋàːti
potem	pɔtéːm
potem	pɔtɛ́m
potok	pɔ̀ːtɔk
pot	póːt
pot	pòːt
potreben	pɔtrèːbən
potrebnejši	pɔtrèːbnɛjʃi
potrebovati	pɔtrɛbɔʋàːti
potres	pɔtrɛ́s
potrpežljivejši	pɔtərpɛʒljìːʋɛjʃi
potrpežljivost	pɔtərpɛʒljìːʋɔst
potrpežljiv	pɔtərpɛʒljíːʋ
potrpežljiv	pɔtərpɛʒljìːʋ
poudariti	pɔudàːriti
povednik	pɔʋéːdnik
povest	pɔʋɛ̀ːst
povratnik	pɔʋráːtnik
površina	pɔʋərʃìːna
pozabiti	pɔzàːbiti
pozabiti	pɔzabíːti
pozabiti	pɔzabìːti
požar	pɔʒáːr
pozavna	pɔzáːʋna
pozdrav	pɔzdráʋ
pozen	pɔ̀ːzən
požig	pɔʒíːk
pozitron	pɔzitróːn
poznati	pɔznàːti
pozno	pɔ̀ːznɔ
pozornost	pɔzòːrnɔst
prababica	práːbàːbitsa
praded	práːdéːt
praded	práːdɛ́t
praga	pràːɡa
pragermanščina	práːɡɛrmáːnʃtʃina
prah	práːx
prakrt	práːkərt
praporščakinja	prapɔrʃtʃàːkinja
praporščak	prapɔrʃtʃàːk
praprot	pràːprɔt
prašati	pràːʃati
prašati	praʃàːti
prase	pràːsɛ
prase	prasɛ́
prašič	pràːʃitʃ
praslovanščina	práːslɔʋáːnʃtʃina
praslovanski	práːslɔʋáːnski
prašnik	práːʃnik
praštevilo	práːʃtɛʋìːlɔ
prati	pràːti
pravica	praʋìːtsa
pravičen	praʋíːtʃən
pravičen	praʋìːtʃən
pravičnost	praʋíːtʃnɔst
pravičnost	praʋìːtʃnɔst
pravilen	praʋíːlən
pravilneje	praʋíːlnɛjɛ
pravilnejše	praʋíːlnɛjʃɛ
pravilno	praʋíːlnɔ
pravkar	práʋkar
pravljica	práːʋljitsa
pravopis	praʋɔpíːs
pravo	práːʋɔ
prazen	pràːzən
prazeodim	prazɛɔdíːm
pražiti	pràːʒiti
prazniti	pràːzniti
prazniti	prazníːti
prazniti	praznìːti
prebava	prɛbáːʋa
prebiti	prɛbìːti
prebivalec	prɛbiʋáːləts
predal	prɛdáːl
predhodnik	prɛdxóːdnik
predlagati	prɛdláːɡati
predlog	prɛ̀ːdlɔk
predmet	prɛ̀ːdmɛt
prednik	préːdnik
predpona	prɛtpóːna
predpreteklik	prɛ́tprɛtɛ̀ːklik
pred	prɛt
predsednik	prɛtséːdnik
predvideti	prɛdʋìːdɛti
predvidljivost	prɛdʋidljìːʋɔst
predvidljiv	prɛdʋidljíːʋ
predvidljiv	prɛdʋidljìːʋ
prehlad	prɛxlát
preja	prɛ́ːja
preja	prɛ̀ːja
preklet	prɛkléːt
prekletstvo	prɛkléːtstʋɔ
premena	prɛméːna
premeniti	prɛmɛníːti
premeniti	prɛmɛnìːti
premirje	prɛmíːrjɛ
premog	prɛ̀ːmòːk
preobrat	prɛɔbràt
prepelica	prɛpɛlìːtsa
preproga	prɛpróːɡa
preproga	prɛpròːɡa
prepucij	prɛpùːtsij
prepustnica	prɛpúːstnitsa
presenečenje	prɛsɛnéːtʃɛnjɛ
presenetiti	prɛsɛnéːtiti
presenetiti	prɛsɛnèːtiti
presredek	prɛsréːdək
prestar	prɛstár
presti	prèːsti
presti	prɛ̀ːsti
prestolnica	prɛstóːlnitsa
prestol	prɛ̀ːstɔl
preteklik	prɛtɛ̀ːklik
prevajalec	prɛʋajáːləts
prevesti	prɛʋèːsti
prevesti	prɛʋɛ̀ːsti
prevodnik	prɛʋóːdnik
prevod	prɛ̀ːʋɔt
prevod	prɛʋɔ́t
preživeti	prɛʒiʋèːti
prga	pə̀rɡa
prha	pə̀rxa
pričakovati	pritʃakɔʋàːti
priča	prìːtʃa
priden	prìːdən
pridevnik	pridéːʋnik
pridevniški	pridéːʋniʃki
pridnejši	prìːdnɛjʃi
prihajati	prixáːjati
prihodnjik	prixóːdnjik
prihodnji	prixóːdnji
prihodnost	prixóːdnɔst
priimek	priíːmək
prijateljica	prijáːtɛljitsa
prijatelj	prijáːtɛl
prijateljski	prijáːtɛlski
prijateljstvo	prijáːtɛlstʋɔ
prijaviti	prijàːʋiti
prijazen	prijàːzən
prijaznejši	prijàːznɛjʃi
prijeten	prijèːtən
priložnost	prilòːʒnɔst
primer	priméːr
primež	príːmɛʃ
primež	prìːmɛʃ
princesa	printséːsa
princ	príːnts
pripeti	pripèːti
pripona	pripóːna
priponski	pripóːnski
pri	pri
prisega	priséːɡa
prislov	prislɔ́ʋ
prisotnost	prisɔ̀ːtnɔst
prispevek	prispéːʋək
pristanišče	pristanìːʃtʃɛ
pristati	pristàːti
priti	prìːti
pritisk	pritíːsk
pritok	pritòːk
pritok	pritɔ́k
priznati	priznàːti
priznavati	priznáːʋati
prižnica	príːʒnitsa
prižnica	prìːʒnitsa
profesor	prɔféːsɔr
proga	pròːɡa
programje	prɔɡráːmjɛ
programski	prɔɡráːmski
prometij	prɔmèːtij
prosim	pròːsim
prositi	prɔsíːti
prositi	prɔsìːti
prostata	próːstata
prostitucija	prɔstitùːtsija
prostornina	prɔstɔrnìːna
prostor	prɔ̀ːstɔr
prostorski	prɔstóːrski
prostorski	prɔstòːrski
prost	prɔ́st
protaktinij	prɔtaktìːnij
protipomenka	próːtipɔméːnka
prstanec	pə̀rstanəts
prstan	pə̀rstan
prst	pə́rst
prtljaga	pərtljáːɡa
prt	pə́rt
prvak	pərʋàːk
prvi	pə́rʋi
prvoten	pərʋɔ̀ːtən
psalmi	psáːlmi
pšenica	pʃɛnìːtsa
psica	psìːtsa
ptica	ptìːtsa
ptič	ptítʃ
puhati	púːxati
puhati	pùːxati
pulzar	púːlzar
puma	pùːma
punt	púnt
puran	puráːn
puščati	pùːʃtʃati
puščava	puʃtʃáːʋa
puška	púːʃka
pustejši	pùːstɛjʃi
pustejši	pustɛ́ːjʃi
pustinja	pustìːnja
pustiti	pustíːti
pustiti	pustìːti
pust	púːst
raba	ràːba
rabarbara	rabàːrbara
rabiti	ràːbiti
rabiti	rabíːti
rabiti	rabìːti
raca	ràːtsa
računalnik	ratʃunáːlnik
radar	ráːdar
radar	ràːdar
radij	ráːdij
radij	ràːdij
radirka	radíːrka
radon	ráːdɔn
radon	radóːn
radost	ràːdɔst
radost	radóːst
radoveden	radɔʋèːdən
radovednost	radɔʋèːdnɔst
rad	ráːt
rad	rát
rakun	rakúːn
ralo	ràːlɔ
rama	ràːma
ramovš	ramɔ́ːʋʃ
rana	ràːna
ranejši	ràːnɛjʃi
ran	ráːn
rasa	ràːsa
rasti	ràːsti
rastlina	rastlìːna
rastlinojedec	rastlinɔjéːdəts
rast	ráːst
raven	ràːʋən
ravnejši	ràːʋnɛjʃi
ravnik	ráːʋnik
ravnost	ràːʋnɔst
ravnotežje	raʋnɔtéːʒjɛ
razglednica	razɡléːdnitsa
razgovor	razɡɔ́ːʋɔr
različen	razlìːtʃən
različnejši	razlìːtʃnɛjʃi
razlika	razlíːka
razpelo	raspèːlɔ
razpelo	raspɛ̀ːlɔ
razred	ràːzrɛt
raztresenost	rastréːsɛnɔst
razumeti	razumèːti
razvoj	razʋɔ́j
rdeč	ərdɛ́tʃ
rebro	rɛ̀ːbrɔ
recikliranje	rɛtsiklíːranjɛ
reči	rɛ̀ːtʃi
reč	réːtʃ
redar	rɛdàːr
redek	rèːdək
redkejši	rèːtkɛjʃi
redkejši	rɛtkɛ́ːjʃi
redkev	rɛ̀ːtkəʋ
redko	rèːtkɔ
red	réːt
regrat	rèːɡrat
reja	rɛ̀ːja
rejec	rɛ́ːjəts
reka	rèːka
rek	réːk
rek	rɛ́k
rektalen	rɛktáːlən
relativnost	réːlatiʋnɔst
relativnost	rɛlatíːʋnɔst
religija	rɛlìːɡija
relikvija	rɛlìːkʋija
renesansa	rɛnɛsáːnsa
renij	rèːnij
repatica	rɛpatìːtsa
rep	réːp
rep	rɛ́p
republika	rɛpùːblika
rešeto	rɛʃɛ̀ːtɔ
reši	rèːʃi
rešitev	rɛʃíːtəʋ
rešiti	rèːʃiti
rešiti	rɛʃíːti
rešiti	rɛʃìːti
resnica	rɛsnìːtsa
resničen	rɛsníːtʃən
resničen	rɛsnìːtʃən
resničnejši	rɛsníːtʃnɛjʃi
resničnejši	rɛsnìːtʃnɛjʃi
resnik	réːsnik
restavracija	rɛstaʋràːtsija
reven	rèːʋən
revija	rɛʋíːja
revnejši	rèːʋnɛjʃi
revolucija	rɛʋɔlùːtsija
rezati	rèːzati
rezilo	rɛzìːlɔ
rezultat	rɛzultáːt
riba	rìːba
ribariti	ribàːriti
ribi	rìːbi
rigler	rìːɡlɛr
rijavec	rìːjaʋəts
rilec	ríːləts
rima	ríːma
rima	rìːma
rim	rìːm
risati	ríːsati
risba	ríːzba
ris	ríːs
riti	rìːti
rit	rít
riž	ríːʃ
rjavec	ərjáːʋəts
rjav	ərjáʋ
rjuha	ərjùːxa
rjuti	ərjùːti
robida	rɔbìːda
robidnica	rɔbíːdnitsa
robot	rɔbóːt
rob	róːp
rodij	ròːdij
rodilnik	rɔdíːlnik
roditi	rɔdíːti
roditi	rɔdìːti
rog	róːk
rojen	rɔ̀ːjɛn
rojstvo	rɔ̀ːjstʋɔ
roka	rɔ̀ːka
rokavica	rɔkaʋìːtsa
rokav	rɔkàːʋ
rokomet	rɔkɔmɛ́t
roman	rɔmáːn
romb	róːmp
romunija	rɔmùːnija
romunka	rɔmúːnka
romun	rɔmúːn
romunščina	rɔmúːnʃtʃina
romunski	rɔmúːnski
romunsko	rɔmúːnskɔ
ropar	róːpar
rosa	rɔ̀ːsa
rosomah	rɔsɔmáːx
rotovž	róːtɔʋʃ
rovka	rɔ́ːʋka
roža	róːʒa
roževina	rɔʒɛʋìːna
rozman	róːzman
rožmarin	róːʒmarin
rožmarin	rɔʒmaríːn
rubidij	rubìːdij
rudar	rudàːr
ruda	rùːda
rudnik	rúːdnik
rumenjak	rumɛnjàːk
rumen	rumɛ́n
runo	rúːnɔ
runo	rùːnɔ
ruščina	rúːʃtʃina
rusija	rúːsija
rusinja	rúːsinja
ruski	rúːski
rusko	rúːskɔ
rus	rúːs
rutenij	rutèːnij
ruti	rùːti
ruvati	rúːʋati
ruvati	rùːʋati
ruvati	ruʋàːti
rvati	ərʋàːti
rž	ə́rʃ
sablja	sáːblja
sabotaža	sabɔtáːʒa
sadež	sáːdɛʃ
sadje	sàːdjɛ
sadovnjak	sadɔʋnjàːk
sad	sáːt
šahovnica	ʃaxɔ́ːʋnitsa
šah	ʃáːx
šakal	ʃakáːl
saksofon	saksɔfóːn
šal	ʃáːl
samarij	samàːrij
samec	sàːməts
samoglasnik	samɔɡláːsnik
samomnožinski	samóːmnɔʒíːnski
samomor	samɔmɔ́r
samorog	samɔróːk
samostalnik	samɔstáːlnik
samostalniški	samɔstáːlniʃki
samostan	samɔstáːn
samota	samɔ̀ːta
samozadovoljevanje	sáːmɔzadɔʋɔljɛʋàːnjɛ
samozadovoljevati	sáːmɔzadɔʋɔljɛʋàːti
sam	sáːm
samum	samúːm
sanjati	sàːnjati
sanje	sàːnjɛ
šank	ʃáːnk
sanskrt	sanskə́rt
šantati	ʃantàːti
sapnik	sáːpnik
sardinija	sardìːnija
šarenica	ʃáːrɛnitsa
šarenica	ʃarɛnìːtsa
satelit	satɛlíːt
saturn	satùːrn
ščavje	ʃtʃáːʋjɛ
ščavje	ʃtʃàːʋjɛ
ščegetavček	ʃtʃɛɡɛtáːʋtʃək
scenarij	stsɛnàːrij
ščet	ʃtʃéːt
ščinkavec	ʃtʃìːnkaʋəts
ščirec	ʃtʃíːrəts
ščir	ʃtʃíːr
ščit	ʃtʃíːt
ščuka	ʃtʃùːka
ščurek	ʃtʃùːrək
seči	sèːtʃi
sečnica	séːtʃnitsa
sečničen	séːtʃnitʃən
seč	séːtʃ
sedanjik	sədáːnjik
sedanjik	sədàːnjik
sedanjik	sɛdáːnjik
sedanjik	sɛdàːnjik
sedemdeset	sèːdəmdɛsɛt
sedemnajst	séːdəmnajst
sedemnajst	sèːdəmnajst
sedemnajst	sɛdəmnàːjst
sedem	sèːdəm
sedeti	sɛdèːti
sedlo	sɛ̀ːdlɔ
sef	séːf
sejati	sɛjàːti
sejšeli	sɛjʃéːli
sekalec	sɛkáːləts
sekira	sɛkìːra
seksati	séːksati
seksologija	sɛksɔlɔɡìːja
seks	séːks
seksualen	sɛksuáːlən
seksualnost	sɛksuáːlnɔst
sekunda	sɛkúːnda
selen	sɛléːn
sel	sə́l
sel	sə́ʋ
semenovod	sɛmɛnɔʋɔ́t
semenski	sèːmɛnski
semenski	sɛméːnski
seme	sèːmɛ
sem	sə́m
sena	séːna
senca	séːntsa
sendvič	séːndʋitʃ
seno	sɛnóː
senožet	sɛnɔ̀ːʒɛt
senožet	sɛnɔʒéːt
september	sɛptɛ̀ːmbər
sesalec	səsáːləts
sesalec	sɛsáːləts
sesati	səsàːti
sesati	sɛsàːti
se	sɛ
šestdeset	ʃéːzddɛsɛt
sesti	sèːsti
šesti	ʃɛ̀ːsti
šestnajst	ʃéːstnajst
šestnajst	ʃɛstnàːjst
sestra	sɛ̀ːstra
sestrična	sɛstríːtʃna
šest	ʃéːst
še	ʃɛ
še	ʃɛ́
seveda	sɛʋéːda
severen	sèːʋɛrən
severnejši	sèːʋɛrnɛjʃi
sever	sèːʋɛr
seznam	səznáːm
seznam	səznám
seznam	sɛznáːm
seznam	sɛznám
sezuti	səzùːti
sezuti	sɛzùːti
shizofrenija	sxizɔfrɛníːja
sibirija	sibìːrija
sicilija	sitsìːlija
sidro	síːdrɔ
sidro	sìːdrɔ
sila	sìːla
šilček	ʃíːltʃək
silicij	silìːtsij
šiliti	ʃìːliti
simboličen	simbòːlitʃən
simbol	simbóːl
simetrija	simɛtríːja
šimpanz	ʃimpáːns
sinagoga	sinaɡɔ̀ːɡa
sinhrono	sinxróːnɔ
sinhron	sinxróːn
sinica	sinìːtsa
sinoči	sinóːtʃi
sinonim	sinɔníːm
sin	síːn
sirija	sìːrija
sirilo	sirìːlɔ
siriščnik	siríːʃtʃnik
siriti	sìːriti
širok	ʃirɔ́k
sirota	siróːta
sirotka	sìːrɔtka
sir	sír
si	si
si	sí
sistem	sistéːm
šiti	ʃìːti
sit	sít
siv	síːʋ
skakač	skakàːtʃ
skala	skàːla
skandij	skàːndij
škarje	ʃkáːrjɛ
škatla	ʃkáːtla
skepticizem	skɛptitsíːzɛm
skepticizem	skɛptitsìːzɛm
skladnja	sklàːdnja
sklanjatev	sklanjáːtəʋ
skleda	sklèːda
sklon	sklɔ́n
skočiti	skɔtʃíːti
skočiti	skɔtʃìːti
skodelica	skɔdéːlitsa
škofija	ʃkɔfíːja
škof	ʃkɔ́f
skoraj	skɔ́ːraj
skoraj	skɔ̀ːraj
skorbut	skɔrbúːt
škorec	ʃkɔ̀ːrəts
škorenj	ʃkóːrən
škorjanec	ʃkɔrjàːnəts
skorja	skóːrja
skorja	skòːrja
škorpijon	ʃkɔrpijóːn
škotska	ʃkóːtska
škripec	ʃkríːpəts
škripec	ʃkrìːpəts
skriti	skrìːti
skrivati	skrìːʋati
skriven	skríːʋən
skrivnejši	skríːʋnɛjʃi
skrivnosten	skriʋnóːstən
skrivnostnejši	skriʋnóːstnɛjʃi
skrivnost	skriʋnóːst
škrjanček	ʃkərjàːntʃɛk
škrjanec	ʃkərjàːnəts
škrjanec	ʃkərjàːnəts
škrjanka	ʃkərjàːnka
škrlec	ʃkə́rləts
skromen	skrɔ̀ːmən
skromnejši	skrɔ̀ːmnɛjʃi
skrotum	skróːtum
škržat	ʃkərʒáːt
skupaj	skúːpaj
skupina	skupìːna
skupnost	skúːpnɔst
skupnost	skùːpnɔst
skuša	skùːʃa
skusiti	skùːsiti
škvorjanec	ʃkʋɔrjàːnəts
slabo	slabóː
slabše	sláːpʃɛ
slabši	sláːpʃi
slab	sláp
sladejši	sladɛ́ːjʃi
sladek	slàːdək
sladkarija	slatkarìːja
sladkor	slàːtkɔr
sladoled	sladɔléːt
slad	sláːt
slajši	sláːjʃi
slamica	slàːmitsa
slanina	slanìːna
slan	sláːn
slap	sláːp
slaščičarna	slaʃtʃitʃáːrna
slaščica	slaʃtʃìːtsa
slava	slàːʋa
slavec	slàːʋəts
slaven	slàːʋən
sleči	slèːtʃi
slediti	slɛdíːti
slediti	slɛdìːti
slep	sléːp
slezenovec	slɛzéːnɔʋəts
slikar	slikàːr
slika	slíːka
slikati	slíːkati
slina	slìːna
slišati	slìːʃati
sliva	slìːʋa
slivovka	slìːʋɔʋka
sljuda	sljùːda
sloka	slóːka
sloka	slòːka
slonica	slɔ̀ːnitsa
slonica	slɔnìːtsa
slonovina	slɔnɔʋìːna
slon	slɔ́n
slop	slɔ́p
slovakinja	slɔʋàːkinja
slovak	slɔʋàːk
slovanka	slɔʋáːnka
slovanski	slɔʋáːnski
slovan	slɔʋáːn
slovar	slɔʋàːr
slovaščina	slɔʋáːʃtʃina
slovaška	slɔʋáːʃka
slovaški	slɔʋáːʃki
slovaško	slɔʋáːʃkɔ
slovenec	slɔʋèːnəts
slovenija	slɔʋèːnija
slovenka	slɔʋèːnka
slovenščina	slɔʋèːnʃtʃina
slovenski	slɔʋèːnski
slovensko	slɔʋèːnskɔ
sloveti	slɔʋèːti
slovi	slɔ̀ːʋi
slovi	slɔʋìː
slovnica	slɔ́ːʋnitsa
slovničen	slɔ́ːʋnitʃən
slovo	slɔʋóː
slušati	slùːʃati
sluti	slùːti
služba	slúːʒba
smeh	sméːx
smejati	smɛjàːti
smelejši	smèːlɛjʃi
smel	sméːʋ
smer	sméːr
smetana	smèːtana
smeti	smèːti
smet	sméːt
smisel	smíːsəʋ
smodnik	smɔdnìːk
smola	smɔ̀ːla
smo	smɔ́
smreka	smrèːka
smrtonosen	smərtɔnɔ̀ːsən
smrt	smə́rt
smučati	smúːtʃati
snaha	snàːxa
sneg	snéːk
sneguljčica	snɛɡúːltʃitsa
sneti	snèːti
snežak	snɛʒàːk
snežinka	snɛʒíːnka
snežiti	snɛʒíːti
snežiti	snɛʒìːti
snovati	snɔʋàːti
snuti	snùːti
soavtor	sɔ́áːʋtɔr
soavtor	sɔ́àːʋtɔr
sobana	sɔbàːna
soba	sɔ̀ːba
sobota	sɔbòːta
soča	sòːtʃa
socializem	sɔtsijalìːzəm
socvetje	sɔtsʋéːtjɛ
sodnik	sɔdnìːk
sodoben	sɔdɔ̀ːbən
sodobnejši	sɔdɔ̀ːbnɛjʃi
sod	sóːt
soglasnik	sɔɡláːsnik
šoja	ʃòːja
soj	sɔ̀j
sokol	sɔ̀ːkɔl
sokrat	sóːkrat
sok	sóːk
solaren	sɔláːrən
šola	ʃóːla
sol	sóːʋ
solza	sɔ̀ːʋza
sonatina	sɔnatíːna
sončen	sóːntʃən
sonce	sóːntsɛ
sončnejši	sóːntʃnɛjʃi
sončnica	sóːntʃnitsa
sončnik	sóːntʃnik
sonet	sɔnéːt
sopomenka	sɔ́pɔméːnka
sopotnica	sɔpóːtnitsa
sopotnik	sɔpóːtnik
sopotništvo	sɔpóːtniʃtʋɔ
soprog	sɔpróːk
sorojenec	sɔ́rɔjɛ̀ːnəts
sosed	sòːsɛt
sosed	sɔ̀ːsɛt
so	sɔ́
sova	sɔ̀ːʋa
sovraštvo	sɔʋráːʃtʋɔ
sovražiti	sɔʋráːʒiti
sovražiti	sɔʋràːʒiti
sovražiti	sɔʋraʒíːti
sovražiti	sɔʋraʒìːti
sovražnik	sɔʋráːʒnik
spalnica	spáːlnitsa
spam	spɛ́ːm
španec	ʃpáːnəts
španija	ʃpàːnija
španka	ʃpáːnka
španščina	ʃpáːnʃtʃina
španski	ʃpáːnski
špansko	ʃpáːnskɔ
spati	spàːti
špela	ʃpèːla
spem	spɛ́ːm
sperma	spɛ́ːrma
speti	spèːti
spet	spéːt
špinača	ʃpinàːtʃa
špirit	ʃpíːrit
sploh	splɔ́x
splošen	splɔ̀ːʃən
splošnejši	splɔ̀ːʃnɛjʃi
spodaj	spɔ̀ːdaj
spodoben	spɔdòːbən
spodobnejši	spɔdòːbnɛjʃi
spogledovati	spɔɡlɛdɔʋàːti
spojina	spɔjìːna
spolovilo	spɔlɔʋìːlɔ
spol	spɔ́l
spominčica	spɔmíːntʃitsa
spominjati	spɔmìːnjati
spomin	spɔmíːn
spomniti	spóːmniti
sporočilo	spɔrɔtʃìːlɔ
sposoditi	spɔsòːditi
sposoditi	spɔsɔdíːti
sposoditi	spɔsɔdìːti
spoznati	spɔznàːti
spregatev	sprɛɡáːtəʋ
sprememba	sprɛméːmba
spremeniti	sprɛmɛníːti
spremeniti	sprɛmɛnìːti
spretnost	sprèːtnɔst
sprevodnik	sprɛʋóːdnik
spustiti	spustíːti
spustiti	spustìːti
srajca	sràːjtsa
sraka	sràːka
sranje	sráːnjɛ
sranje	sràːnjɛ
srati	sràːti
srbija	sə́rbija
srbkinja	sə́rpkinja
srbohrvaščina	sərbɔxərʋáːʃtʃina
srbohrvaški	sərbɔxərʋáːʃki
srbščina	sə́rpʃtʃina
srb	sə́rp
srbski	sə́rpski
srce	sərtséː
srebrnina	srɛbərnìːna
srebrn	srɛbə́rn
srebro	srɛbróː
srečanje	sréːtʃanjɛ
sreča	srèːtʃa
srečati	sréːtʃati
srečen	srèːtʃən
srečneje	srèːtʃnɛjɛ
srečneje	srɛtʃnɛ́ːjɛ
srečnejše	srèːtʃnɛjʃɛ
srečnejše	srɛtʃnɛ́ːjʃɛ
srečnejši	srèːtʃnɛjʃi
srečnejši	srɛtʃnɛ́ːjʃi
srečno	srèːtʃnɔ
sreda	sréːda
sredinec	srɛdíːnəts
središče	srɛdìːʃtʃɛ
srednjevaloven	srɛdnjɛʋalɔ́ːʋən
srednjeveški	srɛdnjɛʋéːʃki
srednji	sréːdnji
srna	sə̀rna
srp	sə́rp
sršen	sərʃéːn
sršen	sərʃɛ́n
sršen	sə̀rʃɛn
s	s
štacun	ʃtatsùːn
štala	ʃtàːla
stanje	stàːnjɛ
stanovati	stanɔʋàːti
starec	stáːrəts
starejši	starɛ́ːjʃi
starka	stáːrka
starodaven	starɔdàːʋən
starost	stàːrɔst
starost	staróːst
starš	stàːrʃ
star	stár
sta	stá
stati	stàːti
stavba	stáːʋba
stavek	stáːʋək
staviti	stàːʋiti
stečaj	stɛtʃáːj
stegno	stɛ̀ːɡnɔ
steklenica	stɛklɛnìːtsa
steklo	stɛ̀ːklɔ
stena	stèːna
ste	stɛ́
šteti	ʃtèːti
stetoskop	stɛtɔskóːp
stetoskop	stɛtɔskɔ́p
število	ʃtɛʋìːlɔ
števnik	ʃtéːʋnik
steza	stəzá
steza	stə̀za
stikalo	stikàːlɔ
štirideset	ʃtíːridɛsɛt
štirinajst	ʃtíːrinajst
štirinajst	ʃtirinàːjst
štirje	ʃtìːrjɛ
stoletje	stɔléːtjɛ
stolp	stɔ́lp
stol	stɔ́ʋ
stopalo	stɔpàːlɔ
stopiti	stòːpiti
stopiti	stɔpíːti
stopiti	stɔpìːti
stopnišče	stɔpnìːʃtʃɛ
štorklja	ʃtóːrklja
štor	ʃtóːr
štor	ʃtɔ́r
sto	stóː
stotnica	stóːtnitsa
stotnik	stóːtnik
stožec	stòːʒəts
stožec	stɔ̀ːʒəts
strah	stráːx
stranišče	stranìːʃtʃɛ
stranka	stráːnka
stran	stráːn
strašek	stráːsɛk
strasten	stràːstən
strastnejši	stràːstnɛjʃi
strast	stráːst
strategija	stratɛɡíːja
streči	strèːtʃi
streha	strèːxa
strela	strèːla
strešica	strèːʃitsa
strgati	stə̀rɡati
striči	strìːtʃi
stric	strìːts
strog	stróːk
strojen	strɔ́ːjən
strojiti	stróːjiti
strojiti	stròːjiti
strojiti	strɔjíːti
strojiti	strɔjìːti
stroj	strɔ́j
stroncij	stròːntsij
strop	strɔ́p
strukturalen	strukturáːlən
struktura	struktúːra
strupen	strúːpən
strupen	strupéːn
strup	strúːp
študent	ʃtudɛ́nt
študirati	ʃtudíːrati
stvar	stʋáːr
suh	súːx
sum	súːm
šum	ʃúːm
šunka	ʃúːnka
suša	sùːʃa
suspenzorij	suspɛnzòːrij
suti	sùːti
suženjstvo	sùːʒənstʋɔ
suženj	sùːʒən
sužnja	sùːʒnja
svakinja	sʋáːkinja
svakinja	sʋàːkinja
svak	sʋàːk
sva	sʋá
sveča	sʋèːtʃa
švedinja	ʃʋéːdinja
švedščina	ʃʋéːtʃtʃina
švedska	ʃʋéːtska
švedski	ʃʋéːtski
švedsko	ʃʋéːtskɔ
šved	ʃʋéːt
svetel	sʋə̀təʋ
svetel	sʋɛ̀ːtəʋ
svetilnik	sʋɛtíːlnik
svetloba	sʋɛtlɔ̀ːba
svetnik	sʋéːtnik
svetnik	sʋɛtnìːk
svet	sʋéːt
svet	sʋɛ́t
švicarski	ʃʋíːtsarski
švica	ʃʋíːtsa
svila	sʋíːla
sviloprejka	sʋilɔprɛ́ːjka
svinčnik	sʋìːntʃnik
svinec	sʋìːnəts
svizec	sʋíːzəts
svoboda	sʋɔbɔ̀ːda
svoboden	sʋɔbɔ̀ːdən
svobodnejši	sʋɔbɔ̀ːdnɛjʃi
svojina	sʋɔjìːna
svoj	sʋòːj
sydney	síːdni
tadej	tadɛ́ːj
tadžikistan	tadʒíːkistan
tajska	táːjska
tajvan	táːjʋan
takoj	takóːj
takoj	takɔ́j
tako	takóː
takrat	takrát
taksi	taksi
talec	táːlɛts
talij	tàːlij
tam	tám
tanek	tàːnək
tantal	táːntal
tanzanija	tanzàːnija
tarča	táːrtʃa
tašča	tàːʃtʃa
taščica	tàːʃtʃitsa
tast	táːst
ta	táː
tat	tát
tavžent	táːʋʒɛnt
tečaj	tɛtʃáːj
teči	tɛ̀ːtʃi
teden	téːdən
tehnecij	tɛxnèːtsij
tekač	tɛkàːtʃ
tekočina	tɛkɔtʃìːna
tekoč	tɛkóːtʃ
tekoč	tɛkòːtʃ
tek	téːk
telesen	tɛléːsən
tele	tɛ̀ːlɛ
telo	tɛlóː
telovaditi	tɛlɔʋàːditi
telur	tɛlúːr
telur	tɛlùːr
tema	téːma
tema	təmá
tema	tə́ma
temen	təmə́n
temen	tə̀mən
temniti	təmníːti
temniti	təmnìːti
tempelj	tɛ̀ːmpəl
temperatura	tɛmpɛratúːra
temza	téːmza
tenis	téːnis
teokracija	tɛɔkratsíːja
teoretičen	tɛɔrèːtitʃən
teoretik	tɛɔrèːtik
teorija	tɛɔríːja
tepsti	tɛ̀ːpsti
terarij	tɛràːrij
terbij	tɛ̀ːrbij
termit	tɛrmíːt
terorist	tɛrɔríːst
tesen	tɛ̀ːsən
teta	tɛ̀ːta
teti	tèːti
tetoviranje	tɛtɔʋíːranjɛ
tetovirati	tɛtɔʋíːrati
težek	tɛ̀ːʒək
težji	téːʒji
tiger	tìːɡər
tih	tíːx
tikati	tíːkati
tikati	tìːkati
tilen	tìːlɛn
timijan	tíːmijan
tipka	tíːpka
tipkovnica	tipkɔ́ːʋnitsa
tip	tíːp
tisa	tíːsa
tišina	tiʃìːna
tisočletje	tisɔtʃléːtjɛ
tisti	tíːsti
titan	titáːn
ti	tí
ti	tíː
tjulenj	tjúːlən
tjulenj	tjùːlən
tkalec	tkáːləts
tkati	tkàːti
tkivo	tkìːʋɔ
tlak	tláːk
tla	tlá
toda	tóːda
toda	tɔda
tod	tóːt
tod	tòːt
tog	tóːk
tokata	tɔkáːta
tok	tóːk
tok	tɔ́k
tolči	tɔ̀ːʋtʃi
tolkalo	tɔʋkàːlɔ
tolmač	tɔlmàːtʃ
tolpa	tɔ̀ːlpa
tomahavk	tɔmaxáːʋk
tomaž	tɔmáːʃ
tom	tóːm
topel	tòːpəʋ
topel	tɔ̀ːpəʋ
topiti	tɔpíːti
topiti	tɔpìːti
toplota	tɔplɔ̀ːta
topol	tɔ̀ːpɔl
top	tɔ́p
torba	tóːrba
torek	tɔ̀ːrək
torij	tòːrij
to	tóː
tovariš	tɔʋáːriʃ
tovarna	tɔʋáːrna
tožilnik	tɔʒíːlnik
tradicija	tradìːtsija
tradicionalen	traditsiɔnáːlən
trajekt	trajéːkt
trakulja	trakùːlja
tramvaj	tráːmʋaj
tramvaj	tramʋáːj
transilvanija	transilʋàːnija
trava	tràːʋa
travnik	tráːʋnik
travnik	tràːʋnik
travojedec	traʋɔjéːdəts
trdnjava	tərdnjáːʋa
trd	tə́rt
trebuh	trèːbux
trener	trɛnɛ́ːr
trenutek	trɛnúːtək
trepalnica	trɛpáːlnitsa
trepetlika	trɛpɛtlìːka
tresti	trèːsti
treti	trèːti
tretjak	trɛtjàːk
trgati	tə̀rɡati
trgovina	tərɡɔʋìːna
trg	tə́rk
trhel	tə̀rxɛl
triangel	trijàːnɡəl
trideset	tríːdɛsɛt
trije	tríːjɛ
trije	trijéː
trikotnik	trikóːtnik
trinajst	tríːnajst
trinajst	trinàːjst
trinko	tríːnkɔ
tris	tríːs
tri	tríː
trizob	trizóːp
trobenta	trɔbéːnta
trod	tróːt
trošt	tróːʃt
trot	tróːt
trpeti	tərpèːti
trši	tə́rʃi
trska	tə̀rska
trstenjak	tərstɛnjàːk
trst	tə́rst
trta	tə̀rta
trtica	tə̀rtitsa
truhel	trùːxəʋ
truplo	trùːplɔ
tuberkuloza	tubɛrkulóːza
tudi	túːdi
tudi	tudi
tukaj	túːkaj
tulij	tùːlij
tuljava	tuljáːʋa
tunizija	tunìːzija
turčija	túːrtʃija
turek	tùːrək
turist	turíːst
turizem	turìːzəm
turkinja	tùːrkinja
turoben	turɔ̀ːbən
turški	tùːrʃki
turško	tùːrʃkɔ
tu	tú
tveganje	tʋéːɡanjɛ
tveganje	tʋèːɡanjɛ
tvegati	tʋéːɡati
tvegati	tʋèːɡati
tvoj	tʋòːj
tvorba	tʋóːrba
tvoriti	tʋóːriti
tvoriti	tʋòːriti
ubiti	ubìːti
ubog	ubóːk
učenec	utʃɛ̀ːnəts
učinek	utʃíːnək
učiteljica	utʃíːtɛljitsa
učitelj	utʃíːtɛl
učiti	utʃíːti
učiti	utʃìːti
udariti	udàːriti
ud	úːt
uganka	uɡáːnka
ugrabitev	uɡrabíːtəʋ
ugrizniti	uɡrìːzniti
ugriz	uɡríːs
uho	uxóː
ujec	úːjəts
ujec	ùːjəts
ujeda	ujéːda
ujeda	ujèːda
ujeti	ujèːti
ukaz	ukás
ukor	ukɔ́r
ukrajina	ukrajìːna
ukrajinski	ukrajíːnski
ukrasti	ukràːsti
ukreniti	ukrɛníːti
ukreniti	ukrɛnìːti
ukvarjati	ukʋàːrjati
ulica	ùːlitsa
ulice	ulitsɛ
ulici	ulitsi
ulico	ulitsɔ
ulic	ulits
ulomek	ulóːmək
ultrakratkovaloven	úːltrakratkɔʋalɔ́ːʋən
umazan	umáːzan
umeti	umèːti
umetnik	uméːtnik
umiti	umìːti
umivati	umìːʋati
umoriti	umɔríːti
umoriti	umɔrìːti
umor	umɔ́r
umreti	umrèːti
uniforma	unifóːrma
univerza	uniʋɛ́ːrza
upanje	úːpanjɛ
upati	úːpati
uplinjač	uplinjàːtʃ
uporaba	upɔráːba
uporabiti	upɔràːbiti
uporabiti	upɔrabíːti
uporabiti	upɔrabìːti
uporabljati	upɔràːbljati
uporabnik	upɔráːbnik
upor	upɔ́r
uraden	uráːdən
uran	uráːn
uran	uráːn
ura	úːra
ura	ùːra
urban	urbáːn
urban	urbáːn
urban	urbán
urnik	úːrnik
urok	urɔ́k
uršič	úːrʃitʃ
urška	úːrʃka
usluga	uslúːɡa
usmrtitev	usmərtíːtəʋ
usnje	ùːsnjɛ
usoda	usóːda
usoden	usóːdən
usoden	usòːdən
usodnejši	usòːdnɛjʃi
uspeh	uspɛ́x
uspeti	uspèːti
usta	ùːsta
ustava	ustáːʋa
ustje	úːstjɛ
ustje	ùːstjɛ
ustnica	úːstnitsa
ustrezen	ustrèːzən
ustreznejši	ustrèːznɛjʃi
ustreznik	ustrèːznik
uš	úːʃ
utor	utɔ́r
utrujati	utrùːjati
utrujen	utrùːjɛn
uvel	uʋèːʋ
uvel	uʋɛ́ʋ
uživati	uʒìːʋati
vabiti	ʋàːbiti
vabiti	ʋabíːti
vabiti	ʋabìːti
vaditi	ʋàːditi
vaga	ʋáːɡa
vagina	ʋaɡíːna
vajin	ʋáːjin
valentin	ʋalɛntíːn
valj	ʋáːl
valj	ʋàːl
val	ʋáːl
vampir	ʋampìːr
vanadij	ʋanàːdij
varen	ʋàːrən
varna	ʋàːrna
varnega	ʋàːrnɛɡa
varnejši	ʋàːrnɛjʃi
varne	ʋàːrnɛ
varni	ʋàːrni
varnost	ʋàːrnɔst
varno	ʋàːrnɔ
varšava	ʋarʃáːʋa
varuh	ʋáːrux
vas	ʋáːs
vaš	ʋáʃ
vaterpolist	ʋatɛrpɔlíːst
vaterpolo	ʋàːtɛrpóːlɔ
vaza	ʋàːza
včasih	ʋtʃáːsix
včeraj	ʋtʃèːraj
včlaniti	ʋtʃláːniti
včlaniti	ʋtʃlàːniti
vdihniti	ʋdìːxniti
vdova	ʋdɔ́ːʋa
veber	ʋèːbər
večen	ʋèːtʃən
večerja	ʋɛtʃéːrja
večer	ʋɛtʃéːr
večji	ʋéːtʃji
več	ʋɛ́tʃ
vedeti	ʋèːdɛti
vedno	ʋèːdnɔ
vedro	ʋɛ̀ːdrɔ
vegetarijanec	ʋɛɡɛtarijáːnəts
vejati	ʋɛ́ːjati
veja	ʋɛ́ːja
vejica	ʋɛ́ːjitsa
vektor	ʋèːktɔr
velblod	ʋɛlblóːt
velelnik	ʋɛléːlnik
velelnik	ʋɛléːʋnik
velemesto	ʋɛ́lɛmèːstɔ
veleposlanik	ʋɛ́lɛpɔslàːnik
veleposlaništvo	ʋɛ́lɛpɔslàːniʃtʋɔ
veličina	ʋɛlitʃìːna
velikan	ʋɛlikáːn
veliko	ʋɛlìːkɔ
velik	ʋɛ̀ːlik
vendar	ʋə́ndar
vendar	ʋə̀ndar
venera	ʋéːnɛra
veniti	ʋèːniti
veper	ʋèːpɛr
vera	ʋèːra
veriga	ʋɛrìːɡa
verjeti	ʋɛrjèːti
veselje	ʋɛsɛ̀ːljɛ
vesel	ʋɛséːʋ
vesim	ʋéːsim
vesiti	ʋèːsiti
vesti	ʋèːsti
vesti	ʋɛ̀ːsti
vest	ʋéːst
ves	ʋə́s
veter	ʋéːtər
veti	ʋèːti
veverica	ʋèːʋɛritsa
ve	ʋéː
vezati	ʋèːzati
vezati	ʋɛzàːti
veznik	ʋéːznik
vez	ʋéːs
vhod	ʋxɔ́t
vice	ʋíːtsɛ
vice	ʋìːtsɛ
videti	ʋìːdɛti
vidra	ʋíːdra
vidra	ʋìːdra
vid	ʋíːt
vihar	ʋixáːr
vijak	ʋijàːk
vikati	ʋíːkati
vikati	ʋìːkati
vila	ʋíːla
vile	ʋìːlɛ
vilice	ʋìːlitsɛ
vinograd	ʋinòːɡrat
vino	ʋìːnɔ
violina	ʋijɔlíːna
violončelo	ʋijɔlɔntʃéːlɔ
vir	ʋíːr
višji	ʋíːʃji
višnu	ʋíːʃnu
visok	ʋisɔ́k
vitez	ʋíːtɛs
viti	ʋíːti
viti	ʋìːti
vi	ʋíː
viza	ʋíːza
viza	ʋìːza
vizum	viːzʊm
vključiti	ʋkljùːtʃiti
vklopiti	ʋklòːpiti
vklopiti	ʋklɔpíːti
vklopiti	ʋklɔpìːti
vladati	ʋláːdati
vladati	ʋlàːdati
vladavina	ʋladaʋìːna
vlada	ʋláːda
vlak	ʋláːk
vleči	ʋlèːtʃi
vljudnost	ʋljùːdnɔst
vltava	ʋə́ltaʋa
vnukinja	ʋnúːkinja
vnukinja	ʋnùːkinja
vnuk	ʋnúːk
vnuk	ʋnùːk
voda	ʋɔ̀ːda
vodič	ʋɔdítʃ
vodik	ʋɔdíːk
voditi	ʋɔdíːti
voditi	ʋɔdìːti
vodja	ʋóːdja
vodnar	ʋɔdnàːr
vodnica	ʋóːdnitsa
vodnjak	ʋɔdnjàːk
vodomec	ʋɔdóːməts
vodomec	ʋɔdòːməts
vogal	ʋɔɡáːʋ
vogel	ʋóːɡəʋ
vohati	ʋóːxati
vohunski	ʋɔxúːnski
vohun	ʋɔxúːn
voh	ʋóːx
vojakinja	ʋɔjàːkinja
vojak	ʋɔjàːk
vojna	ʋɔ̀ːjna
vojščak	ʋɔjʃtʃàːk
vojska	ʋɔ̀ːjska
vojvoda	ʋóːjʋɔda
vojvodina	ʋóːjʋɔdina
vojvodina	ʋóːjʋɔdina
volan	ʋɔláːn
volfram	ʋóːlfram
volga	ʋɔ̀ːʋɡa
volja	ʋòːlja
volkodlak	ʋɔʋkɔdláːk
volk	ʋɔ́ːʋk
volk	ʋɔ́ːʋk
volna	ʋɔ̀ːʋna
voluhar	ʋɔlúːxar
vol	ʋɔ́ʋ
voščilo	ʋɔʃtʃìːlɔ
voščiti	ʋòːʃtʃiti
voščiti	ʋɔʃtʃíːti
voščiti	ʋɔʃtʃìːti
vosek	ʋóːsək
vos	ʋóːs
votor	ʋɔtɔ́r
vovk	ʋɔ́ːʋk
vozel	ʋɔ̀ːzəʋ
voziti	ʋɔzíːti
voziti	ʋɔzìːti
vožnja	ʋɔ̀ːʒnja
voz	ʋóːs
vpiti	ʋpìːti
vpliv	ʋplíːʋ
vprašaj	ʋpraʃáːj
vprašanje	ʋpraʃáːnjɛ
vprašati	ʋpràːʃati
vprašati	ʋpraʃàːti
vrabec	ʋràːbəts
vrana	ʋràːna
vranica	ʋràːnitsa
vran	ʋráːn
vran	ʋráːn
vrata	ʋràːta
vratič	ʋratítʃ
vrat	ʋráːt
vrat	ʋràːt
vraža	ʋràːʒa
vrba	ʋə̀rba
vrč	ʋə́rtʃ
vreči	ʋrèːtʃi
vrednost	ʋrèːdnɔst
vreme	ʋrɛ̀ːmɛ
vretence	ʋrɛtɛ̀ːntsɛ
vreti	ʋrèːti
vroč	ʋróːtʃ
vroč	ʋrɔ́tʃ
vrša	ʋə̀rʃa
vršilec	ʋərʃíːləts
vrsta	ʋə̀rsta
vrsten	ʋə́rstən
vrstilen	ʋərstíːlən
vrstnost	ʋə́rstnɔst
vrst	ʋə́rst
vrtnica	ʋə́rtnitsa
vrt	ʋə́rt
vsaj	ʋsáːj
vsakič	ʋsáːkitʃ
vsebina	ʋsɛbìːna
všečen	ʋʃèːtʃən
všečnost	ʋʃèːtʃnɔst
všeč	uʃéːtʃ
vsejedec	ʋsɛjéːdəts
vstaviti	ʋstàːʋiti
vstopati	ʋstóːpati
vstopati	ʋstòːpati
vstopiti	ʋstòːpiti
vstopiti	ʋstɔpíːti
vstopiti	ʋstɔpìːti
vtis	ʋtíːs
vulkan	ʋulkáːn
vurnik	ʋúːrnik
v	ʋ
vzdevek	ʋzdéːʋɛk
vzeti	ʋzèːti
vzhoden	ʋzxóːdən
vzhodnejši	ʋzxóːdnɛjʃi
vzhod	ʋzxɔ́t
vžigalica	ʋʒiɡáːlitsa
vzpon	ʋspɔ́n
wikipedija	ʋikipɛdíːja
wikislovar	ʋikislɔʋàːr
zabava	zabáːʋa
zabavnik	zabáːʋnik
žaba	ʒàːba
začetek	zatʃéːtək
začeten	zatʃéːtən
začeti	zatʃèːti
zadnjica	záːdnjitsa
zadnjičen	záːdnjitʃən
zadnjik	záːdnjik
zadnji	záːdnji
zadovoljevati	zadɔʋɔljɛʋàːti
zadovoljiti	zadɔʋɔljíːti
zadovoljiti	zadɔʋɔljìːti
žafran	ʒafráːn
žagati	ʒáːɡati
žaga	ʒáːɡa
zagnati	zaɡnàːti
zahoden	zaxóːdən
zahodnejši	zaxóːdnɛjʃi
zahod	zaxɔ́t
zahteva	zaxtéːʋa
zaimek	zaíːmək
zaiti	zaìːti
zajček	záːjtʃək
zajec	záːjəts
zajec	záːjəts
zajtrkovati	zajtərkɔʋàːti
zajtrk	záːjtərk
zajtrk	zàːjtərk
zakaj	zakáːj
zakaj	zakàːj
zaklad	zaklát
zakleniti	zaklɛníːti
zakleniti	zaklɛnìːti
zakon	zàːkɔn
zakristija	zakristíːja
zalar	záːlar
zaliv	zalíːʋ
zaljubiti	zaljúːbiti
zaljubiti	zaljùːbiti
zaljubiti	zaljubíːti
zaljubiti	zaljubìːti
žalost	ʒàːlɔst
žal	ʒàːl
zaman	zamán
zambija	zàːmbija
žamet	ʒàːmɛt
zamuditi	zamudíːti
zamuditi	zamudìːti
zanimivejši	zanimìːʋɛjʃi
zanimiv	zanimíːʋ
zanimiv	zanimìːʋ
zanka	záːnka
zapestje	zapéːstjɛ
zapornica	zapóːrnitsa
zapornik	zapóːrnik
zapor	zapɔ́r
zapreti	zaprèːti
zapustiti	zapustíːti
zapustiti	zapustìːti
žara	ʒàːra
žarek	ʒáːrək
žarek	ʒàːrək
zarnik	záːrnik
zaščita	zaʃtʃíːta
zaseben	zaséːbən
zaspan	zaspàːn
zaspati	zaspàːti
zastava	zastáːʋa
zastavnica	zastáːʋnitsa
zavesa	zaʋéːsa
zavreti	zaʋrèːti
za	za
zažgati	zaʒɡàːti
zbežati	zbɛʒàːti
zbirati	zbíːrati
zbirati	zbìːrati
zbirka	zbíːrka
zbrati	zbràːti
zdaj	zdáj
ždeti	ʒdèːti
zdolgočasen	zdɔʋɡɔtʃáːsɛn
zdravica	zdraʋìːtsa
zdravilo	zdraʋìːlɔ
zdravje	zdráːʋjɛ
zdravljica	zdraʋljìːtsa
zdravnik	zdraʋnìːk
zdravo	zdráːʋɔ
zdravstvo	zdráːʋstʋɔ
zdrav	zdráʋ
zeba	zèːba
žebelj	ʒɛ̀ːbəl
žebelj	ʒɛbə́l
zebra	zéːbra
zebra	zèːbra
zebsti	zèːpsti
zehati	zèːxati
žeja	ʒɛja
zelena	zéːlɛna
zelena	zɛ́ːlɛna
zelena	zɛlɛ̀ːna
zelen	zéːlən
zelen	zɛlɛ́n
želeti	ʒɛlèːti
železo	ʒɛlèːzɔ
želja	ʒɛ̀ːlja
zelje	zèːljɛ
želodec	ʒɛlóːdəts
želod	ʒɛ̀ːlɔt
zelo	zɛlóː
želva	ʒèːlʋa
zel	zéːʋ
zel	zə́ʋ
zemlja	zɛ̀ːmlja
zemlja	zɛ̀ːmlja
zemljepis	zɛmljɛpíːs
zemljevid	zɛmljɛʋíːt
žena	ʒɛ̀ːna
zenica	zɛnìːtsa
ženska	ʒèːnska
ženski	ʒèːnski
žepar	ʒɛ́ːpar
žep	ʒɛ́p
žerjav	ʒɛrjáʋ
žerjav	ʒɛrjáʋ
žetev	ʒéːtəʋ
žeti	ʒèːti
zet	zɛ́t
že	ʒéː
že	ʒɛ
že	ʒɛ́
žgati	ʒɡàːti
zgodaj	zɡóːdaj
zgodba	zɡóːdba
zgodovinar	zɡɔdɔʋíːnar
zgodovina	zɡɔdɔʋìːna
zgodovinski	zɡɔdɔʋíːnski
zgoraj	zɡɔ̀ːraj
zgradba	zɡráːdba
zgrešiti	zɡrɛ̀ːʃiti
zibati	zìːbati
zibati	zibàːti
žica	ʒìːtsa
zidati	zìːdati
zidati	zidàːti
zid	zíːt
žila	ʒìːla
zima	zìːma
žimnica	ʒíːmnitsa
žirafa	ʒiráːfa
žiti	ʒìːti
živahen	ʒiʋàːxən
živahnejši	ʒiʋàːxnɛjʃi
žival	ʒiʋáːʋ
živeti	ʒiʋèːti
živinorejec	ʒiʋinɔrɛ́ːjəts
življenje	ʒiʋljɛ̀ːnjɛ
živ	ʒíːʋ
zjutraj	zjùːtraj
zlaten	zláːtən
zlaten	zlàːtən
zlaten	zlatéːn
zlaten	zlatèːn
zlato	zlatóː
zlat	zláːt
zlemu	zlɛmú
žleza	ʒlèːza
zlitina	zlíːtina
zlitina	zlìːtina
zločinec	zlɔtʃíːnəts
zločin	zlɔtʃíːn
zlog	zlɔ́k
zlomiti	zlɔmíːti
zlomiti	zlɔmìːti
zlomljen	zlòːmljɛn
zlonameren	zlɔnamèːrən
zlo	zlɔ́
zmaga	zmáːɡa
zmagovalec	zmaɡɔʋáːləts
zmaj	zmáːj
zmaj	zmàːj
zmaj	zmáj
zmeraj	zméːraj
značilen	znatʃíːlən
značilnejši	znatʃíːlnɛjʃi
znanje	znáːnjɛ
znanost	znàːnɔst
znanstven	znáːnstʋɛn
znati	znàːti
znoj	znóːj
znoj	znɔ́j
znotraj	znòːtraj
zober	zòːbər
zobozdravnik	zɔbɔzdraʋnìːk
zobozdravstvo	zɔbɔzdráːʋstʋɔ
zobru	zɔ̀ːbru
zob	zóːp
žoga	ʒóːɡa
žoga	ʒòːɡa
žolčevod	ʒɔ́ltʃɛʋòːt
žolčnik	ʒɔ́ːʋtʃnik
žolč	ʒɔ́ːʋtʃ
žolna	ʒɔ̀ːʋna
žolt	ʒɔ́ːʋt
zona	tsóːna
zona	zóːna
zora	zóːra
zora	zɔ̀ːra
zoreti	zɔrèːti
zrak	zrák
žrebec	ʒrèːbəts
žrebe	ʒrɛbɛ́
žrebica	ʒrɛbìːtsa
zrelejši	zrèːlɛjʃi
zrelejši	zrɛlɛ́ːjʃi
zrel	zréːʋ
zrel	zrɛ́ʋ
žreti	ʒrèːti
zrklo	zə̀rklɔ
žrtvovati	ʒərtʋɔʋàːti
zssr	zəsəsərə́
zunaj	zùːnaj
zupančič	zupáːntʃitʃ
zupanc	zúːpants
zupan	zúːpan
zupan	zupán
župan	ʒupàːn
župan	ʒupán
žuželka	ʒuʒéːlka
zvati	zʋàːti
zvečer	zʋɛtʃéːr
žvečiti	ʒʋèːtʃiti
žveplo	ʒʋɛ̀ːplɔ
zverina	zʋɛrìːna
zver	zʋéːr
zver	zʋéːr
zvezda	zʋèːzda
zvezek	zʋéːzək
zvitek	zʋíːtək
zvok	zʋóːk
zvonar	zʋɔnàːr
zvonec	zʋɔ̀ːnəts
zvone	zʋóːnɛ
zvon	zʋóːn
zvon	zʋɔ́ːn
z	z
ž	ʒ
