á	a
á	a
à	a
à	a˥˩
à	a˥˩
ă	a
ă	a
ȧ	ə
ȁ	a˥˩
á	aː
á	a˥˩ː
á	a˩˥ː
à	a˥˩ː
à	a˩˥ː
ă	aː
ă	aː
ā	a˥˩ː
ā	a˩˥ː
ȃ	a˥˩ː
ä	ɐ
ä	ɐ
abak	a˥˩ːbak
abstrakcija	apstra˩˥ːktsija
abstraktno	apstra˥˩ːktnɔ
absurden	apsu˥˩ːrdən
absurdnejši	apsu˥˩ːrdnɛjʃi
aceton	atsɛto˥˩ːn
adaptacija	adapta˩˥ːtsija
adijo	adi˥˩ːjɔ
adjektiven	adjɛkti˥˩ːʋən
adut	adu˥˩ːt
ä	e˥˩ː
ä	e˥˩ː
ä	e˩˥ː
ä	e˩˥ː
aerodinamika	a˥˩ːɛrɔdina˩˥ːmika
aerodinamika	aɛ́ːrɔdina˩˥ːmika
aerolit	aɛrɔli˥˩ːt
ä	ɛ́ː
ä	ɛ́ː
ä	ɛ̀ː
ä	ɛ̀ː
ă	ɤ
ă	ɤ
afganistan	aʋga˥˩ːnistan
afna	a˩˥ːfna
afrika	a˥˩ːfrika
aglomeracija	aglɔmɛra˩˥ːtsija
agrumi	agru˥˩ːmi
ahil	axi˥˩ːl
ahoj	axo˥˩ːj
ajd	a˩˥ːjt
ajd	a˥˩jt
ajnštajnij	a˥˩ːjnʃtajnij
aksiom	aksijo˥˩ːm
aktinij	akti˩˥ːnij
aktualizacija	aktualiza˩˥ːtsija
aktualizirati	aktualizi˥˩ːrati
akuzativ	a˥˩ːkuzatiʋ
akvarij	akʋa˩˥ːrij
albanec	alba˥˩ːnəts
albanija	alba˩˥ːnija
albanka	alba˥˩ːnka
albanščina	alba˥˩ːnʃtʃina
albanski	alba˥˩ːnski
albansko	alba˥˩ːnskɔ
aleksander	alɛksa˩˥ːndər
ali	a˥˩ːli
ali	ali
ali	a˥˩li
aligator	aliga˥˩ːtɔr
aljaska	alja˥˩ːska
alkohol	alkɔxo˥˩ːl
alpaka	alpa˥˩ːka
aluminij	alumi˩˥ːnij
alžirija	alʒi˥˩ːrija
aman	a˥˩ːman
amarant	amara˥˩ːnt
amarant	amara˩˥ːnt
ambasador	ambasa˥˩ːdɔr
ambrozija	ambro˩˥ːzija
americij	amɛri˩˥ːtsij
amerika	amɛ́ːrika
ameriški	amɛ́ːriʃki
amfiteater	amfitɛa˩˥ːtər
ampak	a˥˩mpak
amper	ampɛ́ːr
amputirati	amputi˥˩ːrati
amulet	amule˥˩ːt
ana	a˩˥ːna
anakonda	anako˥˩ːnda
analen	ana˥˩ːlən
analogija	analɔgi˥˩ːja
ananas	a˥˩ːnanas
anarhist	anarxi˥˩ːst
anarhizem	anarxi˩˥ːzəm
anatomija	anatɔmi˥˩ːja
andaluzija	andalu˩˥ːzija
andora	ando˥˩ːra
andreaš	andrɛa˩˥ːʃ
andrej	andrɛ̀ːj
angel	a˩˥ːngɛl
angleščina	angle˥˩ːʃtʃina
angleški	angle˥˩ːʃki
angleško	angle˥˩ːʃkɔ
anglež	angle˥˩ːʃ
angležinja	angle˥˩ːʒinja
anglija	a˥˩ːnglija
anomalija	anɔmali˥˩ːja
antarktika	anta˩˥ːrktika
antilopa	antilo˥˩ːpa
antimon	antimo˥˩ːn
anton	anto˥˩ːn
antonim	antɔni˥˩ːm
apartma	apartma˥˩ː
apnenec	apne˥˩ːnəts
apnenec	apne˩˥ːnəts
apokalipsa	apɔkali˥˩ːpsa
apostrof	apɔstro˥˩ːf
april	apri˥˩ːl
arabski	ara˥˩ːpski
aragonit	aragɔni˥˩ːt
arašid	araʃi˥˩ːt
argon	a˥˩ːrgɔn
argon	argo˥˩ːn
arh	a˥˩ːrx
arhangel	arxa˩˥ːngɛl
arhitektura	arxitɛktu˥˩ːra
arhivar	arxiʋa˩˥ːr
aristokracija	aristɔkratsi˥˩ːja
aristotel	aristo˥˩ːtɛl
armada	arma˥˩ːda
armenija	arme˩˥ːnija
artefakt	artɛfa˥˩ːkt
arterija	artɛ̀ːrija
arzen	arze˥˩ːn
as	a˥˩ːs
asimetrija	a˥˩simɛtri˥˩ːja
asklepij	askle˩˥ːpij
astat	asta˥˩ːt
asteroid	astɛrɔi˥˩ːt
astrofizika	a˥˩ːstrɔfi˩˥ːzika
astrologija	astrɔlɔgi˥˩ːja
astronomija	astrɔnɔmi˥˩ːja
ateizem	atɛi˩˥ːzəm
atena	ate˥˩ːna
atene	ate˥˩ːnɛ
atol	ato˥˩ːl
atomski	ato˥˩ːmski
atonalen	a˥˩tɔna˥˩ːlən
atrij	a˩˥ːtrij
autokracija	autɔkratsi˥˩ːja
avgust	aʋgu˥˩ːst
avstralija	aʋstra˩˥ːlija
avstrija	a˥˩ːʋstrija
avstrijec	aʋstri˥˩ːjəts
avstrijka	aʋstri˥˩ːjka
avstrijski	aʋstri˥˩ːjski
avtizem	aʋti˩˥ːzɛm
avto	a˥˩ːʋtɔ
avtobus	a˥˩ːʋtɔbus
avtocesta	a˥˩ːʋtɔtse˩˥ːsta
avtomehanik	a˥˩ːʋtɔmɛxa˩˥ːnik
avtopralnica	a˥˩ːʋtɔpra˥˩ːlnitsa
avtor	a˥˩ːʋtɔr
avtor	a˩˥ːʋtɔr
avtosedež	a˥˩ːʋtɔse˥˩ːdɛʃ
avtošola	a˥˩ːʋtɔʃo˥˩ːla
avtosugestija	a˥˩ːʋtɔsugɛsti˥˩ːja
azerbajdžan	azɛrbajdʒa˥˩ːn
azija	a˩˥ːzija
azil	azi˥˩ːl
baba	ba˩˥ːba
babica	ba˩˥ːbitsa
bager	ba˩˥ːgər
bagrist	bagri˥˩ːst
bahami	baxa˥˩ːmi
bahrajn	baxra˥˩ːjn
bajen	ba˥˩ːjən
bajonet	bajɔne˥˩ːt
bajta	ba˥˩ːjta
baker	ba˩˥ːkər
bakla	ba˥˩ːkla
baklonosec	baklɔno˥˩ːsɛts
balet	bale˥˩ːt
bambus	ba˥˩ːmbus
banja	ba˩˥ːnja
banka	ba˥˩ːnka
barantati	baranta˩˥ːti
bar	ba˥˩ːr
barcelona	bartsɛlo˥˩ːna
barij	ba˩˥ːrij
barion	ba˥˩ːrijɔn
barion	barijo˥˩ːn
barka	ba˥˩ːrka
barva	ba˥˩ːrʋa
basati	ba˩˥ːsati
bas	ba˥˩ːs
bask	ba˥˩ːsk
baskovščina	ba˥˩ːskɔʋʃtʃina
baskovski	ba˥˩ːskɔʋski
baterija	batɛri˥˩ːja
bati	ba˩˥ːti
batiskaf	batiska˥˩ːf
baza	ba˥˩ːza
baza	ba˩˥ːza
bazalt	baza˥˩ːlt
bazen	baze˥˩ːn
b	b
b	b
b	be˥˩ː
b	be˥˩ː
b	be˩˥ː
b	be˩˥ː
b	bə
b	bə˥˩
b	bə˥˩
be	be˥˩ː
beda	be˩˥ːda
bedak	bɛda˩˥ːk
beden	be˩˥ːdən
bednejši	be˩˥ːdnɛjʃi
bedro	bɛ̀ːdrɔ
beg	be˥˩ːk
begunec	bɛgu˥˩ːnəts
bel	be˩˥ːʋ
belejši	bɛlɛ́ːjʃi
belgija	be˩˥ːlgija
belgijski	be˩˥ːlgijski
belina	bɛli˩˥ːna
beljak	bɛlja˩˥ːk
beloruščina	bɛlɔru˥˩ːʃtʃina
belorusija	bɛlɔru˥˩ːsija
beloruski	bɛlɔru˥˩ːski
benetke	bɛne˥˩ːtkɛ
benzen	bɛnze˥˩ːn
beograd	be˥˩ːɔgrat
bergla	be˥˩ːrgla
berilij	bɛri˩˥ːlij
berkelij	bɛrke˩˥ːlij
beseda	bɛse˥˩ːda
beseden	bɛse˥˩ːdən
besedilo	bɛsɛdi˩˥ːlɔ
besedotvoren	bɛsɛdɔtʋo˥˩ːrən
besedotvoren	bɛsɛdɔtʋo˩˥ːrən
besedotvorje	bɛsɛdɔtʋo˥˩ːrjɛ
betežen	bɛte˩˥ːʒən
betežnejši	bɛte˩˥ːʒnɛjʃi
betlehem	be˥˩ːtlɛxɛm
beton	bɛto˥˩ːn
bežati	bɛʒa˩˥ːti
bezeg	bəzə˥˩k
bezeg	bə˩˥zək
bezjak	bɛzja˥˩ːk
bič	bi˥˩ːtʃ
bič	bi˩˥ːtʃ
bič	bi˥˩tʃ
bik	bi˥˩k
binom	bino˥˩ːm
biokemija	bi˥˩ːjɔkɛmi˥˩ːja
biološki	biɔlo˥˩ːʃki
birtija	birti˥˩ːja
bisaga	bisa˥˩ːga
bisaga	bisa˩˥ːga
biseksualnost	bi˥˩ːsɛksua˥˩ːlnɔst
biser	bi˥˩ːsɛr
bistvo	bi˥˩ːstʋɔ
biti	bi˩˥ːti
bitje	bi˥˩ːtjɛ
bitje	bi˩˥ːtjɛ
bivol	bi˥˩ːʋɔl
bivši	bi˥˩ːʋʃi
bizantinski	bizanti˥˩ːnski
bizgec	bi˥˩ːzgəts
bizmut	bi˥˩ːzmut
bizon	bi˥˩ːzɔn
blagajna	blaga˥˩ːjna
blag	bla˥˩ːk
blago	blago˥˩ː
blagosloviti	blagɔslɔʋi˥˩ːti
blagosloviti	blagɔslɔʋi˩˥ːti
blatnik	bla˥˩ːtnik
blato	bla˩˥ːtɔ
blazen	bla˩˥ːzən
blaznik	bla˥˩ːznik
bled	ble˥˩ːt
blesteti	blɛste˩˥ːti
blesti	blɛ̀ːsti
bliže	bli˥˩ːʒɛ
blizek	bli˩˥ːzək
bližje	bli˥˩ːʒjɛ
bližnjica	bli˥˩ːʒnjitsa
blizu	bli˩˥ːzu
boben	bo˥˩ːbən
bober	bo˩˥ːbər
bober	bo˩˥ːbər
bo	bo˥˩ː
bodi	bo˩˥ːdi
bodimo	bo˩˥ːdimɔ
bodimo	bɔdi˥˩ːmɔ
bodita	bo˩˥ːdita
bodita	bɔdi˥˩ːta
bodite	bo˩˥ːditɛ
bodite	bɔdi˥˩ːtɛ
bodiva	bo˩˥ːdiʋa
bodiva	bɔdi˥˩ːʋa
bodo	bo˥˩ːdɔ
bogastvo	bɔga˥˩ːstʋɔ
bogat	bo˩˥ːgat
bogat	bɔga˥˩t
bogatejši	bɔgatɛ́ːjʃi
bog	bo˥˩ːk
bog	bo˥˩ːk
boginja	bɔgi˩˥ːnja
bogomolka	bɔgɔmo˥˩ːlka
bogoslužje	bɔgɔslu˥˩ːʒjɛ
boja	bo˥˩ːja
bojazen	bɔja˥˩ːzən
bojo	bo˥˩ːjɔ
bokal	bɔka˥˩ːl
bokal	bɔka˥˩ːʋ
bolan	bɔla˥˩ːn
bolečina	bɔlɛtʃi˩˥ːna
boleti	bɔle˩˥ːti
bolezen	bɔle˥˩ːzən
bolgar	bɔlga˥˩ːr
bolgarija	bɔlga˩˥ːrija
bolgarka	bɔlga˥˩ːrka
bolgarščina	bɔlga˥˩ːrʃtʃina
bolgarščina	bɔlga˩˥ːrʃtʃina
bolgarski	bɔlga˥˩ːrski
bolgarski	bɔlga˩˥ːrski
bolgarsko	bɔlga˥˩ːrskɔ
bolgarsko	bɔlga˩˥ːrskɔ
bolha	bo˩˥ːʋxa
bolj	bo˥˩l
bolje	bo˥˩ːljɛ
boljše	bo˥˩ːlʃɛ
boljši	bo˥˩ːlʃi
bolnica	bo˥˩ːlnitsa
bolnik	bɔʋni˩˥ːk
bolnišnica	bɔʋni˥˩ːʃnitsa
bomba	bo˥˩ːmba
bombardirati	bɔmbardi˥˩ːrati
bombaž	bɔmba˥˩ːʃ
bombnik	bo˥˩ːmbnik
bom	bo˥˩ːm
bomo	bo˥˩ːmɔ
bon	bo˥˩ːn
borba	bo˥˩ːrba
bor	bo˥˩ːr
bor	bo˥˩r
borec	bo˥˩ːrəts
boriti	bɔri˥˩ːti
boriti	bɔri˩˥ːti
borka	bo˥˩ːrka
borka	bo˩˥ːrka
borovnica	bɔrɔʋni˩˥ːtsa
borša	bo˥˩ːrʃa
borut	bo˥˩ːrut
borza	bo˥˩ːrza
bosanščina	bɔsa˥˩ːnʃtʃina
bosanščina	bɔsa˩˥ːnʃtʃina
bosanski	bɔsa˥˩ːnski
bosanski	bɔsa˩˥ːnski
bos	bo˥˩ːs
boš	bo˥˩ːʃ
bos	bo˥˩s
bosenski	bo˥˩ːsənski
bosna	bo˥˩ːsna
bosta	bo˥˩ːsta
boste	bo˥˩ːstɛ
bosti	bo˩˥ːsti
bova	bo˥˩ːʋa
božanski	bɔʒa˥˩ːnski
božanstvo	bɔʒa˥˩ːnstʋɔ
božati	bo˥˩ːʒati
božič	bo˩˥ːʒitʃ
bozon	bɔzo˥˩ːn
božur	bɔʒu˥˩ːr
božur	bɔʒu˩˥ːr
brada	bra˩˥ːda
bradat	brada˥˩t
bradatejši	brada˩˥ːtɛjʃi
bradavica	bradaʋi˩˥ːtsa
bralnik	bra˥˩ːlnik
brana	bra˩˥ːna
bran	bra˥˩ːn
branik	brani˩˥ːk
braniti	bra˩˥ːniti
braniti	brani˥˩ːti
braniti	brani˩˥ːti
brat	bra˥˩t
brati	bra˩˥ːti
bratranec	bra˩˥ːtranəts
bratranec	bratra˥˩ːnəts
brazda	bra˩˥ːzda
brazgotina	brazgɔti˩˥ːna
brazilija	brazi˩˥ːlija
brazilski	brazi˥˩ːlski
brca	bə˥˩rtsa
brcniti	bə˩˥rtsniti
brdavs	bərda˥˩ːʋs
breg	bre˥˩ːk
breskev	bre˥˩ːskəʋ
brest	bre˥˩ːst
brest	bre˩˥ːst
brest	brɛ́st
bresti	brɛ̀ːsti
bretanja	brɛta˩˥ːnja
bretonec	brɛto˥˩ːnəts
bretonka	brɛto˥˩ːnka
bretonščina	brɛto˥˩ːnʃtʃina
bretonski	brɛto˥˩ːnski
bretonsko	brɛto˥˩ːnskɔ
breza	bre˩˥ːza
brez	brɛs
brezčustven	brɛstʃu˥˩ːstʋɛn
brezoseben	brɛzɔse˥˩ːbən
brglez	bə˥˩rglɛs
briga	bri˥˩ːga
brihten	bri˩˥ːxtən
brihtnejši	bri˩˥ːxtnɛjʃi
brin	bri˥˩n
brisača	brisa˩˥ːtʃa
britanija	brita˩˥ːnija
britanski	brita˥˩ːnski
briti	bri˩˥ːti
britof	bri˥˩ːtɔf
brivec	bri˥˩ːʋəts
brki	bə˥˩rki
brlog	bərlo˥˩k
brod	bro˥˩ːt
brom	bro˥˩ːm
brom	bro˥˩m
bron	bro˥˩n
brskati	bə˥˩rskati
brskati	bə˩˥rskati
bršljan	bərʃlja˥˩ːn
bruc	bru˥˩ːts
bruselj	bru˩˥ːsəl
brusnica	bru˥˩ːsnitsa
bruto	bru˥˩ːtɔ
brv	bə˥˩rʋ
buča	bu˩˥ːtʃa
buda	bu˥˩ːda
budala	buda˩˥ːla
budalo	buda˩˥ːlɔ
buden	bu˩˥ːdən
budimpešta	bu˥˩ːdimpɛʃta
budist	budi˥˩ːst
budnejši	bu˩˥ːdnɛjʃi
bukarešta	bukare˥˩ːʃta
bukev	bu˥˩ːkəʋ
bukselj	bu˩˥ːksəl
bukva	bu˥˩ːkʋa
buldog	bu˥˩ːldɔk
bunda	bu˥˩ːnda
burek	bu˥˩ːrɛk
burja	bu˥˩rja
butan	buta˥˩ːn
butara	bu˩˥ːtara
buteljka	bute˥˩ːlka
čad	tʃa˥˩ːt
čajnica	tʃa˥˩ːjnitsa
čaj	tʃa˥˩ːj
čakalnica	tʃaka˥˩ːlnitsa
čakati	tʃa˩˥ːkati
čao	tʃa˥˩ːɔ
čaplja	tʃa˥˩ːplja
carica	tsari˩˥ːtsa
čarovnica	tʃaro˥˩ːʋnitsa
čarovnik	tʃaro˥˩ːʋnik
carstvo	tsa˥˩ːrstʋɔ
car	tsa˥˩ːr
car	tsa˩˥ːr
čaša	tʃa˩˥ːʃa
časnik	tʃa˥˩ːsnik
časopis	tʃasɔpi˥˩ːs
častnik	tʃa˥˩ːstnik
čas	tʃa˥˩s
čast	tʃa˥˩ːst
c	cə
c	cə
čebela	tʃəbe˥˩ːla
čebela	tʃɛbe˥˩ːla
čebula	tʃəbu˩˥ːla
čebula	tʃɛbu˩˥ːla
čefur	tʃɛfu˩˥ːr
čefur	tʃɛfu˩˥ːr
čehinja	tʃe˥˩ːxinja
ceh	tse˥˩ːx
čeh	tʃe˥˩ːx
cekin	tsɛki˥˩ːn
ček	tʃe˥˩ːk
celina	tsɛli˩˥ːna
celota	tsɛlo˩˥ːta
celo	tsɛlo˥˩ː
čelo	tʃe˥˩ːlɔ
čelo	tʃɛ̀ːlɔ
cel	tse˥˩ːʋ
čemaž	tʃe˩˥ːmaʃ
čemaž	tʃɛma˥˩ːʃ
čembalo	tʃe˥˩ːmbalɔ
cena	tse˩˥ːna
cenzura	tsɛnzu˥˩ːra
čeprav	tʃɛpra˥˩ʋ
cerij	tsɛ̀ːrij
cerkev	tse˩˥ːrkəʋ
čer	tʃe˥˩ːr
cesarica	tsɛsari˩˥ːtsa
cesarstvo	tsɛsa˥˩ːrstʋɔ
cesar	tsɛ̀ːsar
češčina	tʃe˥˩ːʃtʃina
česen	tʃɛ̀ːsən
češka	tʃe˥˩ːʃka
češki	tʃe˥˩ːʃki
češkoslovaška	tʃe˥˩ːʃkɔslɔʋa˥˩ːʃka
češko	tʃe˥˩ːʃkɔ
česmina	tʃɛsmi˩˥ːna
češnja	tʃe˥˩ːʃnja
češplja	tʃe˥˩ːʃplja
cesta	tse˩˥ːsta
četrtek	tʃɛtə˩˥rtək
četrtinka	tʃɛtərti˥˩ːnka
če	tʃɛ
čevelj	tʃe˥˩ːʋəl
čevljekljun	tʃe˥˩ːʋljɛklju˥˩ːn
cev	tse˥˩ːʋ
cezij	tse˩˥ːzij
čifut	tʃi˩˥ːfut
cigara	tsiga˥˩ːra
cigara	tsiga˩˥ːra
cigareta	tsigare˥˩ːta
čigar	tʃi˥˩ːgar
čigav	tʃiga˩˥ːʋ
ciklon	tsiklo˥˩ːn
čile	tʃi˥˩ːlɛ
cilj	tsi˥˩ːl
cimet	tsi˥˩ːmɛt
cimet	tsi˩˥ːmɛt
cink	tsi˥˩ːnk
ciper	tsi˩˥ːpər
čiraj	tʃira˥˩ːj
cirilica	tsiri˥˩ːlitsa
cirkonij	tsirko˩˥ːnij
čistiti	tʃi˩˥ːstiti
čistota	tʃisto˩˥ːta
čist	tʃi˥˩ːst
čitati	tʃi˥˩ːtati
čitati	tʃi˩˥ːtati
citre	tsi˥˩ːtrɛ
čivava	tʃiʋa˥˩ːʋa
čižek	tʃi˥˩ːʒɛk
članek	tʃla˥˩ːnək
član	tʃla˥˩ːn
človek	tʃlo˩˥ːʋɛk
človeški	tʃlɔʋe˩˥ːʃki
človeštvo	tʃlɔʋe˥˩ːʃtʋɔ
čmrlj	tʃmə˩˥rl
čober	tʃo˩˥ːbər
cokla	tso˥˩ːkla
čokolada	tʃɔkɔla˥˩ːda
čoln	tʃo˥˩ːʋn
cona	tso˥˩ːna
čopič	tʃo˥˩ːpitʃ
čopič	tʃo˥˩ːpitʃ
črevce	tʃre˩˥ːʋtsɛ
črevo	tʃrɛʋo˥˩ː
čriček	tʃri˥˩ːtʃək
črka	tʃə˩˥rka
crkljati	tsərklja˩˥ːti
črkovati	tʃərkɔʋa˩˥ːti
črnilo	tʃərni˩˥ːlɔ
črnogorski	tʃərnɔgo˥˩ːrski
črn	tʃə˩˥rn
črv	tʃə˥˩rʋ
ć	tɕ
ć	tɕ
č	tɕ
č	tɕ
ć	tɕe˥˩ː
ć	tɕe˥˩ː
ć	tɕe˩˥ː
ć	tɕe˩˥ː
ć	tɕə˥˩
ć	tɕə˥˩
c	ts
c	ts
c	tse˥˩ː
c	tse˥˩ː
c	tse˩˥ː
c	tse˩˥ː
c	tsə˥˩
c	tsə˥˩
ć	tʃ
ć	tʃ
č	tʃ
č	tʃ
č	tʃe˥˩ː
č	tʃe˥˩ː
č	tʃe˩˥ː
č	tʃe˩˥ː
ć	tʃə
ć	tʃə
č	tʃə
č	tʃə
č	tʃə˥˩
č	tʃə˥˩
cula	tsu˩˥ːla
čustven	tʃu˥˩ːstʋən
čustvo	tʃu˥˩ːstʋɔ
čutiti	tʃu˩˥ːtiti
čutiti	tʃuti˥˩ːti
čutiti	tʃuti˩˥ːti
čuti	tʃu˩˥ːti
čut	tʃu˥˩ːt
cvek	tsʋɛ́k
cvesti	tsʋəsti˥˩
cvesti	tsʋə˩˥sti
cvesti	tsʋɛ̀ːsti
cveten	tsʋe˥˩ːtən
cvetje	tsʋe˩˥ːtjɛ
cvet	tsʋe˥˩ːt
cviliti	tsʋi˩˥ːliti
cvrček	tsʋə˥˩rtʃək
cvreti	tsʋre˩˥ːti
dajalec	daja˥˩ːləts
dajalnik	daja˥˩ːlnik
dajati	daja˩˥ːti
daleč	da˩˥ːlɛtʃ
dalek	da˥˩ːlɛk
dalija	da˩˥ːlija
dalj	da˥˩l
daljšati	da˥˩ːlʃati
daljši	da˥˩ːlʃi
dama	da˩˥ːma
damask	dama˥˩ːsk
damjak	da˥˩ːmjak
dan	da˥˩ːn
dan	da˩˥ːn
dandanes	da˥˩ːnda˩˥ːnəs
danec	da˥˩ːnəts
danes	da˩˥ːnəs
danka	da˥˩ːnka
danščina	da˥˩ːnʃtʃina
danska	da˥˩ːnska
danski	da˥˩ːnski
dansko	da˥˩ːnskɔ
dar	da˥˩ːr
darilo	dari˩˥ːlɔ
darovati	darɔʋa˩˥ːti
datelj	da˩˥ːtəl
dati	da˩˥ːti
dativ	da˥˩ːtiʋ
datum	da˥˩ːtum
datum	da˩˥ːtum
davek	da˩˥ːʋək
daven	da˩˥ːʋən
d	d
d	d
ḍ	d
ḍ	d
d	de˥˩ː
d	de˥˩ː
d	de˩˥ː
d	de˩˥ː
d	də
d	də˥˩
d	də˥˩
đ	dʑ
đ	dʑ
đ	dʑe˥˩ː
đ	dʑe˥˩ː
đ	dʑe˩˥ː
đ	dʑe˩˥ː
đ	dʑə
đ	dʑə˥˩
đ	dʑə˥˩
đ	dʒ
đ	dʒ
đ	dʒə
ḍ	dˤ
ḍ	dˤ
debel	dɛ̀ːbɛʋ
debelejši	dɛbɛlɛ́ːjʃi
deber	de˥˩ːbər
deber	de˩˥ːbər
deber	dəbə˥˩r
deblo	dɛ̀ːblɔ
deček	de˥˩ːtʃək
december	dɛtsɛ̀ːmbər
ded	de˥˩ːt
ded	dɛ́t
dedovati	de˥˩ːdɔʋati
dedovati	de˩˥ːdɔʋati
dedovati	dɛdɔʋa˩˥ːti
dejanje	dɛja˥˩ːnjɛ
dejati	dɛja˩˥ːti
dejaven	dɛja˥˩ːʋən
dejaven	dɛja˩˥ːʋən
dejavnejši	dɛja˥˩ːʋnɛjʃi
dejavnejši	dɛja˩˥ːʋnɛjʃi
dejavnost	dɛja˥˩ːʋnɔst
dejavnost	dɛja˩˥ːʋnɔst
dekle	dɛklɛ́
delati	de˩˥ːlati
delavec	de˩˥ːlaʋəts
del	de˥˩ːl
del	de˩˥ːl
del	de˥˩ːʋ
del	de˩˥ːʋ
deležnik	dɛle˥˩ːʒnik
delfin	dɛlfi˥˩ːn
delo	de˩˥ːlɔ
demiurg	dɛmiju˥˩ːrk
demografija	dɛmɔgrafi˥˩ːja
demokracija	dɛmɔkratsi˥˩ːja
denar	dɛna˩˥ːr
denarnica	dɛna˥˩ːrnitsa
dendrokronologija	dɛndrɔkrɔnɔlɔgi˩˥ːja
depo	dɛpɔ
depresija	dɛprɛsi˥˩ːja
desetarka	dɛsɛta˩˥ːrka
deset	dɛse˥˩ːt
desetletje	dɛsɛtle˥˩ːtjɛ
desetnica	dɛse˥˩ːtnitsa
deska	dəska˥˩
deska	də˩˥ska
detel	de˩˥ːtəl
deti	de˩˥ːti
deva	de˥˩ːʋa
deverbativen	dɛʋɛrbati˥˩ːʋən
devetdeset	dɛʋe˥˩ːddɛsɛt
devet	dɛʋe˥˩ːt
devetnajst	dɛʋe˥˩ːtnajst
devetnajst	dɛʋɛtna˩˥ːjst
devica	dɛʋi˩˥ːtsa
dež	də˥˩ʃ
dežela	dɛʒɛ̀ːla
deževati	dəʒɛʋa˩˥ːti
dežnik	dəʒni˩˥ːk
diamant	dijama˥˩ːnt
diamant	dijama˩˥ːnt
diamanten	diama˥˩ːntən
dihati	di˩˥ːxati
dihur	dixu˥˩ːr
dihur	dixu˩˥ːr
dijak	dija˩˥ːk
dim	di˥˩m
dimlje	di˥˩ːmljɛ
dimlje	di˩˥ːmljɛ
dimnik	di˥˩ːmnik
dinastija	dinasti˥˩ːja
dinozaver	dinɔza˩˥ːʋər
dirigent	dirigɛ́nt
dirka	di˥˩ːrka
diskriminacija	diskrimina˩˥ːtsija
disprozij	dispro˩˥ːzij
diti	di˩˥ːti
divizija	diʋizi˥˩ːja
divjak	di˩˥ːʋjak
divji	di˩˥ːʋji
dlaka	dla˩˥ːka
dlan	dla˥˩ːn
dleto	dle˩˥ːtɔ
dnevnik	dne˥˩ːʋnik
dninar	dni˥˩ːnar
dno	dno˥˩
doba	do˩˥ːba
dob	do˥˩ːp
dober	do˩˥ːbər
dobiti	dɔbi˥˩ːti
dobiti	dɔbi˩˥ːti
dobrava	dɔbra˥˩ːʋa
dobrodošel	dɔbrɔdo˩˥ːʃəʋ
dobro	do˩˥ːbrɔ
do	dɔ
dogajati	dɔga˥˩ːjati
dogajati	dɔga˩˥ːjati
dogodek	dɔgo˥˩ːdək
dogovor	dɔgo˥˩ːʋɔr
dojenček	dɔjɛ̀ːntʃək
dojilja	dɔji˩˥ːlja
dokler	do˥˩ːklɛr
dokler	dɔklɛ́r
dokler	do˥˩klɛr
dol	do˥˩ːʋ
dol	do˩˥ːl
dol	do˥˩ːʋ
dolg	do˥˩ːʋk
dolgočasen	dɔʋgɔtʃa˩˥ːsən
dolgočasnejši	dɔlgɔtʃa˩˥ːsnɛjʃi
dolgovaloven	dɔʋgɔʋalo˥˩ːʋən
dolina	dɔli˩˥ːna
dolžina	dɔʋʒi˩˥ːna
doma	dɔma˥˩ː
dom	do˥˩ːm
domišljija	dɔmiʃlji˥˩ːja
domoljub	dɔmɔlju˥˩ːp
domov	dɔmo˥˩ːʋ
domov	dɔmo˩˥ːʋ
domovina	dɔmɔʋi˩˥ːna
donava	do˥˩ːnaʋa
dopoldan	dɔpo˥˩ːʋdan
dotakniti	dɔta˩˥ːkniti
dotakniti	dɔtakni˥˩ːti
dotakniti	dɔtakni˩˥ːti
dovolj	dɔʋo˥˩l
dovoljenje	dɔʋɔljɛ̀ːnjɛ
dovršen	dɔʋə˥˩rʃən
dovtip	dɔʋti˥˩ːp
doživeti	dɔʒiʋe˩˥ːti
drag	dra˥˩ːk
drago	dra˥˩ːgɔ
dragulj	dragu˥˩ːl
dragulj	dragu˩˥ːl
dražji	dra˥˩ːʒji
drek	drɛ́k
dren	drɛ́n
dreti	dre˩˥ːti
drevo	drɛʋo˥˩ː
drka	də˥˩rka
drkaj	də˥˩rkaj
drkajmo	də˥˩rkajmɔ
drkajo	də˥˩rkajɔ
drkajta	də˥˩rkajta
drkajte	də˥˩rkajtɛ
drkajva	də˥˩rkajʋa
drkam	də˥˩rkam
drkamo	də˥˩rkamɔ
drkanje	də˥˩rkanjɛ
drkaš	də˥˩rkaʃ
drkata	də˥˩rkata
drkate	də˥˩rkatɛ
drkati	də˥˩rkati
drkava	də˥˩rkaʋa
droben	dro˩˥ːbən
drobiž	drɔbi˩˥ːʃ
drobnjak	drɔbnja˩˥ːk
drog	dro˥˩ːk
dromedar	drɔmɛda˩˥ːr
dromlja	dro˥˩ːmlja
drozd	dro˥˩ːst
drozg	dro˥˩ːsk
drseti	dərse˩˥ːti
drug	dru˥˩ːk
drugi	dru˥˩ːgi
drugi	dru˩˥ːgi
drugoten	drugo˩˥ːtən
družba	dru˥˩ːʒba
družina	druʒi˩˥ːna
drva	dərʋa˥˩
drva	də˩˥rʋa
država	dərʒa˥˩ːʋa
državljan	dərʒaʋlja˥˩ːn
ducat	du˥˩ːtsat
ducat	du˩˥ːtsat
duda	du˥˩ːda
duda	du˩˥ːda
dude	du˥˩ːdɛ
dude	du˩˥ːdɛ
duh	du˥˩ːx
dunaj	du˩˥ːnaj
dunajski	du˩˥ːnajski
duša	du˩˥ːʃa
dušik	duʃi˥˩ːk
dva	dʋa˥˩ː
dvajset	dʋa˥˩ːjsɛt
dvanajst	dʋa˥˩ːnajst
dvanajst	dʋana˩˥ːjst
dve	dʋe˥˩ː
dvigniti	dʋi˩˥ːgniti
dvojček	dʋo˥˩ːjtʃək
dvojček	dʋo˩˥ːjtʃək
dvojina	dʋɔji˩˥ːna
dvojka	dʋo˥˩ːjka
dvom	dʋo˥˩ːm
dvom	dʋo˥˩m
dvomiti	dʋo˥˩ːmiti
dvomiti	dʋo˩˥ːmiti
dvomiti	dʋɔmi˥˩ːti
dvomiti	dʋɔmi˩˥ːti
dvopičje	dʋo˥˩ːpi˥˩ːtʃjɛ
dvovidski	dʋo˥˩ːʋi˥˩ːtski
dvoživka	dʋɔʒi˥˩ːʋka
džamija	dʒa˩˥ːmija
dz	de˥˩ːze˩˥
dz	de˩˥ːze˩˥
dz	de˥˩ːze˩˥ː
dz	de˩˥ːze˩˥ː
dž	də˥˩ʃ
dz	də˥˩zə˥˩
dz	dz
dz	dz
dz	dz
dz	dze˥˩ː
dz	dze˥˩ː
dz	dze˥˩ː
dz	dze˩˥ː
dz	dze˩˥ː
dz	dze˩˥ː
dz	dzə˥˩
dz	dzə˥˩
dz	dzə˥˩
dž	dʒ
dž	dʒ
dž	dʒ
dž	dʒe˥˩ː
dž	dʒe˥˩ː
dž	dʒe˥˩ː
dž	dʒe˩˥ː
dž	dʒe˩˥ː
dž	dʒe˩˥ː
dž	dʒə˥˩
dž	dʒə˥˩
dž	dʒə˥˩
džez	dʒe˥˩ːs
džihad	dʒi˥˩ːxat
džihad	dʒixa˥˩ːt
džungla	dʒu˥˩ːngla
eden	ɛ̀ːdən
ednina	ɛdni˩˥ːna
edvard	e˥˩ːdʋart
e	e
e	e
ė	ĕ
e	e˥˩ː
e	e˥˩ː
e	e˩˥ː
e	e˩˥ː
é	e˥˩ː
é	e˥˩ː
é	e˩˥ː
é	e˩˥ː
ē	eː
ē	eː
ẹ	e˥˩ː
ẹ	e˩˥ː
e	ə˥˩
e	ə˥˩
e	ə˩˥
e	ə˩˥
ë	ə
ë	ə
e	ɛ
e	ɛ
e	ɛ́
e	ɛ́
e	ɛ̆
e	ɛ̆
é	ɛ
é	ɛ
è	ɛ
è	ɛ
è	ɛ́
ȩ	ɛ
ȅ	ɛ́
e	ɛː
e	ɛː
e	ɛ́ː
e	ɛ́ː
e	ɛ̀ː
e	ɛ̀ː
é	ɛ́ː
é	ɛ̀ː
ê	ɛ́ː
ê	ɛ́ː
ê	ɛ̀ː
ê	ɛ̀ː
ē	ɛː
ē	ɛː
ē	ɛ́ː
ē	ɛ̀ː
ȇ	ɛ́ː
egipt	ɛgi˥˩ːpt
è	ɪ
ejakulacija	ɛjakula˩˥ːtsija
ë	joː
ë	joː
ë	jɔ
ë	jɔ
ekologija	ɛkɔlɔgi˥˩ːja
ekonomija	ɛkɔnɔmi˥˩ːja
ekonomist	ɛkɔnɔmi˥˩ːst
ekosistem	e˥˩ːkɔsiste˥˩ːm
eksodus	e˥˩ːksɔdus
elektromagnetski	ɛle˥˩ːktrɔmagne˥˩ːtski
elektron	ɛle˥˩ːktrɔn
elektron	ɛlɛktro˩˥ːn
emigracija	ɛmigra˩˥ːtsija
enačaj	ɛnatʃa˥˩ːj
enačba	ɛna˥˩ːdʒba
ena	ɛ̀ːna
enaindvajset	ɛ́ːnaindʋa˥˩ːjsɛt
enaindvajset	ɛ̀ːnaindʋa˥˩ːjsɛt
enajst	ɛna˩˥ːjst
enakonočje	ɛnakɔno˥˩ːtʃjɛ
energija	ɛnɛrgi˥˩ːja
en	ɛn
en	ɛ́n
enkrat	ɛ̀ːnkrat
enkrat	ɛnkra˥˩t
enota	ɛno˩˥ːta
entomologija	ɛntɔmɔlɔgi˥˩ːja
epicenter	ɛpitse˥˩ːntər
epicenter	ɛpitse˩˥ːntər
epicenter	ɛpitsɛ́ːntər
epicenter	ɛpitsɛ̀ːntər
epir	ɛpi˥˩ːr
epistemologija	ɛpistɛmɔlɔgi˩˥ːja
erbij	ɛ̀ːrbij
erekcija	ɛre˩˥ːktsija
erik	ɛ́ːrik
eritreja	ɛritrɛ́ːja
erotičen	ɛro˩˥ːtitʃən
eržen	ɛrʒe˥˩ːn
esej	ɛsɛ́ːj
estonec	ɛsto˥˩ːnəts
estonija	ɛsto˩˥ːnija
estonka	ɛsto˥˩ːnka
estonščina	ɛsto˥˩ːnʃtʃina
estonski	ɛsto˥˩ːnski
estonsko	ɛsto˥˩ːnskɔ
estuarij	ɛstua˩˥ːrij
etimologija	ɛtimɔlɔgi˥˩ːja
etiopija	ɛtijo˩˥ːpija
eto	e˥˩ːtɔ
eto	ɛ́tɔ
evo	e˥˩ːʋɔ
evo	ɛ́ʋɔ
evro	ɛʋrɔ
evropa	ɛʋro˥˩ːpa
evropij	ɛʋro˩˥ːpij
ə	ə˥˩
ə	ə˩˥
ə	ə˩˥ː
ə	pɔʋgla˥˩ːsnik
ɛ	ɛ
fagot	fago˥˩ːt
fakulteta	fakulte˥˩ːta
falzet	falze˥˩ːt
fant	fa˥˩nt
fašizem	faʃi˥˩ːzɛm
fašizem	faʃi˩˥ːzɛm
fazan	faza˥˩ːn
februar	fe˥˩ːbruar
federacija	fɛdɛra˩˥ːtsija
felicijan	fɛlitsija˥˩ːn
feminizem	fɛmini˥˩ːzɛm
feminizem	fɛmini˩˥ːzɛm
feniks	fe˥˩ːniks
fermij	fɛ̀ːrmij
f	f
f	f
f	fə
f	fə
figa	fi˩˥ːga
file	file˥˩ː
filipini	filipi˥˩ːni
filozof	filɔzo˥˩ːf
finec	fi˥˩ːnəts
fin	fi˥˩ːn
finka	fi˥˩ːnka
finščina	fi˥˩ːnʃtʃina
finska	fi˥˩ːnska
finski	fi˥˩ːnski
finsko	fi˥˩ːnskɔ
fizika	fi˩˥ːzika
fižol	fiʒo˥˩ʋ
flavta	fla˥˩ːʋta
fluor	flu˥˩ːɔr
fonetika	fɔne˩˥ːtika
fosfor	fo˥˩ːsfɔr
fotograf	fɔtɔgra˥˩ːf
fotografija	fɔtɔgrafi˥˩ːja
franc	fra˥˩nts
francija	fra˩˥ːntsija
francij	fra˩˥ːntsij
francoščina	frantso˥˩ːʃtʃina
francoski	frantso˥˩ːski
francosko	frantso˥˩ːskɔ
francoz	frantso˥˩ːs
francozinja	frantso˥˩ːzinja
frekvenca	frɛkʋe˥˩ːntsa
friz	fri˥˩ːs
fukajoč	fukajo˥˩ːtʃ
fukajoč	fukajo˩˥ːtʃ
fukati	fu˥˩ːkati
funt	fu˥˩ːnt
gabez	ga˥˩ːbɛs
gadolinij	gadɔli˩˥ːnij
galeb	gale˥˩ːp
galicija	gali˩˥ːtsija
galij	ga˩˥ːlij
gambija	ga˩˥ːmbija
gams	ga˩˥ːms
gams	ga˥˩ms
gana	ga˥˩ːna
gasa	ga˥˩ːsa
gaziti	ga˩˥ːziti
gejzir	gɛjzi˥˩ːr
gejzir	gɛjzi˩˥ːr
generacija	gɛnɛra˩˥ːtsija
genij	ge˩˥ːnij
genitiv	ge˥˩ːnitiʋ
genocid	gɛnɔtsi˥˩ːt
geodezija	gɛɔdɛzi˥˩ːja
geografija	gɛɔgrafi˥˩ːja
geologija	gɛɔlɔgi˥˩ːja
gepard	ge˥˩ːpart
germanij	gɛrma˩˥ːnij
geslo	gɛ̀ːslɔ
g	g
g	g
gibanje	gi˩˥ːbanjɛ
gimnazija	gimna˩˥ːzija
ginekologija	ginɛkɔlɔgi˥˩ːja
glad	gla˥˩ːt
gladilka	gladi˥˩ːlka
glagol	gla˩˥ːgɔl
glagolica	glago˥˩ːlitsa
glagolnik	gla˩˥ːgɔlnik
glagolski	gla˩˥ːgɔlski
glasba	gla˥˩ːzba
glasben	gla˥˩ːzbɛn
glasbenik	gla˥˩ːzbɛnik
glasen	gla˩˥ːsən
glas	gla˥˩ːs
glasnejši	glasnɛ́ːjʃi
glasoslovje	glasɔslo˥˩ːʋjɛ
glava	gla˩˥ːʋa
glaven	gla˥˩ːʋən
glaven	gla˩˥ːʋən
glavnik	glaʋni˩˥ːk
glavonožec	glaʋɔno˥˩ːʒɛts
glazba	gla˥˩ːzba
gledališče	glɛdali˩˥ːʃtʃɛ
gledati	gle˩˥ːdati
gleženj	gle˩˥ːʒən
glina	gli˩˥ːna
globina	glɔbi˩˥ːna
globlji	glo˥˩ːblji
globok	glɔbo˥˩k
glodalec	glɔda˥˩ːləts
glodavec	glɔda˥˩ːʋɛts
glog	glo˥˩ːk
glog	glo˥˩k
gluh	glu˥˩ːx
glup	glu˥˩ːp
glušji	glu˥˩ːʃji
gnati	gna˩˥ːti
gnesti	gnɛ̀ːsti
gnezdo	gne˩˥ːzdɔ
gnil	gni˥˩ːʋ
gniti	gni˩˥ːti
gnoj	gno˥˩ːj
gnostičen	gno˩˥ːstitʃən
gnosticizem	gnɔstitsi˩˥ːzəm
goba	go˩˥ːba
godba	go˥˩ːdba
god	go˥˩ːt
gol	go˥˩ːl
gol	go˥˩ːʋ
gol	go˥˩ʋ
golibar	gɔli˥˩ːbar
golk	go˥˩ːʋk
golob	gɔlo˥˩ːp
golob	gɔlo˥˩ːp
golobica	gɔlɔbi˩˥ːtsa
golobrad	gɔlɔbra˥˩ːt
golobrad	gɔlɔbra˥˩t
golt	go˥˩ːʋt
gonoreja	gɔnɔrɛ́ːja
gora	go˩˥ːra
gorčica	go˥˩ːrtʃitsa
gorčica	gɔrtʃi˩˥ːtsa
gorek	go˩˥ːrək
gorek	go˩˥ːrɛk
goreti	gɔre˩˥ːti
gor	go˩˥ːr
gorica	gɔri˩˥ːtsa
gorica	gɔri˩˥ːtsa
gorivo	gɔri˩˥ːʋɔ
gosar	gɔsa˩˥ːr
gosenica	gɔse˥˩ːnitsa
gos	go˥˩ːs
gospa	gɔspa˩˥ː
gospodar	gɔspɔda˩˥ːr
gospod	gɔspo˥˩ːt
gospodična	gɔspɔdi˥˩ːtʃna
gost	go˥˩ːst
gost	go˥˩st
gosti	go˩˥ːsti
gostilna	gɔsti˥˩ːlna
gostitelj	gɔsti˥˩ːtɛl
govedina	gɔʋe˥˩ːdina
govedo	gɔʋe˥˩ːdɔ
govno	go˩˥ːʋnɔ
govorec	gɔʋo˥˩ːrəts
govor	go˥˩ːʋɔr
govoriti	gɔʋɔri˥˩ːti
govoriti	gɔʋɔri˩˥ːti
gozdar	gɔzda˩˥ːr
gozdarstvo	gɔzda˥˩ːrstʋɔ
gozden	go˥˩ːzdən
gozden	go˩˥ːzdən
gozd	go˥˩ːst
gozd	go˥˩st
grablje	gra˩˥ːbljɛ
gradec	gra˥˩ːdəts
grad	gra˥˩ːt
grah	gra˥˩x
granica	gra˥˩ːnitsa
grapa	gra˩˥ːpa
gravitacija	graʋita˩˥ːtsija
gravitacijski	graʋitatsi˥˩ːjski
grba	gə˩˥rba
grb	gə˥˩rp
grča	gə˩˥rtʃa
grčija	gə˥˩rtʃija
grd	gə˥˩rt
greben	grɛbe˥˩ːn
grebsti	grɛ̀ːpsti
gregorič	gre˩˥ːgɔritʃ
greh	gre˩˥ːx
grenak	grɛna˥˩ːk
grenek	grɛ̀ːnək
grenivka	grɛni˥˩ːʋka
grenlandija	gre˥˩ːnla˥˩ːndija
grešiti	grɛʃi˥˩ːti
grešiti	grɛʃi˩˥ːti
greti	gre˩˥ːti
gripa	gri˩˥ːpa
gristi	gri˩˥ːsti
griva	gri˩˥ːʋa
griža	gri˥˩ːʒa
grji	gə˥˩rji
grk	gə˥˩rk
grkinja	gə˥˩rkinja
grlica	gə˩˥rlitsa
grlo	gə˩˥rlɔ
grm	gə˥˩rm
grob	gro˥˩p
grof	gro˥˩f
grofica	grɔfi˩˥ːtsa
grofija	grɔfi˥˩ːja
grom	gro˥˩m
gros	gro˥˩ː
grozdje	gro˩˥ːzdjɛ
groziti	grɔzi˥˩ːti
groziti	grɔzi˩˥ːti
grozljivejši	grɔzlji˩˥ːʋɛjʃi
grozljiv	grɔzlji˩˥ːʋ
grozljivka	grɔzlji˥˩ːʋka
grščina	gə˥˩rʃtʃina
grši	gə˥˩rʃi
grški	gə˥˩rʃki
grško	gə˥˩rʃkɔ
gruden	gru˩˥ːdən
gruzija	gru˥˩ːzija
gruzijski	gru˥˩ːzijski
gruzinski	gruzi˥˩ːnski
guba	gu˩˥ːba
gubiti	gubi˥˩ːti
gubiti	gubi˩˥ːti
gumb	gu˥˩ːmp
gvajana	gʋaja˥˩ːna
gvineja	gʋinɛ́ːja
haag	xa˥˩ːk
habakuk	xabaku˥˩ːk
hadron	xadro˥˩ːn
hafnij	xa˩˥ːfnij
haitijski	xai˥˩ːtijski
halucinacija	xalutsina˩˥ːtsija
harfa	xa˥˩ːrfa
harmonika	xarmo˩˥ːnika
hasidizem	xasidi˥˩ːzəm
hašiš	xa˥˩ːʃiʃ
ha	xa˥˩
ha	xa˥˩ː
hči	xtʃi˥˩ː
heksagon	xɛksago˥˩ːn
hektoliter	xe˥˩ːktɔli˩˥ːtər
helij	xe˩˥ːlij
hematologija	xɛmatɔlɔgi˥˩ːja
heraldika	xɛra˩˥ːldika
herbivor	xɛrbiʋo˥˩ːr
hercegovina	xɛrtsɛgɔʋi˩˥ːna
hermelin	xɛrmɛli˥˩ːn
herodot	xɛro˥˩ːdɔt
heteroseksualnost	xɛtɛrɔsɛksua˥˩ːlnɔst
heziod	xɛzijo˥˩ːt
hiba	xi˩˥ːba
hidrat	xidra˥˩ːt
hidrologija	xidrɔlɔgi˥˩ːja
hidrolog	xidrɔlo˥˩ːk
hidroplan	xidrɔpla˥˩ːn
hidžra	xi˥˩ːdʒra
higrometer	xigrɔme˥˩ːtɛr
higrometer	xigrɔme˩˥ːtɛr
hijena	xije˥˩ːna
hinavski	xina˥˩ːʋski
hip	xi˥˩ːp
hiša	xi˩˥ːʃa
hišen	xi˥˩ːʃən
historičen	xisto˩˥ːritʃən
hitreje	xitrɛ̀ːjɛ
hitrejše	xitrɛ̀ːjʃɛ
hitrost	xitro˥˩ːst
hitro	xi˩˥ːtrɔ
hlače	xla˩˥ːtʃɛ
hladen	xla˥˩ːdən
hladilnik	xladi˥˩ːlnik
hleb	xle˥˩ːp
hleb	xlɛ́p
hlev	xle˥˩ːʋ
hlev	xle˩˥ːʋ
hmelj	xme˥˩ːl
hmelj	xmɛ́l
hobotnica	xɔbo˥˩ːtnitsa
hoditi	xɔdi˥˩ːti
hoditi	xɔdi˩˥ːti
holandski	xɔla˥˩ːntski
holmij	xo˩˥ːlmij
holm	xo˥˩ːlm
holm	xo˩˥ːlm
homeopatija	xɔmɛɔpati˥˩ːja
homoseksualec	xɔmɔsɛksua˥˩ːləts
homoseksualen	xɔmɔsɛksua˥˩ːlən
homoseksualnost	xɔmɔsɛksua˥˩ːlnɔst
horvat	xo˥˩ːrʋat
hosta	xo˥˩ːsta
hostnik	xo˥˩ːstnik
hotel	xɔtɛ̀ːl
hoteti	xɔte˩˥ːti
hrana	xra˩˥ːna
hraniti	xra˩˥ːniti
hraniti	xrani˥˩ːti
hraniti	xrani˩˥ːti
hrast	xra˩˥ːst
hrbet	xərbə˥˩t
hrbet	xə˩˥rbət
hrbtenica	xərptɛni˩˥ːtsa
hrbtenjača	xərptɛnja˩˥ːtʃa
hrček	xə˥˩rtʃək
hren	xrɛ́n
hrib	xri˩˥ːp
hripav	xri˩˥ːpaʋ
hropsti	xro˩˥ːpsti
hrošč	xro˥˩ʃtʃ
hrupen	xru˥˩ːpən
hrupen	xru˩˥ːpən
hrup	xru˥˩ːp
hruška	xru˥˩ːʃka
hrvaščina	xərʋa˥˩ːʃtʃina
hrvaška	xərʋa˥˩ːʃka
hrvaški	xərʋa˥˩ːʃki
hudič	xudi˩˥ːtʃ
hud	xu˥˩ːt
hujši	xu˥˩ːjʃi
hurija	xu˩˥ːrija
huriska	xuri˥˩ːska
husit	xusi˥˩ːt
hvala	xʋa˩˥ːla
hvaliti	xʋa˩˥ːliti
hvaliti	xʋali˥˩ːti
hvaliti	xʋali˩˥ːti
hvošč	xʋo˥˩ːʃtʃ
h	x
h	x
ideologija	idɛɔlɔgi˥˩ːja
idila	idi˥˩ːla
igla	i˥˩ːgla
iglica	i˥˩ːglitsa
iglokožec	iglɔko˥˩ːʒəts
igo	igo˥˩ː
igrača	igra˩˥ːtʃa
igra	i˥˩ːgra
igralec	igra˥˩ːləts
igrati	igra˩˥ːti
igrišče	igri˩˥ːʃtʃɛ
ihan	ixa˥˩n
i	i
i	i
i	i˥˩
i	i˥˩
ì	i
ì	i
ì	i˥˩
ì	i˥˩
ȉ	i
ȉ	i˥˩
ȋ	i˥˩
i	iː
i	iː
i	i˥˩ː
i	i˥˩ː
i	i˩˥ː
i	i˩˥ː
í	iː
í	iː
í	i˥˩ː
í	i˥˩ː
í	i˩˥ː
í	i˩˥ː
ī	iː
ī	i˥˩ː
ī	i˩˥ː
ȋ	iː
ȋ	i˥˩ː
ikona	iko˥˩ːna
ime	ime˥˩ː
imenovalnik	imɛnɔʋa˥˩ːlnik
imenovati	imɛnɔʋa˩˥ːti
imeti	ime˩˥ːti
indija	i˩˥ːndija
indijec	i˥˩ːndijəts
indij	i˩˥ːndij
indijka	i˩˥ːndijka
indijski	i˩˥ːndijski
indonezija	indɔne˩˥ːzija
inflacija	infla˩˥ːtsija
informatik	infɔrma˩˥ːtik
ingver	i˥˩ːngʋɛr
ingver	i˩˥ːngʋɛr
insekt	inse˥˩ːkt
inštitut	inʃtitu˥˩ːt
instrumentalen	instrumɛnta˥˩ːlən
instrumental	i˥˩ːnstrumɛntal
instrumental	instrumɛnta˥˩ːl
invazija	inʋazi˥˩ːja
irak	ira˥˩ːk
irec	i˥˩ːrəts
iridij	iri˩˥ːdij
irka	i˥˩ːrka
ironija	irɔni˥˩ːja
irščina	i˥˩ːrʃtʃina
irska	i˥˩ːrska
irski	i˥˩ːrski
irsko	i˥˩ːrskɔ
iskati	iska˩˥ːti
iskra	i˩˥ːskra
islam	i˥˩ːslam
islandija	isla˩˥ːndija
islandski	isla˥˩ːntski
istanbul	i˥˩ːstanbul
isti	i˥˩ːsti
istra	i˥˩ːstra
italija	ita˩˥ːlija
italijan	italija˥˩ːn
italijan	italija˥˩n
italijanka	italija˥˩ːnka
italijanščina	italija˥˩ːnʃtʃina
italijanski	italija˥˩ːnski
italijansko	italija˥˩ːnskɔ
iterbij	itɛ̀ːrbij
iti	i˥˩ːti
iti	i˩˥ːti
itrij	i˩˥ːtrij
ivan	i˥˩ːʋan
izbira	izbi˥˩ːra
izboljšava	izbɔlʃa˥˩ːʋa
izbrati	izbra˩˥ːti
izdajalec	izdaja˥˩ːləts
izdati	izda˩˥ːti
izglagolski	izgla˩˥ːgɔlski
izgovoriti	izgɔʋɔri˥˩ːti
izgovoriti	izgɔʋɔri˩˥ːti
izgovorjava	izgɔʋɔrja˥˩ːʋa
izgubiti	izgubi˥˩ːti
izgubiti	izgubi˩˥ːti
iz	is
izključiti	isklju˩˥ːtʃiti
izklopiti	isklo˥˩ːpiti
izklopiti	isklo˩˥ːpiti
izklopiti	isklɔpi˥˩ːti
izklopiti	isklɔpi˩˥ːti
izkrcanje	i˥˩ːskərtsa˩˥ːnjɛ
izložba	izlo˥˩ːʒba
izmena	izmɛ́ːna
izmolsti	izmo˩˥ːʋsti
izpeljanka	ispɛlja˩˥ːnka
izpeljati	ispɛlja˩˥ːti
izposoditi	ispɔso˩˥ːditi
izposoditi	ispɔsɔdi˥˩ːti
izposoditi	ispɔsɔdi˩˥ːti
izpuščaj	ispuʃtʃa˥˩ːj
izrael	i˥˩ːzraɛl
izraz	izra˥˩s
izsiljevalski	issiljɛʋa˥˩ːlski
izsiljevalski	issiljɛʋa˥˩ːʋski
izuti	izu˩˥ːti
izvijač	izʋija˩˥ːtʃ
izvir	izʋi˥˩ːr
jablana	ja˥˩ːblana
jablana	ja˩˥ːblana
jabolko	ja˩˥ːbɔʋkɔ
jadro	ja˥˩ːdrɔ
jadro	ja˩˥ːdrɔ
jagnjec	ja˥˩ːgnjəts
jagnjec	ja˩˥ːgnjəts
jagnje	ja˩˥ːgnjɛ
jagnjetina	ja˩˥ːgnjɛtina
jagnjetina	jagnjɛti˩˥ːna
jagoda	ja˩˥ːgɔda
jahati	ja˥˩ːxati
jahati	ja˩˥ːxati
ja	ja˥˩ː
ja	ja˩˥ː
jajce	ja˩˥ːjtsɛ
jajčevec	ja˥˩ːjtʃɛʋəts
jajčevec	ja˩˥ːjtʃɛʋəts
jajčnik	ja˥˩ːjtʃnik
jakac	ja˥˩ːkats
jak	ja˥˩ːk
jama	ja˩˥ːma
jamajka	jama˥˩ːjka
jamar	ja˥˩ːmar
janez	ja˩˥ːnɛs
janež	ja˩˥ːnɛʃ
janšizem	janʃizɛm
jantar	ja˥˩ːntar
jantar	ja˩˥ːntar
januar	ja˥˩ːnuar
japonska	japo˥˩ːnska
jarek	ja˥˩ːrək
jarek	ja˩˥ːrək
jarem	ja˩˥ːrəm
jasen	ja˩˥ːsən
jasna	ja˥˩ːsna
jasnejši	ja˩˥ːsnɛjʃi
jasnejši	jasnɛ́ːjʃi
jasniti	jasni˥˩ːti
jasniti	jasni˩˥ːti
jaspisen	ja˥˩ːspisən
jaspis	ja˥˩ːspis
jastreb	ja˥˩ːstrɛp
javiti	ja˩˥ːʋiti
javor	ja˩˥ːʋɔr
jazbec	ja˥˩ːzbəts
jaz	ja˥˩s
jazon	ja˥˩ːzɔn
jebati	je˥˩ːbati
jebati	jɛ́ːbati
ječmen	jɛ̀ːtʃmɛn
jedec	je˥˩ːdəts
jegulja	jɛgu˩˥ːlja
je	je˩˥ː
je	jɛ́
jeklo	jɛ̀ːklɔ
jelena	jɛle˥˩ːna
jelen	jɛ̀ːlɛn
jelka	je˩˥ːlka
jelša	je˩˥ːʋʃa
jemati	jɛma˩˥ːti
jemen	je˩˥ːmən
jerebica	jɛrɛbi˩˥ːtsa
jereb	jɛre˥˩ːp
jeremija	jɛrɛmi˥˩ːja
jeruzalem	jɛru˥˩ːzalɛm
jesen	jɛ̀ːsɛn
jesen	jɛse˥˩ːn
jesika	jɛsi˩˥ːka
jesti	je˩˥ːsti
jeti	je˩˥ːti
jetika	je˩˥ːtika
jetra	je˩˥ːtra
jezen	je˩˥ːzən
jezero	je˥˩ːzɛrɔ
ježevec	je˥˩ːʒɛʋəts
ježevec	je˩˥ːʒɛʋəts
jezik	jɛ̀ːzik
jezikoslovec	jɛzikɔslo˥˩ːʋəts
jezikoslovje	jɛzikɔslo˥˩ːʋjɛ
jež	je˥˩ːʃ
jež	je˥˩ːʃ
jež	je˩˥ːʃ
jež	je˩˥ːʃ
jeznejši	je˩˥ːznɛjʃi
jezus	je˥˩ːzus
jod	jo˥˩ːt
joga	jo˥˩ːga
jogurt	jo˥˩ːgurt
jokati	jo˩˥ːkati
jokati	jɔka˩˥ːti
jordanija	jɔrda˩˥ːnija
jordanski	jɔrda˥˩ːnski
jožef	jo˥˩ːʒɛf
jože	jo˥˩ːʒɛ
judovstvo	ju˩˥ːdɔʋstʋɔ
jug	ju˥˩ːk
jug	ju˥˩k
jugoslavija	jugɔsla˩˥ːʋija
juha	ju˩˥ːxa
julij	ju˩˥ːlij
junak	juna˩˥ːk
junij	ju˩˥ːnij
jupiter	ju˥˩ːpitər
jurij	ju˩˥ːrij
jur	ju˩˥ːr
jutri	ju˥˩ːtri
jutro	ju˩˥ːtrɔ
juvan	ju˥˩ːʋan
južen	ju˩˥ːʒən
južina	ju˩˥ːʒina
južnejši	ju˩˥ːʒnɛjʃi
južnoameriški	juʒnɔamɛ́ːriʃki
južnoslovanski	juʒnɔslɔʋa˥˩ːnski
kača	ka˩˥ːtʃa
kadar	ka˥˩dar
kadilo	kadi˩˥ːlɔ
kaditi	kadi˥˩ːti
kaditi	kadi˩˥ːti
kad	ka˥˩t
kadmij	ka˩˥ːdmij
kajak	ka˥˩ːjak
kaj	ka˩˥ːj
kaj	ka˥˩j
kako	kako˥˩ː
kako	kako˩˥ː
kakor	ka˥˩kɔr
kakovost	kako˩˥ːʋɔst
kakšen	ka˥˩ːkʃən
kakšen	ka˩˥ːkʃən
kalcij	ka˩˥ːltsij
kalifornija	kalifo˩˥ːrnija
kalifornij	kalifo˩˥ːrnij
kalij	ka˩˥ːlij
kaliti	kali˥˩ːti
kaliti	kali˩˥ːti
kamela	kame˥˩ːla
kamen	ka˩˥ːmən
kamerun	ka˥˩ːmɛrun
kamin	kami˥˩ːn
kamion	kamijo˥˩ːn
kanada	ka˥˩ːnada
kanal	kana˩˥ːl
kanjon	ka˥˩ːnjɔn
kapati	ka˩˥ːpati
kapela	kapɛ̀ːla
kapetanka	kape˥˩ːtanka
kapetan	kape˥˩ːtan
kapitalist	kapitali˥˩ːst
kapitalizem	kapitali˩˥ːzəm
kaplja	ka˩˥ːplja
kapsula	ka˥˩ːpsula
karamela	karame˥˩ːla
kardinal	kardina˥˩ːl
karel	ka˩˥ːrəl
kartagina	karta˥˩ːgina
kašča	ka˩˥ːʃtʃa
kašelj	ka˩˥ːʃəl
kašljati	ka˥˩ːʃljati
kastelic	kaste˥˩ːlits
katalonija	katalo˩˥ːnija
katalonščina	katalo˥˩ːnʃtʃina
katalonski	katalo˥˩ːnski
katedrala	katɛdra˥˩ːla
kategorialen	katɛgɔrija˥˩ːlən
kategorija	katɛgɔri˥˩ːja
kateter	kate˩˥ːtər
kava	ka˩˥ːʋa
kavarna	kaʋa˥˩ːrna
kavčič	ka˥˩ːʋtʃitʃ
kavka	ka˥˩ːʋka
kavkaz	kaʋka˥˩ːs
kavsati	ka˥˩ːʋsati
kazahstan	ka˥˩ːzaxstan
kazalec	kaza˥˩ːləts
kazati	ka˩˥ːzati
kazati	kaza˩˥ːti
kazen	ka˥˩ːzən
kaznovati	kaznɔʋa˩˥ːti
kdaj	gda˥˩ːj
kdaj	gda˩˥ːj
kdaj	gda˥˩j
kdo	gdo˥˩ː
kdo	gdo˩˥ː
kdor	gdo˥˩ːr
kdor	gdo˥˩r
kelih	ke˩˥ːlix
kelt	ke˥˩ːlt
kemija	kɛmi˥˩ːja
kenguru	kɛnguru˥˩ː
kenija	ke˩˥ːnija
kenta	ke˥˩ːnta
ker	kɛr
kern	kɛ́ːrn
kersnik	kɛrsni˩˥ːk
ki	ki
kikiriki	kikiriki˥˩ː
kilometer	kilɔme˩˥ːtər
kinin	kini˥˩ːn
kino	ki˥˩ːnɔ
kip	ki˥˩ːp
kirij	kiri˩˥ːj
kisel	ki˩˥ːsəʋ
kisik	kisi˥˩ːk
kis	ki˥˩ːs
kislina	kisli˩˥ːna
kitajec	kita˥˩ːjəts
kitajka	kita˥˩ːjka
kitajščina	kita˥˩ːjʃtʃina
kitajska	kita˥˩ːjska
kitajski	kita˥˩ːjski
kita	ki˩˥ːta
kitara	kita˥˩ːra
kit	ki˥˩ːt
kje	kje˥˩ː
kje	kje˩˥ː
kjer	kje˥˩ːr
kladivce	kla˩˥ːdiʋtsɛ
kladivce	kladi˥˩ːʋtsɛ
kladivce	kladi˩˥ːʋtsɛ
kladivo	kla˩˥ːdiʋɔ
kladivo	kladi˩˥ːʋɔ
klarinet	klarine˥˩ːt
klasičen	kla˩˥ːsitʃən
klas	kla˥˩ːs
klasti	kla˩˥ːsti
klati	kla˩˥ːti
klavir	klaʋi˥˩ːr
klečati	klɛtʃa˩˥ːti
klen	kle˥˩ːn
klen	kle˩˥n
klen	klɛ̀n
kleopatra	klɛo˥˩ːpatra
klepati	klɛpa˩˥ːti
klepec	klɛ̀ːpəts
kleptokracija	klɛptɔkratsi˥˩ːja
klešče	kle˩˥ːʃtʃɛ
klicaj	klitsa˥˩ːj
klicati	kli˩˥ːtsati
klic	kli˥˩ːts
klima	kli˥˩ːma
klima	kli˩˥ːma
klitoris	kli˥˩ːtɔris
ključavnica	kljutʃa˥˩ːʋnitsa
ključiti	klju˩˥ːtʃiti
ključ	klju˩˥ːtʃ
kljukica	klju˩˥ːkitsa
kljunaš	kljuna˩˥ːʃ
kljun	klju˥˩ːn
klobasa	klɔba˩˥ːsa
klobučar	klɔbutʃa˩˥ːr
klobuk	klɔbu˩˥ːk
klofuta	klɔfu˩˥ːta
klokan	klo˥˩ːkan
klop	klo˥˩ːp
klop	klo˥˩p
klopotača	klɔpɔta˩˥ːtʃa
klor	klo˥˩ːr
klorofil	klɔrɔfi˥˩ːl
klošar	klo˥˩ːʃar
klošar	klɔʃa˩˥ːr
klošč	klo˥˩ʃtʃ
klovn	klo˩˥ːʋn
kmalu	kma˥˩ːlu
kmetija	kmɛti˥˩ːja
kmet	kmɛ́t
kmet	kmɛ́t
kneginja	kne˥˩ːginja
knez	kne˥˩ːs
knjiga	knji˩˥ːga
knjigarna	knjiga˥˩ːrna
knjigovez	knjigɔʋe˥˩ːs
književnost	knjiʒe˥˩ːʋnɔst
knjižnica	kni˥˩ːʒnjitsa
kobalt	ko˥˩ːbalt
kobarid	kɔbari˥˩ːt
kobila	kɔbi˩˥ːla
kobilar	kɔbi˥˩ːlar
kobilica	kɔbi˩˥ːlitsa
kočija	kɔtʃi˥˩ːja
kocka	ko˥˩ːtska
kockati	ko˥˩ːtskati
koder	ko˩˥ːdər
koder	ko˩˥ːdər
kokalj	ko˩˥ːkal
kokalj	ko˩˥ːkal
kokolj	ko˩˥ːkɔl
kokoš	kɔko˥˩ːʃ
kokot	kɔko˥˩ːt
ko	kɔ
kola	ko˥˩ːla
kola	ko˩˥ːla
kolcanje	ko˥˩ːu̯tsanjɛ
kolcanje	ko˩˥ːu̯tsanjɛ
kolc	ko˥˩ːʋts
koledar	kɔlɛda˩˥ːr
koledž	ko˥˩ːlɛtʃ
koleno	kɔle˩˥ːnɔ
kolesariti	kɔlɛsa˩˥ːriti
količina	kɔlitʃi˩˥ːna
kolidž	ko˥˩ːlitʃ
kol	ko˥˩ʋ
kolo	ko˥˩ːlɔ
kolo	kɔlo˥˩ː
komaj	ko˥˩ːmaj
komarček	kɔma˥˩ːrtʃək
komarček	kɔma˩˥ːrtʃək
komar	kɔma˩˥ːr
komet	kɔme˥˩ːt
komolec	kɔmo˥˩ːləts
komori	kɔmo˥˩ːri
kompas	ko˥˩ːmpas
kompas	kɔmpa˥˩ːs
komunizem	kɔmuni˩˥ːzəm
končati	kɔntʃa˩˥ːti
končen	ko˩˥ːntʃən
končno	ko˩˥ːntʃnɔ
kondom	kɔndo˥˩ːm
konec	ko˩˥ːnəts
konjar	kɔnja˩˥ːr
konj	ko˥˩n
konjuh	kɔnju˥˩ːx
konjuh	kɔnju˩˥ːx
konkreten	kɔnkre˥˩ːtən
konkretno	kɔnkre˥˩ːtnɔ
kontinent	kɔntinɛ́nt
kontrabas	ko˥˩ːntraba˥˩ːs
konzulka	ko˥˩ːnzulka
konzul	ko˥˩ːnzul
kopalnica	kɔpa˥˩ːlnitsa
kopati	ko˩˥ːpati
kopati	kɔpa˩˥ːti
kopel	ko˩˥ːpɛʋ
kopel	kɔpe˥˩ːl
koper	ko˩˥ːpər
koper	ko˩˥ːpər
kopina	kɔpi˩˥ːna
kopito	kɔpi˩˥ːtɔ
kopje	ko˩˥ːpjɛ
kop	ko˥˩ːp
kopno	ko˥˩ːpnɔ
kopno	ko˥˩ːpnɔ
kopno	ko˩˥ːpnɔ
korak	kɔra˥˩ːk
koreja	kɔrɛ́ːja
korenina	kɔrɛni˩˥ːna
korenje	kɔre˥˩ːnjɛ
korenje	kɔrɛ̀ːnjɛ
koren	kɔre˥˩ːn
koren	kɔre˥˩ːn
korošec	kɔro˥˩ːʃəts
koroška	kɔro˥˩ːʃka
koruza	kɔru˩˥ːza
košara	kɔʃa˥˩ːra
košarka	kɔʃa˥˩ːrka
kosilo	kɔsi˩˥ːlɔ
kosinus	ko˥˩ːsinus
kosinus	ko˥˩ːzinus
kosinus	ko˥˩si˥˩ːnus
kositer	kɔsi˩˥ːtər
kositi	ko˩˥ːsiti
kositi	kɔsi˥˩ːti
kositi	kɔsi˩˥ːti
kos	ko˥˩ːs
koš	ko˥˩ʃ
kosmulja	kɔsmu˩˥ːlja
kostanj	ko˩˥ːstan
kost	ko˥˩ːst
kostnica	ko˥˩ːstnitsa
kot	ko˩˥ːt
kot	kɔt
kotnik	ko˥˩ːtnik
kovač	kɔʋa˩˥ːtʃ
kovač	kɔʋa˩˥ːtʃ
kovanec	kɔʋa˩˥ːnəts
kovati	kɔʋa˩˥ːti
kovinski	kɔʋi˥˩ːnski
kovnica	ko˥˩ːʋnitsa
koža	ko˩˥ːʒa
koza	ko˩˥ːza
kozarec	kɔza˥˩ːrəts
kozel	ko˩˥ːzəʋ
kozmologija	kɔzmɔlɔgi˥˩ːja
kozorog	kɔzɔro˥˩ːk
kozorog	kɔzɔro˥˩ːk
krajina	kra˥˩ːjina
krajina	kra˩˥ːjina
kraj	kra˥˩j
krajšava	krajʃa˥˩ːʋa
krajši	kra˥˩ːjʃi
kraljestvo	kralje˥˩ːstʋɔ
kraljevina	kraljɛʋi˩˥ːna
kraljica	kralji˩˥ːtsa
kralj	kra˩˥ːl
kralj	kra˩˥ːl
krap	kra˥˩p
kras	kra˥˩ːs
kras	kra˥˩s
krastača	krasta˩˥ːtʃa
krasti	kra˩˥ːsti
kratek	kra˩˥ːtək
krater	kra˩˥ːtɛr
kratica	krati˩˥ːtsa
kratkovaloven	kratkɔʋalo˥˩ːʋən
krava	kra˩˥ːʋa
kravžati	kra˥˩ːʋʒati
krč	kə˥˩rtʃ
krč	kə˩˥rtʃ
kreda	kre˥˩ːda
krema	kre˥˩ːma
krempelj	kre˩˥ːmpəl
kreniti	krɛni˥˩ːti
kreniti	krɛni˩˥ːti
kres	kre˥˩ːs
kreta	kre˥˩ːta
krik	kri˥˩ːk
kri	kri˥˩ː
krilo	kri˩˥ːlɔ
kripton	kri˥˩ːptɔn
kristalizacija	kristaliza˩˥ːtsija
kristal	krista˥˩ːl
kristjan	kristja˥˩ːn
kristus	kri˥˩ːstus
kriti	kri˩˥ːti
krivda	kri˥˩ːʋda
krivoverec	kriʋɔʋe˥˩ːrəts
križanje	kri˥˩ːʒanjɛ
križanje	kri˩˥ːʒanjɛ
križanka	kri˥˩ːʒanka
križ	kri˩˥ːʃ
krma	kə˩˥rma
krog	kro˥˩ːk
krog	krɔk
krogla	kro˥˩ːgla
krojač	krɔja˩˥ːtʃ
krokar	kro˥˩ːkar
krom	kro˥˩ːm
krom	kro˥˩m
krompir	krɔmpi˥˩ːr
krompir	krɔmpi˩˥ːr
krona	kro˥˩ːna
kronati	kro˥˩ːnati
krožnik	kro˥˩ːʒnik
krščanstvo	kərʃtʃa˥˩ːnstʋɔ
krsta	kə˩˥rsta
krst	kə˥˩rst
krt	kə˥˩rt
krutejši	kru˥˩ːtɛjʃi
krutejši	kru˩˥ːtɛjʃi
krut	kru˥˩ːt
krvaveti	kərʋaʋe˩˥ːti
krzno	kə˥˩rznɔ
ksenofobija	ksɛnɔfɔbi˥˩ːja
ksenon	kse˥˩ːnɔn
ksilofon	ksilɔfo˥˩ːn
kuba	ku˥˩ːba
kuga	ku˩˥ːga
kuhar	ku˥˩ːxar
kuhati	ku˩˥ːxati
kuhinja	ku˩˥ːxinja
kukavica	ku˩˥ːkaʋitsa
kuna	ku˩˥ːna
kunec	ku˥˩ːnəts
kunec	ku˩˥ːnəts
kupa	ku˩˥ːpa
kupiti	ku˩˥ːpiti
kupiti	kupi˥˩ːti
kupiti	kupi˩˥ːti
kup	ku˥˩p
kupovati	kupɔʋa˩˥ːti
kura	ku˩˥ːra
kurba	ku˥˩ːrba
kurdščina	ku˥˩ːrtʃtʃina
kurec	ku˥˩ːrəts
kurva	ku˥˩ːrʋa
kuščar	ku˥˩ːʃtʃar
kuščar	ku˩˥ːʃtʃar
kuža	ku˥˩ːʒa
kvadrat	kʋadra˥˩ːt
kvark	kʋa˥˩ːrk
kvar	kʋa˥˩ːr
kvartet	kʋarte˥˩ːt
kvas	kʋa˥˩ːs
labod	labo˥˩ːt
lačen	la˩˥ːtʃən
ladja	la˩˥ːdja
lagati	laga˩˥ːti
lahek	la˩˥ːxək
lahko	laxko˥˩ː
lajati	la˥˩ːjati
lakota	la˩˥ːkɔta
lama	la˩˥ːma
lani	la˩˥ːni
lantan	lanta˥˩ːn
las	la˥˩ːs
lasten	la˩˥ːstən
last	la˥˩ːst
lastnina	lastni˩˥ːna
lastnost	lastno˥˩ːst
lastovica	la˩˥ːstɔʋitsa
lastovka	la˩˥ːstɔʋka
latinica	lati˥˩ːnitsa
latinščina	lati˥˩ːnʃtʃina
latinski	lati˥˩ːnski
latvija	la˩˥ːtʋija
latvijec	la˩˥ːtʋijəts
latvijka	la˩˥ːtʋijka
latvijščina	la˩˥ːtʋijʃtʃina
latvijski	la˩˥ːtʋijski
latvijsko	la˩˥ːtʋijskɔ
lavrencij	laʋre˩˥ːntsij
lažji	la˥˩ːʒji
laž	la˥˩ːʃ
lažnivec	laʒni˥˩ːʋəts
leči	le˩˥ːtʃi
ledenik	lɛdɛni˩˥ːk
led	le˥˩ːt
ledolomilec	lɛdɔlɔmi˥˩ːlɛts
ledvica	lɛdʋi˩˥ːtsa
legendaren	lɛgɛnda˥˩ːrən
leha	le˩˥ːxa
lek	le˥˩ːk
le	lɛ́
lemež	le˥˩ːmɛʃ
lemež	lɛ̀ːmɛʃ
lenivec	lɛni˥˩ːʋəts
len	le˥˩ːn
len	lɛ́n
leon	le˥˩ːɔn
lepiti	le˩˥ːpiti
lepiti	lɛpi˥˩ːti
lepiti	lɛpi˩˥ːti
lep	le˥˩ːp
lepota	lɛpo˩˥ːta
lepši	le˥˩ːpʃi
leska	le˩˥ːska
lesketati	lɛskɛta˩˥ːti
les	le˥˩ːs
lešnik	le˩˥ːʃnik
lesti	le˩˥ːsti
lestvica	le˩˥ːstʋitsa
letališče	lɛtali˩˥ːʃtʃɛ
letalo	lɛta˩˥ːlɔ
leten	le˥˩ːtən
leteti	lɛte˩˥ːti
let	lɛ́t
leto	le˩˥ːtɔ
levinja	lɛ́ːʋinja
levinja	lɛ̀ːʋinja
levinja	lɛʋi˩˥ːnja
lev	lɛ́ʋ
ležaj	lɛʒa˥˩ːj
ležati	lɛʒa˩˥ːti
lezbijka	le˩˥ːzbijka
libanon	li˥˩ːbanɔn
liberija	libɛ̀ːrija
libidinozen	libidino˥˩ːzən
libija	li˩˥ːbija
lice	li˥˩ːtsɛ
lice	li˩˥ːtsɛ
ličinka	litʃi˥˩ːnka
ličnica	li˥˩ːtʃnitsa
liga	li˩˥ːga
lijak	lija˩˥ːk
likalnik	lika˥˩ːlnik
likati	li˥˩ːkati
limonada	limɔna˥˩ːda
limona	limo˥˩ːna
lipa	li˩˥ːpa
lipovec	li˩˥ːpɔʋəts
lira	li˥˩ːra
lišaj	liʃa˥˩ːj
lisica	lisi˩˥ːtsa
lisička	lisi˩˥ːtʃka
list	li˥˩ːst
literatura	litɛratu˥˩ːra
liter	li˩˥ːtər
litij	li˩˥ːtij
liti	li˩˥ːti
litovec	li˩˥ːtɔʋəts
litovka	li˩˥ːtɔʋka
litovščina	li˩˥ːtɔʋʃtʃina
litovski	li˥˩ːtɔʋski
litovsko	li˥˩ːtɔʋskɔ
liturgija	liturgi˥˩ːja
litva	li˥˩ːtʋa
lizati	li˩˥ːzati
lizati	liza˩˥ːti
lizbona	lizbo˥˩ːna
ljubeč	ljubɛ́tʃ
ljubezen	ljube˥˩ːzən
ljubiti	lju˥˩ːbiti
ljubiti	lju˩˥ːbiti
ljubiti	ljubi˥˩ːti
ljubiti	ljubi˩˥ːti
ljubit	lju˩˥ːbit
ljubljana	ljublja˩˥ːna
ljubljenje	lju˥˩ːbljɛnjɛ
ljubljenje	lju˩˥ːbljɛnjɛ
ljubosumen	ljubɔsu˩˥ːmən
ljubosumnejši	ljubɔsu˩˥ːmnɛjʃi
ljubosumnost	ljubɔsu˩˥ːmnɔst
ljudski	lju˥˩ːtski
lobanja	lɔba˩˥ːnja
ločevati	lɔtʃɛʋa˩˥ːti
ločiti	lo˩˥ːtʃiti
ločiti	lɔtʃi˥˩ːti
ločiti	lɔtʃi˩˥ːti
log	lo˥˩ːk
lokacija	lɔka˩˥ːtsija
lokativ	lo˥˩ːkatiʋ
lok	lo˥˩ːk
lokomotiva	lɔkɔmɔti˥˩ːʋa
lombardija	lɔmbardi˥˩ːja
lomiti	lɔmi˥˩ːti
lomiti	lɔmi˩˥ːti
lom	lo˥˩m
lonec	lo˩˥ːnəts
lopata	lɔpa˩˥ːta
lopov	lo˥˩ːpɔʋ
lopov	lo˥˩ːpɔʋ
los	lo˥˩ːs
losos	lo˥˩ːsɔs
lotos	lo˥˩ːtɔs
lovec	lo˩˥ːʋəts
loviti	lɔʋi˥˩ːti
loviti	lɔʋi˩˥ːti
lovka	lo˥˩ːʋka
loza	lo˩˥ːza
loza	lo˩˥ːza
lubenica	lu˥˩ːbɛnitsa
lubje	lu˩˥ːbjɛ
luč	lu˥˩ːtʃ
luč	lu˩˥ːtʃ
lug	lu˥˩ːk
lug	lu˩˥ːk
luka	lu˩˥ːka
luka	lu˩˥ːka
luknja	lu˥˩ːknja
luksemburg	lu˥˩ːksɛmburk
luksemburški	lu˥˩ːksɛmburʃki
luksemburški	luksɛmbu˥˩ːrʃki
lulček	lu˥˩ːltʃək
lunah	lu˩˥ːnax
luna	lu˩˥ːna
lunama	lu˩˥ːnama
lunami	lu˩˥ːnami
lunam	lu˩˥ːnam
lunaren	luna˥˩ːrən
lune	lu˩˥ːnɛ
luni	lu˩˥ːni
lun	lu˩˥ːn
luno	lu˩˥ːnɔ
luska	lu˩˥ːska
lutecij	lute˩˥ːtsij
luteranec	lutɛra˥˩ːnəts
lutnja	lu˥˩ːtnja
mačeha	ma˩˥ːtʃɛxa
maček	ma˩˥ːtʃək
macesen	matsɛ̀ːsən
mačka	ma˥˩ːtʃka
madžarka	madʒa˥˩ːrka
madžar	madʒa˥˩ːr
madžarščina	madʒa˥˩ːrʃtʃina
madžarska	madʒa˥˩ːrska
madžarski	madʒa˥˩ːrski
madžarsko	madʒa˥˩ːrskɔ
mafija	ma˩˥ːfija
magnet	magne˥˩ːt
magnezij	magne˥˩ːzij
mah	ma˥˩ːx
mah	ma˥˩x
maja	ma˩˥ːja
majati	ma˩˥ːjati
majati	maja˩˥ːti
majhen	ma˥˩ːjxən
maj	ma˩˥ːj
majoneza	majɔne˥˩ːza
majorka	majo˥˩ːrka
makedonec	makɛdo˥˩ːnəts
makedonija	makɛdo˩˥ːnija
makedonka	makɛdo˥˩ːnka
makedonščina	makɛdo˥˩ːnʃtʃina
makedonski	makɛdo˥˩ːnski
maklen	maklɛ́n
mak	ma˥˩ːk
mak	ma˥˩k
malarija	mala˩˥ːrija
maldivi	maldi˥˩ːʋi
malezija	male˩˥ːzija
malina	mali˩˥ːna
malo	ma˩˥ːlɔ
malte	ma˥˩ːltɛ
malteščina	malte˥˩ːʃtʃina
malteški	malte˥˩ːʃki
malteško	malte˥˩ːʃkɔ
maltežanka	maltɛʒa˥˩ːnka
maltežan	maltɛʒa˥˩ːn
maltežan	maltɛʒa˥˩n
malti	ma˥˩ːlti
malto	ma˥˩ːltɔ
mamilo	mami˩˥ːlɔ
mamut	ma˥˩ːmut
mandolina	mandɔli˥˩ːna
mangan	manga˥˩ːn
manjkati	ma˥˩ːnkati
manjšalnica	manʃa˥˩ːlnitsa
manjši	ma˥˩ːnʃi
marec	ma˩˥ːrəts
marelica	mare˥˩ːlitsa
marija	mari˥˩ːja
marjan	ma˥˩ːrjan
marjeta	marjɛ̂ta
marko	ma˩˥ːrkɔ
maroko	maro˥˩ːkɔ
mars	ma˥˩ːrs
masa	ma˥˩ːsa
maša	ma˩˥ːʃa
maslen	masle˥˩ːn
maslen	masle˩˥ːn
maslo	ma˩˥ːslɔ
masturbacija	masturba˩˥ːtsija
masturbirati	masturbi˥˩ːrati
matej	matɛ́ːj
matematika	matɛma˩˥ːtika
materen	ma˥˩ːtɛrən
maternica	ma˥˩ːtɛrnitsa
matica	ma˥˩ːtitsa
mati	ma˩˥ːti
mavec	ma˩˥ːʋəts
mavretanija	maʋrɛta˩˥ːnija
mavrica	ma˥˩ːʋritsa
mečji	me˥˩ːtʃji
meč	mɛ́tʃ
medenica	mɛdɛni˩˥ːtsa
meden	mɛde˥˩ːn
medicina	mɛditsi˥˩ːna
med	me˥˩ːt
med	mɛt
medvedka	mɛdʋe˥˩ːtka
medved	mɛ̀ːdʋɛt
megavat	me˥˩ːgaʋa˥˩ːt
megla	məgla˥˩
megla	mə˩˥gla
meglica	məgli˩˥ːtsa
mehaničen	mɛxa˩˥ːnitʃən
mehek	mɛ̀ːxək
meher	mexɛ̀ːr
mehika	me˥˩ːxika
mehir	mexi˩˥ːr
mehkužec	mɛxku˥˩ːʒəts
meh	me˥˩ːx
mehur	mexu˩˥ːr
mejak	mɛja˩˥ːk
meja	mɛ̀ːja
mejiti	mɛji˥˩ːti
mejiti	mɛji˩˥ːti
meka	me˩˥ːka
melancana	mɛlantsa˥˩ːna
melodija	mɛlɔdi˥˩ːja
melona	mɛlo˥˩ːna
me	me˥˩ː
mendelevij	mɛndɛle˩˥ːʋij
menih	məni˩˥ːx
menih	mɛni˩˥ːx
meniti	me˩˥ːniti
meniti	mɛni˥˩ːti
meniti	mɛni˩˥ːti
menjati	me˩˥ːnjati
menjati	mɛnja˩˥ːti
menstruacija	mɛnstrua˩˥ːtsija
meriti	me˩˥ːriti
merjasec	mɛrja˩˥ːsəts
merkur	mɛrku˥˩ːr
mesar	mɛsa˩˥ːr
mešati	me˩˥ːʃati
mešati	mɛʃa˩˥ːti
mesec	me˥˩ːsəts
mesec	me˥˩ːsəts
mesija	mɛsi˥˩ːja
mesojedec	mɛsɔje˥˩ːdəts
meso	mɛso˥˩ː
mesti	me˩˥ːsti
mesti	mɛ̀ːsti
mestnik	me˥˩ːstnik
mesto	me˩˥ːstɔ
metafizika	mɛtafi˩˥ːzika
meta	me˥˩ːta
metati	mɛta˩˥ːti
metež	me˥˩ːtɛʃ
meti	me˩˥ːti
metla	mɛ̀ːtla
met	mɛ́t
metulj	mɛtu˩˥ːl
mezeg	məzə˥˩k
mezeg	mə˩˥zək
mezinec	mɛzi˥˩ːnəts
mezon	mɛzo˥˩ːn
m	ɛm
mihaela	mi˥˩ːxaɛla
mihael	mi˥˩ːxaɛl
miha	mi˩˥ːxa
miličnica	mili˥˩ːtʃnitsa
miličnik	mili˥˩ːtʃnik
milijon	milijo˥˩ːn
milimeter	milime˩˥ːtər
milisekunda	mi˥˩ːlisɛku˥˩ːnda
militi	mi˥˩ːliti
militi	mi˩˥ːliti
mil	mi˥˩ːl
milo	mi˩˥ːlɔ
mi	mi˥˩ː
mina	mi˥˩ːna
mineralogija	minɛralɔgi˥˩ːja
miniti	mini˥˩ːti
miniti	mini˩˥ːti
minuta	minu˥˩ːta
mir	mi˥˩ːr
mirna	mi˥˩ːrna
mirna	mi˩˥ːrna
mirta	mi˩˥ːrta
misel	mi˥˩ːsəʋ
mišica	mi˥˩ːʃitsa
mišičen	mi˥˩ːʃitʃən
mišjak	mi˥˩ːʃjak
miška	mi˥˩ːʃka
misliti	mi˩˥ːsliti
miš	mi˥˩ʃ
miti	mi˩˥ːti
mitologija	mitɔlɔgi˥˩ːja
mitološki	mitɔlo˥˩ːʃki
miza	mi˩˥ːza
mizantropija	mizantrɔpi˥˩ːja
mjanmar	mjanma˥˩ːr
mladič	mladi˥˩tʃ
mladina	mladi˩˥ːna
mlad	mla˥˩ːt
mladost	mlado˥˩ːst
mlajši	mla˥˩ːjʃi
mlečen	mle˩˥ːtʃən
mleko	mle˩˥ːkɔ
mlesti	mle˩˥ːsti
mleti	mle˩˥ːti
mlin	mli˥˩ːn
moča	mo˩˥ːtʃa
močerad	mɔtʃɛra˥˩t
moči	mo˩˥ːtʃi
moč	mo˥˩ːtʃ
močvirje	mɔtʃʋi˥˩ːrjɛ
moder	mo˩˥ːdər
modernizirati	mɔdɛrnizi˥˩ːrati
modnik	mo˥˩ːdnik
modo	mo˥˩ːdɔ
modo	mo˩˥ːdɔ
modrec	mo˥˩ːdrəts
modrejši	mo˩˥ːdrɛjʃi
modrejši	mɔdrɛ́ːjʃi
modrost	mo˩˥ːdrɔst
modrost	mɔdro˥˩ːst
mogoče	mɔgo˩˥ːtʃɛ
mohamed	mo˩˥ːxamɛt
mohar	mo˩˥ːxar
moj	mo˩˥ːj
mojzes	mo˥˩ːjzɛs
moka	mo˩˥ːka
moker	mo˩˥ːkər
molčati	mɔʋtʃa˩˥ːti
moldavija	mɔlda˩˥ːʋija
molekula	mɔle˥˩ːkula
molibden	mɔlibde˥˩ːn
molitev	mɔli˥˩ːtəʋ
moliti	mɔli˥˩ːti
moliti	mɔli˩˥ːti
molk	mo˥˩ːʋk
molsti	mo˩˥ːʋsti
monako	mɔna˥˩ːkɔ
monarhija	mɔnarxi˥˩ːja
monarh	mɔna˥˩rx
monom	mɔno˥˩ːm
monoteizem	mɔnɔtɛi˩˥ːzəm
morati	mo˥˩ːrati
moravec	mɔra˩˥ːʋəts
morda	mɔrda˥˩
moriti	mɔri˥˩ːti
moriti	mɔri˩˥ːti
morje	mo˥˩ːrjɛ
morje	mɔrje˥˩ː
mornarica	mɔrna˥˩ːritsa
mornarka	mɔrna˩˥ːrka
morski	mo˩˥ːrski
mošeja	mɔʃɛ́ːja
moški	mo˩˥ːʃki
moskva	mo˥˩ːskʋa
most	mo˥˩ːst
mošt	mo˥˩ʃt
motika	mɔti˥˩ːka
motor	mo˥˩ːtɔr
možen	mo˩˥ːʒən
možgani	mɔʒga˥˩ːni
mož	mo˥˩ːʃ
možnar	mo˩˥ːʒnar
možnost	mo˩˥ːʒnɔst
mravlja	mra˥˩ːʋlja
mravlja	mra˩˥ːʋlja
mraz	mra˥˩s
mreti	mre˩˥ːti
mreža	mre˩˥ːʒa
mrhovina	mərxɔʋi˩˥ːna
mrkev	mə˩˥rkəʋ
mrkva	mə˩˥rkʋa
mrož	mro˥˩ːʃ
mrtev	mə˩˥rtəʋ
muditi	mudi˥˩ːti
muditi	mudi˩˥ːti
muflon	muflo˥˩ːn
muha	mu˩˥ːxa
mujezin	mujɛzi˥˩ːn
mula	mu˩˥ːla
mulj	mu˥˩ːl
mungo	mu˥˩ːngɔ
murva	mu˥˩ːrʋa
muskularen	muskula˥˩ːrən
muslimanka	muslima˥˩ːnka
musliman	muslima˥˩ːn
muslimanski	muslima˥˩ːnski
mušnica	mu˥˩ːʃnitsa
muzej	muzɛ́ːj
muzikalen	muzika˥˩ːlən
muzikologija	muzikɔlɔgi˥˩ːja
načelo	natʃɛ́ːlɔ
načelo	natʃɛ̀ːlɔ
načeti	natʃe˩˥ːti
nacizem	natsi˥˩ːzɛm
nacizem	natsi˩˥ːzɛm
načrt	natʃə˥˩rt
nadlegovati	nadlɛgɔʋa˩˥ːti
nad	nat
nadporočnica	natpɔro˥˩ːtʃnitsa
nadporočnik	natpɔro˥˩ːtʃnik
nadzorovati	nadzɔrɔʋa˩˥ːti
naenkrat	naɛ̀ːnkrat
nafta	na˥˩ːfta
nagelj	na˩˥ːgəl
nagel	na˩˥ːgəʋ
naglas	nagla˥˩s
naglejši	na˩˥ːglɛjʃi
nag	na˥˩ːk
najabsurdnejši	na˥˩japsu˥˩ːrdnɛjʃi
najbednejši	na˥˩jbe˩˥ːdnɛjʃi
najbelejši	na˥˩jbɛlɛ́ːjʃi
najbetežnejši	na˥˩jbɛte˩˥ːʒnɛjʃi
najbliže	na˥˩jbli˥˩ːʒɛ
najbližje	na˥˩jbli˥˩ːʒjɛ
najbogatejši	na˥˩jbɔgatɛ́ːjʃi
najbolje	na˥˩jbo˥˩ːljɛ
najbolj	na˥˩jbɔl
najboljše	na˥˩jbo˥˩ːlʃɛ
najboljši	na˥˩jbo˥˩ːlʃi
najbradatejši	na˥˩jbrada˩˥ːtɛjʃi
najbrihtnejši	na˥˩jbri˩˥ːxtnɛjʃi
najbudnejši	na˥˩jbu˩˥ːdnɛjʃi
najdalj	na˥˩jda˥˩l
najdaljši	na˥˩jda˥˩ːlʃi
najdebelejši	na˥˩jdɛbɛlɛ́ːjʃi
najdejavnejši	na˥˩jdɛja˥˩ːʋnɛjʃi
najdejavnejši	na˥˩jdɛja˩˥ːʋnɛjʃi
najdolgočasnejši	na˥˩jdɔlgɔtʃa˩˥ːsnɛjʃi
najdražji	na˥˩jdra˥˩ːʒji
najglasnejši	na˥˩jglasnɛ́ːjʃi
najglušji	na˥˩jglu˥˩ːʃji
najgrji	na˥˩jgə˥˩rji
najgrozljivejši	na˥˩jgrɔzlji˩˥ːʋɛjʃi
najgrši	na˥˩jgə˥˩rʃi
najhitreje	na˥˩jxitrɛ̀ːjɛ
najhitrejše	na˥˩jxitrɛ̀ːjʃɛ
najhujši	na˥˩jxu˥˩ːjʃi
najin	na˥˩ːjin
najjasnejši	na˥˩jja˩˥ːsnɛjʃi
najjasnejši	na˥˩jjasnɛ́ːjʃi
najjeznejši	na˥˩jje˩˥ːznɛjʃi
najkrajši	na˥˩jkra˥˩ːjʃi
najkrutejši	na˥˩jkru˥˩ːtɛjʃi
najkrutejši	na˥˩jkru˩˥ːtɛjʃi
najlažji	na˥˩jla˥˩ːʒji
najlepši	na˥˩jle˥˩ːpʃi
najljubosumnejši	na˥˩jljubɔsu˩˥ːmnɛjʃi
najmanjši	na˥˩jma˥˩ːnʃi
najmečji	na˥˩jme˥˩ːtʃji
najmlajši	na˥˩jmla˥˩ːjʃi
najmodrejši	na˥˩jmo˩˥ːdrɛjʃi
najmodrejši	na˥˩jmɔdrɛ́ːjʃi
najnaglejši	na˥˩jna˩˥ːglɛjʃi
najnaravnejši	na˥˩jnara˩˥ːʋnɛjʃi
najnepotrpežljivejši	na˥˩jnɛ́pɔtərpɛʒlji˩˥ːʋɛjʃi
najneumnejši	na˥˩jnɛu˩˥ːmnɛjʃi
najnevarnejši	na˥˩jnɛʋa˩˥ːrnɛjʃi
najobčutljivejši	na˥˩jɔptʃutlji˩˥ːʋɛjʃi
najočitnejši	na˥˩jɔtʃi˩˥ːtnɛjʃi
najodličnejši	na˥˩jɔdli˩˥ːtʃnɛjʃi
najokusnejši	na˥˩jɔku˩˥ːsnɛjʃi
najosnovnejši	na˥˩jɔsno˥˩ːʋnɛjʃi
najožji	na˥˩jo˥˩ːʒji
najpestrejši	na˥˩jpe˩˥ːstrɛjʃi
najplodnejši	na˥˩jplo˩˥ːdnɛjʃi
najpočasneje	na˥˩jpɔtʃa˩˥ːsnɛjɛ
najpočasneje	na˥˩jpɔtʃasnɛ́ːjɛ
najpodlejši	na˥˩jpo˩˥ːdlɛjʃi
najpodobnejši	na˥˩jpɔdo˩˥ːbnɛjʃi
najpodrobnejši	na˥˩jpɔdro˥˩ːbnɛjʃi
najpogosteje	na˥˩jpɔgo˥˩ːstɛjɛ
najpogostejše	na˥˩jpɔgo˥˩ːstɛjʃɛ
najpogumnejši	na˥˩jpɔgu˩˥ːmnɛjʃi
najpolnejši	na˥˩jpo˩˥ːlnɛjʃi
najpomembnejši	na˥˩jpɔme˥˩ːmbnɛjʃi
najpomembnejši	na˥˩jpɔme˩˥ːmbnɛjʃi
najpotrebnejši	na˥˩jpɔtre˩˥ːbnɛjʃi
najpotrpežljivejši	na˥˩jpɔtərpɛʒlji˩˥ːʋɛjʃi
najpravilneje	na˥˩jpraʋi˥˩ːlnɛjɛ
najpravilnejše	na˥˩jpraʋi˥˩ːlnɛjʃɛ
najpridnejši	na˥˩jpri˩˥ːdnɛjʃi
najprijaznejši	na˥˩jprija˩˥ːznɛjʃi
najpustejši	na˥˩jpu˩˥ːstɛjʃi
najpustejši	na˥˩jpustɛ́ːjʃi
najranejši	na˥˩jra˩˥ːnɛjʃi
najravnejši	na˥˩jra˩˥ːʋnɛjʃi
najrazličnejši	na˥˩jrazli˩˥ːtʃnɛjʃi
najredkejši	na˥˩jre˩˥ːtkɛjʃi
najredkejši	na˥˩jrɛtkɛ́ːjʃi
najresničnejši	na˥˩jrɛsni˥˩ːtʃnɛjʃi
najresničnejši	na˥˩jrɛsni˩˥ːtʃnɛjʃi
najrevnejši	na˥˩jre˩˥ːʋnɛjʃi
najskrivnejši	na˥˩jskri˥˩ːʋnɛjʃi
najskrivnostnejši	na˥˩jskriʋno˥˩ːstnɛjʃi
najskromnejši	na˥˩jskro˩˥ːmnɛjʃi
najslabše	na˥˩jsla˥˩ːpʃɛ
najslabši	na˥˩jsla˥˩ːpʃi
najsladejši	na˥˩jsladɛ́ːjʃi
najslajši	na˥˩jsla˥˩ːjʃi
najsmelejši	na˥˩jsme˩˥ːlɛjʃi
najsodobnejši	na˥˩jsɔdo˩˥ːbnɛjʃi
najsončnejši	na˥˩jso˥˩ːntʃnɛjʃi
najsplošnejši	na˥˩jsplo˩˥ːʃnɛjʃi
najspodobnejši	na˥˩jspɔdo˩˥ːbnɛjʃi
najsrečnejše	na˥˩jsre˩˥ːtʃnɛjʃɛ
najsrečnejše	na˥˩jsrɛtʃnɛ́ːjʃɛ
najsrečnejši	na˥˩jsre˩˥ːtʃnɛjʃi
najsrečnejši	na˥˩jsrɛtʃnɛ́ːjʃi
najstarejši	na˥˩jstarɛ́ːjʃi
najstrastnejši	na˥˩jstra˩˥ːstnɛjʃi
najsvobodnejši	na˥˩jsʋɔbo˩˥ːdnɛjʃi
najtežji	na˥˩jte˥˩ːʒji
najti	na˩˥ːjti
najtrši	na˥˩jtə˥˩rʃi
najusodnejši	na˥˩juso˩˥ːdnɛjʃi
najustreznejši	na˥˩justre˩˥ːznɛjʃi
najvarnejši	na˥˩jʋa˩˥ːrnɛjʃi
največji	na˥˩jʋe˥˩ːtʃji
največ	na˥˩jʋɛtʃ
največ	na˥˩jʋɛ́tʃ
najvišji	na˥˩jʋi˥˩ːʃji
najzanimivejši	na˥˩jzanimi˩˥ːʋɛjʃi
najživahnejši	na˥˩jʒiʋa˩˥ːxnɛjʃi
najznačilnejši	na˥˩jznatʃi˥˩ːlnɛjʃi
najzrelejši	na˥˩jzre˩˥ːlɛjʃi
najzrelejši	na˥˩jzrɛlɛ́ːjʃi
naključje	naklju˥˩ːtʃjɛ
namenilnik	namɛni˥˩ːlnik
namera	name˥˩ːra
namibija	nami˩˥ːbija
namigovati	namigɔʋa˩˥ːti
nanašati	nana˥˩ːʃati
nanositi	nanɔsi˥˩ːti
nanositi	nanɔsi˩˥ːti
napačen	na˥˩ːpatʃən
napačen	napa˥˩ːtʃən
napad	napa˥˩t
napaka	napa˥˩ːka
napisati	napi˩˥ːsati
napisati	napisa˩˥ːti
naprava	napra˥˩ːʋa
naprstnik	napə˥˩rstnik
narava	nara˥˩ːʋa
naraven	nara˩˥ːʋən
naravnejši	nara˩˥ːʋnɛjʃi
naravnost	nara˩˥ːʋnɔst
narečje	nare˥˩ːtʃjɛ
narediti	narɛdi˥˩ːti
narediti	narɛdi˩˥ːti
narkolepsija	narkɔlɛpsi˥˩ːja
narod	na˩˥ːrɔt
naslednji	nasle˥˩ːdnji
nasmeh	nasme˥˩ːx
nasmeh	nasmɛ́x
nasmehniti	nasme˩˥ːxniti
naš	na˥˩ʃ
nastati	nasta˩˥ːti
nastroj	nastro˥˩j
nasvidenje	nasʋi˥˩ːdɛnjɛ
nataša	nata˥˩ːʃa
natrij	na˩˥ːtrij
navada	naʋa˥˩ːda
navdih	naʋdi˥˩ːx
nazaj	naza˩˥ːj
neapelj	nɛa˩˥ːpəl
nebesa	nɛbe˩˥ːsa
nebo	nɛbo˥˩ː
nebotičnik	nɛbɔti˥˩ːtʃnik
nečakinja	nɛtʃa˩˥ːkinja
nečak	nɛtʃa˩˥ːk
nedelja	nɛde˩˥ːlja
nedoločnik	nɛ́dɔlo˥˩ːtʃnik
nedoločnik	nɛ́dɔlo˩˥ːtʃnik
nedovršen	nɛ́dɔʋə˥˩rʃən
neenakost	nɛ́ɛna˥˩ːkɔst
neenakost	nɛ́ɛna˩˥ːkɔst
nehati	ne˥˩ːxati
nehemija	nɛxɛmi˥˩ːja
nekaj	ne˥˩ːkaj
nekaj	ne˩˥ːkaj
nekam	ne˩˥ːkam
nekdo	ne˥˩ːgdɔ
nekdo	nɛgdo˥˩ː
nekdo	nɛgdo˩˥ː
nekje	nɛkje˥˩ː
nekje	nɛkje˩˥ː
nekrofilija	nɛkrɔfili˥˩ːja
nekropola	nɛkro˥˩ːpɔla
nemčija	ne˥˩ːmtʃija
nemec	ne˩˥ːməts
nemka	ne˩˥ːmka
nem	ne˥˩ːm
nemogoč	nɛ́mɔgo˩˥ːtʃ
nemščina	ne˩˥ːmʃtʃina
nemški	ne˩˥ːmʃki
ne	nɛ
ne	nɛ́
neodim	nɛɔdi˥˩ːm
neodvisen	nɛ́ɔdʋi˩˥ːsən
neonacizem	ne˥˩ːɔnatsi˥˩ːzɛm
neonacizem	ne˥˩ːɔnatsi˩˥ːzɛm
neon	ne˥˩ːɔn
neplodnost	nɛ́plo˩˥ːdnɔst
neposreden	nɛ́pɔsre˥˩ːdən
neposredno	nɛ́pɔsre˥˩ːdnɔ
nepotrpežljivejši	nɛ́pɔtərpɛʒlji˩˥ːʋɛjʃi
nepotrpežljiv	nɛ́pɔtərpɛʒlji˥˩ːʋ
nepotrpežljiv	nɛ́pɔtərpɛʒlji˩˥ːʋ
nepredvidljiv	nɛ́prɛdʋidlji˥˩ːʋ
nepredvidljiv	nɛ́prɛdʋidlji˩˥ːʋ
neptunij	nɛptu˩˥ːnij
neptun	nɛptu˥˩ːn
nesti	nɛ̀ːsti
netopir	nɛtɔpi˥˩ːr
netopir	nɛtɔpi˩˥ːr
neumen	nɛu˩˥ːmən
neumnejši	nɛu˩˥ːmnɛjʃi
nevaren	nɛʋa˩˥ːrən
nevarnejši	nɛʋa˩˥ːrnɛjʃi
nevihta	nɛʋi˥˩ːxta
nič	ni˥˩tʃ
nihče	ni˥˩ːxtʃɛ
nihče	nixtʃɛ́
nikamor	nika˥˩ːmɔr
nikelj	ni˩˥ːkəl
nikjer	nikje˥˩ːr
nikolaj	nikɔla˥˩ːj
nikoli	niko˥˩ːli
nindža	ni˥˩ːndʒa
niobij	nijo˩˥ːbij
niša	ni˥˩ːʃa
niša	ni˩˥ːʃa
nisem	ni˩˥ːsɛm
nisi	ni˩˥ːsi
nismo	ni˩˥ːsmɔ
niso	ni˩˥ːsɔ
nista	ni˩˥ːsta
niste	ni˩˥ːstɛ
nisva	ni˩˥ːsʋa
nit	ni˥˩t
nizek	ni˩˥ːzək
nizozemec	nizɔze˥˩ːməts
nizozemka	nizɔze˥˩ːmka
nizozemščina	nizɔze˥˩ːmʃtʃina
nizozemska	nizɔze˥˩ːmska
nizozemski	nizɔze˥˩ːmski
nizozemsko	nizɔze˥˩ːmskɔ
njegov	njɛgo˩˥ːʋ
njegov	njɛgo˥˩ʋ
njen	nje˩˥ːn
njihov	nji˥˩ːxɔʋ
njihov	nji˩˥ːxɔʋ
njun	nju˩˥ːn
nlp	nələpə˥˩
nobelij	nɔbe˩˥ːlij
noč	no˥˩ːtʃ
nocoj	nɔtso˩˥ːj
noga	no˩˥ːga
nogavica	nɔgaʋi˩˥ːtsa
nogomet	nɔgɔmɛ́t
noht	no˥˩ːxt
noj	no˥˩ːj
noj	no˥˩j
nominativ	no˥˩ːminatiʋ
nor	no˥˩r
norveščina	nɔrʋe˥˩ːʃtʃina
norveška	nɔrʋe˥˩ːʃka
norveški	nɔrʋe˥˩ːʃki
norveško	nɔrʋe˥˩ːʃkɔ
norvežanka	nɔrʋɛʒa˥˩ːnka
norvežan	nɔrʋɛʒa˥˩ːn
norvežan	nɔrʋɛʒa˥˩n
nosečnica	nɔse˥˩ːtʃnitsa
nosečnost	nɔse˩˥ːtʃnɔst
nosilec	nɔsi˥˩ːləts
nositi	nɔsi˥˩ːti
nositi	nɔsi˩˥ːti
nos	no˥˩ːs
nosorog	nɔsɔro˥˩ːk
nota	no˥˩ːta
noter	no˥˩ːtɛr
noter	no˩˥ːtɛr
notri	no˥˩ːtri
notri	no˩˥ːtri
novak	nɔʋa˩˥ːk
november	nɔʋɛ̀ːmbər
novina	nɔʋi˩˥ːna
novinec	nɔʋi˥˩ːnəts
nov	no˥˩ʋ
nož	no˥˩ʃ
nuna	nu˩˥ːna
občinstvo	ɔptʃi˥˩ːnstʋɔ
občutljivejši	ɔptʃutlji˩˥ːʋɛjʃi
občutljiv	ɔptʃutlji˥˩ːʋ
občutljiv	ɔptʃutlji˩˥ːʋ
obed	ɔbɛ́t
obesiti	ɔbe˩˥ːsiti
obiskati	ɔbiska˩˥ːti
obiskovati	ɔbiskɔʋa˩˥ːti
objaviti	ɔbja˩˥ːʋiti
objem	ɔbjɛ́m
objeti	ɔbje˩˥ːti
oblak	ɔbla˥˩ːk
oblak	ɔbla˥˩ːk
oblast	ɔbla˥˩ːst
obleka	ɔble˥˩ːka
oblika	ɔbli˥˩ːka
oblikosloven	ɔblikɔslo˥˩ːʋən
oblikoslovje	ɔblikɔslo˥˩ːʋjɛ
obljuba	ɔblju˥˩ːba
obljubiti	ɔblju˥˩ːbiti
obljubiti	ɔblju˩˥ːbiti
obljubiti	ɔbljubi˥˩ːti
obljubiti	ɔbljubi˩˥ːti
obmodek	ɔbmo˥˩ːdək
oboa	o˥˩ːbɔa
obramba	ɔbra˥˩ːmba
obraniti	ɔbrani˥˩ːti
obraniti	ɔbrani˩˥ːti
obrazen	ɔbra˥˩ːzən
obrazilo	ɔbrazi˩˥ːlɔ
obraz	ɔbra˥˩s
obrezovanje	ɔbrɛzɔʋa˩˥ːnjɛ
obrv	ɔbə˥˩rʋ
obsečnica	ɔpse˥˩ːtʃnitsa
obsedenost	ɔpse˥˩ːdɛnɔst
observatorij	ɔpsɛrʋato˥˩ːrij
obuti	ɔbu˩˥ːti
očala	ɔtʃa˥˩ːla
ocean	ɔtsɛa˩˥ːn
oče	o˩˥ːtʃɛ
očim	o˥˩ːtʃim
očim	o˩˥ːtʃim
očiten	ɔtʃi˩˥ːtən
očitnejši	ɔtʃi˩˥ːtnɛjʃi
oddajnik	ɔdda˥˩ːjnik
odeja	ɔdɛ́ːja
odgovoriti	ɔdgɔʋɔri˥˩ːti
odgovoriti	ɔdgɔʋɔri˩˥ːti
odgovor	ɔdgo˥˩ːʋɔr
oditi	ɔdi˩˥ːti
odjaviti	ɔdja˩˥ːʋiti
odličen	ɔdli˩˥ːtʃən
odličnejši	ɔdli˩˥ːtʃnɛjʃi
odločba	ɔdlo˥˩ːdʒba
odnos	ɔdno˥˩s
odpreti	ɔtpre˩˥ːti
odprt	ɔtpə˥˩rt
odrešenik	ɔdrɛʃɛni˩˥ːk
odvetnik	ɔdʋe˥˩ːtnik
odvisen	ɔdʋi˩˥ːsən
odvreti	ɔdʋre˩˥ːti
ogal	ɔga˥˩ːʋ
ogel	o˥˩ːgəʋ
ogel	o˩˥ːgəʋ
ogenj	o˩˥ːgən
oglas	ɔgla˥˩s
ogledalo	ɔglɛda˩˥ːlɔ
oglje	o˥˩ːgljɛ
ogljik	ɔglji˥˩ːk
ognjenik	ɔgnjɛni˩˥ːk
ogor	o˥˩ːgɔr
ogor	ɔgo˥˩ːr
ograja	ɔgra˥˩ːja
ograja	ɔgra˩˥ːja
ogrožati	ɔgro˩˥ːʒati
ogroziti	ɔgrɔzi˥˩ːti
ogroziti	ɔgrɔzi˩˥ːti
ogrska	o˥˩ːgərska
ogrska	o˩˥ːgərska
oje	ɔje˥˩ː
okarina	ɔkari˥˩ːna
oklepaj	ɔklɛpa˥˩ːj
okno	o˩˥ːknɔ
oko	o˥˩ːkɔ
oko	ɔko˥˩ː
okopati	ɔko˩˥ːpati
okopati	ɔkɔpa˩˥ːti
okopavati	ɔkɔpa˥˩ːʋati
okostje	ɔko˥˩ːstjɛ
okrogel	ɔkro˩˥ːgəʋ
oktober	ɔkto˩˥ːbər
okusen	ɔku˥˩ːsən
okusen	ɔku˩˥ːsən
okusnejši	ɔku˩˥ːsnɛjʃi
okus	ɔku˥˩ːs
oligarhija	ɔligarxi˥˩ːja
olje	o˩˥ːljɛ
ol	o˥˩ːl
ol	o˥˩ːʋ
oltar	ɔlta˩˥ːr
omaka	ɔma˥˩ːka
oman	o˥˩ːman
oman	o˥˩ːman
ona	o˩˥ːna
one	o˩˥ːnɛ
oni	o˩˥ːni
ono	o˩˥ːnɔ
ono	ɔno˥˩ː
opatija	ɔpati˥˩ːja
opatinja	ɔpa˥˩ːtinja
opat	ɔpa˥˩ːt
opazovati	ɔpazɔʋa˩˥ːti
opeka	ɔpe˥˩ːka
opeklina	ɔpɛkli˩˥ːna
opereta	ɔpɛre˥˩ːta
opica	o˥˩ːpitsa
opomba	ɔpo˥˩ːmba
oporoka	ɔpɔro˥˩ːka
oprostite	ɔprɔsti˥˩ːtɛ
optičen	o˩˥ːptitʃən
optika	o˩˥ːptika
opuščaj	ɔpuʃtʃa˥˩ːj
orakelj	ɔra˩˥ːkəl
oranža	ɔra˥˩ːnʒa
oranžen	ɔra˥˩ːnʒən
oreh	o˩˥ːrɛx
orel	o˩˥ːrəʋ
organizacija	ɔrganiza˩˥ːtsija
orgazem	ɔrga˩˥ːzəm
orgazmičen	ɔrga˩˥ːzmitʃən
orgiastičen	ɔrgia˩˥ːstitʃən
orgija	o˩˥ːrgija
orgle	o˥˩ːrglɛ
orhideja	ɔrxidɛ́ːja
orjak	ɔrja˩˥ːk
orlič	ɔrli˥˩tʃ
orodje	ɔro˥˩ːdjɛ
orodnik	ɔro˥˩ːdnik
osa	o˩˥ːsa
oseba	ɔse˥˩ːba
oseben	ɔse˥˩ːbən
osebnost	ɔse˥˩ːbnɔst
osel	o˩˥ːsəʋ
osemdeset	o˩˥ːsəmdɛsɛt
osemnajst	o˥˩ːsəmnajst
osemnajst	o˩˥ːsəmnajst
osemnajst	ɔsəmna˩˥ːjst
osem	o˩˥ːsəm
ošiliti	ɔʃi˩˥ːliti
osmij	o˩˥ːsmij
osnoven	ɔsno˥˩ːʋən
osnovnejši	ɔsno˥˩ːʋnɛjʃi
osončje	ɔso˥˩ːntʃjɛ
ostati	ɔsta˩˥ːti
oster	o˩˥ːstər
ost	o˥˩ːst
ostriga	ɔstri˥˩ːga
ostriga	ɔstri˩˥ːga
ostrivec	ɔstri˥˩ːʋəts
otava	ɔta˩˥ːʋa
oteti	ɔte˩˥ːti
otok	o˩˥ːtɔk
otomanski	ɔtɔma˥˩ːnski
otor	ɔto˥˩r
otroče	ɔtrɔtʃɛ́
otročji	ɔtro˩˥ːtʃji
otrok	ɔtro˥˩k
otrpniti	ɔtə˩˥rpniti
otvoriti	ɔtʋo˥˩ːriti
otvoriti	ɔtʋo˩˥ːriti
ovca	o˩˥ːʋtsa
ovčar	ɔʋtʃa˩˥ːr
oven	o˩˥ːʋən
oves	o˩˥ːʋəs
ovratnik	ɔʋra˥˩ːtnik
ozek	o˩˥ːzək
ožemati	ɔʒe˥˩ːmati
ožeti	ɔʒe˩˥ːti
oziroma	ɔzi˥˩ːrɔma
ožji	o˥˩ːʒji
oznaka	ɔzna˥˩ːka
ozvezdje	ɔzʋe˥˩ːzdjɛ
pač	pa˥˩tʃ
padalo	pada˩˥ːlɔ
padati	pa˥˩ːdati
padati	pa˩˥ːdati
padec	pa˥˩ːdəts
paglavec	pa˩˥ːglaʋəts
pahor	pa˩˥ːxɔr
pajek	pa˥˩ːjək
palača	pala˩˥ːtʃa
paladij	pala˩˥ːdij
paladin	paladi˥˩ːn
palčnik	pa˥˩ːʋtʃnik
palec	pa˥˩ːləts
paleolitik	palɛɔli˩˥ːtik
palestina	palɛsti˥˩ːna
palindrom	palindro˥˩ːm
palma	pa˥˩ːlma
pamet	pa˩˥ːmɛt
panj	pa˥˩ːn
pa	pa
papagaj	papaga˥˩ːj
papež	pa˥˩ːpɛʃ
papiga	pa˥˩ːpiga
papir	papi˥˩ːr
paradižnik	paradi˥˩ːʒnik
paradoks	parado˥˩ːks
paranoja	parano˥˩ːja
parfum	parfu˥˩ːm
pariz	pari˥˩ːs
par	pa˩˥ːr
pasti	pa˩˥ːsti
pastir	pasti˩˥ːr
past	pa˥˩ːst
patologija	patɔlɔgi˥˩ːja
patološki	patɔlo˥˩ːʃki
pavel	pa˥˩ːʋəl
pav	pa˥˩ːʋ
pazderje	pazde˥˩ːrjɛ
pazder	pazde˥˩ːr
pazder	pazde˩˥ːr
pazduha	pa˥˩ːzduxa
pečat	pɛtʃa˥˩ːt
peči	pɛ̀ːtʃi
peč	pe˥˩ːtʃ
pedagogika	pɛdago˩˥ːgika
pegatka	pɛga˥˩ːtka
pehati	pe˥˩ːxati
pehati	pəxa˩˥ːti
pekel	pəkə˥˩ʋ
pekel	pə˩˥kəʋ
pek	pe˥˩ːk
pek	pe˩˥ːk
peljati	pɛlja˩˥ːti
pena	pe˩˥ːna
penis	pe˥˩ːnis
pepelka	pɛpe˥˩ːlka
pepel	pɛpe˥˩ːʋ
pereti	pɛre˩˥ːti
peron	pɛro˥˩ːn
pero	pɛro˥˩ː
perutnina	pɛrutni˩˥ːna
perut	pɛru˥˩ːt
perverzija	pɛrʋɛ̀ːrzija
perverzija	pɛrʋɛrzi˥˩ːja
pesek	pe˩˥ːsək
pesem	pe˥˩ːsəm
pesnik	pe˥˩ːsnik
pesništvo	pe˥˩ːsniʃtʋɔ
pes	pə˥˩s
pes	pɛ́s
pester	pe˩˥ːstər
pestič	pɛsti˥˩tʃ
pestrejši	pe˩˥ːstrɛjʃi
peta	pɛ̀ːta
petdeset	pe˥˩ːddɛsɛt
petek	pe˩˥ːtək
petek	pe˩˥ːtɛk
petelin	pɛtɛ̀ːlin
peter	pe˩˥ːtər
peteršilj	pɛtɛrʃi˥˩ːl
peteršilj	pɛtɛrʃi˥˩l
peti	pe˩˥ːti
peti	pɛ̀ːti
petnajst	pe˥˩ːtnajst
petnajst	pɛtna˩˥ːjst
pet	pe˥˩ːt
pet	pɛ́ːt
pevec	pe˩˥ːʋəts
pezdir	pɛzdi˥˩ːr
pezdir	pɛzdi˩˥ːr
phati	pxa˩˥ːti
pianist	pijani˥˩ːst
pica	pi˥˩ːtsa
pica	pi˩˥ːtsa
pihati	pi˩˥ːxati
pijača	pija˩˥ːtʃa
pijavka	pija˥˩ːʋka
pikapolonica	pikapɔlo˥˩ːnitsa
pila	pi˥˩ːla
pila	pi˩˥ːla
pil	pi˥˩ːl
pil	pi˩˥ːl
pil	pi˥˩ːʋ
pingvin	pingʋi˥˩ːn
pintarič	pi˩˥ːntaritʃ
pipa	pi˩˥ːpa
pi	pi˥˩ː
piramida	pirami˥˩ːda
pira	pi˩˥ːra
pisarna	pisa˥˩ːrna
pisatelj	pisa˥˩ːtɛl
pisati	pi˩˥ːsati
pisati	pisa˩˥ːti
piščanec	piʃtʃa˩˥ːnəts
pismo	pi˩˥ːsmɔ
pistacija	pista˩˥ːtsija
pištola	piʃto˥˩ːla
pitagora	pita˩˥ːgɔra
pita	pi˩˥ːta
piti	pi˩˥ːti
piton	pito˥˩ːn
pivo	pi˩˥ːʋɔ
pizda	pi˥˩ːzda
pizda	pi˩˥ːzda
plačati	pla˩˥ːtʃati
plačati	platʃa˩˥ːti
plamenec	plame˥˩ːnəts
plamenec	plame˩˥ːnəts
plamen	pla˩˥ːmɛn
planet	plane˥˩ːt
plašč	pla˩˥ːʃtʃ
platana	plata˥˩ːna
platina	pla˥˩ːtina
platno	pla˩˥ːtnɔ
plavati	pla˥˩ːʋati
plaža	pla˩˥ːʒa
plazilec	plazi˥˩ːlɛts
plaz	pla˥˩ːs
plesati	ple˩˥ːsati
plesati	plɛsa˩˥ːti
plesen	ple˥˩ːsən
ples	ple˥˩ːs
plesti	plɛ̀ːsti
pleti	ple˩˥ːti
pleva	ple˩˥ːʋa
pljuča	plju˩˥ːtʃa
pljučnica	plju˥˩ːtʃnitsa
pločevinka	plɔtʃɛʋi˥˩ːnka
ploden	plo˩˥ːdən
plodnejši	plo˩˥ːdnɛjʃi
plod	plo˥˩ːt
plosk	plo˥˩sk
plug	plu˥˩ːk
plug	plu˥˩k
pluta	plu˩˥ːta
pluti	plu˩˥ːti
plutokracija	plutɔkratsi˥˩ːja
plutonij	pluto˩˥ːnij
pluton	plu˥˩ːtɔn
počasi	pɔtʃa˥˩ːsi
počasneje	pɔtʃa˩˥ːsnɛjɛ
počasneje	pɔtʃasnɛ́ːjɛ
počasno	pɔtʃa˩˥ːsnɔ
poceni	pɔtse˩˥ːni
počitek	pɔtʃi˥˩ːtək
počiti	po˩˥ːtʃiti
počiti	pɔtʃi˩˥ːti
počivati	pɔtʃi˩˥ːʋati
podaljšati	pɔda˥˩ːlʃati
podaljšava	pɔdalʃa˥˩ːʋa
podcelina	po˩˥ttsɛli˩˥ːna
podel	po˩˥ːdəʋ
pode	pɔ̂dɛ
podgana	pɔdga˩˥ːna
podkev	po˩˥ːtkəʋ
podkovati	pɔtkɔʋa˩˥ːti
podla	po˩˥ːdla
podlasica	pɔdla˩˥ːsitsa
podleči	pɔdle˩˥ːtʃi
podlejši	po˩˥ːdlɛjʃi
podmornica	pɔdmo˥˩ːrnitsa
podnebje	pɔdne˥˩ːbjɛ
podoba	pɔdo˥˩ːba
podoben	pɔdo˩˥ːbən
podobnejši	pɔdo˩˥ːbnɛjʃi
podpičje	po˥˩tpi˥˩ːtʃjɛ
pod	po˥˩t
podroben	pɔdro˥˩ːbən
podrobnejši	pɔdro˥˩ːbnɛjʃi
podrobnost	pɔdro˥˩ːbnɔst
pofukan	pɔfu˥˩ːkan
pofukati	pɔfu˥˩ːkati
pogača	pɔga˩˥ːtʃa
pogačar	pɔga˥˩ːtʃar
pogodba	pɔgo˥˩ːdba
pogojnik	pɔgo˥˩ːjnik
pogoj	pɔgo˥˩j
pogoltniti	pɔgo˩˥ːʋtniti
pogosteje	pɔgo˥˩ːstɛjɛ
pogostejše	pɔgo˥˩ːstɛjʃɛ
pogosto	pɔgo˥˩ːstɔ
pogovarjati	pɔgɔʋa˥˩ːrjati
pogovoren	pɔgo˥˩ːʋɔrən
pogovoriti	pɔgɔʋɔri˥˩ːti
pogovoriti	pɔgɔʋɔri˩˥ːti
pogovor	pɔgo˥˩ːʋɔr
pogrešati	pɔgre˩˥ːʃati
pogumen	pɔgu˩˥ːmən
pogumnejši	pɔgu˩˥ːmnɛjʃi
pogum	pɔgu˥˩ːm
pohištvo	pɔxi˥˩ːʃtʋɔ
pohorje	po˥˩ːxɔrjɛ
pojasniti	pɔja˥˩ːsniti
pojasniti	pɔja˩˥ːsniti
pojasniti	pɔjasni˥˩ːti
pojasniti	pɔjasni˩˥ːti
pojutrišnjem	pɔju˥˩ːtriʃnjɛm
pokazati	pɔka˩˥ːzati
pokazati	pɔkaza˩˥ːti
poker	po˩˥ːkər
poklekniti	pɔkle˩˥ːkniti
poklekniti	pɔklɛkni˥˩ːti
poklekniti	pɔklɛkni˩˥ːti
poklicati	pɔkli˩˥ːtsati
poklic	pɔkli˥˩ːts
pokol	pɔko˥˩l
pokopališče	pɔkɔpali˩˥ːʃtʃɛ
pokop	pɔko˥˩p
pokrov	pɔkro˥˩ʋ
polbrat	po˥˩ːʋbra˥˩t
poldan	po˥˩ːʋdan
polenovka	pɔle˩˥ːnɔʋka
poletje	pɔle˥˩ːtjɛ
polglasnik	pɔʋgla˥˩ːsnik
polh	po˥˩ːʋx
polh	po˩˥ːʋx
polica	pɔli˩˥ːtsa
policija	pɔlitsi˥˩ːja
policistka	pɔlitsi˥˩ːstka
policist	pɔlitsi˥˩ːst
politeizem	pɔlitɛi˩˥ːzəm
polizati	pɔli˩˥ːzati
polizati	pɔliza˩˥ːti
poljakinja	pɔlja˩˥ːkinja
poljak	pɔlja˩˥ːk
poljanšek	pɔlja˩˥ːnʃək
poljedelstvo	pɔljɛde˥˩ːlstʋɔ
polje	po˥˩ːljɛ
polje	pɔlje˥˩ː
poljščina	po˥˩ːlʃtʃina
poljska	po˥˩ːlska
poljski	po˥˩ːlski
poljsko	po˥˩ːlskɔ
poljubiti	pɔlju˥˩ːbiti
poljubiti	pɔlju˩˥ːbiti
poljubiti	pɔljubi˥˩ːti
poljubiti	pɔljubi˩˥ːti
poljub	pɔlju˥˩ːp
polkovnica	pɔlko˥˩ːʋnitsa
polkrog	po˥˩ːlkro˥˩ːk
polmer	pɔlme˥˩ːr
polmer	pɔʋme˥˩ːr
polmesec	po˥˩ːlme˥˩ːsɛts
polnejši	po˩˥ːʋnɛjʃi
polnoč	po˥˩ːʋnɔtʃ
poln	po˥˩ːʋn
polonij	pɔlo˩˥ːnij
polotok	po˥˩ːlɔtɔk
polotok	pɔlɔto˥˩k
polovica	pɔlɔʋi˩˥ːtsa
položaj	pɔlɔʒa˥˩ːj
polzeti	pɔʋze˩˥ːti
polž	po˥˩ːʋʃ
polž	po˩˥ːʋʃ
pomagati	pɔma˩˥ːgati
pomagati	pɔmaga˩˥ːti
pomaranča	pɔmara˥˩ːntʃa
pomemben	pɔme˥˩ːmbən
pomemben	pɔme˩˥ːmbən
pomembnejši	pɔme˥˩ːmbnɛjʃi
pomembnejši	pɔme˩˥ːmbnɛjʃi
pomembnost	pɔme˥˩ːmbnɔst
pomembnost	pɔme˩˥ːmbnɔst
pomenoslovje	pɔmɛnɔslo˥˩ːʋjɛ
pomen	pɔmɛ́n
pomenski	pɔme˥˩ːnski
pomlad	pɔmla˥˩ːt
pomniti	po˥˩ːmniti
pomočnik	pɔmɔtʃni˩˥ːk
pomoč	pɔmo˥˩ːtʃ
ponarediti	pɔnarɛdi˥˩ːti
ponarediti	pɔnarɛdi˩˥ːti
ponedeljek	pɔnɛde˥˩ːljək
ponos	pɔno˥˩s
popačenka	pɔpa˥˩ːtʃɛnka
popek	po˥˩ːpək
poper	po˩˥ːpər
poplava	pɔpla˥˩ːʋa
popoldan	pɔpo˥˩ːʋdan
popolnoma	pɔpo˥˩ːʋnɔma
popoln	pɔpo˥˩ːʋn
po	pɔ
porcelan	pɔrtsɛla˥˩ːn
pornografija	pɔrnɔgrafi˥˩ːja
pornograf	pɔrnɔgra˥˩ːf
pornografski	pɔrnɔgra˥˩ːfski
poročen	pɔro˥˩ːtʃən
poročen	pɔrɔtʃɛ́n
poročilo	pɔrɔtʃi˩˥ːlɔ
poročnica	pɔro˥˩ːtʃnitsa
poročnik	pɔro˥˩ːtʃnik
porod	po˩˥ːrɔt
porod	pɔro˥˩t
por	po˥˩ːr
por	po˥˩r
portfelj	pɔrtfe˥˩ːl
portoriko	pɔrtɔri˥˩ːkɔ
portret	pɔrtre˥˩ːt
portugalec	pɔrtuga˥˩ːləts
portugalka	pɔrtuga˥˩ːlka
portugalščina	pɔrtuga˥˩ːlʃtʃina
portugalska	pɔrtuga˥˩ːlska
portugalski	pɔrtuga˥˩ːlski
portugalsko	pɔrtuga˥˩ːlskɔ
posameznik	pɔsa˥˩ːmɛznik
posebej	pɔse˥˩ːbɛj
posel	po˩˥ːsəʋ
poskušati	pɔsku˩˥ːʃati
poskusiti	pɔsku˩˥ːsiti
poslati	pɔsla˩˥ːti
poslušati	pɔslu˩˥ːʃati
poslušati	pɔsluʃa˩˥ːti
posoditi	pɔso˩˥ːditi
posoditi	pɔsɔdi˥˩ːti
posoditi	pɔsɔdi˩˥ːti
posodobiti	pɔsɔdo˥˩ːbiti
posodobiti	pɔsɔdo˩˥ːbiti
pospešek	pɔspe˥˩ːʃək
postaja	pɔsta˥˩ːja
postati	pɔsta˩˥ːti
postelja	po˩˥ːstɛlja
posteljica	po˩˥ːstɛljitsa
post	po˥˩st
postrv	pɔstə˥˩rʋ
potegovati	pɔtɛgɔʋa˩˥ːti
potem	pɔte˥˩ːm
potem	pɔtɛ́m
potok	po˩˥ːtɔk
pot	po˥˩ːt
pot	po˩˥ːt
potreben	pɔtre˩˥ːbən
potrebnejši	pɔtre˩˥ːbnɛjʃi
potrebovati	pɔtrɛbɔʋa˩˥ːti
potres	pɔtrɛ́s
potrpežljivejši	pɔtərpɛʒlji˩˥ːʋɛjʃi
potrpežljivost	pɔtərpɛʒlji˩˥ːʋɔst
potrpežljiv	pɔtərpɛʒlji˥˩ːʋ
potrpežljiv	pɔtərpɛʒlji˩˥ːʋ
poudariti	pɔuda˩˥ːriti
povednik	pɔʋe˥˩ːdnik
povest	pɔʋɛ̀ːst
povratnik	pɔʋra˥˩ːtnik
površina	pɔʋərʃi˩˥ːna
pozabiti	pɔza˩˥ːbiti
pozabiti	pɔzabi˥˩ːti
pozabiti	pɔzabi˩˥ːti
požar	pɔʒa˥˩ːr
pozavna	pɔza˥˩ːʋna
pozdrav	pɔzdra˥˩ʋ
pozen	po˩˥ːzən
požig	pɔʒi˥˩ːk
pozitron	pɔzitro˥˩ːn
poznati	pɔzna˩˥ːti
pozno	po˩˥ːznɔ
pozornost	pɔzo˩˥ːrnɔst
prababica	pra˥˩ːba˩˥ːbitsa
praded	pra˥˩ːde˥˩ːt
praded	pra˥˩ːdɛ́t
praga	pra˩˥ːga
pragermanščina	pra˥˩ːgɛrma˥˩ːnʃtʃina
prah	pra˥˩ːx
prakrt	pra˥˩ːkərt
praporščakinja	prapɔrʃtʃa˩˥ːkinja
praporščak	prapɔrʃtʃa˩˥ːk
praprot	pra˩˥ːprɔt
prašati	pra˩˥ːʃati
prašati	praʃa˩˥ːti
prase	pra˩˥ːsɛ
prase	prasɛ́
prašič	pra˩˥ːʃitʃ
praslovanščina	pra˥˩ːslɔʋa˥˩ːnʃtʃina
praslovanski	pra˥˩ːslɔʋa˥˩ːnski
prašnik	pra˥˩ːʃnik
praštevilo	pra˥˩ːʃtɛʋi˩˥ːlɔ
prati	pra˩˥ːti
pravica	praʋi˩˥ːtsa
pravičen	praʋi˥˩ːtʃən
pravičen	praʋi˩˥ːtʃən
pravičnost	praʋi˥˩ːtʃnɔst
pravičnost	praʋi˩˥ːtʃnɔst
pravilen	praʋi˥˩ːlən
pravilneje	praʋi˥˩ːlnɛjɛ
pravilnejše	praʋi˥˩ːlnɛjʃɛ
pravilno	praʋi˥˩ːlnɔ
pravkar	pra˥˩ʋkar
pravljica	pra˥˩ːʋljitsa
pravopis	praʋɔpi˥˩ːs
pravo	pra˥˩ːʋɔ
prazen	pra˩˥ːzən
prazeodim	prazɛɔdi˥˩ːm
pražiti	pra˩˥ːʒiti
prazniti	pra˩˥ːzniti
prazniti	prazni˥˩ːti
prazniti	prazni˩˥ːti
prebava	prɛba˥˩ːʋa
prebiti	prɛbi˩˥ːti
prebivalec	prɛbiʋa˥˩ːləts
predal	prɛda˥˩ːl
predhodnik	prɛdxo˥˩ːdnik
predlagati	prɛdla˥˩ːgati
predlog	prɛ̀ːdlɔk
predmet	prɛ̀ːdmɛt
prednik	pre˥˩ːdnik
predpona	prɛtpo˥˩ːna
predpreteklik	prɛ́tprɛtɛ̀ːklik
pred	prɛt
predsednik	prɛtse˥˩ːdnik
predvideti	prɛdʋi˩˥ːdɛti
predvidljivost	prɛdʋidlji˩˥ːʋɔst
predvidljiv	prɛdʋidlji˥˩ːʋ
predvidljiv	prɛdʋidlji˩˥ːʋ
prehlad	prɛxla˥˩t
preja	prɛ́ːja
preja	prɛ̀ːja
preklet	prɛkle˥˩ːt
prekletstvo	prɛkle˥˩ːtstʋɔ
premena	prɛme˥˩ːna
premeniti	prɛmɛni˥˩ːti
premeniti	prɛmɛni˩˥ːti
premirje	prɛmi˥˩ːrjɛ
premog	prɛ̀ːmo˩˥ːk
preobrat	prɛɔbra˩˥t
prepelica	prɛpɛli˩˥ːtsa
preproga	prɛpro˥˩ːga
preproga	prɛpro˩˥ːga
prepucij	prɛpu˩˥ːtsij
prepustnica	prɛpu˥˩ːstnitsa
presenečenje	prɛsɛne˥˩ːtʃɛnjɛ
presenetiti	prɛsɛne˥˩ːtiti
presenetiti	prɛsɛne˩˥ːtiti
presredek	prɛsre˥˩ːdək
prestar	prɛsta˥˩r
presti	pre˩˥ːsti
presti	prɛ̀ːsti
prestolnica	prɛsto˥˩ːlnitsa
prestol	prɛ̀ːstɔl
preteklik	prɛtɛ̀ːklik
prevajalec	prɛʋaja˥˩ːləts
prevesti	prɛʋe˩˥ːsti
prevesti	prɛʋɛ̀ːsti
prevodnik	prɛʋo˥˩ːdnik
prevod	prɛ̀ːʋɔt
prevod	prɛʋo˥˩t
preživeti	prɛʒiʋe˩˥ːti
prga	pə˩˥rga
prha	pə˩˥rxa
pričakovati	pritʃakɔʋa˩˥ːti
priča	pri˩˥ːtʃa
priden	pri˩˥ːdən
pridevnik	pride˥˩ːʋnik
pridevniški	pride˥˩ːʋniʃki
pridnejši	pri˩˥ːdnɛjʃi
prihajati	prixa˥˩ːjati
prihodnjik	prixo˥˩ːdnjik
prihodnji	prixo˥˩ːdnji
prihodnost	prixo˥˩ːdnɔst
priimek	prii˥˩ːmək
prijateljica	prija˥˩ːtɛljitsa
prijatelj	prija˥˩ːtɛl
prijateljski	prija˥˩ːtɛlski
prijateljstvo	prija˥˩ːtɛlstʋɔ
prijaviti	prija˩˥ːʋiti
prijazen	prija˩˥ːzən
prijaznejši	prija˩˥ːznɛjʃi
prijeten	prije˩˥ːtən
priložnost	prilo˩˥ːʒnɔst
primer	prime˥˩ːr
primež	pri˥˩ːmɛʃ
primež	pri˩˥ːmɛʃ
princesa	printse˥˩ːsa
princ	pri˥˩ːnts
pripeti	pripe˩˥ːti
pripona	pripo˥˩ːna
priponski	pripo˥˩ːnski
pri	pri
prisega	prise˥˩ːga
prislov	prislo˥˩ʋ
prisotnost	priso˩˥ːtnɔst
prispevek	prispe˥˩ːʋək
pristanišče	pristani˩˥ːʃtʃɛ
pristati	prista˩˥ːti
priti	pri˩˥ːti
pritisk	priti˥˩ːsk
pritok	prito˩˥ːk
pritok	prito˥˩k
priznati	prizna˩˥ːti
priznavati	prizna˥˩ːʋati
prižnica	pri˥˩ːʒnitsa
prižnica	pri˩˥ːʒnitsa
profesor	prɔfe˥˩ːsɔr
proga	pro˩˥ːga
programje	prɔgra˥˩ːmjɛ
programski	prɔgra˥˩ːmski
prometij	prɔme˩˥ːtij
prosim	pro˩˥ːsim
prositi	prɔsi˥˩ːti
prositi	prɔsi˩˥ːti
prostata	pro˥˩ːstata
prostitucija	prɔstitu˩˥ːtsija
prostornina	prɔstɔrni˩˥ːna
prostor	pro˩˥ːstɔr
prostorski	prɔsto˥˩ːrski
prostorski	prɔsto˩˥ːrski
prost	pro˥˩st
protaktinij	prɔtakti˩˥ːnij
protipomenka	pro˥˩ːtipɔme˥˩ːnka
prstanec	pə˩˥rstanəts
prstan	pə˩˥rstan
prst	pə˥˩rst
prtljaga	pərtlja˥˩ːga
prt	pə˥˩rt
prvak	pərʋa˩˥ːk
prvi	pə˥˩rʋi
prvoten	pərʋo˩˥ːtən
psalmi	psa˥˩ːlmi
pšenica	pʃɛni˩˥ːtsa
psica	psi˩˥ːtsa
ptica	pti˩˥ːtsa
ptič	pti˥˩tʃ
puhati	pu˥˩ːxati
puhati	pu˩˥ːxati
pulzar	pu˥˩ːlzar
puma	pu˩˥ːma
punt	pu˥˩nt
puran	pura˥˩ːn
puščati	pu˩˥ːʃtʃati
puščava	puʃtʃa˥˩ːʋa
puška	pu˥˩ːʃka
pustejši	pu˩˥ːstɛjʃi
pustejši	pustɛ́ːjʃi
pustinja	pusti˩˥ːnja
pustiti	pusti˥˩ːti
pustiti	pusti˩˥ːti
pust	pu˥˩ːst
raba	ra˩˥ːba
rabarbara	raba˩˥ːrbara
rabiti	ra˩˥ːbiti
rabiti	rabi˥˩ːti
rabiti	rabi˩˥ːti
raca	ra˩˥ːtsa
računalnik	ratʃuna˥˩ːlnik
radar	ra˥˩ːdar
radar	ra˩˥ːdar
radij	ra˥˩ːdij
radij	ra˩˥ːdij
radirka	radi˥˩ːrka
radon	ra˥˩ːdɔn
radon	rado˥˩ːn
radost	ra˩˥ːdɔst
radost	rado˥˩ːst
radoveden	radɔʋe˩˥ːdən
radovednost	radɔʋe˩˥ːdnɔst
rad	ra˥˩ːt
rad	ra˥˩t
rakun	raku˥˩ːn
ralo	ra˩˥ːlɔ
rama	ra˩˥ːma
ramovš	ramo˥˩ːʋʃ
rana	ra˩˥ːna
ranejši	ra˩˥ːnɛjʃi
ran	ra˥˩ːn
rasa	ra˩˥ːsa
rasti	ra˩˥ːsti
rastlina	rastli˩˥ːna
rastlinojedec	rastlinɔje˥˩ːdəts
rast	ra˥˩ːst
raven	ra˩˥ːʋən
ravnejši	ra˩˥ːʋnɛjʃi
ravnik	ra˥˩ːʋnik
ravnost	ra˩˥ːʋnɔst
ravnotežje	raʋnɔte˥˩ːʒjɛ
razglednica	razgle˥˩ːdnitsa
razgovor	razgo˥˩ːʋɔr
različen	razli˩˥ːtʃən
različnejši	razli˩˥ːtʃnɛjʃi
razlika	razli˥˩ːka
razpelo	raspe˩˥ːlɔ
razpelo	raspɛ̀ːlɔ
razred	ra˩˥ːzrɛt
raztresenost	rastre˥˩ːsɛnɔst
razumeti	razume˩˥ːti
razvoj	razʋo˥˩j
rdeč	ərdɛ́tʃ
rebro	rɛ̀ːbrɔ
recikliranje	rɛtsikli˥˩ːranjɛ
reči	rɛ̀ːtʃi
reč	re˥˩ːtʃ
redar	rɛda˩˥ːr
redek	re˩˥ːdək
redkejši	re˩˥ːtkɛjʃi
redkejši	rɛtkɛ́ːjʃi
redkev	rɛ̀ːtkəʋ
redko	re˩˥ːtkɔ
red	re˥˩ːt
regrat	re˩˥ːgrat
reja	rɛ̀ːja
rejec	rɛ́ːjəts
reka	re˩˥ːka
rek	re˥˩ːk
rek	rɛ́k
rektalen	rɛkta˥˩ːlən
relativnost	re˥˩ːlatiʋnɔst
relativnost	rɛlati˥˩ːʋnɔst
religija	rɛli˩˥ːgija
relikvija	rɛli˩˥ːkʋija
renesansa	rɛnɛsa˥˩ːnsa
renij	re˩˥ːnij
repatica	rɛpati˩˥ːtsa
rep	re˥˩ːp
rep	rɛ́p
republika	rɛpu˩˥ːblika
rešeto	rɛʃɛ̀ːtɔ
reši	re˩˥ːʃi
rešitev	rɛʃi˥˩ːtəʋ
rešiti	re˩˥ːʃiti
rešiti	rɛʃi˥˩ːti
rešiti	rɛʃi˩˥ːti
resnica	rɛsni˩˥ːtsa
resničen	rɛsni˥˩ːtʃən
resničen	rɛsni˩˥ːtʃən
resničnejši	rɛsni˥˩ːtʃnɛjʃi
resničnejši	rɛsni˩˥ːtʃnɛjʃi
resnik	re˥˩ːsnik
restavracija	rɛstaʋra˩˥ːtsija
reven	re˩˥ːʋən
revija	rɛʋi˥˩ːja
revnejši	re˩˥ːʋnɛjʃi
revolucija	rɛʋɔlu˩˥ːtsija
rezati	re˩˥ːzati
rezilo	rɛzi˩˥ːlɔ
rezultat	rɛzulta˥˩ːt
riba	ri˩˥ːba
ribariti	riba˩˥ːriti
ribi	ri˩˥ːbi
rigler	ri˩˥ːglɛr
rijavec	ri˩˥ːjaʋəts
rilec	ri˥˩ːləts
rima	ri˥˩ːma
rima	ri˩˥ːma
rim	ri˩˥ːm
risati	ri˥˩ːsati
risba	ri˥˩ːzba
ris	ri˥˩ːs
riti	ri˩˥ːti
rit	ri˥˩t
riž	ri˥˩ːʃ
rjavec	ərja˥˩ːʋəts
rjav	ərja˥˩ʋ
rjuha	ərju˩˥ːxa
rjuti	ərju˩˥ːti
robida	rɔbi˩˥ːda
robidnica	rɔbi˥˩ːdnitsa
robot	rɔbo˥˩ːt
rob	ro˥˩ːp
rodij	ro˩˥ːdij
rodilnik	rɔdi˥˩ːlnik
roditi	rɔdi˥˩ːti
roditi	rɔdi˩˥ːti
rog	ro˥˩ːk
rojen	ro˩˥ːjɛn
rojstvo	ro˩˥ːjstʋɔ
roka	ro˩˥ːka
rokavica	rɔkaʋi˩˥ːtsa
rokav	rɔka˩˥ːʋ
rokomet	rɔkɔmɛ́t
roman	rɔma˥˩ːn
romb	ro˥˩ːmp
romunija	rɔmu˩˥ːnija
romunka	rɔmu˥˩ːnka
romun	rɔmu˥˩ːn
romunščina	rɔmu˥˩ːnʃtʃina
romunski	rɔmu˥˩ːnski
romunsko	rɔmu˥˩ːnskɔ
ropar	ro˥˩ːpar
rosa	ro˩˥ːsa
rosomah	rɔsɔma˥˩ːx
rotovž	ro˥˩ːtɔʋʃ
rovka	ro˥˩ːʋka
roža	ro˥˩ːʒa
roževina	rɔʒɛʋi˩˥ːna
rozman	ro˥˩ːzman
rožmarin	ro˥˩ːʒmarin
rožmarin	rɔʒmari˥˩ːn
rubidij	rubi˩˥ːdij
rudar	ruda˩˥ːr
ruda	ru˩˥ːda
rudnik	ru˥˩ːdnik
rumenjak	rumɛnja˩˥ːk
rumen	rumɛ́n
runo	ru˥˩ːnɔ
runo	ru˩˥ːnɔ
ruščina	ru˥˩ːʃtʃina
rusija	ru˥˩ːsija
rusinja	ru˥˩ːsinja
ruski	ru˥˩ːski
rusko	ru˥˩ːskɔ
rus	ru˥˩ːs
rutenij	rute˩˥ːnij
ruti	ru˩˥ːti
ruvati	ru˥˩ːʋati
ruvati	ru˩˥ːʋati
ruvati	ruʋa˩˥ːti
rvati	ərʋa˩˥ːti
rž	ə˥˩rʃ
sablja	sa˥˩ːblja
sabotaža	sabɔta˥˩ːʒa
sadež	sa˥˩ːdɛʃ
sadje	sa˩˥ːdjɛ
sadovnjak	sadɔʋnja˩˥ːk
sad	sa˥˩ːt
šahovnica	ʃaxo˥˩ːʋnitsa
šah	ʃa˥˩ːx
šakal	ʃaka˥˩ːl
saksofon	saksɔfo˥˩ːn
šal	ʃa˥˩ːl
samarij	sama˩˥ːrij
samec	sa˩˥ːməts
samoglasnik	samɔgla˥˩ːsnik
samomnožinski	samo˥˩ːmnɔʒi˥˩ːnski
samomor	samɔmo˥˩r
samorog	samɔro˥˩ːk
samostalnik	samɔsta˥˩ːlnik
samostalniški	samɔsta˥˩ːlniʃki
samostan	samɔsta˥˩ːn
samota	samo˩˥ːta
samozadovoljevanje	sa˥˩ːmɔzadɔʋɔljɛʋa˩˥ːnjɛ
samozadovoljevati	sa˥˩ːmɔzadɔʋɔljɛʋa˩˥ːti
sam	sa˥˩ːm
samum	samu˥˩ːm
sanjati	sa˩˥ːnjati
sanje	sa˩˥ːnjɛ
šank	ʃa˥˩ːnk
sanskrt	sanskə˥˩rt
šantati	ʃanta˩˥ːti
sapnik	sa˥˩ːpnik
sardinija	sardi˩˥ːnija
šarenica	ʃa˥˩ːrɛnitsa
šarenica	ʃarɛni˩˥ːtsa
satelit	satɛli˥˩ːt
saturn	satu˩˥ːrn
ščavje	ʃtʃa˥˩ːʋjɛ
ščavje	ʃtʃa˩˥ːʋjɛ
ščegetavček	ʃtʃɛgɛta˥˩ːʋtʃək
scenarij	stsɛna˩˥ːrij
ščet	ʃtʃe˥˩ːt
ščinkavec	ʃtʃi˩˥ːnkaʋəts
ščirec	ʃtʃi˥˩ːrəts
ščir	ʃtʃi˥˩ːr
ščit	ʃtʃi˥˩ːt
ščuka	ʃtʃu˩˥ːka
ščurek	ʃtʃu˩˥ːrək
seči	se˩˥ːtʃi
sečnica	se˥˩ːtʃnitsa
sečničen	se˥˩ːtʃnitʃən
seč	se˥˩ːtʃ
sedanjik	səda˥˩ːnjik
sedanjik	səda˩˥ːnjik
sedanjik	sɛda˥˩ːnjik
sedanjik	sɛda˩˥ːnjik
sedemdeset	se˩˥ːdəmdɛsɛt
sedemnajst	se˥˩ːdəmnajst
sedemnajst	se˩˥ːdəmnajst
sedemnajst	sɛdəmna˩˥ːjst
sedem	se˩˥ːdəm
sedeti	sɛde˩˥ːti
sedlo	sɛ̀ːdlɔ
sef	se˥˩ːf
sejati	sɛja˩˥ːti
sejšeli	sɛjʃe˥˩ːli
sekalec	sɛka˥˩ːləts
sekira	sɛki˩˥ːra
seksati	se˥˩ːksati
seksologija	sɛksɔlɔgi˩˥ːja
seks	se˥˩ːks
seksualen	sɛksua˥˩ːlən
seksualnost	sɛksua˥˩ːlnɔst
sekunda	sɛku˥˩ːnda
selen	sɛle˥˩ːn
sel	sə˥˩l
sel	sə˥˩ʋ
semenovod	sɛmɛnɔʋo˥˩t
semenski	se˩˥ːmɛnski
semenski	sɛme˥˩ːnski
seme	se˩˥ːmɛ
sem	sə˥˩m
sena	se˥˩ːna
senca	se˥˩ːntsa
sendvič	se˥˩ːndʋitʃ
seno	sɛno˥˩ː
senožet	sɛno˩˥ːʒɛt
senožet	sɛnɔʒe˥˩ːt
september	sɛptɛ̀ːmbər
sesalec	səsa˥˩ːləts
sesalec	sɛsa˥˩ːləts
sesati	səsa˩˥ːti
sesati	sɛsa˩˥ːti
se	sɛ
šestdeset	ʃe˥˩ːzddɛsɛt
sesti	se˩˥ːsti
šesti	ʃɛ̀ːsti
šestnajst	ʃe˥˩ːstnajst
šestnajst	ʃɛstna˩˥ːjst
sestra	sɛ̀ːstra
sestrična	sɛstri˥˩ːtʃna
šest	ʃe˥˩ːst
še	ʃɛ
še	ʃɛ́
seveda	sɛʋe˥˩ːda
severen	se˩˥ːʋɛrən
severnejši	se˩˥ːʋɛrnɛjʃi
sever	se˩˥ːʋɛr
seznam	səzna˥˩ːm
seznam	səzna˥˩m
seznam	sɛzna˥˩ːm
seznam	sɛzna˥˩m
sezuti	səzu˩˥ːti
sezuti	sɛzu˩˥ːti
shizofrenija	sxizɔfrɛni˥˩ːja
sibirija	sibi˩˥ːrija
sicilija	sitsi˩˥ːlija
sidro	si˥˩ːdrɔ
sidro	si˩˥ːdrɔ
sila	si˩˥ːla
šilček	ʃi˥˩ːltʃək
silicij	sili˩˥ːtsij
šiliti	ʃi˩˥ːliti
simboličen	simbo˩˥ːlitʃən
simbol	simbo˥˩ːl
simetrija	simɛtri˥˩ːja
šimpanz	ʃimpa˥˩ːns
sinagoga	sinago˩˥ːga
sinhrono	sinxro˥˩ːnɔ
sinhron	sinxro˥˩ːn
sinica	sini˩˥ːtsa
sinoči	sino˥˩ːtʃi
sinonim	sinɔni˥˩ːm
sin	si˥˩ːn
sirija	si˩˥ːrija
sirilo	siri˩˥ːlɔ
siriščnik	siri˥˩ːʃtʃnik
siriti	si˩˥ːriti
širok	ʃiro˥˩k
sirota	siro˥˩ːta
sirotka	si˩˥ːrɔtka
sir	si˥˩r
si	si
si	si˥˩
sistem	siste˥˩ːm
šiti	ʃi˩˥ːti
sit	si˥˩t
siv	si˥˩ːʋ
skakač	skaka˩˥ːtʃ
skala	ska˩˥ːla
skandij	ska˩˥ːndij
škarje	ʃka˥˩ːrjɛ
škatla	ʃka˥˩ːtla
skepticizem	skɛptitsi˥˩ːzɛm
skepticizem	skɛptitsi˩˥ːzɛm
skladnja	skla˩˥ːdnja
sklanjatev	sklanja˥˩ːtəʋ
skleda	skle˩˥ːda
sklon	sklo˥˩n
skočiti	skɔtʃi˥˩ːti
skočiti	skɔtʃi˩˥ːti
skodelica	skɔde˥˩ːlitsa
škofija	ʃkɔfi˥˩ːja
škof	ʃko˥˩f
skoraj	sko˥˩ːraj
skoraj	sko˩˥ːraj
skorbut	skɔrbu˥˩ːt
škorec	ʃko˩˥ːrəts
škorenj	ʃko˥˩ːrən
škorjanec	ʃkɔrja˩˥ːnəts
skorja	sko˥˩ːrja
skorja	sko˩˥ːrja
škorpijon	ʃkɔrpijo˥˩ːn
škotska	ʃko˥˩ːtska
škripec	ʃkri˥˩ːpəts
škripec	ʃkri˩˥ːpəts
skriti	skri˩˥ːti
skrivati	skri˩˥ːʋati
skriven	skri˥˩ːʋən
skrivnejši	skri˥˩ːʋnɛjʃi
skrivnosten	skriʋno˥˩ːstən
skrivnostnejši	skriʋno˥˩ːstnɛjʃi
skrivnost	skriʋno˥˩ːst
škrjanček	ʃkərja˩˥ːntʃɛk
škrjanec	ʃkərja˩˥ːnəts
škrjanec	ʃkərja˩˥ːnəts
škrjanka	ʃkərja˩˥ːnka
škrlec	ʃkə˥˩rləts
skromen	skro˩˥ːmən
skromnejši	skro˩˥ːmnɛjʃi
skrotum	skro˥˩ːtum
škržat	ʃkərʒa˥˩ːt
skupaj	sku˥˩ːpaj
skupina	skupi˩˥ːna
skupnost	sku˥˩ːpnɔst
skupnost	sku˩˥ːpnɔst
skuša	sku˩˥ːʃa
skusiti	sku˩˥ːsiti
škvorjanec	ʃkʋɔrja˩˥ːnəts
slabo	slabo˥˩ː
slabše	sla˥˩ːpʃɛ
slabši	sla˥˩ːpʃi
slab	sla˥˩p
sladejši	sladɛ́ːjʃi
sladek	sla˩˥ːdək
sladkarija	slatkari˩˥ːja
sladkor	sla˩˥ːtkɔr
sladoled	sladɔle˥˩ːt
slad	sla˥˩ːt
slajši	sla˥˩ːjʃi
slamica	sla˩˥ːmitsa
slanina	slani˩˥ːna
slan	sla˥˩ːn
slap	sla˥˩ːp
slaščičarna	slaʃtʃitʃa˥˩ːrna
slaščica	slaʃtʃi˩˥ːtsa
slava	sla˩˥ːʋa
slavec	sla˩˥ːʋəts
slaven	sla˩˥ːʋən
sleči	sle˩˥ːtʃi
slediti	slɛdi˥˩ːti
slediti	slɛdi˩˥ːti
slep	sle˥˩ːp
slezenovec	slɛze˥˩ːnɔʋəts
slikar	slika˩˥ːr
slika	sli˥˩ːka
slikati	sli˥˩ːkati
slina	sli˩˥ːna
slišati	sli˩˥ːʃati
sliva	sli˩˥ːʋa
slivovka	sli˩˥ːʋɔʋka
sljuda	slju˩˥ːda
sloka	slo˥˩ːka
sloka	slo˩˥ːka
slonica	slo˩˥ːnitsa
slonica	slɔni˩˥ːtsa
slonovina	slɔnɔʋi˩˥ːna
slon	slo˥˩n
slop	slo˥˩p
slovakinja	slɔʋa˩˥ːkinja
slovak	slɔʋa˩˥ːk
slovanka	slɔʋa˥˩ːnka
slovanski	slɔʋa˥˩ːnski
slovan	slɔʋa˥˩ːn
slovar	slɔʋa˩˥ːr
slovaščina	slɔʋa˥˩ːʃtʃina
slovaška	slɔʋa˥˩ːʃka
slovaški	slɔʋa˥˩ːʃki
slovaško	slɔʋa˥˩ːʃkɔ
slovenec	slɔʋe˩˥ːnəts
slovenija	slɔʋe˩˥ːnija
slovenka	slɔʋe˩˥ːnka
slovenščina	slɔʋe˩˥ːnʃtʃina
slovenski	slɔʋe˩˥ːnski
slovensko	slɔʋe˩˥ːnskɔ
sloveti	slɔʋe˩˥ːti
slovi	slo˩˥ːʋi
slovi	slɔʋi˩˥ː
slovnica	slo˥˩ːʋnitsa
slovničen	slo˥˩ːʋnitʃən
slovo	slɔʋo˥˩ː
slušati	slu˩˥ːʃati
sluti	slu˩˥ːti
služba	slu˥˩ːʒba
smeh	sme˥˩ːx
smejati	smɛja˩˥ːti
smelejši	sme˩˥ːlɛjʃi
smel	sme˥˩ːʋ
smer	sme˥˩ːr
smetana	sme˩˥ːtana
smeti	sme˩˥ːti
smet	sme˥˩ːt
smisel	smi˥˩ːsəʋ
smodnik	smɔdni˩˥ːk
smola	smo˩˥ːla
smo	smo˥˩
smreka	smre˩˥ːka
smrtonosen	smərtɔno˩˥ːsən
smrt	smə˥˩rt
smučati	smu˥˩ːtʃati
snaha	sna˩˥ːxa
sneg	sne˥˩ːk
sneguljčica	snɛgu˥˩ːltʃitsa
sneti	sne˩˥ːti
snežak	snɛʒa˩˥ːk
snežinka	snɛʒi˥˩ːnka
snežiti	snɛʒi˥˩ːti
snežiti	snɛʒi˩˥ːti
snovati	snɔʋa˩˥ːti
snuti	snu˩˥ːti
soavtor	so˥˩a˥˩ːʋtɔr
soavtor	so˥˩a˩˥ːʋtɔr
sobana	sɔba˩˥ːna
soba	so˩˥ːba
sobota	sɔbo˩˥ːta
soča	so˩˥ːtʃa
socializem	sɔtsijali˩˥ːzəm
socvetje	sɔtsʋe˥˩ːtjɛ
sodnik	sɔdni˩˥ːk
sodoben	sɔdo˩˥ːbən
sodobnejši	sɔdo˩˥ːbnɛjʃi
sod	so˥˩ːt
soglasnik	sɔgla˥˩ːsnik
šoja	ʃo˩˥ːja
soj	so˩˥j
sokol	so˩˥ːkɔl
sokrat	so˥˩ːkrat
sok	so˥˩ːk
solaren	sɔla˥˩ːrən
šola	ʃo˥˩ːla
sol	so˥˩ːʋ
solza	so˩˥ːʋza
sonatina	sɔnati˥˩ːna
sončen	so˥˩ːntʃən
sonce	so˥˩ːntsɛ
sončnejši	so˥˩ːntʃnɛjʃi
sončnica	so˥˩ːntʃnitsa
sončnik	so˥˩ːntʃnik
sonet	sɔne˥˩ːt
sopomenka	so˥˩pɔme˥˩ːnka
sopotnica	sɔpo˥˩ːtnitsa
sopotnik	sɔpo˥˩ːtnik
sopotništvo	sɔpo˥˩ːtniʃtʋɔ
soprog	sɔpro˥˩ːk
sorojenec	so˥˩rɔjɛ̀ːnəts
sosed	so˩˥ːsɛt
sosed	so˩˥ːsɛt
so	so˥˩
sova	so˩˥ːʋa
sovraštvo	sɔʋra˥˩ːʃtʋɔ
sovražiti	sɔʋra˥˩ːʒiti
sovražiti	sɔʋra˩˥ːʒiti
sovražiti	sɔʋraʒi˥˩ːti
sovražiti	sɔʋraʒi˩˥ːti
sovražnik	sɔʋra˥˩ːʒnik
spalnica	spa˥˩ːlnitsa
spam	spɛ́ːm
španec	ʃpa˥˩ːnəts
španija	ʃpa˩˥ːnija
španka	ʃpa˥˩ːnka
španščina	ʃpa˥˩ːnʃtʃina
španski	ʃpa˥˩ːnski
špansko	ʃpa˥˩ːnskɔ
spati	spa˩˥ːti
špela	ʃpe˩˥ːla
spem	spɛ́ːm
sperma	spɛ́ːrma
speti	spe˩˥ːti
spet	spe˥˩ːt
špinača	ʃpina˩˥ːtʃa
špirit	ʃpi˥˩ːrit
sploh	splo˥˩x
splošen	splo˩˥ːʃən
splošnejši	splo˩˥ːʃnɛjʃi
spodaj	spo˩˥ːdaj
spodoben	spɔdo˩˥ːbən
spodobnejši	spɔdo˩˥ːbnɛjʃi
spogledovati	spɔglɛdɔʋa˩˥ːti
spojina	spɔji˩˥ːna
spolovilo	spɔlɔʋi˩˥ːlɔ
spol	spo˥˩l
spominčica	spɔmi˥˩ːntʃitsa
spominjati	spɔmi˩˥ːnjati
spomin	spɔmi˥˩ːn
spomniti	spo˥˩ːmniti
sporočilo	spɔrɔtʃi˩˥ːlɔ
sposoditi	spɔso˩˥ːditi
sposoditi	spɔsɔdi˥˩ːti
sposoditi	spɔsɔdi˩˥ːti
spoznati	spɔzna˩˥ːti
spregatev	sprɛga˥˩ːtəʋ
sprememba	sprɛme˥˩ːmba
spremeniti	sprɛmɛni˥˩ːti
spremeniti	sprɛmɛni˩˥ːti
spretnost	spre˩˥ːtnɔst
sprevodnik	sprɛʋo˥˩ːdnik
spustiti	spusti˥˩ːti
spustiti	spusti˩˥ːti
srajca	sra˩˥ːjtsa
sraka	sra˩˥ːka
sranje	sra˥˩ːnjɛ
sranje	sra˩˥ːnjɛ
srati	sra˩˥ːti
srbija	sə˥˩rbija
srbkinja	sə˥˩rpkinja
srbohrvaščina	sərbɔxərʋa˥˩ːʃtʃina
srbohrvaški	sərbɔxərʋa˥˩ːʃki
srbščina	sə˥˩rpʃtʃina
srb	sə˥˩rp
srbski	sə˥˩rpski
srce	sərtse˥˩ː
srebrnina	srɛbərni˩˥ːna
srebrn	srɛbə˥˩rn
srebro	srɛbro˥˩ː
srečanje	sre˥˩ːtʃanjɛ
sreča	sre˩˥ːtʃa
srečati	sre˥˩ːtʃati
srečen	sre˩˥ːtʃən
srečneje	sre˩˥ːtʃnɛjɛ
srečneje	srɛtʃnɛ́ːjɛ
srečnejše	sre˩˥ːtʃnɛjʃɛ
srečnejše	srɛtʃnɛ́ːjʃɛ
srečnejši	sre˩˥ːtʃnɛjʃi
srečnejši	srɛtʃnɛ́ːjʃi
srečno	sre˩˥ːtʃnɔ
sreda	sre˥˩ːda
sredinec	srɛdi˥˩ːnəts
središče	srɛdi˩˥ːʃtʃɛ
srednjevaloven	srɛdnjɛʋalo˥˩ːʋən
srednjeveški	srɛdnjɛʋe˥˩ːʃki
srednji	sre˥˩ːdnji
srna	sə˩˥rna
srp	sə˥˩rp
sršen	sərʃe˥˩ːn
sršen	sərʃɛ́n
sršen	sə˩˥rʃɛn
s	s
štacun	ʃtatsu˩˥ːn
štala	ʃta˩˥ːla
stanje	sta˩˥ːnjɛ
stanovati	stanɔʋa˩˥ːti
starec	sta˥˩ːrəts
starejši	starɛ́ːjʃi
starka	sta˥˩ːrka
starodaven	starɔda˩˥ːʋən
starost	sta˩˥ːrɔst
starost	staro˥˩ːst
starš	sta˩˥ːrʃ
star	sta˥˩r
sta	sta˥˩
stati	sta˩˥ːti
stavba	sta˥˩ːʋba
stavek	sta˥˩ːʋək
staviti	sta˩˥ːʋiti
stečaj	stɛtʃa˥˩ːj
stegno	stɛ̀ːgnɔ
steklenica	stɛklɛni˩˥ːtsa
steklo	stɛ̀ːklɔ
stena	ste˩˥ːna
ste	stɛ́
šteti	ʃte˩˥ːti
stetoskop	stɛtɔsko˥˩ːp
stetoskop	stɛtɔsko˥˩p
število	ʃtɛʋi˩˥ːlɔ
števnik	ʃte˥˩ːʋnik
steza	stəza˥˩
steza	stə˩˥za
stikalo	stika˩˥ːlɔ
štirideset	ʃti˥˩ːridɛsɛt
štirinajst	ʃti˥˩ːrinajst
štirinajst	ʃtirina˩˥ːjst
štirje	ʃti˩˥ːrjɛ
stoletje	stɔle˥˩ːtjɛ
stolp	sto˥˩lp
stol	sto˥˩ʋ
stopalo	stɔpa˩˥ːlɔ
stopiti	sto˩˥ːpiti
stopiti	stɔpi˥˩ːti
stopiti	stɔpi˩˥ːti
stopnišče	stɔpni˩˥ːʃtʃɛ
štorklja	ʃto˥˩ːrklja
štor	ʃto˥˩ːr
štor	ʃto˥˩r
sto	sto˥˩ː
stotnica	sto˥˩ːtnitsa
stotnik	sto˥˩ːtnik
stožec	sto˩˥ːʒəts
stožec	sto˩˥ːʒəts
strah	stra˥˩ːx
stranišče	strani˩˥ːʃtʃɛ
stranka	stra˥˩ːnka
stran	stra˥˩ːn
strašek	stra˥˩ːsɛk
strasten	stra˩˥ːstən
strastnejši	stra˩˥ːstnɛjʃi
strast	stra˥˩ːst
strategija	stratɛgi˥˩ːja
streči	stre˩˥ːtʃi
streha	stre˩˥ːxa
strela	stre˩˥ːla
strešica	stre˩˥ːʃitsa
strgati	stə˩˥rgati
striči	stri˩˥ːtʃi
stric	stri˩˥ːts
strog	stro˥˩ːk
strojen	stro˥˩ːjən
strojiti	stro˥˩ːjiti
strojiti	stro˩˥ːjiti
strojiti	strɔji˥˩ːti
strojiti	strɔji˩˥ːti
stroj	stro˥˩j
stroncij	stro˩˥ːntsij
strop	stro˥˩p
strukturalen	struktura˥˩ːlən
struktura	struktu˥˩ːra
strupen	stru˥˩ːpən
strupen	strupe˥˩ːn
strup	stru˥˩ːp
študent	ʃtudɛ́nt
študirati	ʃtudi˥˩ːrati
stvar	stʋa˥˩ːr
suh	su˥˩ːx
sum	su˥˩ːm
šum	ʃu˥˩ːm
šunka	ʃu˥˩ːnka
suša	su˩˥ːʃa
suspenzorij	suspɛnzo˩˥ːrij
suti	su˩˥ːti
suženjstvo	su˩˥ːʒənstʋɔ
suženj	su˩˥ːʒən
sužnja	su˩˥ːʒnja
svakinja	sʋa˥˩ːkinja
svakinja	sʋa˩˥ːkinja
svak	sʋa˩˥ːk
sva	sʋa˥˩
sveča	sʋe˩˥ːtʃa
švedinja	ʃʋe˥˩ːdinja
švedščina	ʃʋe˥˩ːtʃtʃina
švedska	ʃʋe˥˩ːtska
švedski	ʃʋe˥˩ːtski
švedsko	ʃʋe˥˩ːtskɔ
šved	ʃʋe˥˩ːt
svetel	sʋə˩˥təʋ
svetel	sʋɛ̀ːtəʋ
svetilnik	sʋɛti˥˩ːlnik
svetloba	sʋɛtlo˩˥ːba
svetnik	sʋe˥˩ːtnik
svetnik	sʋɛtni˩˥ːk
svet	sʋe˥˩ːt
svet	sʋɛ́t
švicarski	ʃʋi˥˩ːtsarski
švica	ʃʋi˥˩ːtsa
svila	sʋi˥˩ːla
sviloprejka	sʋilɔprɛ́ːjka
svinčnik	sʋi˩˥ːntʃnik
svinec	sʋi˩˥ːnəts
svizec	sʋi˥˩ːzəts
svoboda	sʋɔbo˩˥ːda
svoboden	sʋɔbo˩˥ːdən
svobodnejši	sʋɔbo˩˥ːdnɛjʃi
svojina	sʋɔji˩˥ːna
svoj	sʋo˩˥ːj
sydney	si˥˩ːdni
tadej	tadɛ́ːj
tadžikistan	tadʒi˥˩ːkistan
tajska	ta˥˩ːjska
tajvan	ta˥˩ːjʋan
takoj	tako˥˩ːj
takoj	tako˥˩j
tako	tako˥˩ː
takrat	takra˥˩t
taksi	taksi
talec	ta˥˩ːlɛts
talij	ta˩˥ːlij
tam	ta˥˩m
tanek	ta˩˥ːnək
tantal	ta˥˩ːntal
tanzanija	tanza˩˥ːnija
tarča	ta˥˩ːrtʃa
tašča	ta˩˥ːʃtʃa
taščica	ta˩˥ːʃtʃitsa
tast	ta˥˩ːst
ta	ta˥˩ː
tat	ta˥˩t
tavžent	ta˥˩ːʋʒɛnt
tečaj	tɛtʃa˥˩ːj
teči	tɛ̀ːtʃi
teden	te˥˩ːdən
tehnecij	tɛxne˩˥ːtsij
tekač	tɛka˩˥ːtʃ
tekočina	tɛkɔtʃi˩˥ːna
tekoč	tɛko˥˩ːtʃ
tekoč	tɛko˩˥ːtʃ
tek	te˥˩ːk
telesen	tɛle˥˩ːsən
tele	tɛ̀ːlɛ
telo	tɛlo˥˩ː
telovaditi	tɛlɔʋa˩˥ːditi
telur	tɛlu˥˩ːr
telur	tɛlu˩˥ːr
tema	te˥˩ːma
tema	təma˥˩
tema	tə˥˩ma
temen	təmə˥˩n
temen	tə˩˥mən
temniti	təmni˥˩ːti
temniti	təmni˩˥ːti
tempelj	tɛ̀ːmpəl
temperatura	tɛmpɛratu˥˩ːra
temza	te˥˩ːmza
tenis	te˥˩ːnis
teokracija	tɛɔkratsi˥˩ːja
teoretičen	tɛɔre˩˥ːtitʃən
teoretik	tɛɔre˩˥ːtik
teorija	tɛɔri˥˩ːja
tepsti	tɛ̀ːpsti
terarij	tɛra˩˥ːrij
terbij	tɛ̀ːrbij
termit	tɛrmi˥˩ːt
terorist	tɛrɔri˥˩ːst
tesen	tɛ̀ːsən
teta	tɛ̀ːta
teti	te˩˥ːti
tetoviranje	tɛtɔʋi˥˩ːranjɛ
tetovirati	tɛtɔʋi˥˩ːrati
težek	tɛ̀ːʒək
težji	te˥˩ːʒji
tiger	ti˩˥ːgər
tih	ti˥˩ːx
tikati	ti˥˩ːkati
tikati	ti˩˥ːkati
tilen	ti˩˥ːlɛn
timijan	ti˥˩ːmijan
tipka	ti˥˩ːpka
tipkovnica	tipko˥˩ːʋnitsa
tip	ti˥˩ːp
tisa	ti˥˩ːsa
tišina	tiʃi˩˥ːna
tisočletje	tisɔtʃle˥˩ːtjɛ
tisti	ti˥˩ːsti
titan	tita˥˩ːn
ti	ti˥˩
ti	ti˥˩ː
tjulenj	tju˥˩ːlən
tjulenj	tju˩˥ːlən
tkalec	tka˥˩ːləts
tkati	tka˩˥ːti
tkivo	tki˩˥ːʋɔ
tlak	tla˥˩ːk
tla	tla˥˩
toda	to˥˩ːda
toda	tɔda
tod	to˥˩ːt
tod	to˩˥ːt
tog	to˥˩ːk
tokata	tɔka˥˩ːta
tok	to˥˩ːk
tok	to˥˩k
tolči	to˩˥ːʋtʃi
tolkalo	tɔʋka˩˥ːlɔ
tolmač	tɔlma˩˥ːtʃ
tolpa	to˩˥ːlpa
tomahavk	tɔmaxa˥˩ːʋk
tomaž	tɔma˥˩ːʃ
tom	to˥˩ːm
topel	to˩˥ːpəʋ
topel	to˩˥ːpəʋ
topiti	tɔpi˥˩ːti
topiti	tɔpi˩˥ːti
toplota	tɔplo˩˥ːta
topol	to˩˥ːpɔl
top	to˥˩p
torba	to˥˩ːrba
torek	to˩˥ːrək
torij	to˩˥ːrij
to	to˥˩ː
tovariš	tɔʋa˥˩ːriʃ
tovarna	tɔʋa˥˩ːrna
tožilnik	tɔʒi˥˩ːlnik
tradicija	tradi˩˥ːtsija
tradicionalen	traditsiɔna˥˩ːlən
trajekt	traje˥˩ːkt
trakulja	traku˩˥ːlja
tramvaj	tra˥˩ːmʋaj
tramvaj	tramʋa˥˩ːj
transilvanija	transilʋa˩˥ːnija
trava	tra˩˥ːʋa
travnik	tra˥˩ːʋnik
travnik	tra˩˥ːʋnik
travojedec	traʋɔje˥˩ːdəts
trdnjava	tərdnja˥˩ːʋa
trd	tə˥˩rt
trebuh	tre˩˥ːbux
trener	trɛnɛ́ːr
trenutek	trɛnu˥˩ːtək
trepalnica	trɛpa˥˩ːlnitsa
trepetlika	trɛpɛtli˩˥ːka
tresti	tre˩˥ːsti
treti	tre˩˥ːti
tretjak	trɛtja˩˥ːk
trgati	tə˩˥rgati
trgovina	tərgɔʋi˩˥ːna
trg	tə˥˩rk
trhel	tə˩˥rxɛl
triangel	trija˩˥ːngəl
trideset	tri˥˩ːdɛsɛt
trije	tri˥˩ːjɛ
trije	trije˥˩ː
trikotnik	triko˥˩ːtnik
trinajst	tri˥˩ːnajst
trinajst	trina˩˥ːjst
trinko	tri˥˩ːnkɔ
tris	tri˥˩ːs
tri	tri˥˩ː
trizob	trizo˥˩ːp
trobenta	trɔbe˥˩ːnta
trod	tro˥˩ːt
trošt	tro˥˩ːʃt
trot	tro˥˩ːt
trpeti	tərpe˩˥ːti
trši	tə˥˩rʃi
trska	tə˩˥rska
trstenjak	tərstɛnja˩˥ːk
trst	tə˥˩rst
trta	tə˩˥rta
trtica	tə˩˥rtitsa
truhel	tru˩˥ːxəʋ
truplo	tru˩˥ːplɔ
tuberkuloza	tubɛrkulo˥˩ːza
tudi	tu˥˩ːdi
tudi	tudi
tukaj	tu˥˩ːkaj
tulij	tu˩˥ːlij
tuljava	tulja˥˩ːʋa
tunizija	tuni˩˥ːzija
turčija	tu˥˩ːrtʃija
turek	tu˩˥ːrək
turist	turi˥˩ːst
turizem	turi˩˥ːzəm
turkinja	tu˩˥ːrkinja
turoben	turo˩˥ːbən
turški	tu˩˥ːrʃki
turško	tu˩˥ːrʃkɔ
tu	tu˥˩
tveganje	tʋe˥˩ːganjɛ
tveganje	tʋe˩˥ːganjɛ
tvegati	tʋe˥˩ːgati
tvegati	tʋe˩˥ːgati
tvoj	tʋo˩˥ːj
tvorba	tʋo˥˩ːrba
tvoriti	tʋo˥˩ːriti
tvoriti	tʋo˩˥ːriti
ubiti	ubi˩˥ːti
ubog	ubo˥˩ːk
učenec	utʃɛ̀ːnəts
učinek	utʃi˥˩ːnək
učiteljica	utʃi˥˩ːtɛljitsa
učitelj	utʃi˥˩ːtɛl
učiti	utʃi˥˩ːti
učiti	utʃi˩˥ːti
udariti	uda˩˥ːriti
ud	u˥˩ːt
uganka	uga˥˩ːnka
ugrabitev	ugrabi˥˩ːtəʋ
ugrizniti	ugri˩˥ːzniti
ugriz	ugri˥˩ːs
uho	uxo˥˩ː
ujec	u˥˩ːjəts
ujec	u˩˥ːjəts
ujeda	uje˥˩ːda
ujeda	uje˩˥ːda
ujeti	uje˩˥ːti
ukaz	uka˥˩s
ukor	uko˥˩r
ukrajina	ukraji˩˥ːna
ukrajinski	ukraji˥˩ːnski
ukrasti	ukra˩˥ːsti
ukreniti	ukrɛni˥˩ːti
ukreniti	ukrɛni˩˥ːti
ukvarjati	ukʋa˩˥ːrjati
ulica	u˩˥ːlitsa
ulice	ulitsɛ
ulici	ulitsi
ulico	ulitsɔ
ulic	ulits
ulomek	ulo˥˩ːmək
ultrakratkovaloven	u˥˩ːltrakratkɔʋalo˥˩ːʋən
umazan	uma˥˩ːzan
umeti	ume˩˥ːti
umetnik	ume˥˩ːtnik
umiti	umi˩˥ːti
umivati	umi˩˥ːʋati
umoriti	umɔri˥˩ːti
umoriti	umɔri˩˥ːti
umor	umo˥˩r
umreti	umre˩˥ːti
uniforma	unifo˥˩ːrma
univerza	uniʋɛ́ːrza
upanje	u˥˩ːpanjɛ
upati	u˥˩ːpati
uplinjač	uplinja˩˥ːtʃ
uporaba	upɔra˥˩ːba
uporabiti	upɔra˩˥ːbiti
uporabiti	upɔrabi˥˩ːti
uporabiti	upɔrabi˩˥ːti
uporabljati	upɔra˩˥ːbljati
uporabnik	upɔra˥˩ːbnik
upor	upo˥˩r
uraden	ura˥˩ːdən
uran	ura˥˩ːn
uran	ura˥˩ːn
ura	u˥˩ːra
ura	u˩˥ːra
urban	urba˥˩ːn
urban	urba˥˩ːn
urban	urba˥˩n
urnik	u˥˩ːrnik
urok	uro˥˩k
uršič	u˥˩ːrʃitʃ
urška	u˥˩ːrʃka
usluga	uslu˥˩ːga
usmrtitev	usmərti˥˩ːtəʋ
usnje	u˩˥ːsnjɛ
usoda	uso˥˩ːda
usoden	uso˥˩ːdən
usoden	uso˩˥ːdən
usodnejši	uso˩˥ːdnɛjʃi
uspeh	uspɛ́x
uspeti	uspe˩˥ːti
usta	u˩˥ːsta
ustava	usta˥˩ːʋa
ustje	u˥˩ːstjɛ
ustje	u˩˥ːstjɛ
ustnica	u˥˩ːstnitsa
ustrezen	ustre˩˥ːzən
ustreznejši	ustre˩˥ːznɛjʃi
ustreznik	ustre˩˥ːznik
uš	u˥˩ːʃ
utor	uto˥˩r
utrujati	utru˩˥ːjati
utrujen	utru˩˥ːjɛn
uvel	uʋe˩˥ːʋ
uvel	uʋɛ́ʋ
uživati	uʒi˩˥ːʋati
vabiti	ʋa˩˥ːbiti
vabiti	ʋabi˥˩ːti
vabiti	ʋabi˩˥ːti
vaditi	ʋa˩˥ːditi
vaga	ʋa˥˩ːga
vagina	ʋagi˥˩ːna
vajin	ʋa˥˩ːjin
valentin	ʋalɛnti˥˩ːn
valj	ʋa˥˩ːl
valj	ʋa˩˥ːl
val	ʋa˥˩ːl
vampir	ʋampi˩˥ːr
vanadij	ʋana˩˥ːdij
varen	ʋa˩˥ːrən
varna	ʋa˩˥ːrna
varnega	ʋa˩˥ːrnɛga
varnejši	ʋa˩˥ːrnɛjʃi
varne	ʋa˩˥ːrnɛ
varni	ʋa˩˥ːrni
varnost	ʋa˩˥ːrnɔst
varno	ʋa˩˥ːrnɔ
varšava	ʋarʃa˥˩ːʋa
varuh	ʋa˥˩ːrux
vas	ʋa˥˩ːs
vaš	ʋa˥˩ʃ
vaterpolist	ʋatɛrpɔli˥˩ːst
vaterpolo	ʋa˩˥ːtɛrpo˥˩ːlɔ
vaza	ʋa˩˥ːza
včasih	ʋtʃa˥˩ːsix
včeraj	ʋtʃe˩˥ːraj
včlaniti	ʋtʃla˥˩ːniti
včlaniti	ʋtʃla˩˥ːniti
vdihniti	ʋdi˩˥ːxniti
vdova	ʋdo˥˩ːʋa
veber	ʋe˩˥ːbər
večen	ʋe˩˥ːtʃən
večerja	ʋɛtʃe˥˩ːrja
večer	ʋɛtʃe˥˩ːr
večji	ʋe˥˩ːtʃji
več	ʋɛ́tʃ
vedeti	ʋe˩˥ːdɛti
vedno	ʋe˩˥ːdnɔ
vedro	ʋɛ̀ːdrɔ
vegetarijanec	ʋɛgɛtarija˥˩ːnəts
vejati	ʋɛ́ːjati
veja	ʋɛ́ːja
vejica	ʋɛ́ːjitsa
vektor	ʋe˩˥ːktɔr
velblod	ʋɛlblo˥˩ːt
velelnik	ʋɛle˥˩ːlnik
velelnik	ʋɛle˥˩ːʋnik
velemesto	ʋɛ́lɛme˩˥ːstɔ
veleposlanik	ʋɛ́lɛpɔsla˩˥ːnik
veleposlaništvo	ʋɛ́lɛpɔsla˩˥ːniʃtʋɔ
veličina	ʋɛlitʃi˩˥ːna
velikan	ʋɛlika˥˩ːn
veliko	ʋɛli˩˥ːkɔ
velik	ʋɛ̀ːlik
vendar	ʋə˥˩ndar
vendar	ʋə˩˥ndar
venera	ʋe˥˩ːnɛra
veniti	ʋe˩˥ːniti
veper	ʋe˩˥ːpɛr
vera	ʋe˩˥ːra
veriga	ʋɛri˩˥ːga
verjeti	ʋɛrje˩˥ːti
veselje	ʋɛsɛ̀ːljɛ
vesel	ʋɛse˥˩ːʋ
vesim	ʋe˥˩ːsim
vesiti	ʋe˩˥ːsiti
vesti	ʋe˩˥ːsti
vesti	ʋɛ̀ːsti
vest	ʋe˥˩ːst
ves	ʋə˥˩s
veter	ʋe˥˩ːtər
veti	ʋe˩˥ːti
veverica	ʋe˩˥ːʋɛritsa
ve	ʋe˥˩ː
vezati	ʋe˩˥ːzati
vezati	ʋɛza˩˥ːti
veznik	ʋe˥˩ːznik
vez	ʋe˥˩ːs
vhod	ʋxo˥˩t
vice	ʋi˥˩ːtsɛ
vice	ʋi˩˥ːtsɛ
videti	ʋi˩˥ːdɛti
vidra	ʋi˥˩ːdra
vidra	ʋi˩˥ːdra
vid	ʋi˥˩ːt
vihar	ʋixa˥˩ːr
vijak	ʋija˩˥ːk
vikati	ʋi˥˩ːkati
vikati	ʋi˩˥ːkati
vila	ʋi˥˩ːla
vile	ʋi˩˥ːlɛ
vilice	ʋi˩˥ːlitsɛ
vinograd	ʋino˩˥ːgrat
vino	ʋi˩˥ːnɔ
violina	ʋijɔli˥˩ːna
violončelo	ʋijɔlɔntʃe˥˩ːlɔ
vir	ʋi˥˩ːr
višji	ʋi˥˩ːʃji
višnu	ʋi˥˩ːʃnu
visok	ʋiso˥˩k
vitez	ʋi˥˩ːtɛs
viti	ʋi˥˩ːti
viti	ʋi˩˥ːti
vi	ʋi˥˩ː
viza	ʋi˥˩ːza
viza	ʋi˩˥ːza
vizum	viːzʊm
vključiti	ʋklju˩˥ːtʃiti
vklopiti	ʋklo˩˥ːpiti
vklopiti	ʋklɔpi˥˩ːti
vklopiti	ʋklɔpi˩˥ːti
vladati	ʋla˥˩ːdati
vladati	ʋla˩˥ːdati
vladavina	ʋladaʋi˩˥ːna
vlada	ʋla˥˩ːda
vlak	ʋla˥˩ːk
vleči	ʋle˩˥ːtʃi
vljudnost	ʋlju˩˥ːdnɔst
vltava	ʋə˥˩ltaʋa
vnukinja	ʋnu˥˩ːkinja
vnukinja	ʋnu˩˥ːkinja
vnuk	ʋnu˥˩ːk
vnuk	ʋnu˩˥ːk
voda	ʋo˩˥ːda
vodič	ʋɔdi˥˩tʃ
vodik	ʋɔdi˥˩ːk
voditi	ʋɔdi˥˩ːti
voditi	ʋɔdi˩˥ːti
vodja	ʋo˥˩ːdja
vodnar	ʋɔdna˩˥ːr
vodnica	ʋo˥˩ːdnitsa
vodnjak	ʋɔdnja˩˥ːk
vodomec	ʋɔdo˥˩ːməts
vodomec	ʋɔdo˩˥ːməts
vogal	ʋɔga˥˩ːʋ
vogel	ʋo˥˩ːgəʋ
vohati	ʋo˥˩ːxati
vohunski	ʋɔxu˥˩ːnski
vohun	ʋɔxu˥˩ːn
voh	ʋo˥˩ːx
vojakinja	ʋɔja˩˥ːkinja
vojak	ʋɔja˩˥ːk
vojna	ʋo˩˥ːjna
vojščak	ʋɔjʃtʃa˩˥ːk
vojska	ʋo˩˥ːjska
vojvoda	ʋo˥˩ːjʋɔda
vojvodina	ʋo˥˩ːjʋɔdina
vojvodina	ʋo˥˩ːjʋɔdina
volan	ʋɔla˥˩ːn
volfram	ʋo˥˩ːlfram
volga	ʋo˩˥ːʋga
volja	ʋo˩˥ːlja
volkodlak	ʋɔʋkɔdla˥˩ːk
volk	ʋo˥˩ːʋk
volk	ʋo˥˩ːʋk
volna	ʋo˩˥ːʋna
voluhar	ʋɔlu˥˩ːxar
vol	ʋo˥˩ʋ
voščilo	ʋɔʃtʃi˩˥ːlɔ
voščiti	ʋo˩˥ːʃtʃiti
voščiti	ʋɔʃtʃi˥˩ːti
voščiti	ʋɔʃtʃi˩˥ːti
vosek	ʋo˥˩ːsək
vos	ʋo˥˩ːs
votor	ʋɔto˥˩r
vovk	ʋo˥˩ːʋk
vozel	ʋo˩˥ːzəʋ
voziti	ʋɔzi˥˩ːti
voziti	ʋɔzi˩˥ːti
vožnja	ʋo˩˥ːʒnja
voz	ʋo˥˩ːs
vpiti	ʋpi˩˥ːti
vpliv	ʋpli˥˩ːʋ
vprašaj	ʋpraʃa˥˩ːj
vprašanje	ʋpraʃa˥˩ːnjɛ
vprašati	ʋpra˩˥ːʃati
vprašati	ʋpraʃa˩˥ːti
vrabec	ʋra˩˥ːbəts
vrana	ʋra˩˥ːna
vranica	ʋra˩˥ːnitsa
vran	ʋra˥˩ːn
vran	ʋra˥˩ːn
vrata	ʋra˩˥ːta
vratič	ʋrati˥˩tʃ
vrat	ʋra˥˩ːt
vrat	ʋra˩˥ːt
vraža	ʋra˩˥ːʒa
vrba	ʋə˩˥rba
vrč	ʋə˥˩rtʃ
vreči	ʋre˩˥ːtʃi
vrednost	ʋre˩˥ːdnɔst
vreme	ʋrɛ̀ːmɛ
vretence	ʋrɛtɛ̀ːntsɛ
vreti	ʋre˩˥ːti
vroč	ʋro˥˩ːtʃ
vroč	ʋro˥˩tʃ
vrša	ʋə˩˥rʃa
vršilec	ʋərʃi˥˩ːləts
vrsta	ʋə˩˥rsta
vrsten	ʋə˥˩rstən
vrstilen	ʋərsti˥˩ːlən
vrstnost	ʋə˥˩rstnɔst
vrst	ʋə˥˩rst
vrtnica	ʋə˥˩rtnitsa
vrt	ʋə˥˩rt
vsaj	ʋsa˥˩ːj
vsakič	ʋsa˥˩ːkitʃ
vsebina	ʋsɛbi˩˥ːna
všečen	ʋʃe˩˥ːtʃən
všečnost	ʋʃe˩˥ːtʃnɔst
všeč	uʃe˥˩ːtʃ
vsejedec	ʋsɛje˥˩ːdəts
vstaviti	ʋsta˩˥ːʋiti
vstopati	ʋsto˥˩ːpati
vstopati	ʋsto˩˥ːpati
vstopiti	ʋsto˩˥ːpiti
vstopiti	ʋstɔpi˥˩ːti
vstopiti	ʋstɔpi˩˥ːti
vtis	ʋti˥˩ːs
vulkan	ʋulka˥˩ːn
vurnik	ʋu˥˩ːrnik
v	ʋ
vzdevek	ʋzde˥˩ːʋɛk
vzeti	ʋze˩˥ːti
vzhoden	ʋzxo˥˩ːdən
vzhodnejši	ʋzxo˥˩ːdnɛjʃi
vzhod	ʋzxo˥˩t
vžigalica	ʋʒiga˥˩ːlitsa
vzpon	ʋspo˥˩n
wikipedija	ʋikipɛdi˥˩ːja
wikislovar	ʋikislɔʋa˩˥ːr
zabava	zaba˥˩ːʋa
zabavnik	zaba˥˩ːʋnik
žaba	ʒa˩˥ːba
začetek	zatʃe˥˩ːtək
začeten	zatʃe˥˩ːtən
začeti	zatʃe˩˥ːti
zadnjica	za˥˩ːdnjitsa
zadnjičen	za˥˩ːdnjitʃən
zadnjik	za˥˩ːdnjik
zadnji	za˥˩ːdnji
zadovoljevati	zadɔʋɔljɛʋa˩˥ːti
zadovoljiti	zadɔʋɔlji˥˩ːti
zadovoljiti	zadɔʋɔlji˩˥ːti
žafran	ʒafra˥˩ːn
žagati	ʒa˥˩ːgati
žaga	ʒa˥˩ːga
zagnati	zagna˩˥ːti
zahoden	zaxo˥˩ːdən
zahodnejši	zaxo˥˩ːdnɛjʃi
zahod	zaxo˥˩t
zahteva	zaxte˥˩ːʋa
zaimek	zai˥˩ːmək
zaiti	zai˩˥ːti
zajček	za˥˩ːjtʃək
zajec	za˥˩ːjəts
zajec	za˥˩ːjəts
zajtrkovati	zajtərkɔʋa˩˥ːti
zajtrk	za˥˩ːjtərk
zajtrk	za˩˥ːjtərk
zakaj	zaka˥˩ːj
zakaj	zaka˩˥ːj
zaklad	zakla˥˩t
zakleniti	zaklɛni˥˩ːti
zakleniti	zaklɛni˩˥ːti
zakon	za˩˥ːkɔn
zakristija	zakristi˥˩ːja
zalar	za˥˩ːlar
zaliv	zali˥˩ːʋ
zaljubiti	zalju˥˩ːbiti
zaljubiti	zalju˩˥ːbiti
zaljubiti	zaljubi˥˩ːti
zaljubiti	zaljubi˩˥ːti
žalost	ʒa˩˥ːlɔst
žal	ʒa˩˥ːl
zaman	zama˥˩n
zambija	za˩˥ːmbija
žamet	ʒa˩˥ːmɛt
zamuditi	zamudi˥˩ːti
zamuditi	zamudi˩˥ːti
zanimivejši	zanimi˩˥ːʋɛjʃi
zanimiv	zanimi˥˩ːʋ
zanimiv	zanimi˩˥ːʋ
zanka	za˥˩ːnka
zapestje	zape˥˩ːstjɛ
zapornica	zapo˥˩ːrnitsa
zapornik	zapo˥˩ːrnik
zapor	zapo˥˩r
zapreti	zapre˩˥ːti
zapustiti	zapusti˥˩ːti
zapustiti	zapusti˩˥ːti
žara	ʒa˩˥ːra
žarek	ʒa˥˩ːrək
žarek	ʒa˩˥ːrək
zarnik	za˥˩ːrnik
zaščita	zaʃtʃi˥˩ːta
zaseben	zase˥˩ːbən
zaspan	zaspa˩˥ːn
zaspati	zaspa˩˥ːti
zastava	zasta˥˩ːʋa
zastavnica	zasta˥˩ːʋnitsa
zavesa	zaʋe˥˩ːsa
zavreti	zaʋre˩˥ːti
za	za
zažgati	zaʒga˩˥ːti
zbežati	zbɛʒa˩˥ːti
zbirati	zbi˥˩ːrati
zbirati	zbi˩˥ːrati
zbirka	zbi˥˩ːrka
zbrati	zbra˩˥ːti
zdaj	zda˥˩j
ždeti	ʒde˩˥ːti
zdolgočasen	zdɔʋgɔtʃa˥˩ːsɛn
zdravica	zdraʋi˩˥ːtsa
zdravilo	zdraʋi˩˥ːlɔ
zdravje	zdra˥˩ːʋjɛ
zdravljica	zdraʋlji˩˥ːtsa
zdravnik	zdraʋni˩˥ːk
zdravo	zdra˥˩ːʋɔ
zdravstvo	zdra˥˩ːʋstʋɔ
zdrav	zdra˥˩ʋ
zeba	ze˩˥ːba
žebelj	ʒɛ̀ːbəl
žebelj	ʒɛbə˥˩l
zebra	ze˥˩ːbra
zebra	ze˩˥ːbra
zebsti	ze˩˥ːpsti
zehati	ze˩˥ːxati
žeja	ʒɛja
zelena	ze˥˩ːlɛna
zelena	zɛ́ːlɛna
zelena	zɛlɛ̀ːna
zelen	ze˥˩ːlən
zelen	zɛlɛ́n
želeti	ʒɛle˩˥ːti
železo	ʒɛle˩˥ːzɔ
želja	ʒɛ̀ːlja
zelje	ze˩˥ːljɛ
želodec	ʒɛlo˥˩ːdəts
želod	ʒɛ̀ːlɔt
zelo	zɛlo˥˩ː
želva	ʒe˩˥ːlʋa
zel	ze˥˩ːʋ
zel	zə˥˩ʋ
zemlja	zɛ̀ːmlja
zemlja	zɛ̀ːmlja
zemljepis	zɛmljɛpi˥˩ːs
zemljevid	zɛmljɛʋi˥˩ːt
žena	ʒɛ̀ːna
zenica	zɛni˩˥ːtsa
ženska	ʒe˩˥ːnska
ženski	ʒe˩˥ːnski
žepar	ʒɛ́ːpar
žep	ʒɛ́p
žerjav	ʒɛrja˥˩ʋ
žerjav	ʒɛrja˥˩ʋ
žetev	ʒe˥˩ːtəʋ
žeti	ʒe˩˥ːti
zet	zɛ́t
že	ʒe˥˩ː
že	ʒɛ
že	ʒɛ́
žgati	ʒga˩˥ːti
zgodaj	zgo˥˩ːdaj
zgodba	zgo˥˩ːdba
zgodovinar	zgɔdɔʋi˥˩ːnar
zgodovina	zgɔdɔʋi˩˥ːna
zgodovinski	zgɔdɔʋi˥˩ːnski
zgoraj	zgo˩˥ːraj
zgradba	zgra˥˩ːdba
zgrešiti	zgrɛ̀ːʃiti
zibati	zi˩˥ːbati
zibati	ziba˩˥ːti
žica	ʒi˩˥ːtsa
zidati	zi˩˥ːdati
zidati	zida˩˥ːti
zid	zi˥˩ːt
žila	ʒi˩˥ːla
zima	zi˩˥ːma
žimnica	ʒi˥˩ːmnitsa
žirafa	ʒira˥˩ːfa
žiti	ʒi˩˥ːti
živahen	ʒiʋa˩˥ːxən
živahnejši	ʒiʋa˩˥ːxnɛjʃi
žival	ʒiʋa˥˩ːʋ
živeti	ʒiʋe˩˥ːti
živinorejec	ʒiʋinɔrɛ́ːjəts
življenje	ʒiʋljɛ̀ːnjɛ
živ	ʒi˥˩ːʋ
zjutraj	zju˩˥ːtraj
zlaten	zla˥˩ːtən
zlaten	zla˩˥ːtən
zlaten	zlate˥˩ːn
zlaten	zlate˩˥ːn
zlato	zlato˥˩ː
zlat	zla˥˩ːt
zlemu	zlɛmu˥˩
žleza	ʒle˩˥ːza
zlitina	zli˥˩ːtina
zlitina	zli˩˥ːtina
zločinec	zlɔtʃi˥˩ːnəts
zločin	zlɔtʃi˥˩ːn
zlog	zlo˥˩k
zlomiti	zlɔmi˥˩ːti
zlomiti	zlɔmi˩˥ːti
zlomljen	zlo˩˥ːmljɛn
zlonameren	zlɔname˩˥ːrən
zlo	zlo˥˩
zmaga	zma˥˩ːga
zmagovalec	zmagɔʋa˥˩ːləts
zmaj	zma˥˩ːj
zmaj	zma˩˥ːj
zmaj	zma˥˩j
zmeraj	zme˥˩ːraj
značilen	znatʃi˥˩ːlən
značilnejši	znatʃi˥˩ːlnɛjʃi
znanje	zna˥˩ːnjɛ
znanost	zna˩˥ːnɔst
znanstven	zna˥˩ːnstʋɛn
znati	zna˩˥ːti
znoj	zno˥˩ːj
znoj	zno˥˩j
znotraj	zno˩˥ːtraj
zober	zo˩˥ːbər
zobozdravnik	zɔbɔzdraʋni˩˥ːk
zobozdravstvo	zɔbɔzdra˥˩ːʋstʋɔ
zobru	zo˩˥ːbru
zob	zo˥˩ːp
žoga	ʒo˥˩ːga
žoga	ʒo˩˥ːga
žolčevod	ʒo˥˩ltʃɛʋo˩˥ːt
žolčnik	ʒo˥˩ːʋtʃnik
žolč	ʒo˥˩ːʋtʃ
žolna	ʒo˩˥ːʋna
žolt	ʒo˥˩ːʋt
zona	tso˥˩ːna
zona	zo˥˩ːna
zora	zo˥˩ːra
zora	zo˩˥ːra
zoreti	zɔre˩˥ːti
zrak	zra˥˩k
žrebec	ʒre˩˥ːbəts
žrebe	ʒrɛbɛ́
žrebica	ʒrɛbi˩˥ːtsa
zrelejši	zre˩˥ːlɛjʃi
zrelejši	zrɛlɛ́ːjʃi
zrel	zre˥˩ːʋ
zrel	zrɛ́ʋ
žreti	ʒre˩˥ːti
zrklo	zə˩˥rklɔ
žrtvovati	ʒərtʋɔʋa˩˥ːti
zssr	zəsəsərə˥˩
zunaj	zu˩˥ːnaj
zupančič	zupa˥˩ːntʃitʃ
zupanc	zu˥˩ːpants
zupan	zu˥˩ːpan
zupan	zupa˥˩n
župan	ʒupa˩˥ːn
župan	ʒupa˥˩n
žuželka	ʒuʒe˥˩ːlka
zvati	zʋa˩˥ːti
zvečer	zʋɛtʃe˥˩ːr
žvečiti	ʒʋe˩˥ːtʃiti
žveplo	ʒʋɛ̀ːplɔ
zverina	zʋɛri˩˥ːna
zver	zʋe˥˩ːr
zver	zʋe˥˩ːr
zvezda	zʋe˩˥ːzda
zvezek	zʋe˥˩ːzək
zvitek	zʋi˥˩ːtək
zvok	zʋo˥˩ːk
zvonar	zʋɔna˩˥ːr
zvonec	zʋo˩˥ːnəts
zvone	zʋo˥˩ːnɛ
zvon	zʋo˥˩ːn
zvon	zʋo˥˩ːn
z	z
ž	ʒ
