aacatlah	aʔaːkatɬ
acaicpalli	aːkaikpalːi
acalmaitl	aːkaɬmaːitɬ
acalyacatl	aːkaɬjakatɬ
acatl	áːkatɬ
acatlah	aːkatɬaʔ
acatlan	aːkatɬan
acaxitl	aːkaʃitɬ
acayotl	aːkájoːtɬ
acelloh	aseːlːoʔ
achcocolli	aːtʃkoːkóːlːi
acilloh	asiːlːi
acoatl	aːkoːaːtɬ
acoatl	aːkoːwaːtɬ
acpatl	aːkpatɬ
acuetzpalin	aːkʷetspalin
acxoyatl	akʃoːjatɬ
acxoyatototl	akʃoːjatoːtoːtɬ
aehecatl	aːeʔeːkatɬ
ahahuacuauhtlah	aʔaːwakʷaʍtɬaʔ
ahahuatlah	aʔaːwatɬaʔ
ahaztontli	aʔastoːntɬi
ahcuallahtolli	aʔkʷalːaʔtóːlːi
ahhuachchoh	aʔwattʃoʔ
ahhuachtli	aʔwatʃtɬi
ahhuechchoh	aʔwettʃoʔ
ahhuechtli	aʔwetʃtɬi
ahmicqui	aʔmikki
ahmo	áʔmoː
ahmolli	aʔmóːlːi
ahpohualiztli	aʔpoːwalistɬi
ahtlatl	áʔtɬatɬ
ahuacamilli	aːwakamilːi
ahuacamolli	aːwakamóːlːi
ahuacatl	aːwákatɬ
ahuacuahuitl	aːwakʷawitɬ
ahuacuauhtlah	aːwakʷaʍtɬaʔ
ahuacuauhtomatl	aːwakʷaʍtomatɬ
ahuatecolotl	aːwaːtekoloːtɬ
ahuatl	aːwaːtɬ
ahuatl	aːwatɬ
ahuatlah	aːwatɬaʔ
ahuatomatl	aːwatomatɬ
aihtectli	aːiʔtektɬi
alcalde	aɬkáːɬteʔ
alcaldeyotl	aɬkaːɬteʔjoːtɬ
alo	álo
alomeh	alómeʔ
altepecuaxochtli	aːɬtepeːkʷaːʃoːtʃtɬi
altepehuah	aːɬtepeːwaʔ
altepemaitl	aːɬtepeːmaːitɬ
altepemeh	aːɬtepéːmeʔ
altepenahuatilli	aːɬtépeːnáːwatíːlːi
altepenanyotl	aːɬtepeːnaːnjoːtɬ
altepetepantli	aːɬtepeːtepaːntɬi
altepetl	aːɬtépeːtɬ
altepetlacatl	aːltepeːtɬaːkatɬ
altepetlahcuiloh	aːɬtepeːtɬaʔkʷíloʔ
altepetlahcuilohqueh	aːɬtepeːtɬaʔkʷilóʔkeʔ
altepetlalli	aːɬtepeːtɬaːlːi
amacal	amáːkaɬ
amachcocol	amaːtʃkóːkoːɬ
amachcocolhuan	amaːtʃkoːkóːɬwaːn
amaitl	aːmaːitɬ
amapatolli	aːmapatoːlːi
amatlahcuilolli	aːmatɬaʔkʷiloːlːi
amatzin	aːmátsin̥
amauh	ámaːʍ
amaxayacatl	aːmaʃaːjakatɬ
ameyalatl	aːmeːjalaːtɬ
ameyallah	aːmeːjalːaʔ
ameyalli	aːmeːjalːi
ameyaltontli	aːmeːjaɬtoːntɬi
amilli	aːmiːlːi
amilomeh	ámilómeʔ
amilotetl	ámilótetɬ
amilotl	amílotɬ
amiquiliztli	aːmikilistɬi
amiquiztli	aːmikistɬi
amiztli	aːmistɬi
amocal	amókaɬ
amochan	amótʃaːn
amochichihuan	amótʃitʃíwaːn̥
amochichiuh	ámotʃítʃiʍ
amochil	amótʃiːɬ
amochimal	amotʃíːmaɬ
amocihhuan	amosíʔwaːn̥
amocuexcoch	ámokʷwéʃkotʃ
amocuitl	amókʷitɬ
amomach	amómatʃ
amomachhuan	ámomátʃwaːn̥
amomazahuan	amomasáːwaːn
amomiquiz	amomíkis
amonacayo	amonakájo
amonahuatlahtol	amonaːwatɬáʔtoːɬ
amonan	amonaːn
amonoch	amónoːtʃ
amotecon	amotékon
amoteouh	amóteʍ
amotepehuan	amótepéːwaːn̥
amotepetzin	amótepéːtsin̥
amotepeuh	ámotépeːʍ
amotilmah	ámotíɬmaʔ
amotiyanquiz	amotijáːŋkis
amotlacahuan	amotɬaːkáwaːn
amotlacauh	amotɬáːkaʍ
amotlahtlacol	amótɬaʔtɬákoːɬ
amotlahtol	ámotɬáʔtoːɬ
amotlaxcal	ámotɬáʃkaɬ
amoxcalli	aːmoʃkalːi
amoxnamacac	aːmoʃnamákak
amoxocoyouh	amóʃoːkójoːʍ
amoxtepiton	aːmoʃtepitoːn
amoxtlahcuiloh	aːmoʃtɬakʷiloʔ
amoxtli	aːmóʃtɬi
amoxtocaitl	aːmoʃtoːkaːiːtɬ
amoxtontli	aːmoʃtoːntɬi
amoyaohuan	amójaːóːwaːn̥
amoyolloh	ámojóːlːoʔ
anantli	aːnaːntɬi
angelomeh	áːn̥ʃilóʔmeʔ
anqui	aŋki
apachtli	aːpatʃtɬi
apantli	aːpantɬi
apizzotl	aːpiːsːoːtɬ
apoctli	aːpoːktɬi
apostolo	ápoʃtóːlóʔ
apostolomeh	apóʃtoːlóʔmeʔ
apozonalli	aːposoːnalːi
apozonallotl	aːposoːnalːoːtɬ
atenyoh	atenjoʔ
atepocatl	atepokatɬ
atetepeyotl	aːtéːtepéːjoːtɬ
atetl	aːtetɬ
atl	áːtɬ
atlacomolatl	aːtɬakomóːlaːtɬ
atlacomolli	aːtɬakomoːlːi
atlacuezonan	aːtɬaːkʷesónan̥
atlauhyoh	aːtɬaʍjoʔ
atonalittaloni	aːtoːnalittalóːni
atonalmachiyotl	aːtoːnaɬmatʃíjoːtɬ
atotonilli	aːtotonilːi
atoyapitzactli	aːtoːjaːpitsaktɬi
atoyapitzactontli	aːtoːjaːpitsaktoːntɬi
atoyatetl	aːtoːjaːtetɬ
atoyatl	aːtoːjaːtɬ
atoyatontli	aːtoːjaːtoːntɬi
axayacatl	aːʃaːjákatɬ
axcan	áːʃkaːn̥
axcancayotl	àːʃkaːŋkáːjoːtɬ
axittontli	aːʃittontɬi
axnoh	aʃnoʔ
axolomeh	aːʃoːlóːmeʔ
axolotl	aːʃóːloːtɬ
ayahuitl	aːjawitɬ
ayauhcozamalotl	aːjaʍkoːsamáːloːtɬ
ayoh	aːjoʔ
ayohtli	ajoʔtɬi
ayollohco	aːjoːlːoʔko
ayoneuctli	aːjoːnekʷtɬi
ayotapalcatl	aːjoːtapaɬkatɬ
ayotl	ajotɬ
azcamolli	aːskamoːlːi
azcapotzalli	aːskapoːtsálːi
azcaxalli	aːskaʃaːlːi
cacahuaatl	kakawaaːtɬ
cacahuapinolli	kakawapinolːi
cacahuapozonallotl	kakawaposoːnalːoːtɬ
cacahuapozonillotl	kakawaposoːnilːoːtɬ
cacahuatl	kakawatɬ
cacamatl	kakamatɬ
calatl	kaːlatɬ
calcuichchoh	kaɬkʷittʃoʔ
callah	kalːaʔ
callalli	kalːaːlːi
calli	kaːlːi
calli	kálːi
camactli	kamaːktɬi
camohtli	kamoʔtɬi
canauhconetl	kanaʍkoneːtɬ
canauhconetontli	kanaʍkoneːtoːntɬi
canauhquilitl	kanaʍkilitɬ
canauhtetl	kanaʍtetɬ
capolcuauhtlah	kapoɬkʷaʍtɬaʔ
capolin	kapoːlin̥
capollah	kapólːaʔ
capoloctli	kapolóktɬi
caxpechtontli	kaʃpetʃtoːntɬi
caxtepiton	kaʃtepitoːn
caxtillan	kaʃtiːlːaːn
caxtolli	kaʃtoːlːi
caxtolpa	kaʃtoːɬpa
cecemilhuitlahcuilolli	sesemiɬwitɬaʔkʷiloːlːi
cecen	séːsen̥
ceehecatl	seeʔeːkatɬ
cehcen	séʔsen̥
cehualli	seːwalːi
cemithualtin	semitwáɬtin
cemolotontli	semoːloːtoːntɬi
cempohualilhuitl	sempoːwaliɬwitɬ
cempohualli	sempoːwalːi
cempohualpa	sempoːwaɬpa
cempohualtiyanquiztli	sempoːwaɬtijaːŋkistɬi
cempohualxihuitl	sempoːwaɬʃiwitɬ
centeconetl	sentekóneːtɬ
centlachipiniltontli	sentɬatʃipiniːɬtoːntɬi
centlacolmetztli	sentɬakoɬmeːtstɬi
centzommayeh	sentsomːaːjeʔ
centzontli	sentsontɬi
ceppa	seppa
ce	se
cetochhuia	seːtoːtʃwiaː
cexihuitl	seʃíwitɬ
cexiuhamatl	seʃiʍaːmatɬ
cexiuhtlahcuilolli	seʃiʍtɬaʔkʷiloːlːi
ceyaliztli	séjalístɬi
chachapahtli	tʃatʃapaʔtɬi
chachapahtontli	tʃatʃapaʔtoːntɬi
chalchihuitl	tʃaːɬtʃíwitɬ
chantli	tʃáːntɬi
chapolin	tʃapólin̥
chapoltepec	tʃapoɬtépeːk
chichihualayotl	tʃiːtʃiːwalaːjoːtɬ
chichiton	tʃitʃítoːn̥
chicome	tʃikóːme
chicoppa	tʃikoːppa
chicoxxihuitl	tʃikoːʃːiwitɬ
chicuaceppa	tʃikʷaseppa
chicuace	tʃikʷáse
chicuexpa	tʃikʷeːʃpa
chicueyilhuitl	tʃikʷeːjiɬwitɬ
chicueyi	tʃikʷeːji
chilatl	tʃiːɬaːtɬ
chilcacahuatl	tʃiːɬkakawatɬ
chilchomolli	tʃiːɬtʃomoːlːi
chilchotl	tʃiːɬtʃotɬ
chilhuacmolli	tʃiːɬwaːkmóːlːi
chilli	tʃiːlːi
chilloh	tʃiːlːoʔ
chilmolcaxitl	tʃiːɬmoːɬkaʃitɬ
chiltototl	tʃiːɬtoːtoːtɬ
chimalmichin	tʃiːmaɬmitʃin
chimalxochitl	tʃiːmaɬʃoːtʃitɬ
chinancalli	tʃinaːŋkalːi
chipahuacatl	tʃipaːwakaːtɬ
chipelihuiztontli	tʃipeliwistoːntɬi
chipilin	tʃipilin̥
chipolin	tʃipolin
chiquiuhchihua	tʃikiʍtʃiːwa
chiquiuhchiuhqueh	tʃikiʍtʃíːʍkeʔ
chiquiuhchiuhqui	tʃikiʍtʃíːʍki
chiquiuhtontli	tʃikiʍtoːntɬi
chiucnahui	tʃikʷnáːwi
chiucnappa	tʃikʷnaːppa
chiucnauhmictlan	tʃikʷnaːʍmiktɬaːn
chiucnauhtiyanquiztli	tʃikʷnaːʍtijaːnkistɬi
chiyamachiuhqueh	tʃijamaːtʃíːʍkeʔ
chiyamachiuhqui	tʃijamaːtʃíːʍki
chiyamatl	tʃijamaːtɬ
chiyampinolli	tʃijampinolːi
chiyancaca	tʃijaŋkáka
chiyan	tʃijan
choquizzoh	tʃoːkisːoʔ
christiano	kiʃtáːnoʔ
christiano	kiʃtijáːnoʔ
christianosmeh	kiʃtaːnóʃmeʔ
christianosmeh	kiʃtijaːnóʃmeʔ
cicitlalloh	siːsitɬaːlːoʔ
cihuah	síwaʔ
cihuahuahqueh	siwaːwáʔkeʔ
cihuahuah	siwáːwaʔ
cihuaichcatl	siwaːitʃkatɬ
cihuameh	siwaːmeʔ
cihuanehtotiliztli	siwaːneʔtoːtiːlístɬi
cihuaoquichtli	siwaːokitʃtɬi
cihuapiltzintli	siwáːpiɬtsíntɬi
cihuateopixqui	siwaːteoːpiʃki
cihuatepiton	siwaːtepitoːn
cihuatlacamichin	siwaːtɬaːkamitʃin
cihuatl	síwaːtɬ
cihuatontli	siwaːtoːntɬi
cihuatotolixpopoyotl	siwaːtoːtoɬiːʃpopojoːtɬ
cihuayotl	siwáːjoːtɬ
cihyotl	siʔjoːtɬ
cinteotl	sinteoːtɬ
cipactin	sipáktin̥
cipactli	sipáktɬi
citlalicue	sitɬaːlíːkʷe
citlalin	s̻itɬaːlin̥
citlalli	siːtɬalːi
citlalloh	sitɬaːlːoʔ
citlaltepiton	sitɬaːɬtepítoːn̥
citlalton	sitɬáːɬtoːn̥
citlaltontli	sitɬaːɬtoːntɬi
citlaltzintli	sitɬaːɬtsintɬi
coaehuatl	koːwaːeːwatɬ
coaiztlactli	koːwaːistɬaktɬi
coatetl	koːaːtetɬ
coatlantli	koːwaːtɬantɬi
coatlicue	koːaːtɬiːkʷe
coatl	koːaːtɬ
coatl	koːwaːtɬ
coatl	kowaːtɬ
cochihuaniton	kotʃiːwanitoːn
cochomeh	kotʃomeʔ
cocohtin	koːkoʔtin
cocohtli	koːkoʔtɬi
cocohton	koːkoʔtoːn
cocolin	kokolin
coconeh	koːkóneʔ
coconeyotl	koːkoneːjoːtɬ
cocoyameh	koːkojámeʔ
cocoyoh	koːkojoʔ
colelectli	kolelektɬi
colelehtin	koleleʔtin
colelehtli	koleleʔtɬi
comaltlilli	komaːɬtɬiːlːi
coneepatl	koneːepatɬ
conetl	kóneːtɬ
conetontli	koneːtoːntɬi
confesoremeh	kompíʃoːlémeʔ
confites	kompiːteʃ
confites	kompiːtiʃ
copitl	kopitɬ
cotaloliztli	kotaloːlistɬi
coxolihtli	koːʃoːliʔtɬi
coyamecalli	kojamekalːi
coyamechiyahuacayotl	kojametʃijaːwakaːjoːtɬ
coyameconetl	kojamekoneːtɬ
coyamemeh	kojamemeʔ
coyametepiton	kojametepitoːn
coyametl	kojametɬ
coyametontli	kojametoːntɬi
coyolacatl	kojoɬaːkatɬ
coyopil	kojoːpiːɬ
coyotontli	kojoːtoːntɬi
cozamalotl	koːsamaːloːtɬ
cozamatl	koːsamaːtɬ
cozcacuauhtli	koːskakʷaːʍtɬi
cuachcalli	kʷaːtʃkalːi
cuachicpalli	kʷaːtʃikpalːi
cuachihchil	kʷaːtʃiʔtʃiːɬ
cuacuauhtin	kʷaːkʷáːʍtin̥
cuahcuauhtlah	kʷaʔkʷawtɬaʔ
cuahuitl	kʷáwitɬ
cuammaitl	kʷammaːitɬ
cuammimiltontli	kʷammimiɬtoːntɬi
cuammitl	kʷammiːtɬ
cuappantontli	kʷappaːntoːntɬi
cuappatolli	kʷappatoːlːi
cuauhcalli	kʷaʍkalːi
cuauhcaltepiton	kʷaʍkaɬtepitoːn
cuauhcaltontli	kʷaʍkaɬtoːntɬi
cuauhchimal	kʷaʍtʃiːmaɬ
cuauhchimalli	kʷaʍtʃiːmalːi
cuauhchiquihuitl	kʷáʍtʃikíwitɬ
cuauhcoconetl	kʷaʍkoːkoneːtɬ
cuauhconetl	kʷaːʍkoneːtɬ
cuauhehuatl	kʷaweːwatɬ
cuauhhuatzalli	kʷaʍwaːtsalːi
cuauhhuatzaltontli	kʷaʍwaːtsaɬtoːntɬi
cuauhicpalli	kʷawikpalːi
cuauhitzcuintli	kʷawitskʷíntɬi
cuauhizhuatl	kʷawiswatɬ
cuauhmiztli	kʷaʍmístɬi
cuauhnanacatl	kʷaʍnanakatɬ
cuauhneuczayoltin	kʷaʍnekʷsaːjóːɬtin̥
cuauhnexatl	kʷaʍnéʃaːtɬ
cuauhocuilin	kʷaʍokʷilin
cuauhpatolli	kʷaʍpatoːlːi
cuauhtlah	kʷawtɬaʔ
cuauhtlahtoatzin	kʷaːʍtɬáʔtoáːtsin̥
cuauhtli	kʷaːʍtɬi
cuauhtontli	kʷaʍtoːntɬi
cuecueyah	kʷeːkʷéjaʔ
cueitl	kʷeːitɬ
cuetzpalin	kʷetspalin̥
cuexcochtli	kʷeʃkótʃtɬi
cueyamolli	kʷéjamóːlːi
cueyatl	kʷejatɬ
cueyatl	kʷéjatɬ
cuezcomatl	kʷeskomatɬ
cuicaamatl	kʷiːkaáːmatɬ
cuicanitototl	kʷiːkanitoːtoːtɬ
cuicatl	kʷiːkatɬ
cuichchoh	kʷittʃoʔ
cuicuicaniton	kʷiːkʷiːkanitoːn
cuicuitlayoh	kʷiːkʷitɬajoʔ
cuilonyotl	kʷilójːoːtɬ
cuitlacochin	kʷitɬakótʃin̥
cuitlayoh	kʷitɬajoʔ
diezmo	tijeːʃmoʔ
dios	tíjoːʃ
discipulomeh	tiʃíːpolóʔmeʔ
discipulo	tíʃiːpóloʔ
ehcamecatl	eʔkamekatɬ
ehcapahcuauhtlah	eʔkapaʔkʷaʍtɬaʔ
ehcapahtli	eʔkapaʔtɬi
ehcaxoctli	eʔkaʃóktɬi
ehecatle	eʔeːkatɬé
ehecatl	eʔeːkatɬ
ehecayoh	eʔeːkajoʔ
ehezzoh	eʔesːoʔ
ehuaamatl	eːwaaːmatɬ
elli	éːlːi
ellotl	éːlːoːtɬ
elmatlatl	eːɬmáːtɬatɬ
emillah	emiːlːaʔ
emilli	emiːlːi
emolli	emoːlːi
epahuaxmolli	epaːwaʃmoːlːi
epahuaxtli	epaːwaʃtɬi
epazotl	epasoːtɬ
eptli	eptɬi
epyollohtli	epjoːlːoʔtɬi
etextli	eteʃtɬi
etiliztli	etilistɬi
etlah	etɬaʔ
etl	etɬ
etzalcualiztli	etsaɬkʷalistɬi
etzatl	eːtsatɬ
evangelistameh	éwaŋkéliːʃtámeʔ
exotl	eʃoːtɬ
eyi	éːji
eyi	jéːji
eyilhuitl	eːjiɬwitɬ
eztli	estɬi
guadalupe	wátalóːpeʔ
he	é
hicoxcuahuitl	iːkoʃkʷáwitɬ
hicoxcuauhtlah	iːkoʃkʷáʍtɬaʔ
hicox	íːkoʃ
huauhquiltamalli	waʍkiɬtamalːi
huehuehpil	weːweʔpiːɬ
huehuehpol	weːweʔpoːɬ
huehueh	wéːweʔ
huehuenton	weːwentoːn
huehuentoton	weːwentotoːn
huehuetcatontli	weːwetkaːtoːntɬi
huehuetqueh	weːwéːtkeʔ
huehueyipol	weːweːjipoːɬ
huehxolomeh	weʔʃoːloːmeʔ
huehxolotl	weʔʃoːloːtɬ
huemmanaliztli	wemːánalístɬi
huentli	wéntɬi
huentzintli	wentsintɬi
huexotlah	weʃoːtɬaʔ
hueyatl	weːjaːtɬ
hueyicayotl	weːjikaːjoːtɬ
hueyi	weːji
huicoltepiton	wikoɬtepitoːn
huicoltontli	wikoɬtoːntɬi
huicoltzintli	wikoɬtsintɬi
huilocalli	wiːloːkálːi
huiloconetl	wiːloːkoneːtɬ
huilopiltontli	wiːloːpiɬtoːntɬi
huitzilopochcah	wiːtsílopótʃkaʔ
huitzilopochtli	wiːtsiloːpoːtʃtɬi
huitzitzilepyollohtli	witsitsilepjoːlːoʔtɬi
huixtohcihuatl	wiːʃtoʔsiwaːtɬ
iahhuayo	íːjaʔwájo
ical	iːkaɬ
ichahuanan	iːtʃaːwánaːn̥
ichan	íːtʃaːn
ichcacalli	itʃkakalːi
ichcaconetl	itʃkakoneːtɬ
ichcaehuatl	itʃkaeːwatɬ
ichcameh	itʃkameʔ
ichcatilmahtli	itʃkatiɬmaʔtɬi
ichcatl	itʃkatɬ
ichichihuan	íːtʃitʃíwaːn̥
ichichiuh	iːtʃítʃiʍ
ichil	íːtʃiːɬ
ichimal	iːtʃíːmaɬ
ichpochpiltontli	itʃpóːtʃpiɬtóntɬi
ichpochtepiton	itʃpóːtʃtepítoːn̥
ichpochtli	itʃpóːtʃ̚tɬi
ichpochtontli	itʃpoːtʃtoːntɬi
ichpochtotolin	itʃpoːtʃtoːtolin
ichpochtzintli	ítʃpoːtʃtsíntɬi
ichpopochtepitoton	itʃpóːpoːtʃtépitótoːn̥
icihuahuahtzin	iːsiwaːwáʔtsin
icihuahuan	iːsiwáːwaːn
icihuauh	iːsíwaːʍ
icihuayo	iːsiwáːjo
icnocihuatl	iknoːsiwaːtɬ
icnocihuayotl	iknoːsiwaːjoːtɬ
icnomacehualli	íknoːmáːseːwálːi
icnomacehualtin	íknoːmáːseːwáɬtin̥
icnooquichchotl	iknoːokittʃoːtɬ
icnooquichtli	iknoːokitʃtɬi
icnopilcalli	iknoːpiɬkalːi
icnotlacah	iknoːtɬaːkaʔ
icnotlacatl	iknoːtɬaːkatɬ
icnotlacayotl	iknoːtɬaːkajoːtɬ
icnotlacualli	iknoːtɬakʷalːi
icnotlaquemitl	iknoːtɬakeːmitɬ
icoauh	iːkóːaːʍ
icoauh	iːkóːwaːʍ
iconeuh	iːkóneːʍ
icox	iːkoʃ
icoztica	iːkoːstíka
icpacxochitl	ikpakʃoːtʃitɬ
icpal	íːkpaɬ
icpalli	ikpalːi
icpatetl	ikpatetɬ
icpatetontli	ikpatetoːntɬi
icpitl	ikpitɬ
icualoca	iːkʷalóːka
icuauhyo	iːkʷáʍjo
icue	íːkʷe
icuexcoch	iːkʷwéʃkotʃ
icuic	íːkʷiːk
icuitl	íːkʷitɬ
idiscipulohuan	íːtiʃíːpolówaːn̥
iel	íːjeːɬ
ieyitiliztzin	íːjejíːtilístsin̥
iglesia	ileːsíjaʔ
ihciuh	iʔsiʍ
ihuallaliz	iːwaːlːáːlis
ihuauhquiltamal	iːwaʍkiɬtámaɬ
ilama	ilama
ilamatcatontli	ilamatkaːtoːntɬi
ilamaton	ilamatoːn
ilhuicaamaitl	iɬwikaaːmaːitɬ
ilhuicaatentli	iɬwikaaːteːntɬi
ilhuicaatl	iɬwikaaːtɬ
ilhuicaaxalli	iɬwikaaːʃaːlːi
ilhuicatl	iɬwíkatɬ
ilhuitlapohualamoxtli	iɬwitɬapoːwalaːmoʃtɬi
imacal	iːmáːkaɬ
imachcocolhuan	iːmaːtʃkoːkóːɬwaːn
imachcocol	iːmaːtʃkóːkoːɬ
imachhuan	iːmátʃwaːn̥
imach	íːmatʃ
imachiyo	iːmatʃíjo
imamox	iːmáːmoʃ
imatzin	iːmáːtsin̥
imazahuan	iːmasáːwaːn
imeuh	íːmeʍ
imezzo	iːmésːo
imichhuan	iːmítʃwaːn
imilpan	iːmíːɬpan̥
imiquiz	iːmíkis
immachhuan	iːmːátʃwaːn̥
immach	íːmːatʃ
immazahuan	iːmːasáːwaːn
immeuh	iːmːeʍ
immiccahuan	iːmːikáːwaːn
immichhuan	iːmːítʃwaːn
immilpan	iːmːíːɬpan̥
immiquiz	iːmːíkis
imoc	íːmok
inacayo	iːnákajo
inahuatlahtol	iːnaːwatɬáʔtoːɬ
inamox	iːnáːmoʃ
inan	iːnaːn
inantzin	iːnáːntsin̥
incal	íːŋkaɬ
inchan	íːntʃaːn
inchichihuan	íːntʃitʃíwaːn̥
inchichiuh	iːntʃítʃiʍ
inchihchimal	iːntʃiʔtʃíːmaɬ
inchil	íːntʃiːɬ
inchimal	iːntʃíːmaɬ
incocohuan	iːŋkokówaːn
incuexcoch	iːŋkʷwéʃkotʃ
incuic	íːŋkʷiːk
incuitl	íːŋkʷitɬ
inix	íːniːʃ
innacayo	iːnːakájo
innahuan	iːnːáːwaːn
innahuatlahtol	iːnːaːwatɬáʔtoːɬ
innan	íːnːaːn
innoch	íːnːoːtʃ
intah	íːntaʔ
intecon	iːntékon
inteohuan	iːnteóːwaːn
inteopixcauh	iːnteoːpíʃkaːʍ
inteouh	íːnteʍ
intepehuan	íːntepéːwaːn̥
intepeuh	iːntépeːʍ
intilmah	iːntíɬmaʔ
intiyanquiz	iːntijáːŋkis
intlacahuan	iːntɬaːkáwaːn
intlacauh	iːntɬáːkaʍ
intlahtlacol	íːntɬaʔtɬákoːɬ
intlahtol	iːntɬáʔtoːɬ
intlaxcal	iːntɬáʃkaɬ
inxocoyouh	íːnʃoːkójoːʍ
inyaohuan	íːjːaːóːwaːn̥
inyaouh	íːjːáːoːʍ
inyolloh	iːn̥jóːlːoʔ
ioc	íːjok
ipillohuan	iːpilːóːwaːn
ipiltzin	iːpíɬtsin̥
ipuñalton	iːponáːɬtoːn
iquillo	ikílːo
itecon	iːtékon
itecpanchan	íːteːkpán̥tʃaːn̥
itecuiyo	iːteːkʷíjo
itehuilotca	iːtewilótka
iteohuan	iːteóːwaːn
iteouh	íːteʍ
itepehuan	íːtepéːwaːn̥
itepeuh	iːtépeːʍ
itezcauh	iːtéskaʍ
ithualli	itwálːi
itilmah	iːtíɬmaʔ
itiyanquiz	iːtijáːŋkis
itlacahuan	iːtɬaːkáwaːn
itlacauh	iːtɬáːkaʍ
itlacoyo	iːtɬakóːjo
itlahtlacol	íːtɬaʔtɬákoːɬ
itlahtohcayohuan	iːtɬaʔtoʔkaːjóːwaːn
itlahtol	iːtɬáʔtoːɬ
itlanequiliz	iːtɬánekílis
itlaxcal	iːtɬáʃkaɬ
itzcuinconetl	itskʷiŋkoneːtɬ
itzcuintin	itskʷintin
itzcuintli	itskʷintɬi
iuctontli	ikʷtoːntɬi
ixachi	iʃatʃi
ixachin	iʃatʃin
ixachintin	iʃatʃintin
ixachipol	iʃatʃipoːɬ
ixayoyoh	iːʃaːjoːjoʔ
ixocoyouh	íːʃoːkójoːʍ
ixoculin	íːʃokʷílin
ixtelolohtontli	iːʃteloloʔtoːntɬi
iyaayo	iːjaːáːjo
iyacal	iːjáːkaɬ
iyachcocolhuan	iːjaːtʃkoːkóːɬwaːn
iyachcocol	iːjaːtʃkóːkoːɬ
iyahciyan	iːjaʔsíjaːn
iyahuitl	ijawitɬ
iyamox	iːjáːmoʃ
iyaohuan	íːjaːóːwaːn̥
iyaouh	íːjáːoːʍ
iyauh	íːjaːʍ
iyauhtlaolli	ijaʍtɬaoːlːi
iyehuayo	iːjeːwájo
iyeliz	iːjelis
iyelli	ijelːi
iyix	íːjiːʃ
iyiztaca	iːjistáːka
iyocuillo	iːjokʷílːo
iyolloh	iːjóːlːoʔ
iyoquichcho	iːjokíttʃo
izquiztepiton	iskistepitoːn
izquiztli	iskistɬi
iztaayotl	istaaːjoːtɬ
iztacayotl	istaːkaːjoːtɬ
iztaccuauhtli	istaːkkʷaːʍtɬi
iztaxalli	istaʃaːlːi
iztlacatlahcuiloh	istɬakatɬaʔkʷíloʔ
iztlacatlahcuilohqueh	istɬakatɬaʔkʷilóʔkeʔ
jesucristo	ijeʃokiːʃtoʔ
judiotlacatl	ʃotiːjoʔtɬaːkatɬ
macal	máːkaɬ
macehuallotl	máːseːwálːoːtɬ
machcocolhuan	maːtʃkoːkóːɬwaːn
machcocol	maːtʃkóːkoːɬ
machiyotl	matʃíjoːtɬ
macpalcomolli	maːkpaɬkomoːlːi
macpalli	maːkpalːi
macpalyollohtli	maːkpaɬjoːlːoʔtɬi
macuilli	maːkʷiːlːi
macuilpa	maːkʷiːɬpa
macuilpohualli	maːkʷiːɬpoːwalːi
macuiltiyanquiztli	maːkʷiːɬtijaːŋkistɬi
mahomacalli	maoːmaʔkalːi
mahpiltontli	maʔpiɬtoːntɬi
mahtlacpa	maʔtɬaːkpa
mahtlacpohualli	maʔtɬaːkpoːwalːi
mahtlacpohualpa	maʔtɬaːkpoːwaɬpa
mahtlactli	maʔtɬaːktɬi
mahuiztli	maːwístɬi
malinalli	maliːnálːi
malina	maliːna
mamazah	maːmásaʔ
mamox	máːmoʃ
mantelex	mantéːleʃ
mantelexton	manteːléʃtoːn̥
maololli	maːolóːlːi
maquechtli	maːketʃtɬi
martiremeh	máːɬtilémeʔ
matepiton	maːtepitoːn
matepoztlaximaloniton	maːtepostɬaxiːmaloːnitoːn
matepoztli	maːtepostɬi
matepoztontli	maːtepostoːntɬi
matlatepiton	maːtɬatepitoːn
matlatontli	maːtɬatoːntɬi
matontli	maːtoːntɬi
matzahoctli	matsaʔóktɬi
matzin	máːtsin̥
mauh	máːʍ
maxtli	maʃtɬi
mayehuatl	maːjeːwatɬ
mazaatemitl	masaːatémitɬ
mazacalli	masaːkalːi
mazacocoliztli	masaːkokolistɬi
mazacocolizzoh	masaːkokolisːoʔ
mazaconetl	masaːkoneːtɬ
mazaehuatl	masaːeːwatɬ
mazamolli	masaːmoːlːi
mazanacatl	másaːnákatɬ
mazapil	maːsapiːɬ
mazatlacualli	masaːtɬakʷalːi
mazatl	masaːtɬ
mazaxococuahuitl	masaːʃokokʷáwitɬ
mazaxocotl	masaːʃókotɬ
mazayotl	masaːjoːtɬ
mehuayo	meːwájo
mel	méːɬ
meneuctli	menekʷtɬi
mequiyotl	mekíjoːtɬ
metztonalli	meːtstoːnalːi
metztonallotl	meːtstoːnalːoːtɬ
metztona	meːtstoːna
metztontli	meːtstoːntɬi
metztontli	metstoːntɬi
mexcalli	meʃkalːi
mexihcah	meːʃíʔkaʔ
mexihcatl	meːʃíʔkatɬ
mexihco	meːʃiʔko
mexihcopahuic	meːʃiʔkopawiːk
mexihcopa	meːʃiʔkopa
mexixin	meʃíʃin̥
mexixquilitl	méʃiʃkílitɬ
mexixquillaxcalli	méʃiʃkílːaʃkálːi
meyollohtli	mejoːlːóʔtɬi
miccapetlacalli	mikkaːpetɬaːkalːi
miccatetl	mikkaːtetɬ
miccatlatatactzaccayotl	míkkaːtlátatáktsakkáːjoːtɬ
miccazayolin	mik̚kaːsaːjóːlin̥
michacaxitl	mitʃaːkáʃitɬ
michahhuatl	mitʃaʔwatɬ
michahxiliztli	mitʃaʔʃilístɬi
michamanalli	mitʃaːmanalːi
michcoyolli	mitʃkojolːi
michehuatl	mitʃeːwatɬ
michinix	mitʃiniʃ
michin	mitʃin̥
michmaliztli	mitʃmalístɬi
michmatlatl	mitʃmaːtɬatɬ
michmolli	mitʃmoːlːi
michnamacacan	mitʃnaːmakakaːn
michomitl	mitʃomitɬ
michtetl	mitʃtetɬ
michtlaoyoh	mitʃtɬaoːjoʔ
micqui	mík̚ki
mictlancayotl	miktɬaːŋkaːjoːtɬ
mictlan	miktɬaːn
mictlanteuctli	miktɬaːnteːkʷtɬi
mihtotihqui	miʔtoːtiʔki
millahtlacah	miːlːaʔtɬáːkaʔ
millahtlacatl	miːlːaʔtɬáːkatɬ
milpanecah	miːɬpanéːkaʔ
milpanecatl	miːɬpanéːkatɬ
milpan	míːɬpan̥
miltepiton	miːɬtepitoːn
miltontli	miːɬtoːntɬi
mimichtin	miːmítʃtin
mimiyahuameh	miːmijaːwámeʔ
mimiztin	miːmítin
miquiztlacualli	mikistɬakʷalːi
miquiztli	mikistɬi
mix	míːʃ
mixxincayotl	miʃːiːŋkaːjoːtɬ
mixxoh	miʃːoʔ
mixxonehuatl	miʃːoneːwatɬ
miyahuatl	mijaːwatɬ
miyahuatototl	mijaːwatoːtoːtɬ
miyequintin	mijekíntin
mizton	mistoːn
miztontli	mistoːntɬi
mocal	mokaɬ
mochahuanan	motʃaːwánaːn̥
mochan	mótʃaːn
mochichihuan	mótʃitʃíwaːn̥
mochichiuh	motʃítʃiʍ
mochil	mótʃiːɬ
mochimal	motʃíːmaɬ
mocih	mósiʔ
mocihuahuan	mosiwáːwaːn
mocihuauh	mosíwaːʍ
mocnomacehual	moknóːmaːséːwaɬ
mococohuan	mokokówaːn
mocuexcoch	mokʷwéʃkotʃ
mocuic	mókʷiːk
mocuitl	mókʷitɬ
molli	moːlːi
momachhuan	momátʃwaːn̥
momach	mómatʃ
momazahuan	momasáːwaːn
momilpan	momíːɬpan̥
momiquiz	momíkis
monacayo	monakájo
monahuatlahtol	monaːwatɬáʔtoːɬ
monan	mónàːn̥
monoch	mónoːtʃ
moquichcho	mokíttʃo
motah	mótaʔ
motecon	motékon
moteohuan	moteóːwaːn
moteouh	móteʍ
motepeuh	motépeːʍ
moteucyohuan	moteːkjóːwaːn
moteucyo	motéːkjo
motezcauh	motéskaʍ
motilmah	motíɬmaʔ
motiyanquiz	motijáːŋkis
motlacahuan	motɬaːkáwaːn
motlacauh	motɬáːkaʍ
motlahtlacol	motɬaʔtɬákoːɬ
motlahtol	motɬáʔtoːɬ
motlanequiliz	motɬánekílis
motlaxcal	motɬáʃkaɬ
moxocoyouh	móʃoːkójoːʍ
moyaohuan	mójaːóːwaːn̥
moyolloh	mojóːlːoʔ
nabox	náːpoʃ
nacaayotl	nakaaːjoːtɬ
nacal	náːkaɬ
nacaocuilin	nakaokʷilin
nacatamalli	nakatamálːi
nacatlaolli	nakatɬaoːlːi
nacatlaoyoh	nakatɬaoːjoʔ
nacatlapatzcaayotl	nakatɬapaːtskaaːjoːtɬ
nacayoh	nakajoʔ
nacayo	naːkájo
nacazcuihcuitlatl	nakaskʷiʔkʷitɬatɬ
nacaztli	nakastɬi
nachcocolhuan	naːtʃkoːkóːɬwaːn
nachcocol	naːtʃkóːkoːɬ
nahciyan	naʔsíjaːn
nahnahui	naʔnáːwi
nahuallotl	naːwalːoːtɬ
nahuatlahtoh	naːwatɬaʔtoʔ
nahuatlahtolli	naːwatɬaʔtoːlːi
nahuatl	naːwatɬ
nahuilhuitl	naːwiɬwitɬ
nahui	náːwi
namiqueh	naːmíkeʔ
namiquehqueh	naːmikéʔkeʔ
namox	náːmoʃ
nanahui	naːnáːwi
nantin	naːntin
nantli	naːntɬi
nantontli	naːntoːntɬi
nanyotl	naːnjoːtɬ
nappa	naːppa
nappohualli	naːppoːwalːi
nappohualpa	naːppoːwaɬpa
natzin	náːtsin̥
nauh	náːʍ
nauhxihuitl	naːʍʃiwitɬ
nealtilatl	neaːɬtiːlaːtɬ
necuatequilizteahpaztli	nekʷaːteːkilisteaʔpastɬi
necuatequiliztli	nékʷatékilístɬi
necuatl	nekʷaːtɬ
nehuayo	neːwájo
nel	néːɬ
nemanahuilcalli	nemaːnaːwiːɬkalːi
nextlahualli	néʃtɬaːwálːi
nextlahualtin	néʃtɬaːwáɬtin̥
nexxoh	neʃːoʔ
nix	níːʃ
nocal	nókaɬ
nocenteconetzin	nosentekoneːtsin
nochahuanan	notʃaːwánaːn̥
nochan	nótʃaːn
nocheztli	noːtʃestɬi
nochichihuan	nótʃitʃíwaːn̥
nochichitohuan	notʃitʃitóːwaːn
nochichiuh	notʃítʃiʍ
nochil	nótʃiːɬ
nochimal	notʃíːmaɬ
nochoctli	noːtʃoktɬi
nochpoch	nótʃpoːtʃ
nocih	nósiʔ
nocihuahuan	nosiwáːwaːn
nocihuauh	nosíwaːʍ
nococohuan	nokokówaːn
noconeuh	nokóneːʍ
nocualac	nokʷálak
nocuexcoch	nokʷwéʃkotʃ
nocuic	nókʷiːk
nocuitl	nókʷitɬ
nohuehxolohuan	nowéʔʃoːlóːwaːn̥
nohuehxolouh	nóweʔʃóːloːʍ
nomachhuan	nomátʃwaːn̥
nomach	nómatʃ
nomazahuan	nomasáːwaːn
nomilpan	nomíːɬpan̥
nomiquiz	nomíkis
nomiuh	nómiʍ
nomiyo	nomijo
nonacayo	nonakajo
nonacaz	nonakas
nonahuatlahtol	nonaːwatɬáʔtoːɬ
nonan	nonaːn
nonoch	nónoːtʃ
nopil	nopiɬ
nopiltzin	nopíɬtsin
noquichcho	nokíttʃo
notah	nótaʔ
notecon	notékon
notecuiyo	noteːkʷíjo
noteohuan	noteóːwaːn
noteouh	nóteʍ
notepehuan	nótepéːwaːn̥
notepeuh	notépeːʍ
notezcauh	notéskaʍ
notilmah	notíɬmaʔ
notiyanquiz	notijáːŋkis
notlacahuan	notɬaːkáwaːn
notlacauh	notɬáːkaʍ
notlahtlacol	nótɬaʔtɬákoːɬ
notlahtol	notɬáʔtoːɬ
notlanequiliz	notɬánekílis
notlaxcal	notɬáʃkaɬ
notoca	notoːka
noxocoyouh	nóʃoːkójoːʍ
noyaohuan	nójaːóːwaːn̥
noyolloh	nojóːlːoʔ
occalli	okkálːi
oceloehuatl	oseːloːeːwatɬ
ocelohe	oseːloʔé
ocelomeh	oseːlóːmeʔ
ocelotle	oseːloːtɬé
ocelotl	oːséːloːtɬ
oceloyotl	oseːloːjoːtɬ
ochpaniztli	otʃpaːnistɬi
ococallotl	okoːkalːoːtɬ
ococentli	okoːsentɬi
ococenyollohtli	okoːsenjoːlːoʔtɬi
ococuahuitl	okoːkʷawitɬ
ococuauhtlah	okoːkʷaʍtɬaʔ
ocotl	okotɬ
ocoxochitl	okoːʃoːtʃitɬ
ocozacatl	okoːsákatɬ
octlaliloyan	oktɬaːliːlóːjaːn̥
ocuilloh	okʷilːoʔ
ocuilton	okʷiɬtoːn
ohococuauhtlah	oʔokoːkʷaʍtɬaʔ
ohocotlah	oʔokoːtɬaʔ
ohome	oʔóːme
ohtlatl	oʔtɬatɬ
ohueyix	oːwéːjiʃ
ohuihcayotl	owiʔkaːjoːtɬ
ohxitl	oʔʃitɬ
olin	oliːn̥
ollamaliztli	oːlːamalístɬi
ollama	oːlːáma
olli	oːlːi
olloh	oːlːoʔ
ome	óːme
omicalli	omikalːi
omilhuitl	oːmiɬwitɬ
ompohualilhuitl	oːmpoːwaliɬwitɬ
ompohualli	oːmpoːwalːi
ompohualpa	oːmpoːwaɬpa
onxihuitl	oːnʃiwitɬ
oome	oːóːme
opochmaitl	oːpoːtʃmaːitɬ
oppa	oːppa
oquichchotl	okíttʃoːtɬ
oquichcuacuahueh	okitʃkʷaːkʷaweʔ
oquichhuah	okítʃwaʔ
oquichhuahqueh	okitʃwáʔkeʔ
oquichhuilotl	okitʃwiːloːtɬ
oquichozomahtli	okitʃosomaʔtɬi
oquichtin	okitʃtin
oyahualiuh	oːjawáliʍ
ozomahtin	osomaʔtin
ozomahtli	osomáʔtɬi
pacxixihtli	pákʃiʃíʔtɬi
pahatl	paʔaːtɬ
pahcalli	paʔkalːi
panquetzaliztli	paŋketsalistɬi
pantli	pantɬi
pantli	pantɬi
papalotepiton	paːpaloːtepitoːn
papalotontli	paːpaloːtoːntɬi
patolli	patóːlːi
patriarcameh	patɬíjaɬkáʔmeʔ
peru	peɾu
petlazolcoatl	petɬasoɬkoːaːtɬ
petztli	petstɬi
piccatl	piːkkatɬ
piciyetl	pisijetɬ
piltontli	piɬtoːntɬi
pinolatl	pinólaːtɬ
pinolli	pinólːi
pipiltzitzintin	piːpiɬtsitsintin
pitzocalli	pitsokalːi
pitzoconetl	pitsokoneːtɬ
pocyoh	poːkjoʔ
poliuhqui	poliʍki
pozolatl	posólaːtɬ
pozonallotl	posoːnalːoːtɬ
puñal	ponaːɬ
puñal	punaːɬ
puñaltontli	ponaːɬtoːntɬi
quehquelli	keʔkelːi
quequetzalcoah	keːkétsaɬkóːwaʔ
quetzalcoatl	kétsaɬkóːwaːtɬ
quetzalli	ketsalːi
quetzalpapalotl	ketsalpaːpaːloːtɬ
quexilli	keʃiːlːi
quiliton	kilítoːn̥
quilmolli	kiɬmoːlːi
quilocuilin	kilokʷilin
quilpalli	kiɬpáːlːi
quimichton	kimitʃtoːn
quiyahuitl	kijáwitɬ
quiyotl	kijoːtɬ
quiyoyoh	kijoːjoʔ
sacerdoteyotl	sasérdoːtéʔjoːtl
semana	ʃimaːnaʔ
tacal	táːkaɬ
tacayo	taːkájo
tacel	táseːɬ
tachcocolhuan	taːtʃkoːkóːɬwaːn
tachcocol	taːtʃkóːkoːɬ
tahtin	taʔtin
tahtli	taʔtɬi
tamalli	tamálːi
tamox	táːmoʃ
tanahtontli	tanaʔtoːntɬi
tapalcatemalacatl	tapaɬkatemalakatɬ
tapalcatlapantli	tapaɬkatɬapantɬi
tapalcatl	tapaɬkatɬ
tata	tata
tatzin	táːtsin̥
tayo	táːjo
teacal	teːáːkaɬ
teachcocolhuan	teːaːtʃkoːkóːɬwaːn̥
teachcocol	teːaːtʃkóːkoːɬ
teahpaztli	téaʔpástɬi
tecal	téːkaɬ
techahuanan	teːtʃaːwánaːn̥
techalotl	tetʃaloːtɬ
techalotl	tetʃaloːtɬ
techan	téːtʃaːn
tecihuauh	teːsíwaːʍ
tecomatl	tekómatɬ
teconeuh	teːkóneːʍ
tecpancalli	teːkpankalːi
tecpan	teːkpan
tecpatl	tekpatɬ
tecpilconetl	teːkpiɬkoneːtɬ
tecpilli	teːkpilːi
tecpin	tekpin
tecpintlah	tekpintɬaʔ
tecpintli	tekpintɬi
tecuacan	teːkʷakaːn
tecuampiltontli	teːkʷaːmpiɬtoːntɬi
tecuancoacoconeh	teːkʷaːŋkoːwaːkoːkoneʔ
tecuancoaconetl	teːkʷaːŋkoːwaːkoneːtɬ
tecuancoatl	teːkʷaːnkoːwaːtɬ
tecuanconetl	teːkʷaːŋkoneːtɬ
tecuanehuatl	teːkʷaːneːwatɬ
tecuanimeh	teːkʷaːnimeʔ
tecuani	teːkʷáːni
tecuappantli	tekʷapántɬi
tecuicihtli	tékʷisíʔtɬi
tecuilhuitontli	teːkʷiɬwitoːntɬi
tehtetlah	teʔtetɬaʔ
tehuayo	teːwájo
tehuilotl	tewiːloːtɬ
telmatl	téːɬmaːtɬ
telpochchotl	teːɬpoːttʃoːtɬ
telpochtli	teːɬpoːtʃtɬi
telpochtontli	teːɬpoːtʃtoːntɬi
telpochyotl	teːɬpoːtʃjoːtɬ
tel	téːɬ
temalacatl	temalakatɬ
temecahuitequini	teːmekawiːtekini
temeh	temeʔ
temetzehqueh	temeːtsekeʔ
temetzeh	temeːtseʔ
temetztli	temeːtstɬi
tenamaztli	tenamastɬi
tenamic	teːnáːmik
tenantzin	teːnáːntsin̥
tenextetl	teneʃtetɬ
tenextli	teneʃtɬi
tenochtitlan	tenoːtʃtítɬan
tenochtitlan	tenotʃtítɬan
tenohpallah	ténoʔpálːaʔ
tenohpalli	ténoʔpálːi
teocalcuitlapilli	teoːkaɬkʷitɬapilːi
teocaltontli	teoːkaɬtoːntɬi
teocaltototl	teoːkaɬtoːtoːtɬ
teocuitlatlalli	teoːkʷitɬatɬaːlːi
teocuitlaxalli	teoːkʷitɬaʃaːlːi
teohcalli	téoʔkálːi
teomicqueh	teoːmikkeʔ
teomicqui	teoːmikki
teomilco	teoːmíːɬko
teopan	teoːpan
teopantli	teoːpantɬi
teopantontli	teoːpantoːntɬi
teopixcacalli	teoːpiʃkaːkálːi
teopixcachantli	teoːpiʃkaːtʃaːntɬi
teopixcatlahtoani	téoːpíʃkaːtɬáʔtowáːni
teopixcatlahtohqueh	teóːpiʃkáːtɬaʔtóʔkeʔ
teopixcayotl	teoːpiʃkaːjoːtɬ
teoquichhui	teːokítʃwi
teotl	teoːtɬ
teoyotl	teoːjoːtɬ
tepechichi	tepeːtʃitʃi
tepeilhuitl	tepeːiɬwitɬ
tepeitzcuintli	tepeːitskʷintɬi
tepemeh	tepeːmeʔ
tepeololli	tepeːoloːlːi
tepetlah	tepeːtɬaʔ
tepetontli	tepeːtoːntɬi
tepetotontin	tepeːtoːtoːntin
tepeyahualli	tepeːjawalːi
tepezolconetl	tepeːsoːɬkoneːtɬ
tepezolin	tepeːsoːlin
tepiton	tepitoːn
tepolayotl	tepoːlaːjoːtɬ
tepolcamapiccatl	tepoːɬkamapíːkkatɬ
tepolcuaxipeuhcatl	tepoɬkʷaːʃipeːʍkatɬ
tepolehuayotl	tepoːleːwajoːtɬ
teponazoani	teponaːsoaːni
teponazoa	teponaːsoa
teponazohqueh	teponaːsoʔkeʔ
teponazoh	teponaːsoʔ
teponaztli	teponaːstɬi
teponaztzatzaztli	teponaːstsatsastɬi
tepozmaccuauhtepiton	teposmaːkkʷaʍtepitoːn
tepozmaccuauhtontli	teposmaːkkʷaʍtoːntɬi
tepozmitl	tepósmiːtɬ
tepoztli	tepostɬi
tepoztopilli	tepostoːpiːlːi
tepoztopiltontli	tepostoːpiːɬtoːntɬi
tetahtzin	teːtáʔtsin̥
teteoh	tèːtéòʔ
teteohuan	teteóːwaːn
teteouh	téːteʍ
tetepeh	teːtepeʔ
teteuctin	teːteːkʷtin
tetiyanquiz	teːtijáːŋkis
tetlah	tetɬaʔ
tetl	tetɬ
tetontli	tetoːntɬi
tetzilacatl	tetsilakatɬ
teuctli	teːkʷtɬi
teuhtlah	teʍtɬaʔ
teuhtli	teʍtɬi
teuhtontli	teʍtoːntɬi
texcalli	teʃkalːi
texcan	teːʃkan
tezcatepiton	teskatepitoːn
tezcatontli	teskatoːntɬi
ticiyotl	tiːsijoːtɬ
tilmahocuilin	tiɬmaʔokʷilin
tilmahtli	tiɬmáʔtɬi
titlantli	tiːtɬantɬi
tix	tíʃ
tiyamicacalli	tijaːmikaːkalːi
tiyanquiztli	tijaːŋkístɬi
tlaayotilli	tɬaaːjoːtíːlːi
tlacah	tɬákaʔ
tlacahuah	tɬaːkáwaʔ
tlacamichin	tɬaːkamitʃin
tlacanacatl	tɬaːkanakatɬ
tlacatecolocihuatl	tɬaːkatekoloːosiwaːtɬ
tlacatecolooquichtli	tɬaːkatekoloːokitʃtɬi
tlacatecolotlahtolli	tɬaːkatekoloːtɬaʔtóːlːi
tlacatecoloxocohuitztli	tɬaːkatekoloːʃokowitstɬi
tlacatilizilhuitl	tɬaːkatilisiɬwitɬ
tlacatl	tɬaːkatɬ
tlacaxinachtli	tɬaːkaʃinaːtʃtɬi
tlacaxipehualiztli	tɬaːkaʃiːpeːwalistɬi
tlachcayotl	tɬatʃkajoːtɬ
tlachihualtontli	tɬatʃiːwaɬtoːntɬi
tlachiuhtontli	tɬatʃiːʍtoːntɬi
tlachtli	tɬatʃtɬi
tlacohtontli	tɬaːkoʔtoːntɬi
tlacotl	tɬákoːtɬ
tlacuahuac	tɬakʷaːwak
tlacualli	tɬakwalːi
tlacuatzin	tɬakʷatsin
tlahcuilolli	tɬaʔkʷiloːlːi
tlahtlamaliztli	tɬaʔtɬamalístɬi
tlahtoaniton	tɬaʔtowaːnitoːn
tlahtohcapilli	tɬaʔtoʔkaːpílːi
tlahtohcapipiltin	tɬaʔtoʔkaːpiːpiɬtin̥
tlahtohcatepiton	tɬaʔtoʔkaːtepitoːn
tlahtohcatlatquitl	tɬaʔtoʔkaːtɬatkitɬ
tlahtohcatontli	tɬaʔtoʔkaːtóːntɬi
tlahtohcatopilli	tɬaʔtoʔkaːtopílːi
tlahtohcatotontin	tɬáʔtoʔkáːtotóːntin̥
tlahtohcayohqueh	tɬaʔtoʔkaːjóʔkeʔ
tlahtohcayoh	tɬaʔtoʔkaːjoʔ
tlahtohqueh	tɬaʔtóʔkeʔ
tlahuilcalli	tɬaːwiːɬkalːi
tlahuilli	tɬaːwiːlːi
tlahuilloh	tɬaːwiːlːoʔ
tlahzolli	tɬaʔsolːi
tlaixxoh	tɬaiːʃːoʔ
tlalaalatlah	tɬaːlaalatɬaʔ
tlalaala	tɬaːlaala
tlalalacatl	tɬalaláːkatɬ
tlalcacahuatl	tɬaːɬkakáwatɬ
tlalchichimeh	tɬaːɬtʃitʃímeʔ
tlalchichi	tɬaːɬtʃitʃi
tlalcoyotl	tɬaːɬkojoːtɬ
tlalli	tɬaːlːi
tlalocahuehuetqueh	tɬáːlokáːweːwétkeʔ
tlaloc	tɬaːlok
tlalohqueh	tɬaːloʔkeʔ
tlaltetontli	tɬaːɬtetoːntɬi
tlamahuizolli	tɬamáːwisóːlːi
tlamahuizoltica	tɬámaːwísoːɬtíka
tlamanaliztli	tɬamánalístɬi
tlamatzohualcaxitl	tɬamaːtsowaɬkáʃitɬ
tlamatzohualli	tɬamaːtsowálːi
tlanequiliztli	tɬanékilístɬi
tlanomitl	tɬanomitɬ
tlaoctacaantli	tɬaoktakaaːntɬi
tlatatactli	tlátatáktɬi
tlatatactzaccayotl	tlátatáktsakkáːjoːtɬ
tlateochihualatl	tɬateoːtʃiːwalaːtɬ
tlateochihuallaxcalli	tɬateoːtʃiːwalːaʃkálːi
tlatlapoloniton	tɬatɬapoːloːnitoːn
tlatlatlahtlalilli	tɬatɬatɬaʔtɬaːliːlːi
tlatquihuahqueh	tɬatkiwáʔkeʔ
tlatquihuah	tɬatkíwaʔ
tlattoyan	tɬat̚tóːjaːn̥
tlaxcalatolli	tɬaʃkalaːtoːlːi
tlaxcalchiquihuitl	tɬaʃkaɬtʃikiwitɬ
tlaxcalli	tɬaʃkalːi
tlaxcalmimilyahualtontli	tɬaʃkaɬmimiɬjawaɬtoːntɬi
tlaxcalpacholli	tɬaʃkalpatʃolːi
tlaxcaltexcalli	tɬaʃkaɬteʃkalːi
tlaxtlahuilehqueh	tɬaʃtɬaːwiːleʔkeʔ
tlaxtlahuileh	tɬaʃtɬaːwiːleʔ
tlaxtlahuilli	tɬaʃtɬaːwiːlːi
tlaxtlahuiltontli	tɬaʃtɬaːwiːɬtoːntɬi
tlazohnantzintli	tɬasóʔnaːntsíntɬi
tlazohnantzitzintin	tɬásoʔnáːntsitsíntin̥
tlazohtli	tɬasóʔtɬi
tlazolli	tɬasoːlːi
tlazolloh	tɬasoːlːoʔ
tlazololololoni	tɬasoːloloːloːloːni
tlazololololoniton	tɬasoːloloːloːloːnitoːn̥
tleatoyatl	tɬeaːtojatɬ
tlecalli	tɬekalːi
tlecuiltontli	tɬekʷiːɬtoːntɬi
tletepiton	tɬetepitoːn
tletl	tɬétɬ
tletontli	tɬetoːntɬi
tletzintli	tɬetsíntɬi
tlilatl	tɬíːlaːtɬ
tliltetl	tɬíːɬtetɬ
tlilxochitl	tɬiːɬʃóːtʃitɬ
tocaamatl	toːkaːaːmatɬ
tocal	tokaɬ
tochahuanahuan	totʃaːwanáːwan̥
tochahuanan	totʃaːwánaːn̥
tochan	tótʃaːn
tochcalli	toːtʃkalːi
tochichihuan	tótʃitʃíwaːn̥
tochichiuh	totʃítʃiʍ
tochil	tótʃiːɬ
tochimal	totʃíːmaɬ
tochohmitl	toːtʃoʔmitɬ
tochtepiton	toːtʃtepitoːn
tochtli	toːtʃtɬi
tocih	tósiʔ
tocihuahuan	tosiwáːwaːn
tococohuan	tokokówaːn
tocuexcoch	tokʷwéʃkotʃ
tocuic	tókʷiːk
tocuitl	tókʷitɬ
toltecatontli	toːɬteːkatóːntɬi
tomachhuan	tomátʃwaːn̥
tomach	tómatʃ
tomatl	tómatɬ
tomazahuan	tomasáːwaːn
tominchiuhqui	tomiːntʃiːwki
tomin	tómiːn
tomiquiz	tomíkis
tomiyo	tomíjo
tonacayo	tonakájo
tonahuan	tonáːwaːn̥
tonahuatlahtol	tonaːwatɬáʔtoːɬ
tonalamatl	toːnalaːmatɬ
tonalchilli	toːnaɬtʃiːlːi
tonalco	toːnaɬko
tonallan	toːnalːaːn
tonalpohualli	toːnaɬpoːwalːi
tonalpouhqueh	toːnaɬpoːʍkeʔ
tonalpouhqui	toːnaɬpoːʍki
tonan	tonaːn̥
tonantzin	tònáːn̥tsìn̥
tonatiuhyoh	toːnatiʍjoʔ
tonoch	tónoːtʃ
topitl	topitɬ
topitzin	topitsin
totahhuan	totáʔwaːn
totah	tótaʔ
totecon	totékon
totec	tóteːkʷ
totecuiyo	tótèːkʷíjò
toteohuan	toteóːwaːn
toteopixcahuan	tóteóːpiʃkáːwaːn̥
toteopixcauh	toteoːpíʃkaːʍ
toteouh	tóteʍ
totepehuan	tótepéːwaːn̥
totepeuh	totépeːʍ
totilmah	totíɬmaʔ
totiyanquiz	totijáːŋkis
totlacahuan	totɬaːkáwaːn
totlacauh	totɬáːkaʍ
totlahtohcatzin	totláʔtoʔkáːtsin̥
totlahtohcauh	totlaʔtóʔkaːʍ
totlahtol	totɬáʔtoːɬ
totlaxcal	totɬáʃkaɬ
totlazohnantzin	totɬásoʔnáːntsin̥
totlazohpiltzin	totɬásoʔpíɬtsin̥
totochiquihuitl	toːtoːtʃikiwitɬ
totoconetl	toːtoːkoneːtɬ
totolayotl	toːtoɬaːjoːtɬ
totolcalli	toːtoɬkalːi
totolcuitlatl	toːtoɬkʷitɬatɬ
totolmolli	toːtoɬmoːlːi
totoltecahcalli	toːtoɬtekaʔkalːi
totolteehuatl	toːtoɬteeːwatɬ
totoltemolli	toːtoɬtemoːlːi
totoltetl	toːtoɬtetɬ
totomatlatl	toːtoːmaːtɬatɬ
totomeh	toːtoːmeʔ
totomicqui	toːtoːmikki
tototapahzolli	toːtoːtapaʔsolːi
tototecaxtli	toːtoːtekaʃtɬi
tototepiton	toːtoːtepitoːn
tototetl	toːtoːtetɬ
tototontli	toːtoːtóːntɬi
toxocoyouh	tóʃoːkójoːʍ
toyaohuan	tójaːóːwaːn̥
toyolloh	tojóːlːoʔ
tozampotzalli	toːsampoːtsalːi
tozoztontli	toːsoːstoːntɬi
tzapaton	tsapatoːn
tzapa	tsapa
tzapatzin	tsapatsin
tzilacayohtli	tsilakaːjoʔtɬi
tzipitl	tsipitɬ
virgineme	wíːɬʃinémeʔ
xacalli	ʃakálːi
xahcaltontli	ʃaʔkaɬtoːntɬi
xallah	ʃaːlːaʔ
xaltetlah	ʃaːɬtetɬaʔ
xalxococuahuitl	ʃaːlʃokokʷawitɬ
xamixcalchihualoyan	ʃamiʃkaɬtʃiːwaloːjaːn
xamixcalcopinaloyan	ʃamiʃkaɬkopiːnaloːjaːn
xamixcalli	ʃamiʃkalːi
xamixcaltepantli	ʃamiʃkaɬtepaːntɬi
xamixcaltexcalli	ʃamiʃkaɬteʃkalːi
xicalli	ʃiːkɑlli
xicama	ʃiːkama
xicmecayotl	ʃiːkmekajoːtɬ
xicohcuitlaocochiuhqui	ʃiːkoʔkʷitɬaokoːtʃiːʍki
xicohcuitlaocotl	ʃiːkoʔkʷitɬaokoːtɬ
xicohcuitlatl	ʃiːkoʔkʷitɬatɬ
xilonen	ʃiːloːnen̥
xilotlah	ʃiːloːtɬaʔ
xipintontli	ʃipintoːntɬi
xiuhtlahcuilohqueh	ʃiʍtɬaʔkʷilóʔkeʔ
xiuhtlahcuiloh	ʃiʍtɬaʔkʷíloʔ
xiuhtototl	ʃiʍtóːtoːtɬ
xochichinancalli	ʃoːtʃitʃinaːŋkalːi
xochihcualcuahuitl	ʃoːtʃiʔkʷaɬkʷawitɬ
xochihcualcuauhtlah	ʃoːtʃiʔkʷaɬkʷaʍtɬaʔ
xochihcualli	ʃoːtʃiʔkʷálːi
xochimanqueh	ʃoːtʃimaŋkeʔ
xochimicqueh	ʃoːtʃimikkeʔ
xochimicqui	ʃoːtʃimikki
xochimilco	ʃoːtʃimiːlko
xochincuahuitl	ʃoːtʃiŋkʷáwitɬ
xochiyoh	ʃoːtʃijoʔ
xoconochnohpalli	ʃókonóːtʃnoʔpálːi
xoconochtli	ʃokonoːtʃtɬi
xocotexxoh	ʃokoteʃoʔ
xoloitzcuintli	ʃolotskʷintɬi
xolo	ʃoːlo
xolotl	ʃoːloːtɬ
xoloton	ʃoːloːtoːn
xometl	ʃoːmetɬ
xopilchicuace	ʃopiɬtʃikʷase
xoxotlameh	ʃoʃoːtɬameʔ
xoxotla	ʃoʃoːtɬa
xoxotlaton	ʃoʃoːtɬatoːn
yacacuitlatl	jakakʷitɬatɬ
yacacuitleh	jakakʷitɬeʔ
yacatotonaton	jakatotonatoːn
yacaxihuitl	jakaʃiwitɬ
yaoacalli	jaːoːwaːkalːi
yaocalli	yaːoːkalːi
yaotl	jáːoːtɬ
yaoyotl	jaːóːjoːtɬ
yecatl	jeːkaːtɬ
yeliztli	jelistɬi
yohualahhuachtli	jowalaʔwatʃtɬi
yohualahhuechtli	jowalaʔwetʃtɬi
yolcatlaxcalli	joːɬkaːtɬaʃkalːi
yolilizatl	joːlilísaːtɬ
yoliliztlaxcalli	joːlilistɬaʃkálːi
yoliliztli	joːlilístɬi
yollohtli	joːlːoʔtɬi
yollohxochitl	joːlːoʔʃoːtʃitɬ
zacamecatl	sakamekatɬ
zacaocuilin	sakaokʷilin
zacatlah	sakatɬaʔ
zacayamanqui	sakajamáːŋki
zacayaman	sakajámaːn̥
zahzacatlah	saʔsakatɬaʔ
zotolcactli	soːtoɬkaktɬi
zotollah	soːtolːaʔ
zoyacapolin	soːjakapolin̥
zoyacuahuitl	soːjakʷawitɬ
zoyacuauhtlah	soːjakʷaʍtɬaʔ
zoyatanahtontli	soːjatanaʔtoːntɬi
zoyatepiton	soːjatepitoːn
zoyatlah	soːjatɬaʔ
zoyatl	soːjaːtɬ
