abaga	ʔʌbagʌ
abaka	ʔabʌkʌ
abakadhan	ʔʌbʌkʌd̪han̪
abaniko	ʔʌbʌn̪ikɔ
abapo	ʔʌbapɔ
abayon	ʔʌbajɔn̪
abello	ʔʌbil̪jɔ
aber	ʔʌbiɾ̪
aberiya	ʔʌbɪɾ̪ja
abesamis	ʔʌbɪs̪amɪs̪
abilidad	ʔʌbɪl̪ɪd̪ad̪
abiso	ʔʌbis̪ɔ
abito	ʔabɪt̪o
abli	ʔʌbl̪i
abo	ʔʌbo
abogado	ʔʌbɔgad̪ɔ
abogago	ʔʌbɔgagɔ
abogasiya	ʔʌbɔgʌs̪iʌ
abohan	ʔʌbohʌn̪
abohon	ʔʌbohɔn̪
abokado	ʔʌbɔkad̪ɔ
abono	ʔʌbon̪ɔ
abrebisyon	ʔʌbɾ̪ɪbis̪jɔn̪
abri	ʔʌbɾ̪i
abrigo	ʔʌbɾ̪igɔ
abril	ʔʌbɾ̪il̪
absolusyon	ʔʌbs̪ɔl̪ʊs̪jon̪
absuwelto	ʔʌbs̪wil̪t̪ɔ
aburido	ʔʌbʊɾ̪id̪ɔ
abutra	ʔʌbut̪ɾ̪ʌ
abyan	ʔabjʌn̪
abyerto	ʔʌbjiɾ̪t̪ɔ
abyogan	ʔʌbjogʌn̪
abyon	ʔʌbjon̪
acebedo	ʔʌs̪ɪbid̪ɔ
adan	ʔʌd̪an̪
adbentista	ʔʌd̪bɪn̪t̪is̪t̪ʌ
adbiyento	ʔʌd̪bjin̪t̪ɔ
adelantado	ʔʌd̪ɪl̪ʌn̪t̪ad̪ɔ
adelpa	ʔʌd̪il̪pʌ
adlaw	ʔad̪l̪aʊ̯
adlawan	ʔʌd̪l̪awʌn̪
administrador	ʔʌd̪mɪn̪ɪs̪t̪ɾ̪ʌd̪oɾ̪
administrasiyon	ʔʌd̪mɪn̪ɪs̪t̪ɾ̪ʌs̪jon̪
administratibo	ʔʌd̪mɪn̪ɪs̪t̪ɾ̪ʌt̪ibɔ
adres	ʔad̪ɾ̪ɪs̪
adto	ʔʌd̪t̪o
aduna	ʔʌd̪un̪ʌ
adunahan	ʔʌd̪ʊn̪ahʌn̪
adunay	ʔʌd̪un̪aɪ̯
agdao	ʔʌgd̪aʊ̯
aghop	ʔʌghop
agigising	ʔʌgɪgis̪ɪŋ
agila	ʔagɪl̪ʌ
agosto	ʔʌgos̪t̪ɔ
agridulse	ʔʌgɾ̪ɪd̪ul̪s̪ɪ
aguho	ʔʌguhɔʔ
aguilar	ʔʌgɪl̪aɾ̪
ahedres	ʔʌhɪd̪ɾ̪is̪
ahensiya	ʔʌhin̪s̪ja
ahente	ʔʌhin̪t̪ɪ
aho	ʔʌho
ahos	ʔahɔs̪
ajaw	ʔʌdʒaʊ̯
akademiya	ʔʌkʌd̪imjʌ
aklas	ʔʌkl̪as̪
ako	ʔʌho
ako	ʔʌko
aksidente	ʔʌks̪ɪd̪in̪t̪ɪ
aksiyon	ʔʌks̪jon̪
aksyon	ʔʌks̪jon̪
aktibidades	ʔʌkt̪ɪbɪd̪ad̪ɪs̪
akurdiyon	ʔʌkʊɾ̪d̪jon̪
akusar	ʔʌkʊs̪aɾ̪
akusasyon	ʔʌkʊs̪ʌs̪jon̪
alagad	ʔʌl̪agʌd̪
alagad	ʔʌl̪ʌgad̪
alahas	ʔʌl̪ahʌs̪
alahero	ʔʌl̪ʌhiɾ̪ɔ
alak	ʔal̪ʌk
alakaak	ʔʌl̪ʌkaʔʌk
alamag	ʔʌl̪amʌg
alambre	ʔʌl̪ambɾ̪ɪ
alang	ʔal̪ʌŋ
alangilan	ʔʌl̪ʌŋil̪ʌn̪
alarma	ʔʌl̪aɾ̪mʌ
alat	ʔal̪ʌt̪
alat	ʔʌl̪at̪
albay	ʔʌl̪baɪ̯
alcoy	ʔʌl̪koj
aldeguer	ʔʌl̪d̪ɪgiɾ̪
alegasyon	ʔʌl̪ɪgʌs̪jon̪
alegoriya	ʔʌl̪ɪgɔɾ̪iʌ
alegre	ʔʌl̪igɾ̪ɪ
aleluya	ʔʌl̪ɪl̪ujʌ
alfonso	ʔʌl̪pon̪s̪ɔ
alibangbang	ʔʌl̪ɪbʌŋbaŋ
alibyo	ʔʌl̪ibjɔ
aligi	ʔʌl̪igɪ
alikate	ʔʌl̪ɪkat̪ɪ
alimango	ʔʌl̪ɪmaŋɔ
alimasag	ʔʌl̪ɪmas̪ʌg
alimpatakan	ʔʌl̪ɪmpʌt̪akʌn̪
alimpulos	ʔʌjɪmpujɔs̪
alimpulos	ʔʌl̪ɪmpos̪
alimpulos	ʔʌl̪ɪmpudʒɔs̪
alimpulos	ʔʌl̪ɪmpul̪ɔs̪
alimyon	ʔʌl̪ɪmjon̪
alindahaw	ʔʌl̪ɪn̪d̪ahaʊ̯
alindanaw	ʔʌl̪ɪn̪d̪an̪aʊ̯
alingagngag	ɐlɪŋʌgŋʌg
alkalde	ʔʌl̪kal̪d̪ɪ
almirante	ʔʌl̪mɪɾ̪an̪t̪ɪ
almirol	ʔʌl̪mɪɾ̪ol̪
almoranas	ʔʌl̪mɔɾ̪an̪ʌs̪
alpa	ʔal̪pʌ
alpabeto	ʔʌl̪pʌbit̪ɔ
alpombra	ʔʌl̪pombɾ̪ʌ
alsa	ʔʌl̪s̪a
alvarado	ʔʌl̪bʌɾ̪ad̪ɔ
amag	ʔamʌg
amahan	ʔʌmʌhan̪
amaon	ʔʌmʌʔon̪
amapola	ʔʌmʌpol̪ʌ
amarilyo	ʔʌmʌɾ̪il̪jɔ
ambulansiya	ʔʌmbʊl̪an̪s̪jʌ
amendar	ʔʌmɪn̪d̪aɾ̪
amerikano	ʔʌmɪɾ̪ɪkan̪ɔ
amigo	ʔʌmigɔ
amihan	ʔʌmihʌn̪
amihanan	ʔʌmɪhan̪ʌn̪
amnestiya	ʔʌmn̪ɪs̪t̪iʌ
amonya	ʔʌmon̪jʌ
ampaw	ʔampaʊ̯
amplipikasyon	ʔʌmpl̪ɪpɪkʌs̪jon̪
anahaw	ʔʌn̪ahaʊ̯
anak	ʔʌn̪ak
anas	ʔan̪ʌs̪
anay	ʔan̪aɪ̯
anay	ʔʌn̪aɪ̯
andam	ʔan̪d̪ʌm
anemya	ʔʌn̪imjʌ
anga	ʔaŋʌ
angga	ʔaŋgʌʔ
anghel	ʔʌŋhil̪
anghit	ʔʌŋhit̪
angkla	ʔaŋkl̪ʌ
angso	ʔʌŋs̪o
angtod	ʔʌŋt̪od̪
anhing	ʔaŋhɪŋ
anilaw	ʔʌn̪ɪl̪aʊ̯
animal	ʔʌn̪ɪmal̪
aninipot	ʔʌn̪ɪn̪ipɔt̪
anino	ʔʌn̪in̪ɔ
anod	ʔan̪ɔd̪
anso	ʔʌn̪s̪o
antepara	ʔʌn̪t̪ɪpaɾ̪ʌ
antigo	ʔan̪t̪ɪgɔ
antisipasyon	ʔʌn̪t̪ɪs̪ɪpʌs̪jon̪
antod	ʔʌn̪t̪od̪
anyag	ʔʌn̪jag
apatot	ʔʌpat̪ɔt̪
apdo	ʔʌpd̪o
apektado	ʔʌpɪkt̪ad̪ɔ
apelyido	ʔʌpɪl̪jid̪ɔ
aping	ʔapɪŋ
apo	ʔʌpo
apostol	ʔʌpos̪t̪ɔl̪
aprobado	ʔʌpɾ̪ɔbad̪ɔ
apura	ʔʌpʊɾ̪a
apurado	ʔʌpʊɾ̪ad̪ɔ
aragon	ʔʌɾ̪ʌgon̪
arak	ʔaɾ̪ʌk
arcaya	ʔʌɾ̪kajʌ
arcenal	ʔʌɾ̪s̪ɪn̪al̪
arellano	ʔʌɾ̪ɪl̪jan̪ɔ
ari	ʔaɾ̪ɪ
arisgado	ʔʌɾ̪ɪs̪gad̪ɔ
arisgar	ʔʌɾ̪is̪gʌɾ̪
ariyos	ʔʌɾ̪ijɔs̪
arkipelago	ʔʌɾ̪kɪpil̪ʌgɔ
arkitekto	ʔʌɾ̪kɪt̪ikt̪ɔ
arnaiz	ʔʌɾ̪n̪aʔɪs̪
arriesgado	ʔʌɾ̪jɪs̪gad̪ɔ
arsobispado	ʔʌɾ̪s̪ɔbɪs̪pad̪ɔ
arsobispo	ʔʌɾ̪s̪ɔbis̪pɔ
asa	ʔas̪ʌ
asawa	ʔʌs̪awʌ
aseras	ʔʌs̪iɾ̪ʌs̪
asin	ʔʌs̪in̪
aslom	ʔʌs̪l̪om
aso	ʔʌs̪o
asosasyon	ʔʌs̪ɔs̪ʌs̪jon̪
aspalto	ʔʌs̪pal̪t̪ɔ
asukar	ʔʌs̪ukʌɾ̪
asul	ʔʌs̪ul̪
asupre	ʔʌs̪upɾ̪ɪ
aswang	ʔʌs̪waŋ
asya	ʔas̪jʌ
ata	ʔat̪ʌʔ
atab	ʔat̪ʌb
atabay	ʔʌt̪abaɪ̯
atake	ʔʌt̪akɪ
atay	ʔat̪aɪ̯
atay	ʔʌt̪aɪ̯
atis	ʔat̪ɪs̪
ato	ʔat̪ɔ
atol	ʔʌt̪ol̪
aton	ʔat̪ɔn̪
atop	ʔʌt̪op
atsay	ʔʌtsaɪ̯
atsoy	ʔʌtsoj
avendaño	ʔʌbɪn̪d̪aɲɔ
away	ʔawaɪ̯
awto	ʔaʊ̯t̪ɔ
awtorisar	ʔaʊ̯t̪ɔɾ̪ɪs̪aɾ̪
ayaay	ʔʌjaʔaɪ̯
ayam	ʔadʒʌm
ayam	ʔajʌm
ayaw	ʔʌdʒaʊ̯
ayaw	ʔʌjaʊ̯
ayroplano	ʔaɪ̯ɾ̪ɔpl̪an̪ɔ
aznar	ʔʌs̪n̪aɾ̪
baang	baʔʌŋ
baba	baʔbʌ
baba	bʌba
babaw	babaʊ̯
babay	babaɪ̯
babay	bʌbaɪ̯
babaye	bʌbadʒɪ
babaye	bʌbajɪ
babaylan	bʌbaɪ̯l̪an̪
baboy	baboɪ̯
baclayon	bʌkl̪ajɔn̪
bacus	bakʊs̪
badlis	bʌd̪l̪is̪
badlit	bʌd̪l̪it̪
badyet	bad̪jɪt̪
baga	bagʌ
baga	bagʌʔ
baga	bʌgaʔ
bagakay	bʌgakaɪ̯
bagani	bʌgan̪ɪʔ
bagaso	bʌgas̪ɔ
bagat	bagʌt̪
bagito	bʌgit̪ɔ
bago	bagɔ
bago	bʌgoʔ
bagol	bʌgol̪
bagon	bagɔn̪
bagon	bʌgon̪
bagongon	bʌgoŋɔn̪
bagos	bagɔs̪
bagsak	bʌgs̪ak
bagtas	bʌgt̪as̪
baguio	bagjɔ
bagyo	bʌgjo
bahada	bʌhad̪ʌ
bahag	bʌhag
bahandi	bʌhan̪d̪ɪ
bahandianon	bʌhʌn̪d̪ɪʔan̪ɔn̪
bahaw	bahaʊ̯
baho	bahɔ
baho	bahɔʔ
baho	bʌhoʔ
bahon	bʌhon̪
baka	bakʌ
bakak	bʌkak
bakal	bʌkal̪
bakilid	bʌkɪl̪id̪
baklad	bʌkl̪ad̪
baklay	bʌkl̪aɪ̯
bako	bʌkoʔ
bakos	bʌkos̪
baktas	bʌkt̪as̪
bakukang	bʌkukʌŋ
bakuna	bʌkun̪ʌ
bakunawa	bʌkʊn̪awʌ
balai	bʌl̪aʔɪ
balalatok	bʌl̪ʌl̪at̪ɔk
balanak	bʌl̪an̪ʌk
balanghoy	bʌl̪ʌŋhoj
balanse	bʌl̪an̪s̪ɪ
balaod	bʌl̪aʔɔd̪
balaodnon	bʌl̪ʌʔɔd̪n̪on̪
balaoron	bʌl̪ʌʔoɾ̪ɔn̪
balaoron	bʌl̪ʌʔɔɾ̪on̪
balas	bʌl̪as̪
balasahon	bʌl̪ʌs̪ʌhon̪
balat	bʌl̪at̪
balatian	bʌl̪ʌt̪iʔʌn̪
balatik	bʌl̪at̪ɪk
balatok	bʌl̪at̪ɔk
balatong	bʌl̪at̪ɔŋ
balaw	bʌl̪aʊ̯
balay	baɪ̯
balay	bʌjaɪ̯
balay	bʌl̪aɪ̯
balbakuwa	bʌl̪bʌkuʌ
balbal	bʌl̪bal̪
balbuena	bʌl̪bwin̪ʌ
balda	bal̪d̪ʌ
balda	bʌl̪d̪a
balde	bal̪d̪ɪ
balete	bʌl̪it̪ɪ
balhibo	bʌl̪hibɔ
balhiboon	bʌl̪hɪboʔɔn̪
balibago	bʌl̪ɪbagɔ
balik	bal̪ɪk
balinsasayaw	bʌl̪in̪s̪ʌs̪ʌjaʊ̯
balintong	bʌl̪ɪn̪t̪oŋ
balion	bʌl̪iʔɔn̪
baliskad	bʌl̪is̪kʌd̪
balite	bʌl̪it̪ɪ
balod	bal̪ɔd̪
balod	bʌl̪od̪
balon	bʌjon̪
balon	bʌl̪on̪
balon	bʌwon̪
balos	bʌl̪os̪
baltazar	bʌl̪t̪ʌs̪aɾ̪
balukag	bʌl̪ukʌg
balyena	bʌl̪jin̪ʌ
banalo	bʌn̪al̪ɔ
banay	ban̪aɪ̯
bandido	bʌn̪d̪id̪ɔ
banga	bʌŋa
banga	bʌŋaʔ
bangag	bʌŋag
bangaw	baŋaʊ̯
bangga	bʌŋgaʔ
bangkarota	bʌŋkʌɾ̪ot̪ʌ
bangkarote	bʌŋkʌɾ̪ot̪ɪ
bangko	baŋkɔ
bangko	baŋkɔʔ
bangon	baŋɔn̪
banig	bʌn̪ig
banigan	bʌn̪ɪgan̪
banika	bʌn̪ɪka
banikanhon	bʌn̪ɪkaŋhɔn̪
banilad	bʌn̪il̪ʌd̪
banog	ban̪ɔg
banog	bʌn̪og
banogon	bʌn̪ɔgon̪
bantay	bʌn̪t̪aɪ̯
bantog	ban̪t̪ɔg
bantogan	bʌn̪t̪ogʌn̪
bantugan	bʌn̪t̪ugʌn̪
banwa	bʌn̪wa
banwaanon	bʌn̪wʌʔan̪ɔn̪
banyaga	bʌn̪jagʌʔ
banyera	bʌn̪jiɾ̪ʌ
banyo	ban̪jɔ
baog	baʔɔg
baog	bʌʔog
barag	bʌɾ̪ag
barang	baɾ̪ʌŋ
barangay	bʌɾ̪ʌŋgaɪ̯
barato	bʌɾ̪at̪ɔ
barcenas	baɾ̪s̪ɪn̪ʌs̪
barkada	bʌɾ̪kad̪ʌ
barrientos	bʌɾ̪jin̪t̪ɔs̪
bartender	baɾ̪t̪ɪn̪d̪iɾ̪
bartolina	bʌɾ̪t̪ɔl̪in̪ʌ
baruto	bʌɾ̪ut̪ɔ
baryable	bʌɾ̪jabl̪ɪ
baryo	barjɔ
baryohanon	bʌrjɔhan̪ɔn̪
basa	bas̪ʌ
basa	bʌs̪aʔ
basahon	bʌs̪ʌhon̪
basco	bas̪kɔ
basi	bas̪ɪ
basin	bas̪ɪn̪
basiyo	bʌs̪ijɔ
basket	bas̪kɪt̪
basketan	bʌs̪kit̪ʌn̪
basketbol	bʌs̪kit̪bɔl̪
baskog	bʌs̪kog
basol	bas̪ɔl̪
basura	bʌs̪uɾ̪ʌ
basurahan	bʌs̪ʊɾ̪ʌhan̪
basurero	bʌs̪ʊɾ̪iɾ̪ɔ
bat	bat̪
bata	bat̪ʌ
bata	bat̪ʌʔ
batad	bʌt̪ad̪
batadbatad	bʌt̪ʌd̪bat̪ʌd̪
batak	bat̪ʌk
batakan	bʌt̪akʌn̪
batal	bʌt̪al̪
batalan	bʌt̪ʌl̪an̪
batalyon	bʌt̪ʌl̪jon̪
batang	bat̪ʌŋ
batang	bʌt̪aŋ
bataon	bʌt̪ʌʔon̪
batasan	bʌt̪as̪ʌn̪
batayan	bʌt̪ajʌn̪
batbat	bat̪bʌt̪
bateriya	bʌt̪ɪɾ̪iʌ
bathala	bʌt̪hal̪ʌʔ
bathay	bat̪haɪ̯
bati	bat̪ɪ
batid	bʌt̪id̪
batiis	bʌt̪ɪʔis̪
batikan	bʌt̪ɪkan̪
batikano	bʌt̪ɪkan̪ɔ
batil	bʌt̪il̪
batin	bat̪ɪn̪
batiya	bʌt̪iʌʔ
bato	bat̪ɔ
bato	bʌt̪o
batok	bat̪ɔk
baton	bʌt̪on̪
batong	bat̪ɔŋ
batoon	bʌt̪oʔɔn̪
batsi	batsɪ
batsilyer	bʌtsɪl̪jiɾ̪
batuta	bʌt̪ut̪ʌʔ
batya	bat̪jʌ
batyag	bʌt̪jag
bautista	baʊ̯t̪is̪t̪ʌ
bawang	bawʌŋ
bawi	bawɪʔ
bawod	bʌwod̪
bawon	bawn̪
bawos	bʌwos̪
bay	baɪ̯
bayabas	bʌdʒabʌs̪
bayabas	bʌjabʌs̪
bayad	badʒʌd̪
bayad	bajʌd̪
bayat	bʌjat̪
bayaw	bʌjaʊ̯
baybay	baɪ̯baɪ̯
bayi	bɐjɪ
bayle	baɪ̯l̪ɪ
baylosis	baɪ̯l̪os̪ɪs̪
baynte	baɪ̯n̪t̪ɪ
bayong	bajɔŋ
bayot	bajɔt̪
belen	bɪl̪in̪
belib	bɪl̪ib
bentana	bɪn̪t̪an̪ʌʔ
bentilador	bɪn̪t̪ɪl̪ʌd̪oɾ̪
berde	biɾ̪d̪ɪ
bernes	biɾ̪n̪ɪs̪
bersikulo	bɪɾ̪s̪ikʊl̪ɔ
berso	biɾ̪s̪ɔ
beterana	bɪt̪ɪɾ̪an̪ʌ
beterano	bɪt̪ɪɾ̪an̪ɔ
bibi	bibɪ
bibingka	bɪbiŋkʌ
bibliya	bibl̪ja
bihag	bihʌg
bihon	bihɔn̪
bika	bɪka
bikangkang	bɪkʌŋkaŋ
biko	bikɔ
bilang	bil̪ʌŋ
bilanggo	bɪl̪ʌŋgoʔ
bilanggoan	bɪl̪ʌŋgoʔʌn̪
bilar	bɪl̪aɾ̪
bilas	bɪl̪as̪
bilat	bɪl̪at̪
bildo	bil̪d̪ɔ
bili	bɪl̪i
bilyar	bɪl̪jaɾ̪
binati	bɪn̪at̪ɪʔ
binatonan	bɪn̪ʌt̪on̪ʌn̪
bingkong	bɪŋkoŋ
binilanggo	bɪn̪ɪl̪ʌŋgoʔ
binisaya	bɪn̪ɪs̪ajʌʔ
bintana	bɪn̪t̪an̪ʌʔ
bira	bɪɾ̪a
birada	bɪɾ̪ad̪ʌ
birtud	bɪɾ̪t̪ud̪
bisan	bis̪ʌn̪
bisaya	bɪs̪ajʌʔ
bisdak	bɪs̪d̪ak
bisdak	bɪzd̪ak
bisikleta	bɪs̪ɪkl̪it̪ʌ
bisita	bɪs̪it̪ʌ
biskuwit	bɪs̪kwit̪
biskwit	bɪs̪kwɪt̪
bisperas	bis̪pɪɾ̪ʌs̪
bitad	bit̪ʌd̪
bitaw	bit̪aʊ̯
bitay	bit̪aɪ̯
bitbit	bit̪bɪt̪
bitoon	bɪt̪oʔɔn̪
bituon	bɪt̪uʔɔn̪
biyabas	bjabʌs̪
biyahe	bjahɪ
biyernes	bjiɾ̪n̪ɪs̪
biyernes	bɪɾnɪs
blanco	bl̪aŋkɔ
bloke	bl̪okɪ
blotter	bl̪at̪ɪɾ̪
boda	bod̪ʌ
bodega	bɔd̪igʌ
bodka	bod̪kʌ
bogohanon	bɔgɔhan̪ɔn̪
bohol	bɔhol̪
bokabularyo	bɔkʌbʊl̪aɾ̪jɔ
bokasyon	bɔkʌs̪jon̪
bolakaw	bɔl̪akaʊ̯
bolinaw	bɔl̪ɪn̪aʊ̯
bolpen	bol̪pɪn̪
boltahe	bɔl̪t̪ahɪ
bombero	bɔmbiɾ̪ɔ
bondying	bon̪d̪jɪŋ
bonghanoy	bɔŋhan̪oɪ̯
bonilla	bɔn̪il̪jʌ
borbon	bɔɾ̪bon̪
borja	boɾ̪hʌ
borongan	bɔɾ̪oŋgʌn̪
bosina	bɔs̪in̪ʌ
boso	bos̪ɔ
bosyo	bos̪jɔ
botar	bɔt̪aɾ̪
botas	bot̪ʌs̪
bote	bot̪ɪ
botelya	bɔt̪il̪jʌ
botik	bɔt̪ik
botika	bɔt̪ikʌ
boto	bot̪ɔ
boykot	bojkɔt̪
braso	bɾ̪as̪ɔ
brigoli	bɾ̪ɪgol̪ɪ
bringhinas	bɾ̪ɪŋhin̪ʌs̪
brip	bɾ̪ip
buak	bʊʔak
buang	buʔʌŋ
buaya	bʊʔajʌ
bubo	bubɔ
bubo	bubɔʔ
budaya	bʊd̪ajʌ
budhi	bʊd̪hiʔ
budong	bʊd̪oŋ
bugang	bʊgaŋ
bugas	bʊgas̪
bugaw	bugaʊ̯
bugdo	bʊgd̪o
bughaw	bʊghaʊ̯
bugnaw	bʊgn̪aʊ̯
bugnay	bʊgn̪aɪ̯
bugtong	bʊgt̪oŋ
buhangin	bʊhaŋɪn̪
buhat	buhʌt̪
buhi	buhɪʔ
buhis	bʊhis̪
buhok	bʊhok
bukag	bʊkag
bukid	bukɪd̪
bukidnon	bʊkɪd̪n̪on̪
buklad	bʊkl̪ad̪
bukol	bukɔl̪
bukton	bʊkt̪on̪
buktot	bʊkt̪ot̪
bukya	bʊkja
bulacan	bʊl̪ʌkan̪
bulad	bʊl̪ad̪
bulak	bul̪ʌk
bulakbol	bʊl̪ʌkbol̪
bulalakaw	bʊl̪ʌl̪akaʊ̯
bulan	bul̪ʌn̪
bulan	buʌn̪
bulang	bul̪ʌŋ
bulang	buʌŋ
bulangan	bʊl̪ʌŋan̪
bulaw	bʊl̪aʊ̯
bulawan	bwawʌn̪
bulawan	bʊl̪awʌn̪
bulbol	bʊl̪bol̪
buldog	bul̪d̪ɔg
bulhog	bʊl̪hog
buli	bʊl̪i
buli	bʊl̪iʔ
bulig	bul̪ɪg
bulinaw	bʊl̪in̪aʊ̯
bulkan	bʊl̪kan̪
bulod	bud̪
bulod	bujɔd̪
bulod	bul̪ɔd̪
bulog	bʊl̪og
bulogan	bʊl̪ɔgan̪
bulto	bul̪t̪ɔ
bumbilya	bʊmbil̪jʌ
bunal	bun̪ʌl̪
bunawan	bʊn̪awʌn̪
bungahoy	bʊŋahoɪ̯
bungaw	bʊŋaʊ̯
bunggo	bʊŋgoʔ
bungi	bʊŋiʔ
bungsod	bʊŋs̪od̪
bungtod	bʊŋt̪od̪
buno	bun̪ɔʔ
buno	bʊn̪oʔ
bunog	bun̪ɔg
bunot	bun̪ɔt̪
bunot	bʊn̪ot̪
bunsod	bʊn̪s̪od̪
buntag	bun̪t̪ʌg
buntag	bʊn̪t̪ag
buntod	bʊn̪t̪od̪
bunwag	bʊn̪wag
bunyag	bun̪jʌg
bunyagan	bʊn̪jagʌn̪
buol	bʊʔol̪
buot	bʊʔot̪
buraw	bʊɾ̪aʊ̯
burgos	buɾ̪gɔs̪
buros	bʊɾ̪os̪
burot	buɾ̪ɔt̪
busay	bʊs̪aɪ̯
buskay	bʊs̪kaɪ̯
busog	bus̪ɔg
busog	bʊs̪og
butakal	bʊt̪ʌkal̪
butakaw	bʊt̪ʌkaʊ̯
butanding	bʊt̪ʌn̪d̪iŋ
butang	bʊt̪aŋ
butkon	bʊt̪kon̪
buto	but̪ɔʔ
butod	bʊt̪od̪
butong	bʊt̪oŋ
buwad	bʊwad̪
buwakaw	bwakaʊ̯
buwang	buʌŋ
buwisit	bwis̪ɪt̪
buyon	bujɔn̪
buyong	bʊjoŋ
byuti	bjut̪ɪ
cabahug	kʌbahʊg
caballero	kʌbʌl̪jiɾ̪ɔ
cabanlit	kʌbʌn̪l̪it̪
cabatuan	kʌbʌt̪uʔʌn̪
cabello	kʌbil̪jɔ
cabrera	kʌbɾ̪iɾ̪ʌ
cadeliña	kʌd̪ɪl̪iɲʌ
cagas	kagʌs̪
cahoy	kahoɪ̯
calamba	kʌl̪ambʌ
calamba	kʌl̪ʌmbaʔ
calculator	kʌl̪kjʊl̪iɪt̪ɔɾ̪
calinan	kʌl̪in̪ʌn̪
calumpang	kʌl̪ʊmpaŋ
camalig	kʌmal̪ɪg
caminero	kʌmɪn̪iɾ̪ɔ
candijay	kʌn̪d̪ihaɪ̯
capalaran	kʌpʌl̪aɾ̪ʌn̪
capistrano	kapɪs̪t̪ɾ̪an̪ɔ
capiz	kapɪs̪
capuyan	kʌpujʌn̪
carcar	kʌɾ̪kaɾ̪
carlos	kaɾ̪l̪ɔs̪
carreon	kʌɾ̪jon̪
castañeda	kʌs̪t̪ʌɲɪd̪ʌ
castaños	kʌs̪t̪aɲɔs̪
castillo	kʌs̪t̪il̪jɔ
castillon	kʌs̪t̪ɪl̪jon̪
catadman	kʌt̪ʌd̪man̪
catarina	kʌt̪ʌɾ̪in̪ʌ
catipay	kʌt̪ipaɪ̯
catmon	kʌt̪mon̪
cayanong	kʌjan̪ɔŋ
cañete	kʌɲɪt̪ɪ
chavez	t̪s̪abɪs̪
chiongbian	t̪s̪ombjʌn̪
cimafranca	s̪ɪmʌpɾ̪aŋkʌ
comendador	kɔmɪn̪d̪ʌd̪oɾ̪
cometa	kɔmit̪ʌ
contreras	kɔn̪t̪ɾ̪iɾ̪ʌs̪
cordova	koɾ̪d̪ɔbʌ
corella	kɔɾ̪il̪jʌ
corominas	kɔɾ̪ɔmin̪ʌs̪
cortes	kɔɾ̪t̪is̪
cotabato	kɔt̪ʌbat̪ɔ
cruz	kɾ̪us̪
cuevas	kwibʌs̪
cutamora	kʊt̪ʌmoɾ̪ʌ
cuyugan	kʊjugʌn̪
cyril	s̪aɪ̯ɾ̪ɪl̪
cyril	s̪iɾ̪ɪl̪
cyrus	s̪aɪ̯ɾ̪ʊs̪
daan	d̪aʔʌn̪
daanglungsod	d̪ʌʌŋl̪ʊŋs̪od̪
daanlungsod	d̪ʌʌn̪l̪ʊŋs̪od̪
dacumos	d̪ʌkumɔs̪
dagami	d̪ʌgamɪ
dagan	d̪agʌn̪
dagat	d̪agʌt̪
daghan	d̪ʌghan̪
dagit	d̪agɪt̪
dagohoy	d̪ʌgohoɪ̯
dagom	d̪agɔm
daguldol	d̪ʌgul̪d̪ɔl̪
dagway	d̪ʌgwaɪ̯
dahil	d̪ʌhil̪
dahom	d̪ʌhom
dahon	d̪ahɔn̪
daing	d̪aʔɪŋ
dakbalay	d̪ʌkbʌl̪aɪ̯
dakbayan	d̪ʌkbʌjan̪
dako	d̪ʌkoʔ
dalag	d̪ag
dalag	d̪ʌjag
dalag	d̪ʌl̪ag
dalaga	d̪ʌl̪agʌ
dalaginding	d̪ʌl̪ʌgɪn̪d̪iŋ
dalagita	d̪ʌl̪ʌgit̪ʌ
dalan	d̪al̪ʌn̪
dalan	d̪an̪
dali	d̪ʌl̪iʔ
dalikdik	d̪ʌl̪ikd̪ɪk
dalo	d̪ʌl̪oʔ
dalugdog	d̪ʌl̪ugd̪ɔg
dalunggan	d̪ʊŋgan̪
dalunggan	d̪ʌl̪ʊŋgan̪
dalunggan	d̪ʌwŋgan̪
damay	d̪amaɪ̯
damgo	d̪amgɔ
dampog	d̪ʌmpog
danaw	d̪an̪aʊ̯
dangaw	d̪aŋaʊ̯
danggit	d̪ʌŋgit̪
danilo	d̪ʌn̪il̪ɔ
daog	d̪ʌʔog
daot	d̪aʔɔt̪
daot	d̪ʌʔot̪
daotan	d̪ʌʔot̪ʌn̪
daro	d̪aɾ̪ɔ
daster	d̪as̪t̪ɪɾ̪
dato	d̪at̪ɔʔ
dawa	d̪awʌ
dawende	d̪ʌwin̪d̪ɪ
dawugdog	d̪ʌwugd̪ɔg
dayap	d̪ajʌp
dayeg	d̪ajɪg
dayo	d̪adʒɔ
dayo	d̪ajɔ
deboto	d̪ɪbot̪ɔ
dedbol	d̪id̪bɔl̪
dekada	d̪ɪkad̪ʌ
dekorar	d̪ɪkɔɾ̪aɾ̪
dekorasyon	d̪ɪkɔɾ̪ʌs̪jon̪
delikado	d̪ɪl̪ɪkad̪ɔ
deliryo	d̪ɪl̪iɾ̪jɔ
denotasyon	d̪ɪn̪ɔt̪ʌs̪jon̪
desisyon	d̪ɪs̪ɪs̪jon̪
desperado	d̪ɪs̪pɪɾ̪ad̪ɔ
detalye	d̪ɪt̪al̪jɪ
determinasyon	d̪ɪt̪ɪɾ̪mɪn̪ʌs̪jon̪
dewende	d̪ɪwin̪d̪ɪ
diaz	d̪iʌs̪
diin	d̪iʔɪn̪
diksyonaryo	d̪ɪks̪jɔn̪aɾ̪jɔ
dila	d̪il̪ʌʔ
dili	d̪ɪl̪i
dinhi	d̪ɪŋhi
diriyot	d̪ɪɾ̪jot̪
disenteriya	d̪ɪs̪ɪn̪t̪ɪɾ̪iʌ
diskuwento	d̪ɪs̪kwin̪t̪ɔ
disposisyon	d̪ɪs̪pɔs̪ɪs̪jon̪
disyembre	d̪ɪs̪jimbɾ̪ɪ
dita	d̪ɪt̪aʔ
divinagracia	d̪ɪbɪn̪ʌgɾ̪as̪jʌ
diwa	d̪iwʌʔ
diyakono	d̪jakɔn̪o
diyos	d̪jos̪
diyot	d̪jot̪
diyotay	d̪ɪjɔt̪aɪ̯
diyutay	d̪jʊt̪aɪ̯
dodong	d̪od̪ɔŋ
dolongan	d̪ɔl̪oŋʌn̪
domeng	d̪omɪŋ
dominggo	d̪ɔmiŋgɔ
dribol	d̪ɾ̪ibɔl̪
duganganan	d̪ʊgʌŋan̪ʌn̪
dugay	d̪ugaɪ̯
dugdog	d̪ugd̪ɔg
dughan	d̪ʊghan̪
dughit	d̪ughɪt̪
dugo	d̪ʊgoʔ
dugos	d̪ugɔs̪
dugta	d̪ugt̪ʌʔ
duha	d̪ʊha
duhaylungsod	d̪ʊhaɪ̯l̪ʊŋs̪od̪
dukesa	d̪ʊkis̪ʌ
duko	d̪ʊkoʔ
dukot	d̪ʊkot̪
dula	d̪ul̪ʌʔ
dula	d̪uʌʔ
dulaan	d̪waʔʌn̪
dulaan	d̪ʊl̪aʔʌn̪
dulok	d̪ul̪ɔk
dulom	d̪ʊl̪om
dulon	d̪ujɔn̪
dulon	d̪ul̪ɔn̪
dulon	d̪uwn̪
dulondulon	d̪ʊl̪ɔn̪d̪ul̪ɔn̪
dulot	d̪ul̪ɔt̪
dulot	d̪ʊl̪ot̪
dulse	d̪ul̪s̪ɪ
dumaguete	d̪ʊmʌgit̪ɪ
dumala	d̪ʊmal̪ʌ
dumanjug	d̪ʊmʌŋhug
dumog	d̪umɔg
dunggab	d̪uŋgʌb
dunggan	d̪uŋgʌn̪
dunggo	d̪ʊŋgoʔ
dunggoan	d̪ʊŋgoʔʌn̪
dunggoanan	d̪ʊŋgɔʔan̪ʌn̪
dungog	d̪uŋɔg
duot	d̪ʊʔot̪
duran	d̪ʊɾ̪an̪
dusmo	d̪ʊs̪moʔ
dusmog	d̪ʊs̪mog
duso	d̪ʊs̪oʔ
duterte	d̪ʊt̪iɾ̪t̪ɪ
duwa	d̪uʌʔ
dyambol	dʒambɔl̪
dyanitor	d̪jan̪ɪt̪oɾ̪
dyip	d̪jip
edukado	ʔɪd̪ʊkad̪ɔ
edukasyon	ʔɪd̪ʊkʌs̪jon̪
eguia	ʔɪgiʌ
ekek	ʔikɪk
ekipahe	ʔɪkɪpahɪ
eklipse	ʔɪkl̪ips̪ɪ
eksakto	ʔɪks̪akt̪ɔ
eksorsismo	ʔiks̪ɔɾ̪s̪is̪mɔ
eksplikar	ʔɪks̪pl̪ɪkaɾ̪
ektarya	ʔɪkt̪aɾ̪jʌ
elegante	ʔɪl̪ɪgan̪t̪ɪ
eleksyon	ʔɪl̪ɪks̪jon̪
elektrisyan	ʔɪl̪ɪkt̪ɾ̪is̪jʌn̪
elementarya	ʔɪl̪ɪmɪn̪t̪aɾ̪jʌ
elepante	ʔɪl̪ɪpan̪t̪ɪ
eliminasyon	ʔɪl̪ɪmɪn̪ʌs̪jon̪
elpidio	ʔɪl̪pid̪jɔ
embutido	ʔɪmbʊt̪id̪ɔ
empleyada	ʔɪmpl̪jad̪ʌ
empleyado	ʔɪmpl̪jad̪ɔ
enero	ʔɪn̪iɾ̪ɔ
engkanto	ʔɪŋkan̪t̪ɔ
engrande	ʔɪŋgɾ̪an̪d̪ɪ
entablado	ʔɪn̪t̪ʌbl̪ad̪ɔ
ermat	ʔiɾ̪mʌt̪
eroplano	ʔɪɾ̪ɔpl̪an̪ɔ
erpat	ʔiɾ̪pʌt̪
escaño	ʔɪs̪kaɲɔ
eskedyul	ʔɪs̪kid̪jʊl̪
eskina	ʔɪs̪kin̪ʌ
eskobilyo	ʔɪs̪kɔbil̪jɔ
eskultor	ʔɪs̪kʊl̪t̪oɾ̪
eskuwela	ʔɪs̪kwil̪ʌ
eskuwelahan	ʔɪs̪kwɪl̪ʌhan̪
esmagol	ʔɪs̪magɔl̪
espanyol	ʔɪs̪pʌn̪jol̪
espeho	ʔɪs̪pihɔ
espirito	ʔɪs̪piɾ̪ɪt̪ɔ
espiritohanon	ʔɪs̪pɪɾ̪ɪt̪ɔhan̪ɔn̪
espiritu	ʔɪs̪piɾ̪ɪt̪ʊ
espirituhanon	ʔɪs̪pɪɾ̪ɪt̪ʊhan̪ɔn̪
espiya	ʔɪs̪piʌ
espongha	ʔɪs̪poŋhʌ
estatuwa	ʔɪs̪t̪at̪wa
estillore	ʔɪs̪t̪ɪl̪joɾ̪ɪ
estorya	ʔɪs̪t̪oɾ̪jʌ
estrella	ʔɪs̪t̪ɾ̪il̪jʌ
estudyante	ʔɪs̪t̪ʊd̪jan̪t̪ɪ
estupido	ʔɪs̪t̪ʊpid̪ɔ
eulogia	ʔiʊ̯l̪ohɪʌ
fabillar	pʌbɪl̪jaɾ̪
fernando	pɪɾ̪n̪an̪d̪ɔ
flores	pl̪oɾ̪ɪs̪
formentera	pɔɾ̪mɪn̪t̪iɾ̪ʌ
francisco	pɾ̪ʌn̪s̪is̪kɔ
fuentes	pwin̪t̪ɪs̪
gaak	gʌʔak
gaan	gʌʔan̪
gaba	gabʌ
gabi	gabɪ
gabii	gʌbɪʔi
gading	gad̪ɪŋ
gadya	gʌd̪jaʔ
gahi	gahɪʔ
gahom	gahɔm
gajod	gʌdʒod̪
gallardo	gʌl̪jaɾ̪d̪ɔ
galon	gʌl̪on̪
gamay	gʌmaɪ̯
gamot	gʌmot̪
gamotpulong	gʌmot̪pʊl̪oŋ
gana	gan̪ʌ
ganahan	gʌn̪ahʌn̪
ganansiya	gʌn̪an̪s̪ja
gang	gaŋ
ganggang	gaŋgʌŋ
ganggang	gʌŋgaŋ
gango	gaŋɔ
gani	gan̪ɪʔ
gapas	gapʌs̪
garahe	gʌɾ̪ahɪ
garcia	gʌɾ̪s̪iʌ
garing	gʌɾ̪iŋ
garo	gʌɾ̪oʔ
gasolina	gʌs̪ɔl̪in̪ʌ
gasolinahan	gʌs̪ɔl̪ɪn̪ʌhan̪
gatas	gat̪ʌs̪
gatos	gʌt̪os̪
gawas	gʌwas̪
gayod	dʒʊd̪
gayod	gjʊd̪
gayod	gʌdʒod̪
gayod	gʌjod̪
gayon	gʌdʒon̪
gayon	gʌjon̪
genaro	hɪn̪aɾ̪ɔ
getafe	hɪt̪apɪ
gigikanan	gɪgɪkan̪ʌn̪
gikalag	gɪkag
gikalag	gɪkʌjag
gikalag	gɪkʌl̪ag
gikan	gikʌn̪
gilayon	gɪl̪ʌjon̪
gingharian	gɪŋhʌɾ̪iʔʌn̪
ginhawa	gɪŋhawʌ
ginikanan	gɪn̪ɪkan̪ʌn̪
ginisal	gɪn̪ɪs̪al̪
ginunting	gɪn̪ʊn̪t̪iŋ
ginuntingan	gɪn̪ʊn̪t̪iŋʌn̪
gira	giɾ̪ʌ
gisa	gis̪ʌʔ
gisa	gɪs̪a
gisado	gɪs̪ad̪ɔ
gisal	gɪs̪al̪
gisi	gis̪ɪʔ
gitara	gɪt̪aɾ̪ʌ
giti	git̪ɪʔ
glorya	gl̪oɾ̪jʌ
golosino	gɔl̪ɔs̪in̪ɔ
gomez	gomɪs̪
gonzaga	gɔn̪s̪agʌ
gorgonio	gɔɾ̪gon̪jɔ
goryo	goɾ̪jɔ
graba	gɾ̪abʌ
guba	gʊbaʔ
gubat	gubʌt̪
gubot	gubɔt̪
gubot	gʊbot̪
gugma	gugmʌ
guindulman	gɪn̪d̪ʊl̪man̪
guiuan	giwʌn̪
gulaman	gʊl̪amʌn̪
gumamela	gʊmʌmil̪ʌ
guna	gun̪ʌ
guno	gʊn̪oʔ
gunting	gun̪t̪ɪŋ
guot	guʔɔt̪
gusok	gus̪ɔk
gutang	gʊt̪aŋ
gutlo	gʊt̪l̪oʔ
gutom	gut̪ɔm
gutom	gʊt̪om
guwapa	gwapʌ
guwapo	gwapɔ
guyabano	gʊjʌban̪ɔ
guyod	gujɔd̪
guzman	gʊs̪man̪
gwapa	gwʌpʌ
gwapo	gwʌpɔ
gyud	gjʊd̪
habagat	hʌbagʌt̪
habagatan	hʌbʌgat̪ʌn̪
habal	habʌl̪
habol	hʌbol̪
hagdan	hʌgd̪an̪
hagdanan	hʌgd̪an̪ʌn̪
hagnaya	hʌgn̪ajʌ
hagok	hagɔk
hagtok	hagt̪ɔk
hakog	hʌkog
halang	hal̪ʌŋ
halas	hal̪ʌs̪
halimaw	hʌl̪imaʊ̯
halingan	hʌl̪iŋʌn̪
halok	hʌl̪ok
halwa	hal̪wʌ
hambog	hʌmbog
hambogera	hʌmbɔgiɾ̪ʌ
hambogero	hʌmbɔgiɾ̪ɔ
hampang	hampʌŋ
hamugaway	hʌmʊgawaɪ̯
hanas	hʌn̪as̪
hang	haŋ
hangad	hʌŋad̪
hangga	haŋgʌʔ
hangin	haŋɪn̪
hangol	hʌŋol̪
hantak	han̪t̪ʌk
hanting	han̪t̪ɪŋ
hardin	hʌɾ̪d̪in̪
hari	haɾ̪ɪʔ
harianon	hʌɾ̪ɪʔan̪ɔn̪
harina	hʌɾ̪in̪ʌ
hasang	has̪ʌŋ
hasler	has̪l̪ɪɾ̪
hatag	hat̪ʌg
hatdog	hat̪d̪ɔg
hatod	hʌt̪od̪
hawak	hawʌk
hawok	hʌwok
hayag	hajʌg
hayahay	hʌjahaɪ̯
hayop	hajɔp
helikopter	hɪl̪ɪkopt̪ɪɾ̪
hepa	hipʌ
hepe	hipɪ
heringgilya	hɪɾ̪ɪŋgil̪jʌ
hesusmaryosep	hɪs̪ʊs̪mʌɾ̪jos̪ɪp
hibalo	hɪbʌl̪o
hibi	hibɪ
higala	hɪgal̪ʌ
higante	hɪgan̪t̪ɪ
higayon	hɪgʌdʒon̪
higayon	hɪgʌjon̪
higda	hɪgd̪aʔ
higdaanan	hɪgd̪ʌʔan̪ʌn̪
higot	hɪgot̪
hikog	hikɔg
hikot	hikɔt̪
hilanat	hɪl̪ʌn̪at̪
hilaw	hɪl̪aʊ̯
hilawas	hɪl̪awʌs̪
hilig	hil̪ɪg
hilo	hil̪ɔ
hilo	hɪl̪o
hilom	hil̪ɔm
hilomon	hɪl̪omɔn̪
hilot	hil̪ɔt̪
himalad	hɪmal̪ʌd̪
himantayon	hɪmʌn̪t̪ajɔn̪
himasa	hɪmas̪ʌ
himasa	hɪmʌs̪aʔ
hinabang	hɪn̪abʌŋ
hinagiban	hɪn̪ʌgɪban̪
hinay	hin̪aɪ̯
hingatulog	hɪŋʌt̪ul̪ɔg
hingaw	hɪŋaʊ̯
hinginom	hɪŋʔɪn̪om
hingugmo	hɪŋʊgmo
hinguha	hɪŋuhʌʔ
hinguko	hɪŋukɔ
hinguto	hɪŋut̪ɔ
hinigugma	hɪn̪ɪgʊgmaʔ
hinog	hɪn̪og
hinudas	hɪn̪ud̪ʌs̪
hinumdom	hɪn̪umd̪ɔm
hinungdan	hɪn̪ʊŋd̪an̪
hipon	hipɔn̪
hipos	hipɔs̪
hisgot	hɪs̪got̪
hisoler	hɪs̪ɔl̪iɾ̪
hita	hit̪ʌʔ
hito	hit̪ɔʔ
hitsura	hɪtsuɾ̪ʌ
honda	hon̪d̪ʌ
hopia	hopjʌʔ
hopya	hopjʌʔ
hospital	hos̪pɪt̪al̪
hubad	hʊbad̪
hubag	hʊbag
hubak	hubʌk
hubakon	hʊbakɔn̪
hubas	hʊbas̪
hubo	hʊboʔ
hubog	hʊbog
hubon	hʊbon̪
hudas	hud̪ʌs̪
hudyo	hʊd̪jo
hugas	hugʌs̪
hugaw	hugaʊ̯
hukom	hʊkom
hula	hul̪ʌ
hulagway	hʊl̪ʌgwaɪ̯
hulam	hʊl̪am
hulat	hʊat̪
hulat	hʊl̪at̪
hulay	hul̪aɪ̯
hulbot	hʊgkot̪
hulga	holgɐʔ
hulhol	hʊl̪hol̪
hulog	hul̪ɔg
hulyo	hul̪jɔ
humok	humɔk
humot	hʊmot̪
hunas	hʊn̪as̪
hungit	huŋɪt̪
hunyo	hun̪jɔ
huot	huʔɔt̪
huramentado	hʊɾ̪ʌmɪn̪t̪ad̪ɔ
hurisdiksiyon	hʊɾ̪ɪs̪d̪ɪks̪jon̪
husay	hus̪aɪ̯
husgado	hʊs̪gad̪ɔ
huwad	hʊad̪
huwam	hʊam
huwat	hʊat̪
huwebes	hʊwibɪs̪
huyang	hujʌŋ
huybes	huɪbɪs̪
huyop	hʊjop
huyuhoy	hʊjuhoɪ̯
ibabaw	ʔɪbabaʊ̯
ibarra	ʔɪbaɾ̪ʌ
ibañez	ʔɪbaɲɪs̪
ideyolohiya	ʔɪd̪ɪjɔl̪ɔhiʌ
ido	ʔid̪ɔʔ
igbaw	ʔɪgbaʊ̯
iglesya	ʔɪgl̪is̪jʌ
ignorante	ʔɪgn̪ɔɾ̪an̪t̪ɪ
igot	ʔigɔt̪
igso	ʔɪgs̪oʔ
ihag	ʔihʌg
ihalas	ʔɪhʌl̪as̪
ihas	ʔɪhas̪
ihi	ʔihɪʔ
iho	ʔihɔ
ija	ʔɪdʒa
ikaw	ʔɪkaʊ̯
ikog	ʔikɔg
ila	ʔil̪ʌ
ilad	ʔɪl̪ad̪
ilaga	ʔɪl̪ʌgaʔ
iling	ʔɪl̪iŋ
ilo	ʔil̪ɔ
ilo	ʔɪl̪o
iloilo	ʔɪl̪ojl̪ɔ
ilok	ʔil̪ɔk
ilusyon	ʔɪl̪ʊs̪jon̪
imahe	ʔɪmahɪ
imbes	ʔɪmbis̪
imbestigar	ʔɪmbɪs̪t̪igʌɾ̪
imbestigasyon	ʔɪmbɪs̪t̪ɪgʌs̪jon̪
imbitar	ʔɪmbɪt̪aɾ̪
imburnal	ʔɪmbʊɾ̪n̪al̪
imo	ʔimɔ
impakto	ʔɪmpakt̪ɔ
impeksyon	ʔɪmpɪks̪jon̪
implementar	ʔɪmpl̪ɪmɪn̪t̪aɾ̪
implikar	ʔɪmpl̪ɪkaɾ̪
implikasyon	ʔɪmpl̪ɪkʌs̪jon̪
importansiya	ʔɪmpɔɾ̪t̪an̪s̪ja
importansya	ʔɪmpɔɾ̪t̪an̪s̪jʌ
ina	ʔɪn̪a
inabanga	ʔɪn̪ʌbaŋgʌ
inadlawan	ʔin̪ad̪l̪ʌwʌn̪
inadlawan	ʔɪn̪ʌd̪l̪awʌn̪
inahan	ʔɪn̪ahʌn̪
inaon	ʔɪn̪ʌʔon̪
inday	ʔɪn̪d̪aɪ̯
indibidwal	ʔɪn̪d̪ɪbɪd̪wal̪
indulhensiya	ʔɪn̪d̪ʊl̪hin̪s̪jʌ
inga	ɪŋʌʔ
ingrato	ʔɪŋgɾ̪at̪ɔ
inilokano	ʔɪn̪ɪl̪ɔkan̪ɔ
iningles	ʔɪn̪ɪŋgl̪is̪
ininsik	ʔɪn̪ɪn̪s̪ik
init	ʔin̪ɪt̪
inkulkasyon	ʔɪŋkʊl̪kʌs̪jon̪
inom	ʔɪn̪om
inosente	ʔɪn̪ɔs̪in̪t̪ɪ
insenso	ʔɪn̪s̪in̪s̪ɔ
instruksyon	ʔɪn̪s̪t̪ɾ̪ʊks̪jon̪
insulto	ʔɪn̪s̪ul̪t̪ɔ
insumniyalak	ʔɪn̪s̪umn̪jal̪ʌk
internasyonal	ʔɪn̪t̪ɪɾ̪n̪ʌs̪jɔn̪al̪
inunlan	ʔɪn̪ʊn̪l̪an̪
inyo	ʔin̪jɔ
ipil	ʔipɪl̪
ipos	ʔipɔs̪
irigasyon	ʔɪɾ̪ɪgʌs̪jon̪
iring	ʔɪɾ̪iŋ
iro	ʔiɾ̪ɔʔ
isda	ʔɪs̪d̪aʔ
isi	ʔis̪ɪ
isigkatawo	ʔɪs̪ɪgkʌʔiŋɔn̪
isip	ʔis̪ɪp
isko	ʔɪs̪koʔ
isla	ʔis̪l̪ʌ
isog	ʔis̪ɔg
itik	ʔit̪ɪk
itlog	ʔɪt̪l̪og
ito	ʔit̪ɔʔ
itsura	ʔɪt̪s̪uɾ̪ʌ
iya	ʔɪa
iya	ʔɪdʒa
iyaha	ʔɪahʌ
iyot	ʔijɔt̪
jagna	hagn̪ʌ
jakol	dʒʌkol̪
jimenez	hɪmin̪ɪs̪
jose	hɔs̪i
jud	dʒʊd̪
jumawan	hʊmawʌn̪
kaajo	kʌʔadʒɔ
kaanyag	kʌʔʌn̪jag
kaaslom	kʌʔʌs̪l̪om
kaaway	kʌʔawaɪ̯
kaayo	kʌʔajɔ
kabakaba	kʌbakʌba
kabanga	kʌbʌŋa
kabankalan	kʌbʌŋkʌl̪an̪
kabata	kʌbat̪ʌʔ
kabaw	kabaʊ̯
kabayo	kʌbajɔ
kabit	kʌbit̪
kabkab	kabkab
kabo	kabɔ
kabo	kabɔʔ
kabog	kʌbog
kabuang	kʌbuʔʌŋ
kadagatan	kʌd̪ʌgat̪ʌn̪
kadagkoan	kʌd̪ʌgkɔʔan̪
kadiyot	kʌd̪jot̪
kadto	kad̪t̪ɔ
kadugo	kad̪ʊgoʔ
kadula	kʌd̪ul̪ʌʔ
kaeskuyla	kʌʔɪs̪kuɪl̪ʌ
kagabhion	kʌgʌbhiʔɔn̪
kagabii	kʌgʌbɪʔi
kagahapon	kʌgʌhapɔn̪
kagaw	kagaʊ̯
kagawasan	kʌgʌwas̪ʌn̪
kagibuhi	kʌgɪbuhɪʔ
kagutom	kʌgut̪ɔm
kagwapa	kʌgwapʌ
kagwapo	kʌgwapɔ
kahibalo	kʌhɪbʌl̪o
kahoy	kahoɪ̯
kahoyan	kʌhɔjan̪
kahubog	kʌhʊbog
kahumot	kʌhʊmot̪
kahusayan	kʌhʊs̪ajʌn̪
kaisog	kʌʔis̪ɔg
kajo	kadʒɔ
kakahoyan	kʌkʌhojʌn̪
kakaw	kʌkaʊ̯
kalabasa	kʌl̪ʌbas̪ʌ
kalabera	kʌl̪ʌbiɾ̪ʌ
kalag	kag
kalag	kʌl̪ag
kalainan	kʌl̪ʌʔin̪ʌn̪
kalamansi	kʌl̪ʌmʌn̪s̪iʔ
kalamboan	kʌl̪ʌmbɔʔan̪
kalambre	kʌl̪ambɾ̪ɪ
kalangitan	kʌl̪ʌŋit̪ʌn̪
kalasag	kas̪ʌg
kalasag	kʌl̪as̪ʌg
kalaskas	kʌl̪ʌs̪kas̪
kalatkat	kʌl̪at̪kʌt̪
kalayo	kadʒɔ
kalayo	kajɔ
kalayo	kʌjajɔ
kalayo	kʌl̪ajɔ
kalayo	kʌl̪ʌdʒoʔ
kalayo	kʌl̪ʌjoʔ
kaldero	kʌl̪d̪iɾ̪ɔ
kalentura	kʌl̪ɪn̪t̪uɾ̪ʌ
kalibang	kʌl̪ɪbaŋ
kalibangan	kʌl̪ɪbaŋʌn̪
kalibotan	kʌl̪ɪbot̪ʌn̪
kalihim	kʌl̪ihɪm
kalinaw	kʌl̪in̪aʊ̯
kalingawan	kʌl̪ɪŋawʌn̪
kalipay	kʌl̪ipaɪ̯
kalis	kal̪ɪs̪
kaliwatan	kʌl̪ɪwat̪ʌn̪
kalo	kal̪ɔʔ
kalos	kal̪ɔs̪
kalos	kaws̪
kalsada	kʌl̪s̪ad̪ʌ
kaluha	kʌl̪ʊha
kaluhaan	kaʊ̯haʔʌn̪
kaluhaan	kʌl̪ʊhaʔʌn̪
kaluhaan	kʌwhaʔʌn̪
kalundan	kʌl̪ʊn̪d̪an̪
kaluoy	kʌl̪uʔoɪ̯
kamagong	kʌmʌgoŋ
kamalig	kʌmal̪ɪg
kamangyan	kʌmaŋjʌn̪
kamantigi	kʌmʌn̪t̪ɪgi
kamao	kʌmaʔɔ
kamatayon	kʌmʌt̪adʒɔn̪
kamatayon	kʌmʌt̪ajɔn̪
kamatis	kʌmat̪ɪs̪
kamatuoran	kʌmʌt̪ʊʔoɾ̪ʌn̪
kamatyonon	kʌmʌt̪jon̪ɔn̪
kambras	kambɾ̪ʌs̪
kami	kʌmi
kamkam	kʌmkam
kamlas	kaml̪ʌs̪
kamo	kʌmo
kamot	kʌmot̪
kamote	kʌmot̪ɪ
kampana	kʌmpan̪ʌʔ
kampanaryo	kʌmpʌn̪aɾ̪jɔ
kampanilya	kʌmpʌn̪il̪jʌ
kamras	kʌmɾ̪as̪
kamunggay	kʌmʊŋgaɪ̯
kamuning	kʌmʊn̪iŋ
kandila	kʌn̪d̪il̪ʌ
kanding	kʌn̪d̪iŋ
kang	kaŋ
kangurulsol	kʌŋʊɾ̪ul̪s̪ɔl̪
kanibalismo	kʌn̪ɪbʌl̪is̪mɔ
kansiyon	kʌn̪s̪jon̪
kanta	kʌn̪t̪a
kanto	kan̪t̪ɔ
kanunay	kʌn̪un̪aɪ̯
kanyon	kʌn̪jon̪
kaon	kaʔɔn̪
kapait	kʌpʌit̪
kapalaran	kʌpʌl̪aɾ̪ʌn̪
kapay	kʌpaɪ̯
kapayas	kʌpajʌs̪
kapinyahan	kʌpɪn̪jahʌn̪
kapitalismo	kʌpɪt̪ʌl̪is̪mɔ
kapitalista	kʌpɪt̪ʌl̪is̪t̪ʌ
kapitolyo	kʌpɪt̪ol̪jɔ
kapoy	kapoɪ̯
kapuloan	kʌpʊl̪ɔʔan̪
kapunawan	kʌpʊn̪awʌn̪
kaputol	kʌput̪ɔl̪
karaan	kʌɾ̪aʌn̪
karaho	kʌɾ̪ahɔ
karbon	kʌɾ̪bon̪
kargaburo	kʌɾ̪gʌbuɾ̪ɔ
kargador	kʌɾ̪gʌd̪oɾ̪
karinyo	kʌɾ̪in̪jɔ
karmelitos	kʌɾ̪mɪl̪it̪ɔs̪
karnabal	kʌɾ̪n̪ʌbal̪
karnero	kʌɾ̪n̪iɾ̪ɔ
karon	kʌɾ̪on̪
karpet	kaɾ̪pɪt̪
karsada	kʌɾ̪s̪ad̪ʌ
karwahe	kʌrwahɪ
kasadpan	kʌs̪ad̪pʌn̪
kasag	kʌs̪ag
kasambagan	kʌs̪ʌmbʌgan̪
kasili	kʌs̪il̪ɪ
kasilyas	kʌs̪il̪jʌs̪
kasingkasing	kʌs̪ɪŋkas̪ɪŋ
kasitas	kʌs̪it̪ʌs̪
kaskas	kʌs̪kas̪
kaso	kas̪ɔ
kaspa	kas̪pʌ
kastigo	kʌs̪t̪igɔ
kasulya	kʌs̪ul̪jʌ
kasundalohan	kʌs̪ʊn̪d̪ʌl̪ohʌn̪
katabang	kʌt̪abʌŋ
katahap	kʌt̪ahʌp
katahom	kʌt̪ʌhom
katakos	kʌt̪ʌkos̪
katarata	kʌt̪ʌɾ̪at̪ʌ
katawa	kʌt̪ʌwa
kategoriya	kʌt̪ɪgɔɾ̪iʌ
katig	kat̪ɪg
katigayonan	kʌt̪ɪgʌjon̪ʌn̪
katkat	kat̪kʌt̪
katmon	kʌt̪mon̪
kato	kat̪ɔ
katol	kʌt̪ol̪
katre	kat̪ɾ̪ɪ
katsila	kʌtsil̪ʌʔ
katulog	kʌt̪ul̪ɔg
katunggan	kʌt̪ʊŋgan̪
katunhayan	kʌt̪ʊŋhʌjan̪
katuod	kʌt̪ʊʔod̪
katupad	kʌt̪upʌd̪
kaugalingnan	kʌʔʊgʌl̪ɪŋn̪an̪
kaugalingon	kʌʔʊgʌl̪iŋɔn̪
kaugmaon	kʌʔʊgmaʔɔn̪
kaulaw	kʌʔuaʊ̯
kaulaw	kʌʔul̪aʊ̯
kaunom	kʌʔun̪ɔm
kauswagan	kʌʔʊs̪wʌgan̪
kawanangan	kʌwʌn̪aŋʌn̪
kawat	kawʌt̪
kawatan	kʌwʌt̪an̪
kawayan	kʌwajʌn̪
kawayanan	kʌwʌjʌn̪an̪
kawit	kawɪt̪
kawras	kaʊ̯ɾ̪ʌs̪
kay	kaɪ̯
kayas	kadʒʌs̪
kayas	kajʌs̪
kayat	kadʒʌt̪
kayat	kajʌt̪
kaymito	kaɪ̯mit̪ɔ
kayo	kajɔ
kendi	kin̪d̪ɪ
keso	kis̪ɔ
kevin	kibɪn̪
kidya	kɪd̪ja
kikik	kɪkik
kilat	kil̪ʌt̪
kilay	kil̪aɪ̯
kilomkilom	kɪl̪ɔmkil̪ɔm
kilumkilom	kɪl̪ʊmkil̪ɔm
kinabuhi	kɪn̪ʌbuhɪʔ
kinahanglan	kɪn̪ʌhaŋl̪ʌn̪
kinamaguwangan	kɪn̪ʌmʌgwaŋʌn̪
kinasingkasing	kɪn̪ʌs̪ɪŋkas̪ɪŋ
kinatsila	kɪn̪ʌtsil̪ʌʔ
kinsa	kɪn̪s̪aʔ
kintanar	kɪn̪t̪ʌn̪aɾ̪
kisame	kis̪ʌmɪ
kisami	kis̪ʌmɪ
kita	kit̪ʌ
kita	kɪt̪a
kitiw	kit̪iʊ̯
kitiw	kɪt̪iʊ̯
klaro	kl̪aɾ̪ɔ
klinika	kl̪in̪ɪka
kliyente	kl̪jin̪t̪ɪ
kobra	kobɾ̪ʌ
kobra	kɔbɾ̪a
kobrador	kɔbɾ̪ʌd̪oɾ̪
kokak	kokʌk
kolehiyo	kɔl̪ɪhijɔ
kolera	kol̪ɪɾ̪ʌ
kombensyon	kɔmbɪn̪s̪jon̪
kombento	kɔmbin̪t̪ɔ
kombida	kɔmbɪd̪a
komedyana	kɔmɪd̪jan̪ʌ
komedyano	kɔmɪd̪jan̪ɔ
komedyante	kɔmɪd̪jan̪t̪ɪ
komemorasyon	kɔmɪmɔɾ̪ʌs̪jon̪
komentarista	kɔmɪn̪t̪ʌɾ̪is̪t̪ʌ
komentaryo	kɔmɪn̪t̪aɾ̪jɔ
komite	kɔmɪt̪i
komo	komɔ
kompetisyon	kɔmpɪt̪ɪs̪jon̪
kompleto	kɔmpl̪it̪ɔ
komportable	kɔmpɔɾ̪t̪abl̪ɪ
komposisyon	kɔmpɔs̪ɪs̪jon̪
komun	kɔmun̪
komunista	kɔmʊn̪is̪t̪ʌ
kondensada	kɔn̪d̪ɪn̪s̪ad̪ʌ
koneho	kɔn̪ihɔ
kongkreto	kɔŋkɾ̪it̪ɔ
kongresista	kɔŋgɾ̪ɪs̪is̪t̪ʌ
kongreso	kɔŋgɾ̪is̪ɔ
konkreto	kɔŋkɾ̪it̪ɔ
konsagrasyon	kɔn̪s̪ʌgɾ̪ʌs̪jon̪
konsensiya	kɔn̪s̪in̪s̪ja
konsensya	kɔn̪s̪in̪s̪jʌ
konsolasyon	kɔn̪s̪ɔl̪ʌs̪jon̪
konsorte	kɔn̪s̪oɾ̪t̪ɪ
konsumidor	kɔn̪s̪ʊmɪd̪oɾ̪
kontador	kɔn̪t̪ʌd̪oɾ̪
kontento	kɔn̪t̪in̪t̪ɔ
kontrabando	kɔn̪t̪ɾ̪ʌban̪d̪ɔ
kooperasyon	kɔɔpɪɾ̪ʌs̪jon̪
kordero	kɔɾ̪d̪iɾ̪ɔ
kosina	kɔs̪in̪ʌ
kosinera	kɔs̪ɪn̪iɾ̪ʌ
kosinero	kɔs̪ɪn̪iɾ̪ɔ
kotse	kotsɪ
krayola	kɾ̪ʌjol̪ʌ
krayon	kɾ̪ajɔn̪
kristo	kɾ̪is̪t̪ɔ
kropek	kɾ̪opɪk
kubalan	kʊbʌl̪an̪
kubalon	kʊbal̪ɔn̪
kubkob	kʊbkob
kubot	kubɔt̪
kubot	kʊbot̪
kubtanan	kʊbt̪an̪ʌn̪
kudeta	kud̪ɪt̪ʌ
kudkoran	kʊd̪kɔɾ̪an̪
kugaw	kugaʊ̯
kughal	kʊghal̪
kugita	kʊgit̪ʌ
kugmo	kugmɔ
kugmohon	kʊgmohɔn̪
kugon	kʊgon̪
kugos	kugɔs̪
kugtong	kʊgt̪oŋ
kuha	kuhʌʔ
kuhit	kuhɪt̪
kujaji	kʊdʒadʒɪ
kuko	kʊko
kukok	kukɔk
kulago	kʊl̪agɔʔ
kulangot	kʊl̪aŋɔt̪
kulas	kʊl̪as̪
kuli	kul̪ɪʔ
kuli	kʊl̪iʔ
kulianon	kʊl̪ɪʔan̪ɔn̪
kulkol	kul̪kɔl̪
kulob	kʊl̪ob
kumagat	kʊmagʌt̪
kumagko	kʊmagkɔʔ
kumalagko	kʊmagkɔʔ
kumalagko	kʊmʌl̪agkɔʔ
kumusta	kʊmʊs̪t̪a
kupo	kʊpoʔ
kupos	kupɔs̪
kupot	kʊpot̪
kuratsa	kʊɾ̪atsʌ
kurba	kʊɾ̪ba
kurus	kʊɾ̪us̪
kuryente	kʊɾ̪jin̪t̪ɪ
kusgan	kʊs̪gan̪
kusina	kʊs̪in̪ʌ
kusisang	kʊs̪is̪ʌŋ
kusog	kʊs̪og
kutana	kʊt̪an̪ʌ
kutas	kʊt̪as̪
kuting	kʊt̪iŋ
kutis	kut̪ɪs̪
kutkot	kut̪kɔt̪
kuto	kut̪ɔ
kutsara	kʊtsaɾ̪ʌ
kutsaron	kʊtsʌɾ̪on̪
kutsilyo	kʊtsil̪jɔ
kuwadrilyon	kwʌd̪ɾ̪ɪl̪jon̪
kuwang	kuʌŋ
kuwarta	kwaɾ̪t̪ʌ
kuwartahan	kwʌɾ̪t̪ahʌn̪
kuweba	kwibʌ
kuwenta	kwin̪t̪ʌ
kuwintilyon	kwɪn̪t̪ɪl̪jon̪
kuwitis	kwit̪ɪs̪
kuyap	kʊjap
kuyba	kuɪbʌ
kwarta	kwʌɾ̪t̪ʌ
kwelyo	kwɪl̪jɔ
kwestyonable	kwɪs̪t̪jɔn̪abl̪ɪ
kyawkyaw	kjaʊ̯kjaʊ̯
laag	l̪aʔʌg
laagan	l̪ʌʔʌgan̪
laba	l̪ʌba
labaha	l̪ʌbahʌ
labandera	l̪ʌbʌn̪d̪iɾ̪ʌ
labandero	l̪ʌbʌn̪d̪iɾ̪ɔ
labanos	l̪abʌn̪ɔs̪
labastida	l̪ʌbʌs̪t̪id̪ʌ
labaw	l̪abaʊ̯
labay	l̪abaɪ̯
labender	l̪ʌbin̪d̪ɪɾ̪
labhan	l̪ʌbhan̪
labong	l̪abɔŋ
labot	l̪abɔt̪
labuyo	l̪ʌbujɔʔ
laga	l̪aʔgʌʔ
lagaw	l̪ʌgaʊ̯
lagay	jʌgaɪ̯
lagay	l̪ʌgaɪ̯
lagingling	l̪ʌgɪŋl̪iŋ
lagos	l̪ʌgos̪
lagutmon	l̪ʌgut̪mɔn̪
lagutom	l̪ʌgut̪ɔm
lahar	l̪ʌhaɾ̪
lain	l̪aʔɪn̪
lakang	l̪akʌŋ
lakat	l̪ʌkat̪
lakaw	l̪ʌkaʊ̯
laki	l̪akɪ
laksa	l̪ʌks̪aʔ
laksot	l̪ʌks̪ot̪
lalag	l̪al̪ʌg
lalaki	l̪ʌl̪akɪ
lalawigan	l̪ʌl̪ʌwigʌn̪
lalom	l̪al̪ɔm
lamdaman	l̪ʌmd̪amʌn̪
lamok	l̪ʌmok
lamparilya	l̪ʌmpʌɾ̪il̪jʌ
lampin	l̪ʌmpin̪
lana	l̪an̪ʌ
langaw	l̪aŋaʊ̯
langgam	l̪ʌŋgam
langit	l̪aŋɪt̪
langob	l̪ʌŋob
langoy	l̪ʌŋoj
langoyanan	l̪ʌŋɔjan̪ʌn̪
lansa	l̪ʌn̪s̪a
lansang	l̪ʌn̪s̪aŋ
lansaro	l̪ʌn̪s̪ʌɾ̪o
lansarohon	l̪ʌn̪s̪ʌɾ̪ɔhon̪
lansones	l̪ʌn̪s̪on̪ɪs̪
lansyaw	l̪an̪s̪jaʊ̯
laog	l̪aʔɔg
laom	l̪aʔɔm
lapad	l̪ʌpad̪
lapas	l̪ʌpas̪
lapida	l̪apɪd̪ʌ
lapis	l̪apɪs̪
lapok	l̪ʌpok
lapot	l̪ʌpot̪
largabista	l̪ʌɾ̪gʌbis̪t̪ʌ
lasang	l̪as̪ʌŋ
lasaw	l̪as̪aʊ̯
laslas	l̪ʌs̪l̪as̪
lastiko	l̪as̪t̪ɪkɔ
laurel	l̪aʊ̯ɾ̪il̪
lauron	l̪aʊ̯ɾ̪on̪
lawas	l̪awʌs̪
laway	l̪awaɪ̯
lawayan	l̪ʌwʌjan̪
lawgaw	l̪aʊ̯gaʊ̯
lawig	l̪ʌwig
lawin	l̪awɪn̪
lawis	l̪awɪs̪
lawod	l̪ʌwod̪
lawting	l̪aʊ̯t̪ɪŋ
laya	l̪ajʌʔ
layag	l̪ajʌg
layas	l̪ajʌs̪
layas	l̪ʌjas̪
layo	jʌjoʔ
layo	l̪ʌdʒoʔ
layo	l̪ʌjoʔ
ledesma	l̪ɪd̪is̪mʌ
legalisasyon	l̪ɪgʌl̪ɪs̪ʌs̪jon̪
lehislasyon	l̪ɪhɪs̪l̪ʌs̪jon̪
lehislatura	l̪ɪhɪs̪l̪ʌt̪uɾ̪ʌ
letse	l̪itsɪ
leytehanon	l̪it̪ɪhan̪ɔn̪
libak	l̪ɪbak
libang	l̪ɪbaŋ
libjo	l̪ɪbhoʔ
libod	l̪ibɔd̪
libog	l̪ibɔg
libot	l̪ibɔt̪
libradilla	l̪ɪbɾ̪ʌd̪il̪jʌ
libre	l̪ibɾ̪ɪ
libro	l̪ɪbɾ̪o
lider	l̪id̪ɪɾ̪
ligid	l̪igɪd̪
lihay	l̪ɪhaɪ̯
likay	l̪ikaɪ̯
liko	l̪ɪkoʔ
likod	l̪ɪkod̪
lima	l̪ɪma
limbaga	l̪ɪmbagʌ
limbong	l̪ɪmboŋ
limonsito	l̪ɪmɔn̪s̪it̪ɔ
limpiyado	l̪ɪmpjad̪ɔ
limpyado	l̪ɪmpjad̪ɔ
limpyo	l̪impjɔ
limugmog	l̪ɪmugmɔg
linaw	l̪in̪aʊ̯
lingaw	l̪iŋaʊ̯
lingkod	l̪iŋkɔd̪
lingkoranan	l̪ɪŋkɔɾ̪an̪ʌn̪
liningkoran	l̪ɪn̪ɪŋkoɾ̪ʌn̪
linkoranan	l̪ɪŋkɔɾ̪an̪ʌn̪
linog	l̪in̪ɔg
linti	l̪in̪t̪ɪʔ
linuto	l̪ɪn̪ut̪ɔʔ
lipay	l̪ipaɪ̯
lisensiya	l̪ɪs̪in̪s̪jʌ
lisensiyado	l̪ɪs̪ɪn̪s̪jad̪ɔ
lisensya	l̪ɪs̪in̪s̪jʌ
lisensyado	l̪ɪs̪ɪn̪s̪jad̪ɔ
liso	l̪is̪ɔ
lisod	l̪is̪ɔd̪
lisod	l̪ɪs̪od̪
lisondra	l̪ɪs̪on̪d̪ɾ̪ʌ
lista	l̪is̪t̪ʌ
listahan	l̪ɪs̪t̪ahʌn̪
litaniya	l̪ɪt̪ʌn̪iʌ
litrato	l̪ɪt̪ɾ̪at̪ɔ
liwat	l̪ɪwat̪
llanera	l̪jʌn̪iɾ̪ʌ
lomo	l̪omɔ
longganisa	l̪ɔŋgʌn̪is̪ʌ
lopez	l̪opɪs̪
loreto	l̪ɔɾ̪it̪ɔ
luag	l̪ʊʔag
lubnganan	l̪ʊbŋan̪ʌn̪
lubong	l̪ʊboŋ
lubot	l̪ʊbot̪
luchavez	l̪ʊtsabɪs̪
lugaw	l̪ugaʊ̯
lugaynan	l̪ʊgaɪ̯n̪an̪
lugi	l̪ugɪʔ
lugos	l̪ugɔs̪
luha	l̪uhʌʔ
luhod	l̪ʊhod̪
lukdo	l̪ukd̪ɔ
lukso	l̪uks̪ɔ
lukton	l̪ʊkt̪on̪
lulod	l̪ul̪ɔd̪
lumos	l̪ʊmos̪
lumponid	l̪ʊmpon̪ɪd̪
lundag	l̪ʊn̪d̪ag
lunes	l̪un̪ɪs̪
lungay	l̪ʊŋaɪ̯
lungayngay	l̪ʊŋaɪ̯ŋaɪ̯
lungib	l̪ʊŋib
lungon	l̪ʊŋon̪
lungsod	l̪ʊŋs̪od̪
lunhaw	l̪ʊŋhaʊ̯
lunod	l̪un̪ɔd̪
lunsod	l̪ʊn̪s̪od̪
luom	l̪uʔɔm
lupad	l̪ʊpad̪
lupog	l̪upɔg
lupoy	l̪ʊpoj
lusay	lusɐj
lusay	lɔsɐj
lusot	l̪ʊs̪ot̪
luta	l̪ut̪ʌ
luta	l̪ʊt̪aʔ
lutahan	l̪ʊt̪ahʌn̪
luto	l̪ut̪ɔʔ
luto	l̪ʊt̪o
luwa	l̪waʔ
luwaan	l̪wʌʔan̪
luwag	l̪wag
luwas	l̪was̪
maa	ma
maanyag	mʌʔan̪jʌg
maayo	mʌʔajɔ
mabalod	mʌbʌl̪od̪
mabangis	mʌbʌŋis̪
mabdos	mʌbd̪os̪
mabolo	mʌbol̪ɔ
mactan	mʌkt̪an̪
madangit	mʌd̪aŋɪt̪
madanguit	mʌd̪ʌŋgit̪
madre	mad̪ɾ̪ɪ
madyong	mʌd̪joŋ
maestra	mʌis̪t̪ɾ̪ʌ
maestro	mʌis̪t̪ɾ̪ɔ
mafalda	mʌpal̪d̪ʌ
magburuhat	mʌgbʊɾ̪uhʌt̪
magdudula	mʌgd̪ʊd̪ul̪ʌʔ
magduduwa	mʌgd̪ʊd̪uʌʔ
magkabayo	mʌgkʌbajɔ
maglala	mʌgl̪al̪ʌ
magpailad	mʌgpʌʔil̪ʌd̪
magulang	mʌgul̪ʌŋ
mahal	mʌhal̪
mahatagon	mʌhʌt̪agɔn̪
mahuyang	mʌhujʌŋ
mainom	mʌʔɪn̪om
makahilo	mʌkʌhɪl̪o
makaon	mʌkaʔɔn̪
makatubol	mʌkʌt̪ʊbol̪
makatunok	mʌkat̪ʊn̪ok
makina	makɪn̪ʌ
makopa	mʌkopʌ
mal	mal̪
mala	mʌl̪a
maldito	mʌl̪d̪it̪ɔ
malinaw	mʌl̪in̪aʊ̯
malinawon	mʌl̪ɪn̪awn̪
malipayon	mʌl̪ɪpajɔn̪
malisyoso	mʌl̪ɪs̪jos̪ɔ
mall	mol̪
maluya	mʌl̪ujʌ
mamaligyaay	mʌmʌl̪ɪgjʌʔaɪ̯
mamatayan	mʌmʌt̪ajʌn̪
mamati	mʌmat̪ɪʔ
mamumuno	mʌmʊmun̪ɔʔ
man	man̪
manahon	mʌn̪ahɔn̪
manambalay	mʌn̪ʌmbʌl̪aɪ̯
manananggot	mʌn̪ʌn̪ʌŋgot̪
mananap	mʌn̪ʌn̪ap
mananquil	mʌn̪ʌŋkil̪
mandauehanon	mʌn̪d̪ʌwɪhan̪ɔn̪
mando	man̪d̪ɔ
maneho	mʌn̪ihɔ
mangahoy	mʌŋahoɪ̯
mangayam	mʌŋajʌm
mangga	maŋgʌ
manghihilot	mʌŋhɪhil̪ɔt̪
manghod	mʌŋhod̪
mangtas	mʌŋt̪as̪
mangubat	mʌŋubʌt̪
mani	mʌn̪i
manigarilyo	mʌn̪ɪgʌɾ̪il̪jɔ
manila	mʌn̪il̪ʌ
manila	mʌn̪il̪ʌʔ
maniobra	mʌn̪jobɾ̪ʌ
manok	mʌn̪ok
manokmanok	mʌn̪ɔkman̪ɔk
mansa	mʌn̪s̪a
mansanas	mʌn̪s̪an̪ʌs̪
mansanitas	mʌn̪s̪ʌn̪it̪ʌs̪
mantala	mʌn̪t̪al̪ʌ
manunubos	mʌn̪ʊn̪ubɔs̪
manzano	mʌn̪s̪an̪ɔ
maong	mʌʔoŋ
mapa	mapʌ
mapahiyomon	mʌpʌhɪjomɔn̪
mapintas	mʌpin̪t̪ʌs̪
maribel	mʌɾ̪ibɪl̪
marigondon	mʌɾ̪ɪgɔn̪d̪on̪
marilog	mʌɾ̪il̪ɔg
marinero	mʌɾ̪ɪn̪iɾ̪ɔ
marpil	mʌɾ̪pil̪
marso	maɾ̪s̪ɔ
martes	maɾ̪t̪ɪs̪
martilyo	mʌɾ̪t̪il̪jɔ
martinez	mʌɾ̪t̪in̪ɪs̪
martsa	maɾ̪t̪s̪ʌ
masahe	mʌs̪ahɪ
masahista	mʌs̪ʌhis̪t̪ʌ
masanagon	mʌs̪ʌn̪agɔn̪
masbate	mʌs̪bat̪ɪ
maskara	mas̪kʌɾ̪ʌ
maskin	mas̪kɪn̪
masol	mas̪ɔl̪
masuso	mʌs̪us̪ɔ
masyador	mʌs̪jad̪ɔɾ̪
mata	mʌt̪a
matahapon	mʌt̪ʌhapɔn̪
matapobre	mʌt̪ʌpobɾ̪ɪ
matay	mʌt̪aɪ̯
mate	mat̪ɪ
matinumanon	mʌt̪ɪn̪ʊman̪ɔn̪
matso	matsɔ
matugas	mʌt̪ugʌs̪
matulogtulog	mʌt̪ʊl̪ɔgt̪ul̪ɔg
matunok	mʌt̪ʊn̪ok
mauswagon	mʌʔʊs̪wagɔn̪
mayo	majɔ
mayor	miɪjɔɾ̪
medina	mɪd̪in̪ʌ
melgar	mɪl̪gaɾ̪
mendoza	mɪn̪d̪os̪ʌ
mensahe	mɪn̪s̪ahɪ
mercader	mɪɾ̪kʌd̪iɾ̪
merida	miɾ̪ɪd̪ʌ
merkado	mɪɾ̪kad̪ɔ
mika	mɪkaʔ
mikropono	mɪkɾ̪opɔn̪ɔ
militarista	mɪl̪ɪt̪ʌɾ̪is̪t̪ʌ
minaisan	mɪn̪ʌʔɪs̪an̪
minero	mɪn̪iɾ̪ɔ
mingming	mɪŋmiŋ
mintal	mɪn̪t̪al̪
mintinar	mɪn̪t̪ɪn̪aɾ̪
minuto	mɪn̪ut̪ɔ
misis	mis̪ɪs̪
miyembro	mjimbɾ̪ɔ
miyentras	mjin̪t̪ɾ̪ʌs̪
miyerkoles	mjiɾ̪kɔl̪is̪
modus	mod̪ʊs̪
mongha	moŋhʌ
montebon	mɔn̪t̪ɪbon̪
montellano	mɔn̪t̪ɪl̪jan̪ɔ
montesino	mɔn̪t̪ɪs̪in̪ɔ
montillano	mɔn̪t̪ɪl̪jan̪ɔ
monyeka	mɔn̪jikʌ
moreno	mɔɾ̪in̪ɔ
morpema	mɔɾ̪pimʌ
moskitero	mɔs̪kɪt̪iɾ̪ɔ
motor	mɔt̪oɾ̪
mulmol	mul̪mɔl̪
mulong	mʊl̪oŋ
multa	mʊl̪t̪a
mumho	mumhɔ
munisipyo	mʊn̪ɪs̪ipjɔ
muro	mʊɾ̪o
musta	mʊs̪t̪a
mutya	mut̪jʌʔ
naga	n̪agʌ
namok	n̪ʌmok
nana	n̪an̪ʌʔ
nancy	n̪an̪s̪ɪ
nangka	n̪aŋkʌʔ
naog	n̪aʔɔg
napo	n̪apɔʔ
napulo	n̪ʌpoʔ
napulo	n̪ʌpul̪ɔʔ
napulo	n̪ʌpuwʔ
nara	n̪aɾ̪ʌ
nasod	n̪as̪ɔd̪
nasyon	n̪ʌs̪jon̪
nawong	n̪awoŋ
negra	n̪igɾ̪ʌ
negro	n̪igɾ̪ɔ
negros	n̪igɾ̪ɔs̪
nepotismo	n̪ɪpɔt̪is̪mɔ
ngabil	ŋabɪl̪
ngalan	ŋal̪ʌn̪
ngano	ŋan̪ɔ
ngipon	ŋipɔn̪
ngisi	ŋis̪ɪ
ngislit	ŋis̪l̪ɪt̪
ngislo	ŋɪs̪l̪oʔ
nguho	ŋuhɔʔ
ngulngol	ŋul̪ŋɔl̪
ngutngot	ŋut̪ŋɔt̪
nigo	n̪igɔ
nila	n̪ɪl̪a
ningtiil	n̪ɪŋt̪iʔɪl̪
ninjo	n̪ɪn̪dʒo
ninyo	n̪ɪn̪dʒo
ninyo	n̪ɪn̪jo
nipis	n̪ɪpis̪
niya	n̪ja
niya	n̪ɪdʒa
nobenta	n̪ɔbin̪t̪ʌ
nobiyembre	n̪ɔbjimbɾ̪ɪ
nobyembre	n̪ɔbjimbɾ̪ɪ
nukos	n̪ukɔs̪
nuñez	n̪uɲɪs̪
obserbasyon	ʔɔbs̪ɪɾ̪bʌs̪jon̪
ocampo	ʔɔkampɔ
ocaña	ʔɔkaɲʌ
oktubre	ʔɔkt̪ubɾ̪ɪ
okupado	ʔɔkʊpad̪ɔ
okupar	ʔɔkupʌɾ̪
olaivar	ʔɔl̪aɪ̯bʌɾ̪
olayvar	ʔɔl̪aɪ̯bʌɾ̪
oliveros	ʔɔl̪ɪbiɾ̪ɔs̪
ompad	ʔompʌd̪
oportunista	ʔɔpɔɾ̪t̪ʊn̪is̪t̪ʌ
ordinaryo	ʔɔɾ̪d̪ɪn̪aɾ̪jɔ
ormocanon	ʔɔɾ̪mɔkan̪ɔn̪
ortega	ʔɔɾ̪t̪igʌ
osmeña	ʔɔs̪miɲʌ
ospital	ʔɔs̪pɪt̪al̪
otap	ʔot̪ʌp
otin	ʔot̪ɪn̪
otsenta	ʔɔtsin̪t̪ʌ
paa	paʔʌ
paagi	pʌʔagɪ
pabo	pabɔ
pabor	pʌboɾ̪
padayhag	pʌd̪ʌjag
pagadian	pʌgʌd̪iʔʌn̪
pagbisita	pʌgbɪs̪it̪ʌ
pagburos	pʌgbʊɾ̪os̪
pagdugang	pʌgd̪ugʌŋ
pagi	pagɪ
pagkalalaki	pʌgkal̪ʌl̪akɪ
pagkaon	pʌgkaʔɔn̪
paglaom	pʌgl̪aʔɔm
pagmabdos	pʌgmʌbd̪os̪
pagpamolitika	pʌgpʌmɔl̪it̪ɪkʌ
pagpanagop	pagpʌn̪ʌgop
pagpanigarilyo	pʌgpʌn̪ɪgʌɾ̪il̪jɔ
pagtuo	pʌgt̪uʔɔ
pagtupad	pʌgt̪ʊpad̪
pahat	pahʌt̪
pahatanan	pʌhʌt̪an̪ʌn̪
pahayahay	pʌhʌjahaɪ̯
pahiyom	pʌhijɔm
pahiyom	pʌhɪjom
pahulay	pʌhul̪aɪ̯
pahumot	pʌhʊmot̪
pahutan	pʌhut̪ʌn̪
painit	pʌʔin̪ɪt̪
paisano	paɪ̯s̪an̪ɔ
pait	pʌʔit̪
pakal	pʌkal̪
paklay	pakl̪aɪ̯
pakol	pakɔl̪
pakpak	pakpʌk
pakwan	pʌkwan̪
palad	pal̪ʌd̪
palad	pʌl̪ad̪
palahubog	pʌl̪ʌhubɔg
palainom	pʌl̪ʌʔin̪ɔm
palaman	pʌl̪ʌman̪
palangga	pʌl̪ʌŋgaʔ
palanggana	pʌl̪ʌŋgan̪ʌ
palaran	pʌl̪aɾ̪ʌn̪
palibot	pʌl̪ibɔt̪
palihog	pʌl̪ihɔg
palihug	pʌl̪ihʊg
palit	pʌl̪it̪
pamahaw	pʌmahaʊ̯
pamati	pʌmat̪ɪ
pambata	pʌmbat̪ʌ
pamilyado	pʌmɪl̪jad̪ɔ
pamilyar	pʌmɪl̪jaɾ̪
pampam	pampʌm
pampanga	pʌmpaŋgʌ
pamuhi	pʌmuhɪʔ
pan	pan̪
panagang	pʌn̪ʌgaŋ
panahon	pʌn̪ʌhon̪
panaw	pan̪aʊ̯
pandak	pʌn̪d̪ak
panday	pʌn̪d̪aɪ̯
pandesal	pʌn̪d̪ɪs̪al̪
pandong	pʌn̪d̪oŋ
pangadye	pʌŋʌd̪jiʔ
pangadyi	pʌŋʌd̪jiʔ
pangalan	pʌŋal̪ʌn̪
panganod	pʌŋʌn̪od̪
panganoron	pʌŋʌn̪oɾ̪ɔn̪
pangguon	pʌŋguʔɔn̪
panginabuhian	paŋɪn̪ʌbʊhiʔʌn̪
panglawas	pʌŋl̪awʌs̪
panigarilyo	pʌn̪ɪgʌɾ̪il̪jɔ
panihapon	pʌn̪ɪhapɔn̪
paniudto	pʌn̪ɪʔʊd̪t̪o
pansat	pʌn̪s̪at̪
pantalan	pʌn̪t̪ʌl̪an̪
pantalon	pan̪t̪ʌl̪on̪
pantasma	pʌn̪t̪as̪mʌ
pantat	pʌn̪t̪at̪
pantihan	pʌn̪t̪ihʌn̪
pantog	pʌn̪t̪og
panultihon	pʌn̪ʊl̪t̪ihɔn̪
panyaspanyas	pan̪jʌs̪pan̪jʌs̪
panyawan	pʌn̪jawʌn̪
papel	pʌpil̪
paquibato	pʌkɪbat̪ɔ
paragrap	paɾ̪ʌgɾ̪ʌp
paraiso	pʌɾ̪aɪ̯s̪ɔ
parapente	pʌɾ̪ʌpin̪t̪ɪ
parapo	paɾ̪ʌpɔ
paras	pʌɾ̪as̪
parat	pʌɾ̪at̪
pareho	pʌɾ̪ihɔ
pareja	pʌɾ̪ihʌ
pari	paɾ̪ɪʔ
paril	pʌɾ̪il̪
partisipasyon	pʌɾ̪t̪ɪs̪ɪpʌs̪jon̪
paryente	pʌɾ̪jin̪t̪ɪ
pasaw	pas̪aʊ̯
pasayan	pʌs̪adʒʌn̪
pasayan	pʌs̪ajʌn̪
pasaylo	pʌs̪aɪ̯l̪ɔ
pasi	pas̪ɪʔ
pasikat	pʌs̪ikʌt̪
pasilidad	pʌs̪ɪl̪ɪd̪ad̪
pasipiko	pʌs̪ipɪko
pasipismo	pʌs̪ɪpis̪mɔ
pasipista	pʌs̪ɪpis̪t̪ʌ
paso	pas̪ɔ
paso	pas̪ɔʔ
paspas	pas̪pʌs̪
pastor	pʌs̪t̪oɾ̪
pasyente	pʌs̪jin̪t̪ɪ
patalinghug	pʌt̪ʌl̪ɪŋhug
patay	pʌt̪aɪ̯
patilya	pʌt̪il̪jʌ
pating	pat̪ɪŋ
pato	pat̪ɔ
patong	pat̪ɔŋ
pautang	pʌʔut̪ʌŋ
pawikan	pʌwikʌn̪
payag	pajʌg
payod	pajɔd̪
payong	pajɔŋ
paypay	paɪ̯paɪ̯
pebrero	pɪbɾ̪iɾ̪ɔ
pederasyon	pɪd̪ɪɾ̪ʌs̪jon̪
pedro	pid̪ɾ̪ɔ
pelikula	pɪl̪ikʊl̪ʌ
pepino	pɪpin̪ɔ
peralta	pɪɾ̪al̪t̪ʌ
perez	piɾ̪ɪs̪
perhuwisyo	pɪɾ̪hʊis̪jɔ
periko	pɪɾ̪ikɔ
perla	piɾ̪l̪ʌ
personal	pɪɾ̪s̪on̪ʌl̪
perya	piɾ̪jʌ
petrolyo	pɪt̪ɾ̪ol̪jɔ
petsa	pitsʌ
petsahan	pɪtsʌhan̪
piguratibo	pɪgʊɾ̪ʌt̪ibɔ
pigurin	pɪgʊɾ̪in̪
pikit	pɪkit̪
pikoy	pɪkoj
pila	pil̪ʌ
pila	pɪl̪a
pilak	pil̪ʌk
pilapil	pɪl̪apɪl̪
pili	pil̪ɪʔ
pilipog	pɪl̪ipɔg
pilit	pɪl̪it̪
pilok	pɪl̪ok
pinadayag	pɪn̪ʌd̪ʌjag
pinansyal	pɪn̪an̪s̪jʌl̪
pinggan	pɪŋgan̪
pinulongan	pɪn̪ʊl̪oŋʌn̪
pinya	pin̪jʌ
pinyahan	pɪɲʌhʌn̪
pirot	pɪɾ̪ot̪
pisikal	pɪs̪ɪkal̪
piskal	pɪs̪kal̪
piso	pis̪ɔ
pisot	pɪs̪ot̪
pispis	pɪs̪pis̪
pistola	pɪs̪t̪ol̪ʌ
pitik	pit̪ɪk
pitlaw	pit̪l̪aʊ̯
pito	pit̪ɔ
pito	pɪt̪o
pitogo	pɪt̪ogɔ
piyansa	pjan̪s̪ʌ
piyer	pjiɾ̪
piyesta	pjis̪t̪ʌ
piyong	pijɔŋ
piñero	pɪɲɪɾ̪ɔ
planta	pl̪an̪t̪ʌ
plaridel	pl̪aɾ̪ɪd̪il̪
plaslayt	pl̪as̪l̪aɪ̯t̪
plema	pl̪imʌ
plete	pl̪it̪ɪ
polbora	pɔl̪boɾ̪ʌ
polbos	pol̪bɔs̪
politika	pɔl̪it̪ɪkʌ
politikanhon	pɔl̪ɪt̪ɪkʌŋhon̪
ponsing	pon̪s̪ɪŋ
porsento	pɔɾ̪s̪in̪t̪ɔ
porsiyento	pɔɾ̪s̪jin̪t̪ɔ
poste	pos̪t̪ɪ
praktis	pɾ̪akt̪ɪs̪
prebensiyon	pɾ̪ɪbɪn̪s̪jon̪
prediksyon	pɾ̪ɪd̪ɪks̪jon̪
preparado	pɾ̪ɪpʌɾ̪ad̪ɔ
preparar	pɾ̪ɪpaɾ̪ʌɾ̪
presensya	pɾ̪ɪs̪in̪s̪jʌ
presidente	pɾ̪ɪs̪ɪd̪in̪t̪ɪ
presko	pɾ̪is̪kɔ
presyo	pɾ̪is̪jɔ
pribado	pɾ̪ɪbad̪ɔ
pribilehiyo	pɾ̪ɪbɪl̪ɪhijɔ
prince	pɾ̪in̪s̪
priso	pɾ̪is̪ɔ
prisohan	pɾ̪ɪs̪ɔhan̪
probinsiya	pɾ̪ɔbin̪s̪jʌ
prutas	pɾ̪ut̪ʌs̪
puasa	pʊʔas̪ʌ
publikasyon	pʊbl̪ɪkʌs̪jon̪
pudlos	pʊd̪l̪os̪
pudno	pud̪n̪ɔ
puga	pugʌ
pugad	pugʌd̪
pughak	pʊghak
pugot	pugɔt̪
pugot	pʊgot̪
puhunan	pʊhun̪ʌn̪
pukaw	pukaʊ̯
puklo	pʊkl̪oʔ
pukot	pukɔt̪
pukpok	pukpɔk
pula	pwa
pula	pʊl̪a
pulas	pul̪ʌs̪
pulbora	pul̪bɔɾ̪ʌ
pulgas	pʊl̪gas̪
puling	pul̪ɪŋ
pulo	pul̪ɔʔ
pulo	pʊl̪oʔ
pulta	pul̪t̪ʌ
punaw	pʊn̪aʊ̯
pundasiyon	pʊn̪d̪ʌs̪jon̪
pundir	pʊn̪d̪iɾ̪
pundo	pun̪d̪ɔ
punerarya	pʊn̪ɪɾ̪aɾ̪jʌ
pungkay	pʊŋkaɪ̯
pungko	pʊŋkoʔ
pungkopungko	pʊŋkopʊŋkoʔ
pungkoy	pʊŋkoj
puno	pun̪ɔʔ
puno	pʊn̪oʔ
punyal	pʊn̪jal̪
punyeta	pʊn̪jit̪ʌ
punyete	pʊn̪jit̪ɪ
puot	pʊʔot̪
pusgay	pʊs̪gaɪ̯
pusil	pʊs̪il̪
pusit	pʊs̪it̪
puso	pus̪ɔ
puso	pus̪ɔʔ
pusod	pus̪ɔd̪
puspos	pus̪pɔs̪
pusta	pʊs̪t̪a
puti	pʊt̪iʔ
putli	pʊt̪l̪iʔ
puto	put̪ɔ
putos	pʊt̪os̪
putot	put̪ɔt̪
putyokan	pʊt̪jokʌn̪
puwa	pwa
puwede	pwid̪ɪ
pwerta	pwɪɾ̪t̪ʌ
quiapo	kjapɔʔ
quirino	kɪɾ̪in̪ɔ
quiñones	kɪɲɔn̪ɪs̪
rabago	ɾ̪abʌgɔ
rabanos	ɾ̪abʌn̪ɔs̪
radyo	ɾ̪ad̪jɔ
rambol	ɾ̪ambɔl̪
rambutan	ɾ̪ʌmbut̪ʌn̪
ramirez	ɾ̪ʌmiɾ̪ɪs̪
ransiyo	ɾ̪ʌn̪s̪jo
rason	ɾ̪ʌs̪on̪
rayban	ɾ̪iɪbʌn̪
rayna	ɾ̪aɪ̯n̪ʌ
razonable	ɾ̪ʌs̪ɔn̪abl̪ɪ
reaksiyon	ɾ̪ɪʔʌks̪jon̪
reaksyon	ɾ̪jʌks̪jon̪
rebaha	ɾ̪ɪbahʌ
rebelde	ɾ̪ɪbil̪d̪ɪ
regadera	ɾ̪ɪgʌd̪iɾ̪ʌ
regalo	ɾ̪ɪgal̪ɔ
rekomendar	ɾ̪ɪkɔmin̪d̪ʌɾ̪
relasyon	ɾ̪ɪl̪ʌs̪jon̪
relo	ɾ̪ɪl̪o
relokasyon	ɾ̪ɪl̪ɔkʌs̪jon̪
reorganisar	ɾ̪ɪʔɔɾ̪gʌn̪ɪs̪aɾ̪
reporma	ɾ̪ɪpoɾ̪mʌ
resibo	ɾ̪ɪs̪ibɔ
resolbar	ɾ̪ɪs̪ɔl̪baɾ̪
reyalista	ɾ̪jʌl̪is̪t̪ʌ
risgo	ɾ̪is̪gɔ
rodrigo	ɾ̪ɔd̪ɾ̪igɔ
rodriguez	ɾ̪ɔd̪ɾ̪igɪs̪
rojas	ɾ̪ohʌs̪
rolyo	ɾ̪ol̪jɔ
romero	ɾ̪ɔmiɾ̪ɔ
rosario	ɾ̪ɔs̪aɾ̪jɔ
rosaryo	ɾ̪ɔs̪aɾ̪jɔ
rubi	ɾ̪ʊbi
ruedas	ɾ̪wid̪ʌs̪
rufino	ɾ̪ʊpin̪ɔ
ruler	ɾ̪ul̪ɪɾ̪
ruperto	ɾ̪ʊpiɾ̪t̪ɔ
saad	s̪aʔʌd̪
sabado	s̪abʌd̪o
sabak	s̪abʌk
sabak	s̪ʌbak
sabat	s̪ʌbat̪
sabaw	s̪ʌbaʊ̯
sabellano	s̪ʌbɪl̪jan̪ɔ
sablay	s̪ʌbl̪aɪ̯
sabon	s̪ʌbon̪
sabong	s̪abɔŋ
sabot	s̪ʌbot̪
sabsab	s̪ʌbs̪ab
sabwag	s̪ʌbwag
sagang	s̪ʌgaŋ
sagay	s̪agaɪ̯
sagbot	s̪agbɔt̪
saging	s̪agɪŋ
sagop	s̪ʌgop
sain	s̪aʔɪn̪
saka	s̪ʌka
sakate	s̪ʌkat̪ɪ
sakay	s̪ʌkaɪ̯
sakayan	s̪ʌkajʌn̪
sako	s̪akɔ
saksak	s̪aks̪ʌk
saksi	s̪ʌks̪i
sakto	s̪akt̪ɔ
sala	s̪al̪ʌ
sala	s̪ʌl̪aʔ
salabay	s̪ʌl̪abaɪ̯
salabotan	s̪ʌl̪ʌbot̪ʌn̪
salag	s̪al̪ʌg
salampati	s̪ʌl̪ʌmpat̪ɪ
salan	s̪ʌl̪an̪
salapi	s̪ʌl̪ʌpiʔ
salazar	s̪ʌl̪ʌs̪aɾ̪
salcedo	s̪ʌl̪s̪id̪ɔ
salida	s̪ʌl̪id̪ʌ
salikwaot	s̪ʌl̪ɪkwʌʔot̪
salimbagat	s̪ʌl̪ɪmbagʌt̪
salinas	s̪ʌl̪in̪ʌs̪
salir	s̪ʌl̪iɾ̪
salog	s̪al̪ɔg
salog	s̪ʌl̪og
salom	s̪al̪ɔm
saluwal	s̪ʌl̪uʌl̪
salvador	s̪ʌl̪bʌd̪oɾ̪
samad	s̪amʌd̪
samar	s̪amʌɾ̪
samarnon	s̪ʌmʌɾ̪n̪on̪
sambag	s̪ʌmbag
samin	s̪ʌmin̪
sampay	s̪ʌmpaɪ̯
sampot	s̪ʌmpot̪
sampurado	s̪ʌmpʊɾ̪ad̪ɔ
samsam	s̪ʌms̪am
samsuy	s̪ams̪ʊɪ
sanag	s̪ʌn̪ag
sanchez	s̪an̪t̪s̪ɪs̪
sandayong	s̪ʌn̪d̪ʌjoŋ
sandiya	s̪ʌn̪d̪iʌ
sanga	s̪aŋʌ
sanga	s̪ʌŋa
sangay	s̪aŋaɪ̯
sanggot	s̪ʌŋgot̪
sanggumay	s̪ʌŋgumaɪ̯
sano	s̪an̪ɔ
santiago	s̪ʌn̪t̪jagɔ
santillan	s̪ʌn̪t̪ɪl̪jan̪
santilmo	s̪ʌn̪t̪il̪mɔ
santol	s̪ʌn̪t̪ol̪
saong	s̪aʔɔŋ
sapa	s̪apʌʔ
sapal	s̪apʌl̪
sapatos	s̪ʌpat̪ɔs̪
satumbaga	s̪ʌt̪ʊmbagʌ
sawa	s̪ʌwa
sawsaw	s̪aʊ̯s̪aʊ̯
saya	s̪ajʌ
saya	s̪ʌja
sayal	s̪ʌjal̪
sayaw	s̪adʒaʊ̯
sayaw	s̪ajaʊ̯
saybit	s̪aɪ̯bit̪
saydwok	s̪aɪ̯d̪wk
saylo	s̪aɪ̯l̪ɔ
saysay	s̪aɪ̯s̪aɪ̯
sedula	s̪id̪ʊl̪ʌ
segurado	s̪ɪgʊɾ̪ad̪ɔ
seguro	s̪ɪguɾ̪ɔ
sekondarya	s̪ɪkɔn̪d̪aɾ̪jʌ
seksyon	s̪ɪks̪jon̪
sekundarya	s̪ɪkʊn̪d̪aɾ̪jʌ
selpon	s̪il̪pɔn̪
semana	s̪ɪman̪ʌ
sementeryo	s̪ɪmɪn̪t̪iɾ̪jɔ
semento	s̪ɪmin̪t̪ɔ
semester	s̪ɪmis̪t̪ɪɾ̪
semilya	s̪ɪmil̪jʌ
senado	s̪ɪn̪ad̪ɔ
seno	s̪in̪ɔ
sensilyo	s̪ɪn̪s̪il̪jɔ
sensiyo	s̪ɪn̪s̪ijɔ
sentido	s̪ɪn̪t̪id̪ɔ
septiyembre	s̪ɪpt̪imbɾ̪ɪ
septiyembre	s̪ɪpt̪jimbɾ̪ɪ
sepulturero	s̪ɪpʊl̪t̪ʊɾ̪iɾ̪ɔ
serado	s̪ɪɾ̪ad̪ɔ
serbesa	s̪ɪɾ̪bis̪ʌ
seremonyas	s̪ɪɾ̪ɪmon̪jʌs̪
serye	s̪iɾ̪jɪ
setenta	s̪ɪt̪in̪t̪ʌ
sevilla	s̪ɪbil̪jʌ
siaton	s̪jat̪ɔn̪
sibat	s̪ɪbat̪
sibuyas	s̪ɪbudʒʌs̪
sibuyas	s̪ɪbujʌs̪
sibya	s̪ɪbja
sida	s̪id̪ʌ
sidlakan	s̪ɪd̪l̪ʌkan̪
sigarilyo	s̪ɪgʌɾ̪il̪jɔ
sige	s̪igɪ
sijam	s̪ɪdʒam
sikat	s̪ɪkat̪
sikil	s̪ɪkil̪
sikmol	s̪ɪkmol̪
siko	s̪ikɔ
sili	s̪il̪ɪ
simba	s̪ɪmba
simbahan	s̪ɪmbahʌn̪
simbajon	s̪ɪmbahɔn̪
simbako	s̪ɪmbakɔ
simbasimba	s̪ɪmbas̪ɪmba
sinangote	s̪ɪn̪ʌŋgot̪ɪ
sindikato	s̪ɪn̪d̪ɪkat̪ɔ
sinehan	s̪ɪn̪ɪhan̪
singin	s̪iŋɪn̪
singking	s̪iŋkɪŋ
singkohan	s̪ɪŋkohʌn̪
singot	s̪ɪŋot̪
singtanon	s̪ɪŋt̪an̪ɔn̪
sino	s̪in̪ɔ
sinugdanan	s̪ɪn̪ʊgd̪an̪ʌn̪
sinumbagay	s̪ɪn̪ʊmbʌgaɪ̯
siomai	s̪jomaɪ̯
sirado	s̪ɪɾ̪ad̪ɔ
sirkulasyon	s̪ɪɾ̪kʊl̪ʌs̪jon̪
sityo	s̪it̪jɔ
siya	s̪iʌ
siya	s̪ja
siya	s̪ɪdʒa
siyagit	s̪jagɪt̪
siyam	s̪jam
siyam	s̪ɪdʒam
siyento	s̪jin̪t̪ɔ
siyudad	s̪jʊd̪ad̪
slogan	s̪l̪ogʌn̪
solusyon	s̪ɔl̪ʊs̪jon̪
sosyalismo	s̪ɔs̪jʌl̪is̪mɔ
sotto	s̪ot̪ɔ
suarez	s̪wʌɾ̪ɪs̪
suba	s̪ʊbaʔ
subang	s̪ubʌŋ
subangan	s̪ʊbaŋʌn̪
subida	s̪ʊbid̪ʌ
suborno	s̪ʊboɾ̪n̪ɔ
sudlay	s̪ud̪l̪aɪ̯
sugal	s̪ʊgal̪
sugalan	s̪ʊgal̪ʌn̪
sugarol	s̪ʊgʌɾ̪ol̪
sugi	s̪ugɪ
sugibuhi	s̪ʊgɪbuhɪʔ
sugilagming	s̪ʊgɪl̪ʌgmiŋ
sugilambong	s̪ʊgɪl̪ʌmboŋ
sugilandong	s̪ʊgɪl̪ʌn̪d̪oŋ
sugilanon	s̪ʊgɪl̪an̪ɔn̪
sugod	s̪ugɔd̪
suhestyon	s̪ʊhɪs̪t̪jon̪
suhol	s̪uhɔl̪
suholan	s̪ʊhol̪ʌn̪
suka	s̪ukʌ
suka	s̪ukʌʔ
sukli	s̪ʊkl̪iʔ
suko	s̪ukɔ
sula	s̪ʊl̪a
sula	s̪ʊl̪aʔ
sulang	s̪ʊl̪aŋ
sulay	s̪ʊl̪aɪ̯
sulo	s̪ʊl̪oʔ
sulod	s̪ud̪
sulod	s̪ul̪ɔd̪
sulod	s̪ʊjod̪
sulod	s̪ʊl̪od̪
sulog	s̪ʊl̪og
sulsol	s̪ul̪s̪ɔl̪
sultaob	s̪ʊl̪t̪aʔɔb
sulu	s̪ʊl̪u
sumalpong	s̪ʊmʌl̪poŋ
sumbag	s̪ʊmbag
sundalo	s̪ʊn̪d̪al̪ɔ
sundalo	s̪ʊn̪d̪awo
sundang	s̪ʊn̪d̪aŋ
sundawo	s̪ʊn̪d̪aw
sungay	s̪uŋaɪ̯
sunoy	s̪ʊn̪oj
suntok	s̪ʊn̪t̪ok
suntokay	s̪ʊn̪t̪ɔkaɪ̯
supsop	s̪ups̪ɔp
sura	s̪uɾ̪ʌ
surigao	s̪ʊɾ̪igaʊ̯
suroy	s̪uɾ̪oɪ̯
susi	s̪us̪ɪ
susmarisep	s̪ʊs̪mʌɾ̪is̪ɪp
susmaryosep	s̪ʊs̪mʌɾ̪jos̪ɪp
suspek	s̪us̪pɪk
sutil	s̪ʊt̪il̪
sutukil	s̪ʊt̪ʊkil̪
suwang	s̪ʊwaŋ
suway	s̪waɪ̯
suweldo	s̪wil̪d̪ɔ
suwerte	s̪wiɾ̪t̪ɪ
suya	s̪ujʌʔ
suyak	s̪ujʌk
suyakan	s̪ʊjakʌn̪
swapang	s̪wʌpʌŋ
ta	t̪a
taas	t̪aʔʌs̪
taas	t̪ʌʔas̪
tabako	t̪ʌbakɔʔ
tabako	t̪ʌbʌkoʔ
tabang	t̪abʌŋ
tabay	t̪abaɪ̯
tabilawan	t̪ʌbɪl̪awʌn̪
tabili	t̪ʌbɪl̪i
tabilikod	t̪ʌbɪl̪ɪkod̪
tabliya	t̪ʌbl̪iʌ
tabunok	t̪ʌbun̪ɔk
tadtad	t̪ad̪t̪ʌd̪
taga	t̪agʌ
taga	t̪ʌga
taga	t̪ʌgaʔ
tagabukid	t̪ʌgʌbukɪd̪
tagad	t̪ʌgad̪
tagam	t̪ʌgam
tagaw	t̪ʌgaʊ̯
tagay	t̪agaɪ̯
tagbo	t̪ʌgboʔ
taghoy	t̪aghoɪ̯
tagiptip	t̪ʌgipt̪ɪp
tagna	t̪agn̪ʌʔ
tagohipos	t̪ʌgɔhipɔs̪
tagok	t̪ʌgok
tahap	t̪ahʌp
tahi	t̪ʌhiʔ
taho	t̪ʌhoʔ
tahom	t̪ʌhom
tahop	t̪ahɔp
tai	t̪aʔɪ
takdol	t̪akd̪ɔl̪
takig	t̪akɪg
takilya	t̪ʌkil̪jʌ
taklob	t̪ʌkl̪ob
tako	t̪akɔʔ
takob	t̪ʌŋkob
takos	t̪ʌkos̪
takwal	t̪ʌkwal̪
talaba	t̪ʌl̪ʌba
talamban	t̪ʌl̪ʌmban̪
talamdan	t̪ʌl̪ʌmd̪an̪
talaw	t̪al̪aʊ̯
talawan	t̪ʌl̪awʌn̪
talay	t̪ʌl̪aɪ̯
tali	t̪al̪ɪ
tali	t̪al̪ɪʔ
talibong	t̪ʌl̪ɪboŋ
talikala	t̪ʌl̪ɪkʌl̪a
talomo	t̪ʌl̪omɔ
talong	t̪ʌl̪oŋ
talong	t̪ʌwoŋ
taludtod	t̪ʌl̪ud̪t̪ɔd̪
talya	t̪al̪jʌ
talyo	t̪al̪jɔ
tambalanan	t̪ʌmbʌl̪an̪ʌn̪
tambaloslos	t̪ʌmbʌl̪os̪l̪ɔs̪
tambis	t̪ambɪs̪
taming	tɐmiŋ
tampohay	t̪ʌmpohaɪ̯
tampos	t̪ʌmpos̪
tampus	t̪ʌmpus̪
tamsi	t̪ʌms̪i
tanan	t̪ʌn̪an̪
taneo	t̪ʌn̪iɔ
tangad	t̪ʌŋad̪
tanggal	t̪ʌŋgal̪
tanggo	t̪aŋgɔ
tangis	t̪aŋɪs̪
tangke	t̪ʌŋki
tangkil	t̪ʌŋkil̪
tangkilepono	t̪ʌŋkɪl̪ipɔn̪ɔ
tangkop	t̪ʌŋkop
tangkugo	t̪ʌŋkugɔʔ
tanglad	t̪ʌŋl̪ad̪
tanlag	t̪ʌn̪l̪ag
tanod	t̪an̪ɔd̪
tanom	t̪ʌn̪om
tanos	t̪an̪ɔs̪
tansan	t̪an̪s̪ʌn̪
tanum	t̪ʌn̪um
taob	t̪ʌʔob
taop	t̪aɔp
tapay	t̪apaɪ̯
tapayan	t̪ʌpajʌn̪
tapo	t̪apɔʔ
tapol	t̪ʌpol̪
tapolan	t̪ʌpɔl̪an̪
tapos	t̪apɔs̪
target	t̪aɾ̪gɪt̪
tariktik	t̪ʌɾ̪ikt̪ɪk
tasa	t̪as̪ʌ
tasik	t̪as̪ɪk
tata	t̪at̪ʌ
tata	t̪at̪ʌʔ
tata	t̪ʌt̪a
taudtaod	t̪ʌʔud̪t̪ʌʔod̪
tawa	t̪ʌwa
tawag	t̪awʌg
tawas	t̪awʌs̪
tawo	t̪aw
tawong	t̪ʌwoŋ
taya	t̪ʌjaʔ
taytay	t̪aɪ̯t̪aɪ̯
telepono	t̪ɪl̪ipɔn̪ɔ
teleponokabildo	t̪ɪl̪ipɔn̪ɔkʌbil̪d̪ɔ
templado	t̪ɪmpl̪ad̪ɔ
tempura	t̪ɪmpuɾ̪ʌ
tenyente	t̪ɪn̪jin̪t̪ɪ
termino	t̪iɾ̪mɪn̪o
tesawro	t̪ɪs̪aʊ̯ɾ̪ɔ
tetanos	t̪it̪ʌn̪os̪
tigbak	t̪ɪgbak
tigdumala	t̪ɪgd̪ʊmal̪ʌ
tigidig	t̪ɪgɪd̪ig
tigulang	t̪ɪgul̪ʌŋ
tikangkang	t̪ɪkʌŋkaŋ
tiket	t̪ikɪt̪
tiklo	t̪ɪkl̪oʔ
tikoy	t̪ikoɪ̯
tilaok	t̪ɪl̪aʔɔk
tilapya	t̪ɪl̪apjʌ
tilok	t̪il̪ɔk
timbang	t̪imbʌŋ
timbangan	t̪ɪmbaŋʌn̪
timonel	t̪ɪmɔn̪il̪
timonero	t̪ɪmɔn̪iɾ̪ɔ
timoteo	t̪imɔt̪iɔ
tinagalog	t̪ɪn̪ʌgal̪ɔg
tinagdan	t̪ɪn̪ʌgd̪an̪
tinapay	t̪ɪn̪apaɪ̯
tinda	t̪in̪d̪ʌ
tindak	t̪in̪d̪ʌk
tindera	t̪ɪn̪d̪iɾ̪ʌ
tindero	t̪ɪn̪d̪iɾ̪ɔ
tindog	t̪ɪn̪d̪og
tinemplahan	t̪ɪn̪ɪmpl̪ʌhan̪
tingali	t̪ɪŋal̪ɪ
tingkagol	t̪ɪŋkagɔl̪
tingkoy	t̪ɪŋkoj
tingsi	t̪iŋs̪ɪʔ
tinidor	t̪ɪn̪ɪd̪oɾ̪
tintin	t̪in̪t̪ɪn̪
tinuhoan	t̪ɪn̪ʊhoʔʌn̪
tipasi	t̪ɪpas̪ɪʔ
tipoy	t̪ɪpoj
tirada	t̪ɪɾ̪ad̪ʌ
tirador	t̪ɪɾ̪ʌd̪oɾ̪
tisoy	t̪ɪs̪oj
titser	t̪itsɪɾ̪
titulo	t̪it̪ʊl̪o
tiya	t̪iʌ
tiyan	t̪jan̪
tiyo	t̪ijɔ
tokaya	t̪ɔkajʌ
tokayo	t̪ɔkajɔ
tokhang	t̪ɔkhaŋ
toledo	t̪ɔl̪id̪ɔ
toledohanon	t̪ɔl̪ɪd̪ɔhan̪ɔn̪
toma	t̪omʌʔ
tomas	t̪ɔmas̪
tomboy	t̪omboɪ̯
tono	t̪on̪ɔ
torero	t̪ɔɾ̪iɾ̪ɔ
toril	t̪ɔɾ̪il̪
torres	t̪oɾ̪ɪs̪
trabahante	t̪ɾ̪ʌbʌhan̪t̪ɪ
trabaho	t̪ɾ̪ʌbahɔ
trangka	t̪ɾ̪aŋkʌ
trangkaso	t̪ɾ̪ʌŋkas̪ɔ
trapik	t̪ɾ̪apɪk
trapiko	t̪ɾ̪apɪko
trato	t̪ɾ̪at̪ɔ
trayanggulo	t̪ɾ̪ʌjaŋgʊl̪ɔ
traynta	t̪ɾ̪aɪ̯n̪t̪ʌ
trisikad	t̪ɾ̪ɪs̪ikʌd̪
trono	t̪ɾ̪on̪ɔ
troso	t̪ɾ̪os̪ɔ
tsampurado	t̪s̪ʌmpʊɾ̪ad̪ɔ
tsinelas	t̪s̪ɪn̪il̪ʌs̪
tsismis	t̪s̪is̪mɪs̪
tsismosa	t̪s̪ɪs̪mos̪ʌ
tsismoso	t̪s̪ɪs̪mos̪ɔ
tsunami	t̪s̪ʊn̪amɪ
tuberkulosis	t̪ʊbɪɾ̪kʊl̪os̪ɪs̪
tubig	t̪ubɪg
tubo	t̪ubɔ
tubo	t̪ubɔʔ
tubo	t̪ʊbo
tubol	t̪ʊbol̪
tudtod	t̪ud̪t̪ɔd̪
tugas	t̪ʊgas̪
tugon	t̪ugɔn̪
tugot	t̪ugɔt̪
tugpahanan	t̪ʊgpʌhan̪ʌn̪
tuhod	t̪uhɔd̪
tuig	t̪uʔɪg
tuka	t̪ʊkaʔ
tukaw	t̪ʊkaʊ̯
tuko	t̪ʊkoʔ
tukoy	t̪ukoɪ̯
tuktok	t̪ukt̪ɔk
tuktugaok	t̪ʊkt̪ʊgaʔɔk
tulak	t̪ul̪ʌk
tulay	t̪ʊl̪aɪ̯
tuli	t̪ul̪ɪʔ
tulis	t̪ul̪ɪs̪
tulisan	t̪ʊl̪ɪs̪an̪
tulo	t̪ul̪ɔʔ
tulo	t̪ʊl̪o
tulo	t̪ʊl̪oʔ
tulod	t̪wod̪
tulod	t̪ʊl̪od̪
tulog	t̪ul̪ɔg
tulong	t̪ul̪ɔŋ
tulos	t̪ul̪ɔs̪
tuman	t̪umʌn̪
tumpag	t̪ʊmpag
tumulak	t̪ʊmul̪ʌk
tunaw	t̪un̪aʊ̯
tunay	t̪un̪aɪ̯
tunga	t̪ʊŋaʔ
tungod	t̪ʊŋod̪
tunok	t̪ʊn̪ok
tunsoy	t̪ʊn̪s̪oj
tuo	t̪uʔɔ
tuo	t̪ʊʔo
tuod	t̪uʔɔd̪
tuohon	t̪ʊʔohɔn̪
tuok	t̪ʊʔok
tuon	t̪ʊʔon̪
tupad	t̪ʊpad̪
turismo	t̪ʊɾ̪is̪mɔ
turutot	t̪ʊɾ̪ut̪ɔt̪
tusok	t̪us̪ɔk
tutoy	t̪ut̪oɪ̯
tuwerka	t̪wiɾ̪kʌ
tuyo	t̪udʒɔ
tuyo	t̪ujɔ
tuñacao	t̪ʊɲʌkaʊ̯
twerka	t̪wɪɾ̪kʌ
ubalde	ʔʊbal̪d̪ɪ
ubi	ʔubɪ
ubo	ʔʊbo
udong	ʔud̪ɔŋ
udto	ʔʊd̪t̪o
ug	ʔug
uga	ʔʊga
ugaling	ʔʊgal̪ɪŋ
ugat	ʔʊgat̪
ugay	ʔugaɪ̯
ugdo	ʔʊgd̪o
ugis	ʔugɪs̪
ugkay	ʔugkaɪ̯
ugma	ʔʊgmaʔ
uhaw	ʔʊhaʊ̯
uhong	ʔuhɔŋ
ukay	ʔukaɪ̯
uki	ʔukɪ
ulalong	ʔʊl̪al̪ɔŋ
ulan	ʔʊl̪an̪
ulan	ʔʊwan̪
ulang	ʔʊl̪aŋ
ulaw	ʔuaʊ̯
ulaw	ʔudʒaʊ̯
ulaw	ʔujaʊ̯
ulaw	ʔul̪aʊ̯
ulayan	ʔʊl̪ajʌn̪
uli	ʔul̪ɪʔ
uli	ʔʊl̪iʔ
uling	ʔul̪ɪŋ
ulipon	ʔʊl̪ipɔn̪
ulo	ʔul̪ɔ
ulod	ʔul̪ɔd̪
ulok	ʔʊl̪ok
ulon	ʔʊl̪on̪
ulonan	ʔʊl̪on̪ʌn̪
umagad	ʔʊmagʌd̪
umang	ʔʊmaŋ
umog	ʔʊmog
umpad	ʔumpʌd̪
unabia	ʔʊn̪abjʌ
unano	ʔʊn̪an̪ɔʔ
ungo	ʔuŋɔʔ
ungol	ʔuŋɔl̪
ungol	ʔʊŋol̪
unibersidad	ʔʊn̪ɪbɪɾ̪s̪ɪd̪ad̪
unlan	ʔʊn̪l̪an̪
unom	ʔʊn̪om
unsa	ʔʊn̪s̪a
unya	ʔʊn̪jaʔ
unyon	ʔʊn̪jon̪
upas	ʔupʌs̪
upas	ʔʊpas̪
upat	ʔʊpat̪
upaw	ʔupaʊ̯
upo	ʔupɔ
usa	ʔʊs̪a
usap	ʔus̪ʌp
uswag	ʔus̪wʌg
uswag	ʔʊs̪wag
utan	ʔut̪ʌn̪
utang	ʔut̪ʌŋ
utangan	ʔʊt̪ʌŋan̪
utanon	ʔʊt̪ʌn̪on̪
utin	ʔut̪ɪn̪
utog	ʔʊt̪og
utok	ʔut̪ɔk
utong	ʔʊt̪oŋ
utot	ʔʊt̪ot̪
uwak	ʔʊak
uwan	ʔʊwan̪
uwang	ʔʊaŋ
uyab	ʔujʌb
uyab	ʔʊjab
uyon	ʔujɔn̪
vasquez	bas̪kɪs̪
velasquez	bɪl̪as̪kɪs̪
villafuerte	bil̪jʌpwiɾ̪t̪ɪ
villanueva	bɪl̪jʌn̪wibʌ
wagas	wʌgas̪
wail	wʌʔil̪
wala	wʌl̪a
wala	wʌl̪aʔ
walay	waɪ̯
walay	wʌl̪aɪ̯
walo	wʌl̪o
walo	wʌwo
walog	wal̪ɔg
wangwang	waŋwʌŋ
wawog	wawg
way	waɪ̯
yabe	jabɪ
yamis	jamɪs̪
yapyap	japjap
yarda	jaɾ̪d̪ʌ
yate	jat̪ɪ
yawa	dʒawʌʔ
yawa	jawʌʔ
yaya	jajʌ
yaya	jaʔjʌʔ
yayong	jajɔŋ
yañez	jaɲɪs̪
ybañez	ʔɪbaɲɪs̪
ylaya	ʔɪl̪ajʌʔ
yosi	jos̪ɪ
yoyoy	jojoɪ̯
zamora	s̪ʌmoɾ̪ʌ
