aada	ɑːd̥ɑ
aadam	ɑːd̥ɑm
aafrika	ɑˑfrikˑɑ
aaron	ɑːron
aasia	ɑːsʲiɑ̯
albaania	ɑlb̥ɑːnʲiɑ̯
albert	ɑlb̥ertˑ
aleksandra	ɑleksɑnd̥rɑ
alina	ɑlʲinɑ
alžiir	ɑlʒiːr
ameerika	ɑmeˑrikˑɑ
andorra	ɑnd̥orˑɑ
andreas	ɑnd̥reɑ̯s
angela	ɑŋg̊elɑ
angelika	ɑng̊eːlʲikˑɑ
antarktis	ɑntɑrkˑtʲis
armeenia	ɑrmeːnʲiɑ̯
aruküla	ɑrukˑylɑ
aserbaidžaan	ɑserb̥ɑi̯d̥ʒɑːn
ateena	ɑteˑnɑ
austria	ɑu̯striɑ̯
b	b̥
b	b̥eː
belfast	b̥elfɑːst
belgia	b̥elʲg̊iɑ̯
belgrad	b̥elg̊rɑd̥
berliin	b̥erlʲiːn
bosnia	b̥osnʲiɑ̯
brüssel	b̥rysːel
budapest	b̥ud̥ɑpˑest
bukarest	b̥ukˑɑrest
bulgaaria	b̥ulg̊ɑːriɑ̯
c	kˑ
c	s
c	ts
c	tseː
eeden	eːd̥en
eesti	eˑstʲi
eestimaa	eˑstʲimɑː
elevandiluurannik	elevɑnʲd̥ʲiluːrɑnˑikˑ
elina	elʲinɑ
emajõgi	emɑ̈jɤg̊i
emil	emil
esko	esko
euroopa	eu̯roːpːɑ
georgia	d̥ʒoːrd̥ʒiɑ̯
georgia	g̊eorg̊iɑ̯
gruusia	g̊ruːsʲiɑ̯
hanna	hɑnːɑ
helen	helen
helsingi	helsʲiŋg̊i
hendrik	hend̥rikˑ
hertsegoviina	hertseg̊oviˑnɑ
hess	hesː
hispaania	hispɑːnʲiɑ̯
horvaatia	horvɑːtʲiɑ̯
hypnos	hypnos
island	islɑnd̥
johannes	joɦɑnːes
jõgeva	jɤg̊evɑ
kairo	kɑi̯ro
kalevipoeg	kɑlevipoe̯g̊
kiribati	kirib̥ɑˑtʲi
koolmajärve	koːlmɑjærve̞
koolmajärve	kuːlmɑjærve̞
lahe	lɑɦe̞
laura	lɑu̯rɑ
libeeria	lʲib̥eːriɑ̯
luxembourg	lyg̊zɑnb̥uːr
maali	mɑˑlʲi
malmö	mɑlmø
malta	mɑltɑ
martin	mɑrtʲin
mati	mɑtʲˑi
melikjan	melʲikjɑ̈n
mooses	moːses
naissaar	nɑi̯ssɑːr
napoli	nɑːpːolʲi
noor	noːr
olga	olʲg̊ɑ
ots	ots
paavo	pɑːvo
panama	pɑnɑmɑ
pluuto	pluːtːo
praha	prɑɦɑ
raudsepp	rɑu̯d̥sepː
rootsi	roˑtsʲi
rüütli	ryːtlʲi
sarajevo	sɑrɑ̈jevo
sevilla	sevilʲjɑ̈
sloveenia	sloveːnʲiɑ̯
sofia	sofˑiɑ̯
soome	soːme̞
stella	stelːɑ
stockholm	stokːholm
tatevosjan	tɑtˑevosʲjɑ̈n
torino	toriːno
vaduz	fɑd̥uːts
varssavi	vɑrsːɑvi
vikisõnaraamat	vikˑisɤnɑrɑˑmɑtˑ
vjatšeslav	vjɑ̈tʃeslɑv
wales	vei̯ls
zagreb	zɑːg̊reb̥
aabits	ɑˑb̥its
aadress	ɑːd̥resʲː
aaker	ɑːkːer
aam	ɑːm
aamissepp	ɑˑmissepː
aare	ɑˑre̞
aas	ɑːs
aasia	ɑːsʲiɑ̯
aasta	ɑːstɑ
aastaaeg	ɑːstɑɑe̯g̊
aastal	ɑːstɑl
aastapäev	ɑːstɑpæe̯v
aastasada	ɑːstɑsɑd̥ɑ
aastat	ɑːstɑtˑ
aatelik	ɑːtːelʲikˑ
abielulahutus	ɑb̥ielulɑɦutˑus
ablas	ɑb̥lɑs
absoluutne	ɑb̥soluːtne̞
adekvaatne	ɑd̥ekvɑːtne̞
adjektiiv	ɑd̥ʲjektʲiːv
adru	ɑd̥ru
adverb	ɑd̥verb̥
adverbiline	ɑd̥verb̥ilʲine̞
advokaat	ɑd̥vokɑːtˑ
advokaat	ɑd̥vokˑɑːtˑ
aeg	ɑe̯g̊
aeglane	ɑe̯g̊lɑne̞
aeglaselt	ɑe̯g̊lɑseltˑ
aeglasemalt	ɑe̯g̊lɑsemɑltˑ
aevastama	ɑe̯vɑstɑmɑ
agar	ɑg̊ɑr
ahas	ɑɦɑs
ahav	ɑɦɑv
aher	ɑɦer
ahhaat	ɑhːɑːtˑ
ahm	ɑhˑm̥
ahmima	ɑhmimɑ
ahne	ɑhne̞
ahu	ɑɦu
aiamaa	ɑi̯ɑmɑː
aiapiire	ɑi̯ɑpiˑre̞
aidata	ɑi̯d̥ɑtˑɑ
aine	ɑi̯ne̞
ainus	ɑi̯nus
ait	ɑi̯tˑ
aita	ɑi̯tˑɑ
aituma	ɑi̯tumɑ
aitäh	ɑi̯tæh
aitüma	ɑi̯tymɑ
ajaja	ɑ̈jɑ̈jɑ̈
ajakiri	ɑ̈jɑ̈kiri
ajakirjandus	ɑ̈jɑ̈kirjɑ̈nd̥us
ajakirjanik	ɑ̈jɑ̈kirjɑ̈nʲikˑ
ajalugu	ɑ̈jɑ̈lug̊u
ajapiirang	ɑ̈jɑ̈piˑrɑŋg̊
ajukasvaja	ɑ̈jükɑsvɑ̈jɑ̈
akronüüm	ɑkronyːm
aktiveerima	ɑkˑtʲiveːrimɑ
aktsiaturg	ɑkˑtsʲiɑ̯turg̊
akvaarium	ɑkvɑːriu̯m
alalõualuu	ɑlɑlɤu̯ɑluː
alalõug	ɑlɑlɤu̯g̊
alates	ɑlɑtˑes
aldehüüd	ɑld̥ehyːd̥
algskandinaavia	ɑlg̊skɑnd̥ʲinɑːviɑ̯
alk	ɑlʲkˑ
alkohol	ɑlkoɦol
alkoholikauplus	ɑlkoɦolʲikɑu̯plus
alkoholism	ɑlkoɦolʲisˑm̥
alkoholivaba	ɑlkoɦolʲivɑb̥ɑ
alkohoolne	ɑlkohoːlne̞
allergiline	ɑlːerg̊ilʲine̞
alustama	ɑlustɑmɑ
ambuma	ɑmb̥umɑ
ametlik	ɑmetlʲikˑ
ammuma	ɑmːumɑ
amulett	ɑmuletʲː
amööb	ɑmøːb̥
analüüs	ɑnɑlyːs
analüüsima	ɑnɑlyːsʲimɑ
anarhism	ɑnɑrhisˑm̥
and	ɑnʲd̥
anda	ɑnd̥ɑ
andis	ɑnʲd̥ʲis
andma	ɑnd̥mɑ
andmebaas	ɑnd̥meb̥ɑːs
andmebaas	ɑnd̥meb̥ɑːsʲ
antisemitism	ɑntʲisemitʲˑisˑm̥
antonüüm	ɑntonyːm
antonüümne	ɑntonyːmne̞
antud	ɑntud̥
apelsinimahl	ɑpˑelsʲinʲimɑhˑl̥
aplus	ɑplus
apteek	ɑpˑteːkˑ
apteek	ɑːpˑteːkˑ
arbuus	ɑrb̥uːs
areng	ɑreŋg̊
arheoloogia	ɑrheo̯loːg̊iɑ̯
armastus	ɑrmɑstus
armee	ɑrmeː
artišokk	ɑrtʲiʃokː
arukus	ɑrukˑus
arutleja	ɑrutlejɑ̈
arvelaud	ɑrvelɑu̯d̥
arvukas	ɑrvukˑɑs
arvutiviirus	ɑrvutʲˑiviːrus
asi	ɑsʲi
asjatundja	ɑsʲjɑ̈tunʲd̥ʲjɑ̈
astenosfäär	ɑstenosfæːr
asteroid	ɑsteroi̯d̥
astmevaheldus	ɑstmevɑɦeld̥us
atmosfäär	ɑtmosfæːr
autism	ɑu̯tʲisˑm̥
auto	ɑu̯tˑo
autobuss	ɑu̯tˑob̥usʲː
autobussijaam	ɑu̯tˑob̥usˑijɑ̈ːm
automaatne	ɑu̯tˑomɑːtne̞
avalik	ɑvɑlʲikˑ
b	b̥
b	b̥eː
baar	b̥ɑːr
baklažaan	b̥ɑklɑʒɑːn
ballett	b̥ɑlːetʲː
barrikaad	b̥ɑrːikɑːd̥
barrikaad	b̥ɑrːikˑɑːd̥
berdõšš	b̥erd̥ɤʃː
biblioteek	b̥ib̥lʲio̯tˑeːkˑ
bioloogia	b̥io̯loːg̊iɑ̯
botaanika	b̥otɑːnʲikˑɑ
buss	b̥usʲː
bussijaam	b̥usˑijɑ̈ːm
bürokraatia	b̥yrokrɑːtʲiɑ̯
c	tseː
d	d̥eː
davai	d̥ɑvɑi̯
davai	tɑvɑi̯
delegatsioon	d̥eleg̊ɑtsʲjoːn
delfiin	d̥elʲfiːn
demograafia	d̥emog̊rɑːfiɑ̯
demokraat	d̥emokrɑːtˑ
demokraatia	d̥emokrɑːtʲiɑ̯
demokraatlik	d̥emokrɑːtlʲikˑ
depressioon	d̥epresʲːio̯ːn
desovetiseerimine	d̥esovetʲˑiseːrimine̞
dialoog	d̥ʲiɑ̯loːg̊
digiraamat	d̥ʲig̊irɑˑmɑtˑ
diivan	d̥ʲiːvɑn
diplomaat	d̥ʲiplomɑːtˑ
diplomaatiline	d̥ʲiplomɑːtʲilʲine̞
dušš	d̥uʃː
džemm	d̥ʒemː
džemper	d̥ʒemper
džihaad	d̥ʒihɑːd̥
džäss	d̥ʒæsː
e	eː
ebaõnn	eb̥ɑɤnʲː
eeden	eːd̥en
eesmärk	eːsmærkˑ
eesti	eˑstʲi
eestimaalane	eˑstʲimɑːlɑne̞
eha	eɦɑ
ehitus	eɦitˑus
ehk	ehk
ekraan	ekrɑːn
ekspert	ekspertˑ
elamu	elɑmu
elekter	elekˑter
elektri	elekˑtri
elektrigeneraator	elekˑtrig̊enerɑːtːor
elektrijalgratas	elekˑtrijɑ̈lg̊rɑtˑɑs
elulugu	elulug̊u
emakas	emɑkˑɑs
enam	enɑm
endale	end̥ɑle̞
endisaeg	enʲd̥ʲisɑe̯g̊
endisaegne	enʲd̥ʲisɑe̯g̊ne̞
energia	energ̊iɑ̯
enesepiiramine	enesepiːrɑmine̞
ennast	enˑɑst
enne	enːe̞
enne	enˑe̞
entsüklopeedia	entsyklopeːd̥ʲiɑ̯
epideemia	epˑid̥eːmiɑ̯
erakond	erɑkˑond̥
eraldama	erɑld̥ɑmɑ
eramu	erɑmu
erektsioon	erekˑtsʲjoːn
eritlus	eritlus
eriväed	erivæe̯d̥
eriüksus	eriyksus
esimees	esʲimeːs
esimene	esʲimene̞
esiteks	esʲitˑeks
esmaspäev	esmɑspæe̯v
ettepanek	etːepˑɑnekˑ
ettevaatlik	etːevɑːtlʲikˑ
ettevõte	etːevɤtˑe̞
eufooria	eu̯foːriɑ̯
euro	eu̯ro
eutanaasia	eu̯tˑɑnɑːsʲiɑ̯
f	efː
feminiin	feminʲiːn
feminiinne	feminʲiːnːe̞
feminiinum	feminʲiːnum
festival	festʲivɑl
filosoofia	filosoːfiɑ̯
filosoofia	filossoːfiɑ̯
foobia	foːb̥iɑ̯
fotoka	fotˑokɑ
fotokas	fotˑokɑs
fotokat	fotˑokɑtˑ
fotorealistlik	fotˑoreɑ̯lʲistlʲikˑ
g	g̊eː
gaas	kɑːs
gangster	g̊æŋg̊ster
gangster	g̊ɑŋg̊ster
generaator	g̊enerɑːtːor
genotsiid	g̊enotsʲiːd̥
geograafia	g̊eo̯g̊rɑːfiɑ̯
geoloogia	g̊eo̯loːg̊iɑ̯
giid	g̊iːd̥
gnoomon	g̊noːmon
grammatika	g̊rɑmmɑtʲˑikɑ
h	hɑʃː
h	hɑː
haak	hɑːkˑ
haarama	hɑːrɑmɑ
habemeajaja	hɑb̥emeɑ̈jɑ̈jɑ̈
haigla	hɑi̯g̊lɑ
hakka	hɑkːɑ
hakkas	hɑkːɑs
haldjas	hɑld̥ʲjɑ̈s
hall	hɑlʲː
hall	hɑlː
hambapasta	hɑmb̥ɑpɑstɑ
hamburger	hɑmb̥urg̊er
hammas	hɑmˑɑs
hansalinn	hɑnsɑlʲinː
harakas	hɑrɑkˑɑs
harilikult	hɑrilʲikˑultˑ
haugas	hɑu̯g̊ɑs
hea	heɑ̯
hele	hele̞
heleda	heled̥ɑ
helisema	helʲisemɑ
hernes	hernes
hiiglane	hiːg̊lɑne̞
hiljuti	hilʲjütʲˑi
hiljutine	hilʲjütʲˑine̞
hingama	hiŋg̊ɑmɑ
hinnang	hinˑɑŋg̊
hirm	hirm
hirv	hirv
hitt	hitʲː
hitt	hitː
hobuseraua	hob̥userɑu̯ɑ
hobuseraud	hob̥userɑu̯d̥
homme	homːe̞
hommikuti	homːikˑutʲi
hoog	hoːg̊
hoomama	hoːmɑmɑ
huligaan	hulʲig̊ɑːn
hundikutsikas	hunʲd̥ʲikutsʲikˑɑs
hussiit	hussʲiːtˑ
häbemekink	hæb̥emekiŋkˑ
hädasignaal	hæd̥ɑsʲig̊nɑːl
hämu	hæmu
hävitama	hævitˑɑmɑ
hää	hæː
hääl	hæːl
hõim	hɤi̯m
hõljum	hɤlʲjüm
hõljumiteadus	hɤlʲjümiteɑ̯d̥us
hõre	hɤre̞
hütt	hytʲː
hüva	hyvɑ
hüüumärk	hyi̯u̯mærkˑ
igapäevane	ig̊ɑpæe̯vɑne̞
igatahes	ig̊ɑtɑɦes
igaüks	ig̊ɑyks
ikka	ikːɑ
ilu	ilu
ime	ime̞
imetama	imetˑɑmɑ
implosioon	implosʲio̯ːn
ingel	iŋg̊el
ingelinvestor	iŋg̊elʲinvestor
inhibiitor	inhib̥iːtːor
instituut	instʲittuːtˑ
instituut	instʲitˑuːtˑ
intellekt	intelːekˑt
intelligents	intelʲːig̊ents
invasioon	invɑsʲio̯ːn
iva	ivɑ
jaam	jɑ̈ːm
jaanalind	jɑ̈ˑnɑlʲind̥
jaaniuss	jɑ̈ˑnʲiusʲː
jah	jɑ̈h
jahe	jɑ̈ɦe̞
jahtima	jɑ̈htʲimɑ
jaoks	jɑ̈o̯ks
jidiš	jid̥ʲiʃ
joom	joːm
jooma	joːmɑ
jooma	joˑmɑ
jootraha	joːtrɑɦɑ
juba	jüb̥ɑ
jumalaga	jümɑlɑg̊ɑ
jutt	jütː
juttu	jütːu
jutu	jütˑu
juurima	jüːrimɑ
järgmine	jærg̊mine̞
jää	jæː
jääaeg	jæːɑe̯g̊
jääkülm	jæːkylʲm
jäämägi	jæːmæg̊i
jääpurikas	jæːpurikˑɑs
jäätama	jæːtˑɑmɑ
jäätis	jæːtˑis
jäätisemasin	jæːtʲisemɑsʲin
jäätuma	jæːtˑumɑ
jõgi	jɤg̊i
jõudma	jɤu̯d̥mɑ
kaaren	kɑːren
kaas	kɑːs
kaassõna	kɑːssɤnɑ
kabeljoo	kɑb̥elʲjoː
kadakasakslane	kɑd̥ɑkˑɑsɑkslɑne̞
kafkalik	kɑfkɑlʲikˑ
kahekesi	kɑɦekˑesʲi
kaheksa	kɑɦeksɑ
kaheksateistkümnene	kɑɦeksɑtei̯stkymnene̞
kaheksateistkümnes	kɑɦeksɑtei̯stkymnes
kahju	kɑhjü
kaitseraud	kɑi̯tserɑu̯d̥
kaja	kɑ̈jɑ̈
kajama	kɑ̈jɑ̈mɑ
kaks	kɑks
kalamari	kɑlɑmɑri
kalamees	kɑlɑmeːs
kalender	kɑlend̥er
kampsun	kɑmpsun
kana	kɑnɑ
kanamuna	kɑnɑmunɑ
kandela	kɑnd̥elɑ
kanep	kɑnepˑ
kaotus	kɑo̯tˑus
kapuuts	kɑpuːts
karask	kɑrɑsk
karusmari	kɑrusmɑri
kasin	kɑsʲin
kaskadöör	kɑskɑd̥øːr
kassikakk	kɑsˑikɑkː
kasvaja	kɑsvɑ̈jɑ̈
keel	keːl
keskpäev	keskpæe̯v
kihisema	kiɦisemɑ
kihk	kihk
kihutama	kiɦutˑɑmɑ
kiikuma	kiːkːumɑ
kiirabi	kiːrɑb̥i
kiirusepiirang	kiːrusepiːrɑŋg̊
kiiruspiirang	kiːruspiːrɑŋg̊
kilometraaž	kilometrɑːʒ̥
kilpnääre	kilpnæˑre̞
king	kiŋg̊
kinnine	kinʲːine̞
kinnistäht	kinʲːistæht
kirjandus	kirjɑ̈nd̥us
kirjeldama	kirjeld̥ɑmɑ
kirjutama	kirjütˑɑmɑ
kirjutusmasin	kirjütˑusmɑsʲin
kirsipuu	kirsʲipˑuː
kirss	kirsː
kirsstomat	kirsːtomɑtˑ
klaver	klɑver
klaveriliteratuur	klɑverilʲitˑerɑttuːr
kleepima	kleːpːimɑ
kleeps	kleːps
kobrutis	kob̥rutʲˑis
kodanik	kod̥ɑnʲikˑ
koer	koe̯r
kohustuslik	koɦustuslʲikˑ
kohv	kohˑv̥
kohvik	kohvikˑ
kohvimasin	kohvimɑsʲin
kohvitass	kohvitɑsʲː
kohviuba	kohviub̥ɑ
kokakunst	kokˑɑkunʲst
kokandus	kokˑɑnd̥us
kole	kole̞
kolm	kolm
kolmas	kolmɑs
kolmekesi	kolmekˑesʲi
kolmekuningapäev	kolmekunʲiŋg̊ɑpæe̯v
komme	komːe̞
komme	komˑe̞
kondiüdi	konʲd̥ʲiyd̥ʲi
koni	konʲi
konsul	konsul
kont	konʲtˑ
kool	koːl
koolja	koːlʲjɑ̈
koolmeister	koːlmei̯ster
korjama	korjɑ̈mɑ
koroonaviirus	koroˑnɑviːrus
korpus	korpus
korruselamu	korːuselɑmu
korrusmaja	korːusmɑ̈jɑ̈
košmaar	koʃmɑːr
krahvinna	krɑhvinːɑ
kriit	kriːtˑ
kruus	kruːs
kruus	kruːsʲ
kruustangid	kruːstɑŋg̊id̥
krõps	krɤps
kudu	kud̥u
kukk	kukː
kuldnokk	kuld̥nokː
kulinaaria	kulʲinɑːriɑ̯
kuljus	kulʲjüs
kulm	kulm
kuluma	kulumɑ
kummuli	kumˑulʲi
kuni	kunʲi
kuningas	kunʲiŋg̊ɑs
kunn	kunʲː
kuri	kuri
kutsika	kutʲsʲikˑɑ
kutsikas	kutʲsʲikˑɑs
kutsikat	kutʲsʲikˑɑtˑ
kuu	kuː
kuueteistkümnes	kuːwetei̯stkymnes
kuulama	kuːlɑmɑ
kuus	kuːs
kuusik	kuːsʲikˑ
kähisema	kæɦisemɑ
käigukast	kæi̯g̊ukɑsʲtˑ
käima	kæi̯mɑ
känd	kænd̥
känguru	kæŋg̊uru
käpik	kæpˑikˑ
kärp	kærpˑ
käsi	kæsʲi
käsitama	kæsʲitˑɑmɑ
käsitlema	kæsʲitlemɑ
käsn	kæsˑn̥
kättemaks	kætːemɑks
kääne	kæːne̞
kääne	kæˑne̞
käärid	kæːrid̥
käärima	kæːrimɑ
kõhunääre	kɤɦunæˑre̞
kõhunäärmejuha	kɤɦunæːrmejüɦɑ
kõhunäärmepõletik	kɤɦunæːrmepɤletʲˑikˑ
kõhunäärmevähk	kɤɦunæːrmevæhk
kõik	kɤi̯kˑ
kõrs	kɤrs
kõrvalmõju	kɤrvɑlmɤjü
kõrvits	kɤrvits
köösner	køːsner
kükk	kykː
küll	kylː
küllane	kylˑɑne̞
külm	kylʲm
külmik	kylmikˑ
külmkapimagnet	kylʲmkɑpˑimɑg̊netˑ
külmkapp	kylmkɑpː
kümme	kymˑe̞
kütma	kytmɑ
küülik	kyːlʲikˑ
küünal	kyˑnɑl
küüslauk	kyːslɑu̯kˑ
laad	lɑːd̥
lagrits	lɑg̊rits
lahe	lɑɦe̞
laisk	lɑi̯sk
laiskus	lɑi̯skus
lask	lɑsk
laskma	lɑskmɑ
lastehaigla	lɑstehɑi̯g̊lɑ
lasteprostitutsioon	lɑsteprostʲitˑutsʲio̯ːn
laukapuu	lɑu̯kˑɑpuː
laupäeviti	lɑu̯pˑæe̯vitʲˑi
lavendel	lɑvend̥el
leem	leːm
leetrid	leːtrid̥
lehetäi	leɦetæi̯
lehm	lehˑm̥
leht	leht
lehtpuu	lehtpuː
leidma	lei̯d̥mɑ
lendama	lend̥ɑmɑ
liikluspiirang	lʲiːkluspiːrɑŋg̊
liikumispiirang	lʲiːkːumispiːrɑŋg̊
liim	lʲiːm
liisk	lʲiːsk
liiv	lʲiːv
lind	lʲind̥
lips	lʲips
literatuur	lʲitˑerɑttuːr
loeng	loe̯ŋg̊
loik	loi̯kˑ
loll	lolʲː
loss	losʲː
lubama	lub̥ɑmɑ
lugemisprillid	lug̊emisprilʲːid̥
luide	lui̯d̥e̞
lumememm	lumememː
lumesadu	lumesɑd̥u
lumi	lumi
luu	luː
luuüdi	luːyd̥ʲi
lääs	læːs
lõbustuspark	lɤb̥ustuspɑrkˑ
lõks	lɤks
lõosilm	lɤo̯sʲilm
lõppjaam	lɤpːjɑ̈ːm
lõõskama	lɤːskɑmɑ
lüüasaamine	lyi̯ːjɑ̈sɑːmine̞
maailmavaade	mɑːilmɑvɑːd̥e̞
maak	mɑːkˑ
maalane	mɑːlɑne̞
maantee	mɑːnteː
maarahvas	mɑːrɑhvɑs
maavärin	mɑːværin
madu	mɑd̥u
magamistuba	mɑg̊ɑmistub̥ɑ
magusjuur	mɑg̊usjüːr
mahl	mɑhˑl̥
maht	mɑht
maks	mɑks
mandariin	mɑnd̥ɑriːn
mandel	mɑnd̥el
mandlipiim	mɑnd̥lʲipiːm
masin	mɑsʲin
matus	mɑtˑus
matš	mɑtʃ
meditsiiniline	med̥ʲitsʲiːnʲilʲine̞
meduus	med̥uːs
meel	meːl
meele	meːle̞
meele	meˑle̞
meelelahutus	meːlelɑɦutˑus
meelespea	meːlespeɑ̯
meeletu	meːletˑu
meem	meːm
meemäger	meːmæg̊er
meene	meːne̞
meene	meˑne̞
mees	meːs
meesisik	meːsisʲikˑ
metspipar	metspipˑɑr
miks	miks
mil	mil
miljon	milʲjon
minibuss	minʲib̥usː
miniseelik	minʲiseːlʲikˑ
minut	minutˑ
misjonär	misʲjonær
moos	moːs
mudžahiid	mud̥ʒɑhiːd̥
muinasjutt	mui̯nɑsʲjütː
muna	munɑ
munand	munɑnd̥
munandikott	munɑnd̥ʲikotʲː
murakas	murɑkˑɑs
muru	muru
muruniiduk	murunʲiˑd̥ukˑ
mutt	mutʲː
muusika	muːsʲikˑɑ
muusikainstrument	muːsʲikˑɑinstrumenʲtˑ
mänd	mænd̥
mänd	mænʲd̥
mõru	mɤru
mõõk	mɤːkˑ
möllama	mølːɑmɑ
müdisema	myd̥ʲisemɑ
münt	myntˑ
mürisema	myrisemɑ
mürk	myrkˑ
müts	myts
müts	mytʲs
müür	myːr
naine	nɑi̯ne̞
narkolepsia	nɑrkolepsʲiɑ̯
neelama	neːlɑmɑ
neli	nelʲi
neljateistkümnes	nelʲjɑ̈tei̯stkymnes
niidistik	nʲiːd̥ʲistʲikˑ
niiduk	nʲiˑd̥ukˑ
niisiis	nʲiːsʲiːs
niit	nʲiːtˑ
niitma	nʲiːtmɑ
nobe	nob̥e̞
nohisema	noɦisemɑ
nokkima	nokːimɑ
noor	noːr
nuhisema	nuɦisemɑ
null	nulʲː
nullis	nulˑis
nussida	nusʲːid̥ɑ
nägu	næg̊u
näidend	næi̯d̥end̥
näljane	nælʲjɑ̈ne̞
nääre	næˑre̞
nõudepesumasin	nɤu̯d̥epesumɑsʲin
nõõ	nɤː
o	oː
oga	og̊ɑ
ohjama	ohjɑ̈mɑ
ohutu	oɦutˑu
olema	olemɑ
oliivipuu	olʲiːvipˑuː
oluline	olulʲine̞
omadus	omɑd̥us
omadussõna	omɑd̥ussɤnɑ
on	on
ooper	oːpːer
ootama	oːtːɑmɑ
oras	orɑs
orientatsioon	orie̯ntɑtsʲio̯ːn
orkaan	orkɑːn
oskama	oskɑmɑ
osoon	osoːn
ots	ots
otse	otse̞
otstarve	otstɑrve̞
paat	pɑːtʲˑ
paat	pɑːtˑ
paaž	pɑːʒ
pada	pɑd̥ɑ
paine	pɑi̯ne̞
paiste	pɑi̯ste̞
paks	pɑks
palee	pɑleː
paleepööre	pɑleːpøːre̞
palmik	pɑlʲmikˑ
park	pɑrkˑ
peaaegu	peɑ̯ɑe̯g̊u
peaingel	peɑ̯iŋg̊el
peamine	peɑ̯mine̞
pedantne	ped̥ɑntne̞
peegel	peːg̊el
peer	peːr
perfektne	perfekˑtne̞
pesumasin	pesumɑsʲin
pidu	pid̥u
piiksuma	piːksumɑ
piim	piːm
piimahammas	piˑmɑhɑmˑɑs
piin	piːn
piinama	piːnɑmɑ
piir	piːr
piiraja	piːrɑ̈jɑ̈
piiramatus	piːrɑmɑtˑus
piiramine	piːrɑmine̞
piiramislahing	piːrɑmislɑɦiŋg̊
piiramismasin	piːrɑmismɑsʲin
piiramisrõngas	piːrɑmisrɤŋg̊ɑs
piiramisseisukord	piːrɑmissei̯sukˑord̥
piiramistorn	piːrɑmistorn
piirang	piːrɑŋg̊
piiratus	piːrɑtˑus
piirdumine	piːrd̥umine̞
piire	piːre̞
pilv	pilv
pinisema	pinʲisemɑ
pirn	pirn
pirnipuu	pirnʲipˑuː
pitsabaar	pitsɑb̥ɑːr
plankton	plɑŋkˑton
platooniline	plɑtoːnʲilʲine̞
pliidiraud	plʲiːd̥ʲirɑu̯d̥
ploomipuu	ploːmipˑuː
pläru	plæru
poeg	poe̯g̊
pohhui	pohːui̯
polaarstratosfääripilv	polɑːrstrɑtˑosfæˑripilv
pomm	pomː
pommi	pomːi
pontoonsild	pontoːnsʲild̥
pood	poːd̥ʲ
pool	poːl
pool	poːlʲ
poole	poːle̞
poolteist	poːltei̯st
professionaalne	profˑesˑio̯nɑːlne̞
prostitutsioon	prostʲitˑutsʲio̯ːn
präänik	præːnʲikˑ
prügikott	pryg̊ikotʲː
pulm	pulm
puna	punɑ
punakas	punɑkˑɑs
punane	punɑne̞
purikas	purikˑɑs
puu	puː
puuvili	puːvilʲi
pädema	pæd̥emɑ
pädev	pæd̥ev
pähkel	pæhkel
päitsed	pæi̯tsed̥
pärdik	pærd̥ʲikˑ
pärlmutter	pærlmutːer
pärlmutterpilv	pærlmutːerpilv
põhi	pɤɦi
põhikool	pɤɦikoːl
põldmurakas	pɤld̥murɑkˑɑs
põlev	pɤlev
põlv	pɤlʲv
põlvitama	pɤlʲvitˑɑmɑ
põsk	pɤsʲkˑ
pöial	pøi̯ɑ̯l
pöör	pøːr
pügal	pyg̊ɑl
pügala	pyg̊ɑlɑ
pügalat	pyg̊ɑlɑtˑ
pühamu	pyɦɑmu
pühapäev	pyɦɑppæe̯v
pühapäev	pyɦɑpæe̯v
rabamurakas	rɑb̥ɑmurɑkˑɑs
raha	rɑɦɑ
rahuläbirääkimised	rɑɦulæb̥iræːkːimised̥
rahvaarv	rɑhvɑɑrv
rahvuspark	rɑhvuspɑrkˑ
rakk	rɑkː
rasv	rɑsˑv̥
ratas	rɑtˑɑs
ratassepp	rɑtˑɑssepˑ
raudsepp	rɑu̯d̥sepː
raudteejaam	rɑu̯d̥teːjɑ̈ːm
rebima	reb̥imɑ
reisijuht	rei̯sʲijüht
resto	resto
riidepuu	riːd̥epˑuː
riik	riːkˑ
riiki	riːkːi
riisikeetja	riːsʲikeːtʲjɑ̈
riisivein	riˑsʲivei̯n
rikastuma	rikˑɑstumɑ
ringmängulaul	riŋg̊mæŋg̊ulɑu̯l
romaan	romɑːn
rongijaam	roŋg̊ijɑ̈ːm
rukis	rukˑis
rämps	ræmps
räpane	ræpˑɑne̞
rääkima	ræːkːimɑ
rõivas	rɤi̯vɑs
rõõm	rɤːm
röövima	røːvimɑ
röövimine	røːvimine̞
rüperaal	rypˑerɑːl
saada	sɑːd̥ɑ
saada	sɑˑd̥ɑ
saadik	sɑˑd̥ʲikˑ
saal	sɑːlʲ
saalibändi	sɑˑlʲib̥ænd̥ʲi
saarlane	sɑːrlɑne̞
saati	sɑːtʲi
sadomasohhism	sɑd̥omɑsohːisˑm̥
sagar	sɑg̊ɑr
sahtel	sɑhtel
sahtli	sɑhtlʲi
sahtlit	sɑhtlʲitˑ
saiake	sɑi̯ɑkˑe̞
saiakese	sɑi̯ɑkˑese̞
saiakest	sɑi̯ɑkˑest
saientoloogia	sɑi̯entoloːg̊iɑ̯
sajand	sɑ̈jɑ̈nd̥
saks	sɑks
samasugune	sɑmɑsug̊une̞
sanskrit	sɑnskritˑ
seadma	seɑ̯d̥mɑ
see	seː
seitse	sei̯tse̞
seitsmeteistkümnes	sei̯tsmetei̯stkymnes
sekretär	sekretˑær
seksuaalne	seksuɑːlne̞
sektor	sekˑtor
selgus	selg̊us
seljaaju	selʲjɑ̈ɑ̈jü
sfäär	sfæːr
sidesõna	sʲid̥esɤnɑ
siga	sʲig̊ɑ
sild	sʲild̥
silmakirjatsema	sʲilmɑkirjɑ̈tsemɑ
siluett	sʲiluetʲː
skisofreenia	skisofreːnʲiɑ̯
skorpion	skorpio̯n
solvang	solvɑŋg̊
soolama	soːlɑmɑ
soome	soːme̞
soum	sou̯m
stratosfäär	strɑtˑosfæːr
stratosfäärilend	strɑtˑosfæˑrilend̥
sugunääre	sug̊unæˑre̞
suletud	suletˑud̥
sundima	sund̥ʲimɑ
sunduslik	sunʲd̥uslʲikˑ
sunduslikkus	sunʲd̥uslʲikːus
sutenöör	sutˑenøːr
suutma	suːtmɑ
säilitama	sæi̯lʲitˑɑmɑ
särg	særg̊
säutsuma	sæu̯tsumɑ
säär	sæːr
sõge	sɤg̊e̞
sõiduk	sɤi̯d̥ukˑ
sõit	sɤi̯tˑ
sõitma	sɤi̯tmɑ
sõltumatu	sɤltumɑtˑu
sõna	sɤnɑ
sõnaraamat	sɤnɑrɑˑmɑtˑ
sõnum	sɤnum
sõsar	sɤsɑr
sööstma	søːstmɑ
sülitama	sylʲitˑɑmɑ
sündima	synʲd̥ʲimɑ
sünnitus	synʲːitˑus
sünnitushaigla	synʲːitˑushɑi̯g̊lɑ
sünonüüm	synonyːm
sünonüümne	synonyːmne̞
süü	syː
taanduma	tɑːnd̥umɑ
tagama	tɑg̊ɑmɑ
tagasi	tɑg̊ɑsʲi
tagasõna	tɑg̊ɑsɤnɑ
taide	tɑi̯d̥e̞
taie	tɑi̯e̞
taiet	tɑi̯etˑ
takjas	tɑkjɑ̈s
tallama	tɑlːɑmɑ
talv	tɑlʲv
tana	tɑnɑ
tantsupõrand	tɑntsupɤrɑnd̥
taotlema	tɑo̯tlemɑ
tapper	tɑpːer
tarkusehammas	tɑrkusehɑmˑɑs
tarkvaraarendaja	tɑrkvɑrɑɑrend̥ɑ̈jɑ̈
tatari	tɑtˑɑri
teada	teɑ̯d̥ɑ
teadja	teɑ̯d̥ʲjɑ̈
teadma	teɑ̯d̥mɑ
tegevuspiirang	teg̊evuspiːrɑŋg̊
teine	tei̯ne̞
telefoninumber	telefˑonʲinumb̥er
telefoniraamat	telefˑonʲirɑˑmɑtˑ
tellima	telʲːimɑ
telliskivi	telˑiskivi
terav	terɑv
tere	tere̞
tibla	tʲib̥lɑ
tiiger	tʲiːg̊er
tikand	tʲikˑɑnd̥
tikk	tʲikː
tipp	tʲipː
tobe	tob̥e̞
toimingupiirang	toi̯miŋg̊upiːrɑŋg̊
tollipiirang	tolʲːipiːrɑŋg̊
tolmuimeja	tolmuimejɑ̈
tomat	tomɑtˑ
tomatimahl	tomɑtʲˑimɑhˑl̥
too	toː
tsaar	tsɑːr
tsement	tsementˑ
tsensuur	tsensuːr
tuletikk	tuletʲˑikː
tunnus	tunːus
tursk	tursk
tuul	tuːl
tuumaelektrijaam	tuˑmɑelekˑtrijɑ̈ːm
tuumaelektrijaama	tuˑmɑelekˑtrijɑ̈ːmɑ
tuumaelektrijaama	tuˑmɑelekˑtrijɑ̈ˑmɑ
tuus	tuːs
tähestik	tæɦestʲikˑ
täheteadus	tæɦeteɑ̯d̥us
tähistama	tæɦistɑmɑ
täht	tæht
täiuslik	tæi̯u̯slʲikˑ
täna	tænɑ
tänan	tænɑn
täring	tæriŋg̊
tõmblukk	tɤmb̥lukː
tõukeratas	tɤu̯kˑerɑtˑɑs
tööriist	tøˑriːst
töötaja	tøːtːɑ̈jɑ̈
tšekk	tʃekː
tšellist	tʃellʲist
tšello	tʃelˑo
ubinale	ub̥inɑle̞
ubinalt	ub̥inɑltˑ
ubinasse	ub̥inɑsːe̞
ubinat	ub̥inɑtˑ
ujuksild	üjüksʲild̥
universaalne	unʲiversɑːlne̞
uss	usʲː
uulits	uˑlʲits
vaas	vɑːs
vaatama	vɑːtˑɑmɑ
vaba	vɑb̥ɑ
vabadus	vɑb̥ɑd̥us
vabamüürlane	vɑb̥ɑmyːrlɑne̞
vabatahtlikult	vɑb̥ɑtɑhtlʲikˑultˑ
vadja	vɑd̥ʲjɑ̈
vaen	vɑe̯n
vagu	vɑg̊u
vaheldama	vɑɦeld̥ɑmɑ
vahetusõpilane	vɑɦetˑusɤpˑilɑne̞
vaip	vɑi̯pˑ
vaksal	vɑksɑl
valamu	vɑlɑmu
valge	vɑlg̊e̞
valguskiir	vɑlg̊uskiːr
vandaal	vɑnd̥ɑːl
vandaali	vɑnd̥ɑːlʲi
vandaali	vɑnd̥ɑˑlʲi
vandaalitsema	vɑnd̥ɑˑlʲitsemɑ
vandenõuteooria	vɑnd̥enɤu̯tˑeoːriɑ̯
vanusepiirang	vɑnusepiːrɑŋg̊
vapper	vɑpːer
varblane	vɑrb̥lɑne̞
vares	vɑres
varjupaik	vɑrjüpˑɑi̯kˑ
vasikaliha	vɑsʲikˑɑlʲiɦɑ
vasikas	vɑsʲikˑɑs
vastupidavus	vɑstupid̥ɑvus
vatitekk	vɑtʲˑitekː
vatnik	vɑtʲnʲikˑ
veider	vei̯d̥er
veidrat	vei̯d̥rɑtˑ
veoauto	veo̯ɑu̯tˑo
verd	verd̥
vere	vere̞
veri	veri
viga	vig̊ɑ
vihm	vihˑm̥
vihmapiisk	vihmɑpiːsk
vihmavari	vihmɑvɑri
viibima	viːb̥imɑ
viieteistkümnes	viːjetei̯stkymnes
viir	viːr
viirus	viːrus
viis	viːs
viis	viːsʲ
vikat	vikˑɑtˑ
vimm	vimː
voodi	voːd̥ʲi
voodilutikas	voːd̥ʲilutʲˑikɑs
vägev	væg̊ev
vähk	væhk
värk	værkˑ
värv	værv
väsinud	væsʲinud̥
västrik	væstrikˑ
väärt	væːrtˑ
võim	vɤi̯m
võtma	vɤtmɑ
võtta	vɤtːɑ
võõras	vɤˑrɑs
õ	ɤ
öland	øːlɑnd̥
äriline	ærilʲine̞
ärkama	ærkɑmɑ
õde	ɤd̥e̞
õepoeg	ɤe̯poe̯g̊
õetütar	ɤe̯tytˑɑr
õgima	ɤg̊imɑ
õhtukleit	ɤhtuklei̯tˑ
õhtuti	ɤhtutʲˑi
õhupall	ɤɦupɑlʲː
õigekeelsus	ɤi̯g̊ekeːlsus
õigekeelsussõnaraamat	ɤi̯g̊ekeːlsussɤnɑrɑˑmɑtˑ
õigusriik	ɤi̯g̊usriːkˑ
õlg	ɤlg̊
õllekõht	ɤlːekɤht
õmblusmasin	ɤmb̥lusmɑsʲin
õpetama	ɤpˑetɑmɑ
õpilane	ɤpˑilɑne̞
õrnus	ɤrnus
õueaiamaa	ɤu̯eɑi̯ɑmɑː
õun	ɤu̯n
öökima	øːkːimɑ
üdi	yd̥ʲi
üheksa	yɦeksɑ
üheksa	øɦeksɑ
üheksateist	øɦeksɑtei̯st
üheksateistkümnendik	øɦeksɑtei̯stkymnend̥ʲikˑ
üheksateistkümnene	yɦeksɑtei̯stkymnene̞
üheksateistkümnes	øɦeksɑtei̯stkymnes
ühikas	yɦikˑɑs
ühiskondlik	yɦiskond̥lʲikˑ
ühistransport	yɦistrɑnsportˑ
üks	yks
üksi	yksʲi
üksteist	ykstei̯st
ülbe	ylb̥e̞
ülekäik	ylekæi̯kˑ
üles	yles
ülevenemaaline	ylevenemɑːlʲine̞
üllatunud	ylˑɑtˑunud̥
ümar	ymɑr
ümberlõikamine	ymb̥erlɤi̯kˑɑmine̞
üritama	yritˑɑmɑ
üritus	yritˑus
ürt	yrtˑ
üsna	ysnɑ
üterbium	ytterb̥ium
üterbium	ytterb̥iu̯m
ütlema	ytlemɑ
ütlev	ytlev
ütrium	ytrium
ütrium	ytriu̯m
üür	yːr
üürikorter	yˑrikorter
šaakal	ʃɑːkːɑl
šampoon	ʃɑmpoːn
šantaaž	ʃɑntɑːʒ
šašlõkk	ʃɑʃlɤkː
šnautser	ʃnɑu̯tser
šokk	ʃokː
šokolaad	ʃokˑolɑːd̥
žanr	ʒɑnr
žürii	ʒyriː
aasta	ɑːstɑ
aimu	kui
elu	elu
hooldatava	on
jää	jæː
just	just
ka	kɑ
kaks	kɑks
kas	kɑs
keel	keːl
kes	kes
kitsaks	kitsɑks
kool	koːl
kuhu	kuɦu
kui	kui
kukk	kukː
kus	kus
kust	kust
kuu	kuː
kuus	kuːs
läks	læks
la	lɑ
ma	mɑ
mees	meːs
meist	meist
me	me
miks	miks
mil	mil
mitte	mitːe
moos	moːs
mu	mu
muru	muru
nižni	niʒni
no	no
oleks	oleks
ole	ole
oma	omɑ
on	on
on	sɑmɑ
piir	piːr
pikalt	pikɑlt
pool	poːl
puu	puː
sama	sɑmɑ
samas	sɑmɑs
sa	sɑ
see	on
see	seː
su	su
tasu	tɑsu
ta	tɑ
toona	tuːnɑ
töö	tøː
tütar	tytɑr
tuul	tuːl
üks	yks
vaja	vɑjɑ
vala	vɑlɑ
valiti	vɑliti
vastu	vɑstu
viis	viːs
vot	vot
