င	ŋ
ငိမ်ႇ	ŋim˩
ငိုင်	ŋɯŋ˨
ငိုၼ်း	ŋɯn˥
ငိူဝ်ႈ	ŋɤː
ငိူၼ်း	ŋɤn˥
ငုမ်ႇ	ŋum˩
ငူၼ်း	ŋon˥
ငဵင်	ŋeŋ˨
ငြႃး	ŋjaː˥
ငွင်	ŋɔŋ˨
ငၢင်	ŋaːŋ˨
ငၢမ်ႇ	ŋaːm˩
ငၢၼ်	ŋaːn˨
ငၢႆး	ŋaːj˥
ငႃ	ŋaː˨
ငႃး	ŋaː˥
ငႃႈ	ŋaː
ငႅင်	ŋeŋ
ငႅင်	ŋɛŋ˨
ငႆႈ	ŋaɪ
တ	t
တိမ်ႇ	tim˩
တိုင်	tɯŋ˨
တိုၼ်း	tɯn˥
တိူၼ်း	tɤn˥
တီႈၼႂ်းၵႄႈ	ti˥˩ naɯ˥˦ kɛː˧˨˨
တုမ်ႇ	tum˩
တူဝ်ႈ	tuː
တူၼ်း	ton˥
တဵင်	teŋ˨
တျႃး	jaː˥
တြႃး	tjaː˥
တွင်	tɔŋ˨
တၢင်	taːŋ˨
တၢမ်ႇ	taːm˩
တၢၼ်	taːn˨
တၢႆး	taːj˥
တႃ	taː˨
တႃး	taː˥
တႅင်	teŋ
တႅင်	tɛŋ˨
တႆႈ	taɪ
ထ	tʰ
ထိုင်	tʰɯŋ˨
ထိုၼ်း	tʰɯn˥
ထိူၼ်း	tʰɤn˥
ထုမ်ႇ	tʰum˩
ထူၼ်း	tʰon˥
ထဵင်	tʰeŋ˨
ထျႃး	jʰaː˥
ထြႃး	tʰjaː˥
ထွင်	tʰɔŋ˨
ထၢင်	tʰaːŋ˨
ထၢမ်ႇ	tʰaːm˩
ထၢၼ်	tʰaːn˨
ထၢႆး	tʰaːj˥
ထႃ	tʰaː˨
ထႃး	tʰaː˥
ထႅင်	tʰɛŋ˨
ပ	p
ပိုင်	pɯŋ˨
ပိုၼ်း	pɯn˥
ပိူဝ်ႈ	pɤː
ပိူၼ်း	pɤn˥
ပုမ်ႇ	pum˩
ပူၼ်း	pon˥
ပဵင်	peŋ˨
ပျႃး	jaː˥
ပြႃး	pjaː˥
ပွင်	pɔŋ˨
ပွၵ်ႉၵႂႃႇၸွမ်း	pɔk˥˦ kʷaː˧˨˨ tɕɔm˥˦
ပၢင်	paːŋ˨
ပၢင်လူင်မိူင်း	paːŋ˨˦ loŋ˨˦ mɤŋ˥˦
ပၢမ်ႇ	paːm˩
ပၢၼ်	paːn˨
ပၢႆး	paːj˥
ပၢႆးသၢႆႊ	paːj˥˦ saːj˨˦
ပႃ	paː˨
ပႃး	paː˥
ပႃႈ	paː
ပႅင်	peŋ
ပႅင်	pɛŋ˨
ပႆႈ	paɪ
မ	m
မိုင်	mɯŋ˨
မိုဝ်း	mui
မိုၼ်း	mɯn˥
မိူဝ်ႈ	mɤː
မိူၼ်း	mɤn˥
မုမ်ႇ	mum˩
မူၼ်း	mon˥
မဵင်	meŋ˨
မျႃး	mjaː˥
မြႃး	mjaː˥
မွင်	mɔŋ˨
မၢင်	maːŋ˨
မၢမ်ႇ	maːm˩
မၢၼ်	maːn˨
မၢႆး	maːj˥
မႃ	maː˨
မႃး	maː˥
မႃႈ	maː
မႄႈ	meː
မႅင်	meŋ
မႅင်	mɛŋ˨
မႆႈ	maɪ
မႆႉ	maːi
ယ	j
ယိုင်	jɯŋ˨
ယိုၼ်း	jɯn˥
ယိူဝ်ႈ	jɤː
ယိူၼ်း	jɤn˥
ယုမ်ႇ	jum˩
ယူၼ်း	jon˥
ယဵင်	jeŋ˨
ယျႃး	jaː˥
ယြႃး	jʰaː˥
ယွင်	jɔŋ˨
ယၢင်	jaːŋ˨
ယၢမ်ႇ	jaːm˩
ယၢၼ်	jaːn˨
ယၢႆး	jaːj˥
ယႃ	jaː˨
ယႃး	jaː˥
ယႃႈ	jaː
ယႅင်	jeŋ
ယႅင်	jɛŋ˨
ယႆႈ	jaɪ
ရ	r
ရိုင်	hɯŋ˨
ရိုၼ်း	hɯn˥
ရိူၼ်း	hɤn˥
ရုမ်ႇ	hum˩
ရူၼ်း	hon˥
ရဵင်	heŋ˨
ရျႃး	jʰaː˥
ရြႃး	jʰaː˥
ရွင်	hɔŋ˨
ရၢင်	haːŋ˨
ရၢမ်ႇ	haːm˩
ရၢၼ်	haːn˨
ရၢႆး	haːj˥
ရႃ	haː˨
ရႃး	haː˥
ရႅင်	hɛŋ˨
လ	l
လိုင်	lɯŋ˨
လိုၼ်း	lɯn˥
လိူဝ်ႈ	lɤː
လိူၼ်း	lɤn˥
လုမ်ႇ	lum˩
လူၼ်း	lon˥
လဵင်	leŋ˨
လျႃး	ljaː˥
လြႃး	ljaː˥
လွင်	lɔŋ˨
လွင်ႈထွင်ႈချႆႈ	lɔŋ˥˩ tʰɔŋ˥˩ tɕʰaj˥˩
လွင်ႈဢဝ်ၵႃႈ	lɔŋ˥˩ ʔaw˨˦ kaː˧˨˨
လွင်ႈဢဝ်ၶႃႈ	lɔŋ˥˩ ʔaw˨˦ kʰaː˧˨˨
လွင်ႈၵိၼ်လဝ်ႈ	lɔŋ˥˩ kin˨˦ law˧˨˨
လွင်ႈၵႂႃႇတမ်းတူဝ်	lɔŋ˥˩ kʷaː˧˨˨ tam˥˦ to˨˦
လွင်ႈၵႂႃႇတမ်းတူဝ်ၶႃႈ	lɔŋ˥˩ kʷaː˧˨˨ tam˥˦ to˨˦ kʰaː˧˨˨
လွင်ႈၵႂႃႇတမ်ႈၼႃႈ	lɔŋ˥˩ kʷaː˧˨˨ tam˧˨˨ naː˧˨˨
လွင်ႈၵႂႃႇတုင်း	lɔŋ˥˩ kʷaː˧˨˨ tuŋ˥˦
လွင်ႈၵႂႃႇတုင်းတူၺ်း	lɔŋ˥˩ kʷaː˧˨˨ tuŋ˥˦ toj˥˦
လွင်ႈၵႂႃႇတုင်းတူၺ်းၶႃႈ	lɔŋ˥˩ kʷaː˧˨˨ tuŋ˥˦ toj˥˦ kʰaː˧˨˨
လွင်ႈၵႂႃႇတုင်းတူၺ်းၶႃႈလီ	lɔŋ˥˩ kʷaː˧˨˨ tuŋ˥˦ toj˥˦ kʰaː˧˨˨ li˨˦
လွင်ႈၵႂႃႇတူၺ်း	lɔŋ˥˩ kʷaː˧˨˨ toj˥˦
လွင်ႈၵႂႃႇတဵင်ႇ	lɔŋ˥˩ kʷaː˧˨˨ tɤŋ˨˦
လွင်ႈၵႂႃႇတၢင်ႇ	lɔŋ˥˩ kʷaː˧˨˨ taːŋ˨˦
လွင်ႈၵႂႃႇထတ်းၶၢဝ်ႇ	lɔŋ˥˩ kʷaː˧˨˨ tʰat˥˦ kʰaːw˨˦
လွင်ႈၵႂႃႇထတ်းၽိင်ႈ	lɔŋ˥˩ kʷaː˧˨˨ tʰat˥˦ pʰiŋ˧˨˨
လွင်ႈၵႂႃႇထတ်းၽိင်ႈၶႃႈ	lɔŋ˥˩ kʷaː˧˨˨ tʰat˥˦ pʰiŋ˧˨˨ kʰaː˧˨˨
လွင်ႈၵႂႃႇထိုင်	lɔŋ˥˩ kʷaː˧˨˨ tʰɯŋ˨˦
လွင်ႈၵႂႃႇထူပ်း	lɔŋ˥˩ kʷaː˧˨˨ tʰop˥˦
လွင်ႈၵႂႃႇထူပ်းၵၼ်	lɔŋ˥˩ kʷaː˧˨˨ tʰop˥˦ kan˨˦
လွင်ႈၵႂႃႇထူပ်းႁၼ်	lɔŋ˥˩ kʷaː˧˨˨ tʰop˥˦ han˨˦
လွင်ႈၵႂႃႇထူပ်းႁၼ်ၶႃႈ	lɔŋ˥˩ kʷaː˧˨˨ tʰop˥˦ han˨˦ kʰaː˧˨˨
လွင်ႈၵႂႃႇထၢမ်	lɔŋ˥˩ kʷaː˧˨˨ tʰaːm˨˦
လွင်ႈၵႂႃႇထၢမ်ၶေႃႈ	lɔŋ˥˩ kʷaː˧˨˨ tʰaːm˨˦ kʰɔ˧˨˨
လွင်ႈၵႂႃႇထၢမ်ၶေႃႈၶႃႈ	lɔŋ˥˩ kʷaː˧˨˨ tʰaːm˨˦ kʰɔ˧˨˨ kʰaː˧˨˨
လွင်ႈၵႂႃႇထၢမ်ၶေႃႈၶႃႈလီ	lɔŋ˥˩ kʷaː˧˨˨ tʰaːm˨˦ kʰɔ˧˨˨ kʰaː˧˨˨ li˨˦
လွင်ႈၵႂႃႇပွႆး	lɔŋ˥˩ kʷaː˧˨˨ pɔj˥˦
လွင်ႈၵႂႃႇပၼ်ႇ	lɔŋ˥˩ kʷaː˧˨˨ pan˨˦
လွင်ႈၵႂႃႇပၼ်ႇငိုၼ်း	lɔŋ˥˩ kʷaː˧˨˨ pan˨˦ ŋɯn˥˦
လွင်ႈၵႂႃႇပၼ်ႇပၼ်ႈ	lɔŋ˥˩ kʷaː˧˨˨ pan˨˦ pan˧˨˨
လွင်ႈၵႂႃႇပၼ်ႇပၼ်ႈၶႃႈ	lɔŋ˥˩ kʷaː˧˨˨ pan˨˦ pan˧˨˨ kʰaː˧˨˨
လွင်ႈၵႂႃႇပၼ်ႇၸႂ်	lɔŋ˥˩ kʷaː˧˨˨ pan˨˦ tɕaɯ˦
လွင်ႈၵႂႃႇပၼ်ႇၸႂ်ၶႃႈ	lɔŋ˥˩ kʷaː˧˨˨ pan˨˦ tɕaɯ˦ kʰaː˧˨˨
လွင်ႈၵႂႃႇပၼ်ႇၸႂ်ၶႃႈလီ	lɔŋ˥˩ kʷaː˧˨˨ pan˨˦ tɕaɯ˦ kʰaː˧˨˨ li˨˦
လွင်ႈၵႂႃႇယုၵ်ႉယွင်ႈ	lɔŋ˥˩ kʷaː˧˨˨ juk˦ jɔŋ˧˨˨
လွင်ႈၵႂႃႇယုၵ်ႉယွင်ႈၶႃႈ	lɔŋ˥˩ kʷaː˧˨˨ juk˦ jɔŋ˧˨˨ kʰaː˧˨˨
လွင်ႈၵႂႃႇယုၵ်ႉၸဝ်ႈ	lɔŋ˥˩ kʷaː˧˨˨ juk˦ tsɔ˧˨˨
လွင်ႈၵႂႃႇယွမ်း	lɔŋ˥˩ kʷaː˧˨˨ jɔm˥˦
လွင်ႈၵႂႃႇယွမ်းတူဝ်	lɔŋ˥˩ kʷaː˧˨˨ jɔm˥˦ to˨˦
လွင်ႈၵႂႃႇယွမ်းတူဝ်ၶႃႈ	lɔŋ˥˩ kʷaː˧˨˨ jɔm˥˦ to˨˦ kʰaː˧˨˨
လွင်ႈၵႂႃႇယွမ်းတူဝ်ၶႃႈလီ	lɔŋ˥˩ kʷaː˧˨˨ jɔm˥˦ to˨˦ kʰaː˧˨˨ li˨˦
လွင်ႈၵႂႃႇယႃႉ	lɔŋ˥˩ kʷaː˧˨˨ jaː˥˦
လွင်ႈၵႂႃႇယႃႉဢဝ်ႇ	lɔŋ˥˩ kʷaː˧˨˨ jaː˥˦ ʔaw˨˦
လွင်ႈၵႂႃႇယႃႉဢဝ်ႇၶႃႈ	lɔŋ˥˩ kʷaː˧˨˨ jaː˥˦ ʔaw˨˦ kʰaː˧˨˨
လွင်ႈၵႂႃႇယႃႉၶၢၼ်ႉ	lɔŋ˥˩ kʷaː˧˨˨ jaː˥˦ kʰaːn˥˦
လွင်ႈၵႂႃႇလၢတ်ႈ	lɔŋ˥˩ kʷaː˧˨˨ laːt˧˨˨
လွင်ႈၵႂႃႇလၢတ်ႈၼႄ	lɔŋ˥˩ kʷaː˧˨˨ laːt˧˨˨ nɛː˨˦
လွင်ႈၵႂႃႇလၢတ်ႈၼႄၶႃႈ	lɔŋ˥˩ kʷaː˧˨˨ laːt˧˨˨ nɛː˨˦ kʰaː˧˨˨
လွင်ႈၵႂႃႇလၢတ်ႈၼႄၶႃႈလီ	lɔŋ˥˩ kʷaː˧˨˨ laːt˧˨˨ nɛː˨˦ kʰaː˧˨˨ li˨˦
လွင်ႈၵႂႃႇလႆ	lɔŋ˥˩ kʷaː˧˨˨ laj˨˦
လွင်ႈၵႂႃႇသိမ်း	lɔŋ˥˩ kʷaː˧˨˨ sim˥˦
လွင်ႈၵႂႃႇသိမ်းပိုတ်ႇ	lɔŋ˥˩ kʷaː˧˨˨ sim˥˦ pɯt˨˦
လွင်ႈၵႂႃႇသိမ်းသီႇ	lɔŋ˥˩ kʷaː˧˨˨ sim˥˦ si˧˨˨
လွင်ႈၵႂႃႇသိမ်းသီႇၶႃႈ	lɔŋ˥˩ kʷaː˧˨˨ sim˥˦ si˧˨˨ kʰaː˧˨˨
လွင်ႈၵႂႃႇဢဝ်ၶၢဝ်ႇ	lɔŋ˥˩ kʷaː˧˨˨ ʔaw˨˦ kʰaːw˨˦
လွင်ႈၵႂႃႇဢုပ်ႇ	lɔŋ˥˩ kʷaː˧˨˨ ʔup˨˦
လွင်ႈၵႂႃႇဢုပ်ႇဢူၼ်ႈ	lɔŋ˥˩ kʷaː˧˨˨ ʔup˨˦ ʔon˧˨˨
လွင်ႈၵႂႃႇဢုပ်ႇဢူၼ်ႈၶႃႈ	lɔŋ˥˩ kʷaː˧˨˨ ʔup˨˦ ʔon˧˨˨ kʰaː˧˨˨
လွင်ႈၵႂႃႇဢုပ်ႇၵၼ်	lɔŋ˥˩ kʷaː˧˨˨ ʔup˨˦ kan˨˦
လွင်ႈၵႂႃႇဢွၼ်တၢင်း	lɔŋ˥˩ kʷaː˧˨˨ ʔɔn˨˦ taːŋ˥˦
လွင်ႈၵႂႃႇဢွၼ်တၢင်းၶႃႈ	lɔŋ˥˩ kʷaː˧˨˨ ʔɔn˨˦ taːŋ˥˦ kʰaː˧˨˨
လွင်ႈၵႂႃႇဢွၼ်ႇ	lɔŋ˥˩ kʷaː˧˨˨ ʔɔn˨˦
လွင်ႈၵႂႃႇဢွၼ်ႇၵၼ်	lɔŋ˥˩ kʷaː˧˨˨ ʔɔn˨˦ kan˨˦
လွင်ႈၵႂႃႇဢွၼ်ႇၵၼ်လီ	lɔŋ˥˩ kʷaː˧˨˨ ʔɔn˨˦ kan˨˦ li˨˦
လွင်ႈၵႂႃႇဢွၼ်ႇၵၼ်လီၶႃႈ	lɔŋ˥˩ kʷaː˧˨˨ ʔɔn˨˦ kan˨˦ li˨˦ kʰaː˧˨˨
လွင်ႈၵႂႃႇဢႅဝ်ႇ	lɔŋ˥˩ kʷaː˧˨˨ ʔɛw˨˦
လွင်ႈၵႂႃႇၵိုတ်း	lɔŋ˥˩ kʷaː˧˨˨ kɯt˥˦
လွင်ႈၵႂႃႇၵဵပ်း	lɔŋ˥˩ kʷaː˧˨˨ kɤp˥˦
လွင်ႈၵႂႃႇၵဵပ်းငူၼ်ႈ	lɔŋ˥˩ kʷaː˧˨˨ kɤp˥˦ ŋon˧˨˨
လွင်ႈၵႂႃႇၵဵပ်းငူၼ်ႈၶႃႈ	lɔŋ˥˩ kʷaː˧˨˨ kɤp˥˦ ŋon˧˨˨ kʰaː˧˨˨
လွင်ႈၵႂႃႇၵဵပ်းႁႅင်း	lɔŋ˥˩ kʷaː˧˨˨ kɤp˥˦ hɛŋ˥˦
လွင်ႈၵႂႃႇၵျွင်း	lɔŋ˥˩ kʷaː˧˨˨ tɕɔŋ˥˦
လွင်ႈၵႂႃႇၵျၢမ်ႇ	lɔŋ˥˩ kʷaː˧˨˨ tɕaːm˨˦
လွင်ႈၵႂႃႇၵျႃႇ	lɔŋ˥˩ kʷaː˧˨˨ tɕaː˧˨˨
လွင်ႈၵႂႃႇၵွၼ်း	lɔŋ˥˩ kʷaː˧˨˨ kɔn˥˦
လွင်ႈၵႂႃႇၵွၼ်းတူဝ်	lɔŋ˥˩ kʷaː˧˨˨ kɔn˥˦ to˨˦
လွင်ႈၵႂႃႇၵွၼ်းတူဝ်ၶႃႈ	lɔŋ˥˩ kʷaː˧˨˨ kɔn˥˦ to˨˦ kʰaː˧˨˨
လွင်ႈၵႂႃႇၵွၼ်းလွင်ႈ	lɔŋ˥˩ kʷaː˧˨˨ kɔn˥˦ lɔŋ˥˩
လွင်ႈၵႂႃႇၶိုၼ်ႈ	lɔŋ˥˩ kʷaː˧˨˨ kʰɯn˧˨˨
လွင်ႈၵႂႃႇၶိုၼ်ႈလွႆ	lɔŋ˥˩ kʷaː˧˨˨ kʰɯn˧˨˨ lɔj˨˦
လွင်ႈၵႂႃႇၶိုၼ်ႈႁိူၼ်း	lɔŋ˥˩ kʷaː˧˨˨ kʰɯn˧˨˨ hɤn˥˦
လွင်ႈၵႂႃႇၶိုၼ်ႈႁိူၼ်းၶႃႈ	lɔŋ˥˩ kʷaː˧˨˨ kʰɯn˧˨˨ hɤn˥˦ kʰaː˧˨˨
လွင်ႈၵႂႃႇၶွၼ်ႉ	lɔŋ˥˩ kʷaː˧˨˨ kʰɔn˥˦
လွင်ႈၵႂႃႇၶွၼ်ႉၶၢႆ	lɔŋ˥˩ kʷaː˧˨˨ kʰɔn˥˦ kʰaːj˨˦
လွင်ႈၵႂႃႇၶွၼ်ႉၼႃႇ	lɔŋ˥˩ kʷaː˧˨˨ kʰɔn˥˦ naː˧˨˨
လွင်ႈၵႂႃႇၶွၼ်ႉၼႃႇၶႃႈ	lɔŋ˥˩ kʷaː˧˨˨ kʰɔn˥˦ naː˧˨˨ kʰaː˧˨˨
လွင်ႈၵႂႃႇၶၢမ်ႇ	lɔŋ˥˩ kʷaː˧˨˨ kʰaːm˨˦
လွင်ႈၵႂႃႇၸွႆႈ	lɔŋ˥˩ kʷaː˧˨˨ tsɔj˧˨˨
လွင်ႈၵႂႃႇၸွႆႈထႅမ်	lɔŋ˥˩ kʷaː˧˨˨ tsɔj˧˨˨ tʰɛm˨˦
လွင်ႈၵႂႃႇၸွႆႈထႅမ်ၶႃႈ	lɔŋ˥˩ kʷaː˧˨˨ tsɔj˧˨˨ tʰɛm˨˦ kʰaː˧˨˨
လွင်ႈၵႂႃႇၸွႆႈၵၼ်	lɔŋ˥˩ kʷaː˧˨˨ tsɔj˧˨˨ kan˨˦
လွင်ႈၵႂႃႇၼိုင်ႈ	lɔŋ˥˩ kʷaː˧˨˨ nɯŋ˧˨˨
လွင်ႈၵႂႃႇၼွၼ်း	lɔŋ˥˩ kʷaː˧˨˨ nɔn˥˦
လွင်ႈၵႂႃႇၼႄႉ	lɔŋ˥˩ kʷaː˧˨˨ nɛ˥˦
လွင်ႈၵႂႃႇၼႄႉၼႃႇ	lɔŋ˥˩ kʷaː˧˨˨ nɛ˥˦ naː˧˨˨
လွင်ႈၵႂႃႇၼႄႉၼႃႇၶႃႈ	lɔŋ˥˩ kʷaː˧˨˨ nɛ˥˦ naː˧˨˨ kʰaː˧˨˨
လွင်ႈၵႂႃႇၼႄႉၼႃႇၶႃႈလီ	lɔŋ˥˩ kʷaː˧˨˨ nɛ˥˦ naː˧˨˨ kʰaː˧˨˨ li˨˦
လွင်ႈၶၢၼ်ႉၶႅင်း	lɔŋ˥˩ kʰaːn˥˦ kʰɛŋ˥˦
လၢင်	laːŋ˨
လၢမ်ႇ	laːm˩
လၢၼ်	laːn˨
လၢႆး	laːj˥
လၢႆးလႅင်းၽူၼ်	laːj˥˦ lɛŋ˥˦ pʰon˨˦
လႃ	laː˨
လႃး	laː˥
လႃႈ	laː
လႅင်	leŋ
လႅင်	lɛŋ˨
လႆႈ	laɪ
ဝ	w
ဝိုင်	wɯŋ˨
ဝိုၼ်း	wɯn˥
ဝိူဝ်ႈ	wɤː
ဝိူၼ်း	wɤn˥
ဝုမ်ႇ	wum˩
ဝူၼ်း	won˥
ဝဵင်	weŋ˨
ဝျႃး	jʰaː˥
ဝြႃး	wjaː˥
ဝွင်	wɔŋ˨
ဝၢင်	waːŋ˨
ဝၢမ်ႇ	waːm˩
ဝၢၼ်	waːn˨
ဝၢႆး	waːj˥
ဝႃ	waː˨
ဝႃး	waː˥
ဝႃႈ	waː
ဝႅင်	weŋ
ဝႅင်	wɛŋ˨
ဝႆႈ	waɪ
သ	sʰ
သိမ်ႇ	sim˩
သိုင်	sɯŋ˨
သိုၼ်း	sɯn˥
သိူဝ်ႈ	sɤː
သိူၼ်း	sɤn˥
သုမ်ႇ	sum˩
သူၼ်း	son˥
သဵင်	seŋ˨
သျႃး	ɕaː˥
သြႃး	sʰjaː˥
သွင်	sɔŋ˨
သၢင်	sʰaːŋ˨
သၢမ်ႇ	sʰaːm˩
သၢၼ်	sʰaːn˨
သၢႆး	sʰaːj˥
သႃ	sʰaː˨
သႃႈ	saː
သႅင်	seŋ
သႅင်	sɛŋ˨
သႆႈ	saɪ
ဢ	ʔ
ဢိုင်	ʔɯŋ˨
ဢိုၼ်း	ʔɯn˥
ဢိူၼ်း	ʔɤn˥
ဢုမ်ႇ	ʔum˩
ဢူၼ်း	ʔon˥
ဢဵင်	ʔeŋ˨
ဢျႃး	jaː˥
ဢြႃး	ʔjaː˥
ဢွင်	ʔɔŋ˨
ဢၢင်	ʔaːŋ˨
ဢၢမ်ႇ	ʔaːm˩
ဢၢၼ်	ʔaːn˨
ဢၢႆး	ʔaːj˥
ဢႃ	ʔaː˨
ဢႃး	ʔaː˥
ဢႅင်	ʔɛŋ˨
ၵ	k
ၵိမ်ႇ	kim˩
ၵိုင်	kɯŋ˨
ၵိုၼ်း	kɯn˥
ၵိူၼ်း	kɤn˥
ၵုမ်ႇ	kum˩
ၵူၼ်း	kon˥
ၵူၼ်း	kuːn
ၵူၼ်းမိူင်းႁဝ်း	kon˥˦ mɤŋ˥˦ haw˥˦
ၵူၼ်းႁၢၼ်ႉတၢင်း	kon˥˦ haːn˥˦ taːŋ˥˦
ၵူၼ်းႁၢၼ်ႉတၢင်းမီးၸႂ်	kon˥˦ haːn˥˦ taːŋ˥˦ mi˥˦ tɕaɯ˦
ၵူၼ်းႁၢၼ်ႉတၢင်းလီ	kon˥˦ haːn˥˦ taːŋ˥˦ li˨˦
ၵူၼ်းႁၢၼ်ႉတၢင်းၶႃႈ	kon˥˦ haːn˥˦ taːŋ˥˦ kʰaː˧˨˨
ၵူၼ်းႁၢၼ်ႉတၢင်းၶႃႈလီ	kon˥˦ haːn˥˦ taːŋ˥˦ kʰaː˧˨˨ li˨˦
ၵူၼ်းႁၢၼ်ႉတၢင်းၶႃႈလီၸဝ်ႈ	kon˥˦ haːn˥˦ taːŋ˥˦ kʰaː˧˨˨ li˨˦ tsɔ˧˨˨
ၵူၼ်းႁၢၼ်ႉတၢင်းၸဝ်ႈ	kon˥˦ haːn˥˦ taːŋ˥˦ tsɔ˧˨˨
ၵူၼ်းႁၢၼ်ႉတၢင်းၸဝ်ႈလီ	kon˥˦ haːn˥˦ taːŋ˥˦ tsɔ˧˨˨ li˨˦
ၵူၼ်းႁၢၼ်ႉတၢင်းၸဝ်ႈၶႃႈ	kon˥˦ haːn˥˦ taːŋ˥˦ tsɔ˧˨˨ kʰaː˧˨˨
ၵူၼ်းႁၢၼ်ႉတၢင်းၸဝ်ႈၶႃႈလီ	kon˥˦ haːn˥˦ taːŋ˥˦ tsɔ˧˨˨ kʰaː˧˨˨ li˨˦
ၵူၼ်းႁၢၼ်ႉတၢင်းၸဝ်ႈၶႃႈလီၶႃႈ	kon˥˦ haːn˥˦ taːŋ˥˦ tsɔ˧˨˨ kʰaː˧˨˨ li˨˦ kʰaː˧˨˨
ၵူၼ်းႁၢၼ်ႉၶႃႈ	kon˥˦ haːn˥˩ kʰaː˧˨˨
ၵဵင်	keŋ˨
ၵျႃး	tɕaː˥
ၵြႃး	kjaː˥
ၵွင်	kɔŋ˨
ၵၢင်	kaːŋ˨
ၵၢမ်ႇ	kaːm˩
ၵၢၼ်	kaːn˨
ၵၢႆး	kaːj˥
ၵႂၢမ်း	kwaːm
ၵႃ	kaː˨
ၵႃး	kaː˥
ၵႅင်	kɛŋ˨
ၶ	kʰ
ၶိမ်ႇ	kʰim˩
ၶိုင်	kʰɯŋ˨
ၶိုၼ်း	kʰɯn˥
ၶိူဝ်ႈ	kʰɤː
ၶိူၼ်း	kʰɤn˥
ၶုမ်ႇ	kʰum˩
ၶူၼ်း	kʰon˥
ၶေႃႈတႅပ်းတတ်း	kʰɔ˧˨˨ tɛp˥˦ tat˥˦
ၶေႃႈတႅပ်းတတ်းလီ	kʰɔ˧˨˨ tɛp˥˦ tat˥˦ li˨˦
ၶေႃႈတႅပ်းတတ်းၶႃႈ	kʰɔ˧˨˨ tɛp˥˦ tat˥˦ kʰaː˧˨˨
ၶေႃႈတႅပ်းတတ်းၶႃႈလီ	kʰɔ˧˨˨ tɛp˥˦ tat˥˦ kʰaː˧˨˨ li˨˦
ၶေႃႈတႅပ်းတတ်းၸဝ်ႈ	kʰɔ˧˨˨ tɛp˥˦ tat˥˦ tsɔ˧˨˨
ၶေႃႈတႅပ်းတတ်းၸဝ်ႈလီ	kʰɔ˧˨˨ tɛp˥˦ tat˥˦ tsɔ˧˨˨ li˨˦
ၶေႃႈတႅပ်းတတ်းၸဝ်ႈၶႃႈ	kʰɔ˧˨˨ tɛp˥˦ tat˥˦ tsɔ˧˨˨ kʰaː˧˨˨
ၶေႃႈတႅပ်းတတ်းၸဝ်ႈၶႃႈလီ	kʰɔ˧˨˨ tɛp˥˦ tat˥˦ tsɔ˧˨˨ kʰaː˧˨˨ li˨˦
ၶေႃႈပိုတ်ႇပၢႆႇ	kʰɔ˧˨˨ pɯt˨˦ paːj˨˦
ၶေႃႈပိုတ်ႇပၢႆႇလီ	kʰɔ˧˨˨ pɯt˨˦ paːj˨˦ li˨˦
ၶေႃႈပိုတ်ႇပၢႆႇၶႃႈ	kʰɔ˧˨˨ pɯt˨˦ paːj˨˦ kʰaː˧˨˨
ၶေႃႈပိုတ်ႇပၢႆႇၸဝ်ႈ	kʰɔ˧˨˨ pɯt˨˦ paːj˨˦ tsɔ˧˨˨
ၶေႃႈပိုတ်ႇပၢႆႇၸဝ်ႈၶႃႈ	kʰɔ˧˨˨ pɯt˨˦ paːj˨˦ tsɔ˧˨˨ kʰaː˧˨˨
ၶဵင်	kʰeŋ˨
ၶျႃး	tɕʰaː˥
ၶြႃး	kʰjaː˥
ၶွင်	kʰɔŋ˨
ၶၢင်	kʰaːŋ˨
ၶၢမ်ႇ	kʰaːm˩
ၶၢဝ်း	kʰaːw
ၶၢၼ်	kʰaːn˨
ၶၢႆး	kʰaːj˥
ၶႃ	kʰaː˨
ၶႃး	kʰaː˥
ၶႃႈ	kʰaː
ၶႃႈတေၵႂႃႇ	kʰaː˧˨˨ te˨˦ kʷaː˧˨˨
ၶႅင်	kʰeŋ
ၶႅင်	kʰɛŋ˨
ၶႆႈ	kʰaɪ
ၸ	s
ၸဃး	sa˥
ၸဝ်ႈၵဝ်ႇၽူႈၼၢင်းယိင်း	tsɔ˧˨˨ kaw˨˦ pʰu˧˨˨ naːŋ˥˦ jiŋ˥˦
ၸဝ်ႈၵဝ်ႇၽူႈၼၢင်းယိင်းမီးတၢင်းမေႃ	tsɔ˧˨˨ kaw˨˦ pʰu˧˨˨ naːŋ˥˦ jiŋ˥˦ mi˥˦ taːŋ˥˦ mɔː˨˦
ၸဝ်ႈၵဝ်ႇၽူႈၼၢင်းယိင်းမီးတၢင်းမေႃလီ	tsɔ˧˨˨ kaw˨˦ pʰu˧˨˨ naːŋ˥˦ jiŋ˥˦ mi˥˦ taːŋ˥˦ mɔː˨˦ li˨˦
ၸဝ်ႈၵဝ်ႇၽူႈၼၢင်းယိင်းမီးတၢင်းမေႃၶႃႈ	tsɔ˧˨˨ kaw˨˦ pʰu˧˨˨ naːŋ˥˦ jiŋ˥˦ mi˥˦ taːŋ˥˦ mɔː˨˦ kʰaː˧˨˨
ၸဝ်ႈၵဝ်ႇၽူႈၼၢင်းယိင်းမီးတၢင်းမေႃၶႃႈလီ	tsɔ˧˨˨ kaw˨˦ pʰu˧˨˨ naːŋ˥˦ jiŋ˥˦ mi˥˦ taːŋ˥˦ mɔː˨˦ kʰaː˧˨˨ li˨˦
ၸဝ်ႈၵဝ်ႇၽူႈၼၢင်းယိင်းမီးတၢင်းမေႃၸဝ်ႈလီ	tsɔ˧˨˨ kaw˨˦ pʰu˧˨˨ naːŋ˥˦ jiŋ˥˦ mi˥˦ taːŋ˥˦ mɔː˨˦ tsɔ˧˨˨ li˨˦
ၸဝ်ႈၵဝ်ႇၽူႈၼၢင်းယိင်းမီးတၢင်းမေႃၸဝ်ႈလီၶႃႈ	tsɔ˧˨˨ kaw˨˦ pʰu˧˨˨ naːŋ˥˦ jiŋ˥˦ mi˥˦ taːŋ˥˦ mɔː˨˦ tsɔ˧˨˨ li˨˦ kʰaː˧˨˨
ၸဝ်ႈၵဝ်ႇၽူႈၼၢင်းယိင်းမီးလွင်ႈၵူၼ်း	tsɔ˧˨˨ kaw˨˦ pʰu˧˨˨ naːŋ˥˦ jiŋ˥˦ mi˥˦ lɔŋ˥˩ kon˥˦
ၸဝ်ႈၵဝ်ႇၽူႈၼၢင်းယိင်းမီးၸႂ်	tsɔ˧˨˨ kaw˨˦ pʰu˧˨˨ naːŋ˥˦ jiŋ˥˦ mi˥˦ tɕaɯ˦
ၸဝ်ႈၵဝ်ႇၽူႈၼၢင်းယိင်းမီးၸႂ်လီ	tsɔ˧˨˨ kaw˨˦ pʰu˧˨˨ naːŋ˥˦ jiŋ˥˦ mi˥˦ tɕaɯ˦ li˨˦
ၸဝ်ႈၵဝ်ႇၽူႈၼၢင်းယိင်းမီးၸႂ်ၶႃႈ	tsɔ˧˨˨ kaw˨˦ pʰu˧˨˨ naːŋ˥˦ jiŋ˥˦ mi˥˦ tɕaɯ˦ kʰaː˧˨˨
ၸဝ်ႈၵဝ်ႇၽူႈၼၢင်းယိင်းမီးၸႂ်ၶႃႈလီ	tsɔ˧˨˨ kaw˨˦ pʰu˧˨˨ naːŋ˥˦ jiŋ˥˦ mi˥˦ tɕaɯ˦ kʰaː˧˨˨ li˨˦
ၸဝ်ႈၵဝ်ႇၽူႈၼၢင်းယိင်းမီးၸႂ်ၶႃႈလီၸဝ်ႈ	tsɔ˧˨˨ kaw˨˦ pʰu˧˨˨ naːŋ˥˦ jiŋ˥˦ mi˥˦ tɕaɯ˦ kʰaː˧˨˨ li˨˦ tsɔ˧˨˨
ၸဝ်ႈၵဝ်ႇၽူႈၼၢင်းယိင်းလီ	tsɔ˧˨˨ kaw˨˦ pʰu˧˨˨ naːŋ˥˦ jiŋ˥˦ li˨˦
ၸဝ်ႈၵဝ်ႇၽူႈၼၢင်းယိင်းၶႃႈ	tsɔ˧˨˨ kaw˨˦ pʰu˧˨˨ naːŋ˥˦ jiŋ˥˦ kʰaː˧˨˨
ၸဝ်ႈၵဝ်ႇၽူႈၼၢင်းယိင်းၶႃႈလီ	tsɔ˧˨˨ kaw˨˦ pʰu˧˨˨ naːŋ˥˦ jiŋ˥˦ kʰaː˧˨˨ li˨˦
ၸိူဝ်ႉၶုၼ်ႁၢၼ်ႉ	tsɯ˥˦ kʰun˨˦ haːn˥˦
ၸိူဝ်ႉၶၼ်ႇၸဝ်ႈ	tsɯ˥˦ kʰan˨˦ tsɔ˧˨˨
ၸိူဝ်ႉၶၼ်ႇၸဝ်ႈလီ	tsɯ˥˦ kʰan˨˦ tsɔ˧˨˨ li˨˦
ၸိူဝ်ႉၶၼ်ႇၸဝ်ႈၶႃႈ	tsɯ˥˦ kʰan˨˦ tsɔ˧˨˨ kʰaː˧˨˨
ၸိူဝ်ႉၶၼ်ႇၸဝ်ႈၶႃႈလီ	tsɯ˥˦ kʰan˨˦ tsɔ˧˨˨ kʰaː˧˨˨ li˨˦
ၸိူဝ်ႉၸၢတ်ႈမိူၼ်	tsɯ˥˦ tsaːt˧˨˨ mɤn˨˦
ၸိူဝ်ႉၸၢတ်ႈမိူၼ်ၵၼ်	tsɯ˥˦ tsaːt˧˨˨ mɤn˨˦ kan˨˦
ၸိူဝ်ႉၸၢတ်ႈမိူၼ်ၵၼ်လီ	tsɯ˥˦ tsaːt˧˨˨ mɤn˨˦ kan˨˦ li˨˦
ၸိူဝ်ႉၸၢတ်ႈမိူၼ်ၵၼ်လီၶႃႈ	tsɯ˥˦ tsaːt˧˨˨ mɤn˨˦ kan˨˦ li˨˦ kʰaː˧˨˨
ၸိူဝ်ႉၸၢတ်ႈၼမ်ႉၵတ်ႉ	tsɯ˥˦ tsaːt˧˨˨ nam˦ kat˦
ၸိူဝ်ႉၸၢတ်ႈၼမ်ႉၵတ်ႉလီ	tsɯ˥˦ tsaːt˧˨˨ nam˦ kat˦ li˨˦
ၸိူဝ်ႉၸၢတ်ႈၼႂ်းမိုဝ်း	tsɯ˥˦ tsaːt˧˨˨ naɯ˥˦ mɯ˥˦
ၸွမ်းၼမ်ႉ	tɕɔm˥˦ nam˦
ၺ	ɲ
ၺိမ်ႇ	ɲim˩
ၺိုင်	ɲɯŋ˨
ၺိုၼ်း	ɲɯn˥
ၺိူၼ်း	ɲɤn˥
ၺုမ်ႇ	ɲum˩
ၺူၼ်း	ɲon˥
ၺဵင်	ɲeŋ˨
ၺျႃး	ɲaː˥
ၺြႃး	ɲaː˥
ၺွင်	ɲɔŋ˨
ၺၢင်	ɲaːŋ˨
ၺၢမ်ႇ	ɲaːm˩
ၺၢၼ်	ɲaːn˨
ၺၢႆး	ɲaːj˥
ၺႃ	ɲaː˨
ၺႃး	ɲaː˥
ၺႅင်	ɲɛŋ˨
ၼ	n
ၼၢမ်း	naːm
ၽ	pʰ
ၽိင်ႈငႄႈတီႈၼႂ်းၵၢင်လွႆ	pʰiŋ˧˨˨ ŋɛː˧˨˨ ti˥˩ naɯ˥˦ kaːŋ˨˦ lɔj˨˦
ၽိင်ႈငႄႈတီႈၼႂ်းၵႄႈ	pʰiŋ˧˨˨ ŋɛː˧˨˨ ti˥˩ naɯ˥˦ kɛː˧˨˨
ၽိင်ႈငႄႈတီႈၼႂ်းႁိူၼ်း	pʰiŋ˧˨˨ ŋɛː˧˨˨ ti˥˩ naɯ˥˦ hɤn˥˦
ၽိင်ႈငႄႈတီႈၼႂ်းႁိူၼ်းၶႃႈ	pʰiŋ˧˨˨ ŋɛː˧˨˨ ti˥˩ naɯ˥˦ hɤn˥˦ kʰaː˧˨˨
ၽိင်ႈငႄႈတႆး	pʰiŋ˧˨˨ ŋɛː˧˨˨ taj˥˦
ၽိင်ႈငႄႈၵၢင်ဝၼ်း	pʰiŋ˧˨˨ ŋɛː˧˨˨ kaːŋ˨˦ wan˥˦
ၽိင်ႈငႄႈၵၢင်ဝၼ်းလီ	pʰiŋ˧˨˨ ŋɛː˧˨˨ kaːŋ˨˦ wan˥˦ li˨˦
ၽိင်ႈငႄႈၵၢင်ဝၼ်းလီၶႃႈ	pʰiŋ˧˨˨ ŋɛː˧˨˨ kaːŋ˨˦ wan˥˦ li˨˦ kʰaː˧˨˨
ၽိင်ႈငႄႈၵၢင်ၶိုၼ်း	pʰiŋ˧˨˨ ŋɛː˧˨˨ kaːŋ˨˦ kʰɯn˥˦
ၽိင်ႈငႄႈၵၢင်ၶိုၼ်းလီ	pʰiŋ˧˨˨ ŋɛː˧˨˨ kaːŋ˨˦ kʰɯn˥˦ li˨˦
ၽိင်ႈငႄႈၵၢင်ၶိုၼ်းလီၶႃႈ	pʰiŋ˧˨˨ ŋɛː˧˨˨ kaːŋ˨˦ kʰɯn˥˦ li˨˦ kʰaː˧˨˨
ၽိင်ႈငႄႈၵၢင်ၼႂ်	pʰiŋ˧˨˨ ŋɛː˧˨˨ kaːŋ˨˦ naɯ˦
ၽိုင်	pʰɯŋ˨
ၽိုၼ်း	pʰɯn˥
ၽိူၵ်ႇၸိုဝ်ႈ	pʰɤk˨˦ tɕɯ˥˩
ၽိူၼ်း	pʰɤn˥
ၽုမ်ႇ	pʰum˩
ၽူၼ်း	pʰon˥
ၽူႈတၢင်းပၼ်ႇၸႂ်	pʰu˧˨˨ taːŋ˥˦ pan˨˦ tɕaɯ˦
ၽူႈတၢင်းလိူၵ်ႈတႆး	pʰu˧˨˨ taːŋ˥˦ lɤk˧˨˨ taj˥˦
ၽူႈတၢင်းလိူၵ်ႈတႆးၶႃႈ	pʰu˧˨˨ taːŋ˥˦ lɤk˧˨˨ taj˥˦ kʰaː˧˨˨
ၽူႈမီးတၢင်းမေႃ	pʰu˧˨˨ mi˥˦ taːŋ˥˦ mɔː˨˦
ၽူႈမီးၸႂ်လီ	pʰu˧˨˨ mi˥˦ tɕaɯ˦ li˨˦
ၽူႈမီးၸႂ်လီၶႃႈ	pʰu˧˨˨ mi˥˦ tɕaɯ˦ li˨˦ kʰaː˧˨˨
ၽူႈမီးၸႂ်လီၶႃႈၸဝ်ႈ	pʰu˧˨˨ mi˥˦ tɕaɯ˦ li˨˦ kʰaː˧˨˨ tsɔ˧˨˨
ၽူႈမီးၸႂ်လီၸဝ်ႈ	pʰu˧˨˨ mi˥˦ tɕaɯ˦ li˨˦ tsɔ˧˨˨
ၽူႈမီးၸႂ်ၶႃႈ	pʰu˧˨˨ mi˥˦ tɕaɯ˦ kʰaː˧˨˨
ၽူႈမီးၸႂ်ၶႃႈလီ	pʰu˧˨˨ mi˥˦ tɕaɯ˦ kʰaː˧˨˨ li˨˦
ၽူႈမီးၸႂ်ၸဝ်ႈ	pʰu˧˨˨ mi˥˦ tɕaɯ˦ tsɔ˧˨˨
ၽူႈမီးၸႂ်ၸဝ်ႈလီ	pʰu˧˨˨ mi˥˦ tɕaɯ˦ tsɔ˧˨˨ li˨˦
ၽူႈမီးၸႂ်ၸဝ်ႈလီၶႃႈ	pʰu˧˨˨ mi˥˦ tɕaɯ˦ tsɔ˧˨˨ li˨˦ kʰaː˧˨˨
ၽူႈၼၢင်းယိင်းမီးတၢင်းမေႃ	pʰu˧˨˨ naːŋ˥˦ jiŋ˥˦ mi˥˦ taːŋ˥˦ mɔː˨˦
ၽူႈၼၢင်းယိင်းမီးတၢင်းမေႃလီ	pʰu˧˨˨ naːŋ˥˦ jiŋ˥˦ mi˥˦ taːŋ˥˦ mɔː˨˦ li˨˦
ၽူႈၼၢင်းယိင်းမီးတၢင်းမေႃၶႃႈ	pʰu˧˨˨ naːŋ˥˦ jiŋ˥˦ mi˥˦ taːŋ˥˦ mɔː˨˦ kʰaː˧˨˨
ၽူႈၼၢင်းယိင်းမီးတၢင်းမေႃၶႃႈလီ	pʰu˧˨˨ naːŋ˥˦ jiŋ˥˦ mi˥˦ taːŋ˥˦ mɔː˨˦ kʰaː˧˨˨ li˨˦
ၽူႈၼၢင်းယိင်းမီးတၢင်းမေႃၶႃႈလီၸဝ်ႈ	pʰu˧˨˨ naːŋ˥˦ jiŋ˥˦ mi˥˦ taːŋ˥˦ mɔː˨˦ kʰaː˧˨˨ li˨˦ tsɔ˧˨˨
ၽူႈၼၢင်းယိင်းမီးတၢင်းမေႃၸဝ်ႈ	pʰu˧˨˨ naːŋ˥˦ jiŋ˥˦ mi˥˦ taːŋ˥˦ mɔː˨˦ tsɔ˧˨˨
ၽူႈၼၢင်းယိင်းမီးတၢင်းမေႃၸဝ်ႈလီ	pʰu˧˨˨ naːŋ˥˦ jiŋ˥˦ mi˥˦ taːŋ˥˦ mɔː˨˦ tsɔ˧˨˨ li˨˦
ၽူႈၼၢင်းယိင်းမီးတၢင်းမေႃၸဝ်ႈလီၶႃႈ	pʰu˧˨˨ naːŋ˥˦ jiŋ˥˦ mi˥˦ taːŋ˥˦ mɔː˨˦ tsɔ˧˨˨ li˨˦ kʰaː˧˨˨
ၽူႈၼၢင်းယိင်းမီးလွင်ႈၵူၼ်း	pʰu˧˨˨ naːŋ˥˦ jiŋ˥˦ mi˥˦ lɔŋ˥˩ kon˥˦
ၽူႈၼၢင်းယိင်းမီးၸႂ်	pʰu˧˨˨ naːŋ˥˦ jiŋ˥˦ mi˥˦ tɕaɯ˦
ၽူႈၼၢင်းယိင်းမီးၸႂ်လီ	pʰu˧˨˨ naːŋ˥˦ jiŋ˥˦ mi˥˦ tɕaɯ˦ li˨˦
ၽူႈၼၢင်းယိင်းလီ	pʰu˧˨˨ naːŋ˥˦ jiŋ˥˦ li˨˦
ၽူႈၼၢင်းယိင်းၶႃႈ	pʰu˧˨˨ naːŋ˥˦ jiŋ˥˦ kʰaː˧˨˨
ၽူႈၼၢင်းယိင်းၶႃႈလီ	pʰu˧˨˨ naːŋ˥˦ jiŋ˥˦ kʰaː˧˨˨ li˨˦
ၽူႈၼၢင်းယိင်းၸႂ်	pʰu˧˨˨ naːŋ˥˦ jiŋ˥˦ tɕaɯ˦
ၽဵင်	pʰeŋ˨
ၽျႃး	jʰaː˥
ၽြႃး	pʰjaː˥
ၽွင်	pʰɔŋ˨
ၽၢင်	pʰaːŋ˨
ၽၢမ်ႇ	pʰaːm˩
ၽၢၼ်	pʰaːn˨
ၽၢႆး	pʰaːj˥
ၽႂ်းၼႂ်းလိၼ်	pʰaɯ˥˦ naɯ˥˦ lin˨˦
ၽႃ	pʰaː˨
ၽႃး	pʰaː˥
ၽႃႇသႃႇတႆး	pʰaː˧˨˨ sʰaː˧˨˨ taj˥˦
ၽႅင်	pʰɛŋ˨
ၾ	f
ႁ	h
ႁိုင်	hɯŋ˨
ႁိုၼ်း	hɯn˥
ႁိူၼ်း	hɤn˥
ႁုမ်ႇ	hum˩
ႁူၼ်း	hon˥
ႁဵင်	heŋ˨
ႁျႃး	tɕʰaː˥
ႁြႃး	tɕʰaː˥
ႁွင်	hɔŋ˨
ႁၢင်	haːŋ˨
ႁၢမ်ႇ	haːm˩
ႁၢၼ်	haːn˨
ႁၢႆး	haːj˥
ႁႃ	haː˨
ႁႃး	haː˥
ႁႅင်	hɛŋ˨
ႁႅင်း	heŋ
