"độ	do˨ˀ˩ʔ
-	-
a	a˧˧
a-di-đà	a˧˧-zi˧˧-da˧˨
a-lê	a˧˧-le˧˧
a-mi-nô	a˧˧-mi˧˧-no˧˧
a-rập	a˧˧-zɤ̆p˨ˀ˩
a-xê-ti-len	a˧˧-se˧˧-ti˧˧-lɛn˧˧
a-xít	a˧˧-sit˦˥
ai	aj˧˧
alo	ʔaːlo˧
am	am˧˧
am-pe	am˧˧-pɛ˧˧
an	an˧˧
ang	aŋ˧˧
anh	ɛŋ˧˧
ao	aw˧˧
au	ăw˧˧
ay	ăj˧˧
ba	baː˧
ba	ba˧˧
ba-trui	ba˧˧-cuj˧˧
ba-xí	ba˧˧-si˨˦
bai	baj˧˧
bam	bam˧˧
ban	ban˧
ban	ban˧˧
bang	baŋ˧˧
bao	baw˧˧
bay	băj˧˧
be	bɛ˧˧
bem	bɛm˧˧
beng	bɛŋ˧˧
beo	beo˧˧
bi	bi˧˧
bia	biə˧˧
bin	bin˧˧
binh	biŋ˧˧
biên	biən˧˧
biêng	biəŋ˧˧
biếc	biək˦˥
biếm	biəm˨˦
biến	biən˨˦
biếng	biəŋ˨˦
biết	biət˦˥
biếu	biəw˨˦
biền	biən˧˨
biển	biən˧˩˨
biểu	biəw˧˩˨
biện	biən˨ˀ˩ʔ
biệt	biət˨ˀ˩
bo	bɔ˧˧
bom	bɔm˧˧
bon	bɔn˧˧
bong	bɔŋm˧˧
boong	bɔŋm˧˧
boóc	bɔkp˦˥
bu	bu˧˧
bui	buj˧˧
bum	bum˧˧
bun	bun˧˧
bung	buŋm˧˧
buôn	buən˧˧
buông	buəŋ˧˧
buốt	buət˦˥
buồm	buəm˧˨
buồn	buən˧˨
buồng	buəŋ˧˨
buổi	buəj˧˩˨
buộc	buək˨ˀ˩
buột	buət˨ˀ˩
bà	baː˧˨
bà	ba˧˨
bài	baj˧˨
bàm	bam˧˨
bàn	ban˧˨
bàng	baŋ˧˨
bành	bɛŋ˧˨
bào	baw˧˨
bàu	băw˧˨
bày	băj˧˨
bá	ba˨˦
bác	bak˦˥
bách	bɛk˦˥
bái	baj˨˦
bám	bam˨˦
bán	ban˨˦
báng	baŋ˨˦
bánh	bɛŋ˨˦
báo	baw˨˦
báo	baːw˧
bát	bat˦˥
bát-tràng	bat˦˥-caŋ˧˨
báu	băw˨˦
bân	bɤ̆n˧˧
bâng	bɤ̆ŋ˧˧
bâu	bɤ̆w˧˧
bây	bɤ̆j˧˧
bã	ba˧ˀ˥
bãi	baj˧ˀ˥
bão	baw˧ˀ˥
bè	bɛ˧˨
bèm	bɛm˧˨
bèn	bɛn˧˨
bèo	beo˧˨
bé	bɛ˧˥
bé	bɛ˨˦
béc	bɛk˦˥
bén	bɛn˨˦
béo	beo˨˦
bép	bɛp˦˥
bét	bɛt˦˥
bê	be˧˧
bê-tông	be˧˧-toŋm˧˧
bên	ben˧˧
bên	bɛn˧
bênh	beŋ˧˧
bêu	bɛu˧˧
bì	bi˧˨
bìa	biə˧˨
bìm	bim˧˨
bình	biŋ˧˨
bìu	biw˧˨
bí	bi˨˦
bích	bik˦˥
bích-câu	bik˦˥-kɤ̆w˧˧
bín	bin˨˦
bính	biŋ˨˦
bíp	bip˦˥
bít	bit˦˥
bíu	biw˨˦
bò	bɔ˧˨
bòi	bɔj˧˨
bòm	bɔm˧˨
bòn	bɔn˧˨
bòng	bɔŋm˧˨
bó	bo˧˥
bó	bɔ˨˦
bóc	bɔkp˦˥
bói	bɔj˨˦
bón	bɔn˨˦
bóng	bɔŋm˨˦
bóp	bɔp˦˥
bô	bo˧˧
bôi	boj˧˧
bôm	bom˧˧
bôn	bon˧˧
bôn-sê-vích	bon˧˧-se˧˧-vik˦˥
bông	boŋm˧˧
bõ	bɔ˧ˀ˥
bù	bu˧˨
bùa	buə˧˨
bùi	buj˧˨
bùm	bum˧˨
bùn	bun˧
bùn	bun˧˨
bùng	buŋm˧˨
bú	bu˨˦
búa	buə˨˦
búi	buj˨˦
bún	bun˨˦
búng	buŋm˨˦
búp	bup˦˥
bút	but˦˥
băm	băm˧˧
băn	băn˧˧
băng	băŋ˧˧
băng-giô	băŋ˧˧-zo˧˧
bĩ	bi˧ˀ˥
bĩnh	biŋ˧ˀ˥
bĩu	biw˧ˀ˥
bơ	bɤ˧˧
bơi	bɤj˧˧
bơm	bɤm˧˧
bơn	bɤn˧˧
bư	bɯ˧˧
bưng	bɯŋ˧˧
bưu	bɯw˧˧
bươm	bɯəm˧˧
bươn	bɯən˧˧
bương	bɯəŋ˧˧
bươu	bɯəw˧˧
bước	bɯək˦˥
bướm	bɯəm˨˦
bướng	bɯəŋ˨˦
bướu	bɯəw˨˦
bưởi	bɯəj˧˩˨
bạ	ba˨ˀ˩ʔ
bạc	bak˨ˀ˩
bạch	bɛk˨ˀ˩
bại	baj˨ˀ˩ʔ
bạn	ban˧˨
bạn	ban˨ˀ˩ʔ
bạng	baŋ˨ˀ˩ʔ
bạnh	bɛŋ˨ˀ˩ʔ
bạo	baw˨ˀ˩ʔ
bạt	bat˨ˀ˩
bạu	băw˨ˀ˩ʔ
bả	ba˧˩˨
bải	baj˧˩˨
bản	ban˧˩˨
bảng	baŋ˧˩˨
bảnh	bɛŋ˧˩˨
bảo	baw˧˩˨
bảu	băw˧˩˨
bảy	băj˧˩˨
bấc	bɤ̆k˦˥
bấm	bɤ̆m˨˦
bấn	bɤ̆n˨˦
bấp	bɤ̆p˦˥
bất	bɤ̆t˦˥
bấu	bɤ̆w˨˦
bấy	bɤ̆j˨˦
bầm	bɤ̆m˧˨
bần	bɤ̆n˧˨
bầng	bɤ̆ŋ˧˨
bầu	bɤ̆w˧˨
bầy	bɤ̆j˧˨
bẩm	bɤ̆m˧˩˨
bẩn	bɤ̆n˧˩˨
bẩy	bɤ̆j˧˩˨
bẫm	bɤ̆m˧ˀ˥
bẫy	bɤ̆j˧ˀ˥
bậc	bɤ̆k˨ˀ˩
bậm	bɤ̆m˨ˀ˩ʔ
bận	ban˧˨
bận	bɤ̆n˨ˀ˩ʔ
bập	bɤ̆p˨ˀ˩
bật	bɤ̆t˨ˀ˩
bậu	bɤ̆w˨ˀ˩ʔ
bậy	bɤ̆j˨ˀ˩ʔ
bắc	băk˦˥
bắn	băn˨˦
bắng	băŋ˨˦
bắp	băp˦˥
bắt	băt˦˥
bằn	băn˧˨
bằng	baŋ˧
bằng	băŋ˧˨
bẳn	băn˧˩˨
bẵng	băŋ˧ˀ˥
bặc	băk˨ˀ˩
bặm	băm˨ˀ˩ʔ
bặng	băŋ˨ˀ˩ʔ
bặt	băt˨ˀ˩
bẹ	bɛ˨ˀ˩ʔ
bẹp	bɛp˨ˀ˩
bẹt	bɛt˨ˀ˩
bẻ	bɛ˧˩˨
bẻm	bɛm˧˩˨
bẻo	beo˧˩˨
bẽ	bɛ˧ˀ˥
bẽn	bɛn˧ˀ˥
bế	be˨˦
bến	ben˨˦
bếp	bep˦˥
bết	bet˦˥
bề	be˧˨
bền	ben˧˨
bềnh	beŋ˧˨
bều	bɛu˧˨
bể	be˧˩˨
bệ	be˨ˀ˩ʔ
bệch	bek˨ˀ˩
bện	ben˨ˀ˩ʔ
bệnh	beŋ˨ˀ˩ʔ
bệt	bet˨ˀ˩
bệu	bɛu˨ˀ˩ʔ
bỉ	bi˧˩˨
bỉm	bim˧˩˨
bỉnh	biŋ˧˩˨
bị	bi˧˨
bị	bi˨ˀ˩ʔ
bịa	biə˨ˀ˩ʔ
bịn	bin˨ˀ˩ʔ
bịp	bip˨ˀ˩
bịt	bit˨ˀ˩
bọ	bɔ˨ˀ˩ʔ
bọc	bɔkp˨ˀ˩
bọn	bɔn˨ˀ˩ʔ
bọng	bɔŋm˨ˀ˩ʔ
bọp	bɔp˨ˀ˩
bọt	bɔt˨ˀ˩
bỏ	bo˧˨
bỏ	bɔ˧˩˨
bỏm	bɔm˧˩˨
bỏn	bɔn˧˩˨
bỏng	bɔŋm˧˩˨
bố	bo˧˥
bố	bo˨˦
bốc	bokp˦˥
bối	boj˨˦
bốn	bon˨˦
bống	boŋm˨˦
bốp	bop˦˥
bồ	bo˧˨
bồi	boj˧˨
bồm	bom˧˨
bồn	bon˧˨
bồng	boŋm˧˨
bổ	bo˧˩˨
bổi	boj˧˩˨
bổn	bon˧˩˨
bổng	boŋm˧˩˨
bỗ	bo˧ˀ˥
bỗng	boŋm˧ˀ˥
bỗng	boŋ˧˨
bộ	bo˨ˀ˩ʔ
bộc	bokp˨ˀ˩
bội	boj˨ˀ˩ʔ
bộn	bon˨ˀ˩ʔ
bộng	boŋm˨ˀ˩ʔ
bộp	bop˨ˀ˩
bột	bot˨ˀ˩
bớ	bɤ˨˦
bới	bɤj˨˦
bớp	bɤp˦˥
bớt	bɤt˦˥
bờ	bɤ˧˨
bời	bɤj˧˨
bờm	bɤm˧˨
bờn	bɤn˧˨
bở	bɤ˧˩˨
bởi	bɤj˧˩˨
bỡ	bɤ˧ˀ˥
bỡn	bɤn˧ˀ˥
bợ	bɤ˨ˀ˩ʔ
bợm	bɤm˨ˀ˩ʔ
bợn	bɤn˨ˀ˩ʔ
bợp	bɤp˨ˀ˩
bợt	bɤt˨ˀ˩
bụ	bu˨ˀ˩ʔ
bụi	buj˨ˀ˩ʔ
bụng	buŋm˨ˀ˩ʔ
bụt	but˨ˀ˩
bủ	bu˧˩˨
bủa	buə˧˩˨
bủn	bun˧˩˨
bủng	buŋm˧˩˨
bứ	bɯ˨˦
bức	bɯk˦˥
bứt	bɯt˦˥
bừa	bɯə˧˨
bừng	bɯŋ˧˨
bửng	bɯŋ˧˩˨
bửu	bɯw˧˩˨
bữa	bɯə˧ˀ˥
bự	bɯ˨ˀ˩ʔ
bực	bɯk˨ˀ˩
ca	ka˧˧
cai	kaj˧˧
cam	kam˧˧
can	kan˧˧
cang	kaŋ˧˧
canh	kɛŋ˧˧
cao	kaw˧˧
cau	kăw˧˧
cay	kăj˧˧
cha	ca˧˧
chai	caj˧˧
cham	cam˧˧
chan	can˧˧
chang	caŋ˧˧
chanh	cɛŋ˧˧
chao	caw˧˧
chau	căw˧˧
chay	căj˧˧
che	cɛ˧˧
chem	cɛm˧˧
chen	cɛn˧˧
cheng	cɛŋ˧˧
cheo	ceo˧˧
chi	ci˧˧
chia	ciə˧˧
chim	cim˧˧
chin	cin˧˧
chinh	ciŋ˧˧
chiu	ciw˧˧
chiêm	ciəm˧˧
chiên	ciən˧˧
chiêng	ciəŋ˧˧
chiêu	ciəw˧˧
chiếc	ciək˦˥
chiếm	ciəm˨˦
chiến	ciən˨˦
chiếng	ciəŋ˨˦
chiếp	ciəp˦˥
chiết	ciət˦˥
chiếu	ciəw˨˦
chiền	ciən˧˨
chiềng	ciəŋ˧˨
chiều	ciəw˧˨
chiểu	ciəw˧˩˨
cho	cɔ˧
cho	cɔ˧˧
choai	cwaj˧˧
choang	cwaŋ˧˧
choe	cwe˧˧
choen	cwen˧˧
choi	cɔj˧˧
chon	cɔn˧˧
chong	cɔŋm˧˧
choàm	cwam˧˨
choàng	cwaŋ˧˨
choá	cwa˨˦
choác	cwak˦˥
choáng	cwaŋ˨˦
choèn	cwen˧˨
choăn	cwăn˧˧
choạc	cwak˨ˀ˩
choạng	cwaŋ˨ˀ˩ʔ
choắt	cwăt˦˥
chu	cu˧˧
chua	cuə˧˧
chui	cuj˧˧
chum	cum˧˧
chun	cun˧˧
chung	cuŋm˧˧
chuyên	cwiən˧˧
chuyến	cwiən˨˦
chuyền	cwiən˧˨
chuyển	cwiən˧˩˨
chuyện	cwiən˨ˀ˩ʔ
chuôi	cuəj˧˧
chuôm	cuəm˧˧
chuông	cuəŋ˧˧
chuẩn	cwɤ̆n˧˩˨
chuế	cwe˨˦
chuếch	cwek˦˥
chuếnh	cweŋ˨˦
chuểnh	cweŋ˧˩˨
chuệch	cwek˨ˀ˩
chuệnh	cweŋ˨ˀ˩ʔ
chuốc	cuək˦˥
chuối	cuəj˨˦
chuốt	cuət˦˥
chuồi	cuəj˧˨
chuồn	cuən˧˨
chuồng	cuəŋ˧˨
chuỗi	cuəj˧ˀ˥
chuộc	cuək˨ˀ˩
chuội	cuəj˨ˀ˩ʔ
chuộng	cuəŋ˨ˀ˩ʔ
chuột	cuət˨ˀ˩
chà	ca˧˨
chài	caj˧˨
chàm	cam˧˨
chàng	caŋ˧˨
chành	cɛŋ˧˨
chào	caw˧˨
chàu	căw˧˨
chày	căj˧˨
chác	cak˦˥
chán	can˨˦
chánh	cɛŋ˨˦
cháo	caw˨˦
chát	cat˦˥
cháu	căw˨˦
cháy	căj˨˦
châm	cɤ̆m˧˧
chân	cɤ̆n˧˧
châng	cɤ̆ŋ˧˧
châu	cɤ̆w˧˧
chây	cɤ̆j˧˧
chão	caw˧ˀ˥
chè	cɛ˧˨
chèm	cɛm˧˨
chèn	cɛn˧˨
chèo	ceo˧˨
chém	cɛm˨˦
chén	cɛn˨˦
chéo	ceo˨˦
chép	cɛp˦˥
chét	cɛt˦˥
chê	ce˧˧
chêm	cem˧˧
chênh	ceŋ˧˧
chêu	cɛu˧˧
chì	ci˧˨
chìa	ciə˧˨
chìm	cim˧˨
chình	ciŋ˧˨
chí	ci˨˦
chích	cik˦˥
chín	cin˨˦
chính	ciŋ˨˦
chíp	cip˦˥
chít	cit˦˥
chíu	ciw˨˦
chò	cɔ˧˨
chòi	cɔj˧˨
chòm	cɔm˧˨
chòng	cɔŋm˧˨
chó	cɔ˨˦
chóc	cɔkp˦˥
chói	cɔj˨˦
chóng	cɔŋm˨˦
chóp	cɔp˦˥
chót	cɔt˦˥
chô	co˧˧
chôm	com˧˧
chôn	con˧˧
chông	coŋm˧˧
chõ	cɔ˧ˀ˥
chõm	cɔm˧ˀ˥
chù	cu˧˨
chùa	cuə˧˨
chùi	cuj˧˨
chùm	cum˧˨
chùn	cun˧˨
chùng	cuŋm˧˨
chú	cu˨˦
chúa	cuə˨˦
chúc	cukp˦˥
chúi	cuj˨˦
chúm	cum˨˦
chúng	cuŋm˨˦
chút	cut˦˥
chăm	căm˧˧
chăn	căn˧˧
chăng	căŋ˧˧
chĩa	ciə˧ˀ˥
chĩnh	ciŋ˧ˀ˥
chũm	cum˧ˀ˥
chũn	cun˧ˀ˥
chơ	cɤ˧˧
chơi	cɤj˧˧
chơm	cɤm˧˧
chơn	cɤn˧˧
chư	cɯ˧˧
chưa	cɯə˧˧
chưng	cɯŋ˧˧
chương	cɯəŋ˧˧
chước	cɯək˦˥
chướng	cɯəŋ˨˦
chưởng	cɯəŋ˧˩˨
chạ	ca˨ˀ˩ʔ
chạc	cak˨ˀ˩
chạch	cɛk˨ˀ˩
chạm	cam˨ˀ˩ʔ
chạng	caŋ˨ˀ˩ʔ
chạnh	cɛŋ˨ˀ˩ʔ
chạo	caw˨ˀ˩ʔ
chạp	cap˨ˀ˩
chạy	căj˨ˀ˩ʔ
chả	ca˧˩˨
chải	caj˧˩˨
chảng	caŋ˧˩˨
chảnh	cɛŋ˧˩˨
chảo	caw˧˩˨
chảu	căw˧˩˨
chảy	căj˧˩˨
chấm	cɤ̆m˨˦
chấn	cɤ̆n˨˦
chấp	cəp˧˥
chấp	cɤ̆p˦˥
chất	cɤ̆t˦˥
chấu	cɤ̆w˨˦
chấy	cɤ̆j˨˦
chầm	cɤ̆m˧˨
chần	cɤ̆n˧˨
chầu	cɤ̆w˧˨
chầy	cɤ̆j˧˨
chẩm	cɤ̆m˧˩˨
chẩn	cɤ̆n˧˩˨
chẫu	cɤ̆w˧ˀ˥
chậc	cɤ̆k˨ˀ˩
chậm	cɤ̆m˨ˀ˩ʔ
chận	cɤ̆n˨ˀ˩ʔ
chập	cɤ̆p˨ˀ˩
chật	cɤ̆t˨ˀ˩
chậu	cɤ̆w˨ˀ˩ʔ
chắc	căk˦˥
chắc	căk˧˥
chắn	căn˨˦
chắp	căp˦˥
chắt	căt˦˥
chằm	căm˧˨
chằn	căn˧˨
chằng	căŋ˧˨
chẳng	căŋ˧˩˨
chẵn	căn˧ˀ˥
chặc	căk˨ˀ˩
chặn	căn˨ˀ˩ʔ
chặng	căŋ˨ˀ˩ʔ
chặp	căp˨ˀ˩
chặt	căt˨ˀ˩
chẹn	cɛn˨ˀ˩ʔ
chẹp	cɛp˨ˀ˩
chẹt	cɛt˨ˀ˩
chẻ	cɛ˧˩˨
chẻm	cɛm˧˩˨
chẻn	cɛn˧˩˨
chẻo	ceo˧˩˨
chế	ce˨˦
chếch	cek˦˥
chếnh	ceŋ˨˦
chết	cet˦˥
chề	ce˧˨
chềm	cem˧˨
chềnh	ceŋ˧˨
chểnh	ceŋ˧˩˨
chễm	cem˧ˀ˥
chễnh	ceŋ˧ˀ˥
chệch	cek˨ˀ˩
chệnh	ceŋ˨ˀ˩ʔ
chỉ	ci˧˩˨
chỉn	cin˧˩˨
chỉnh	ciŋ˧˩˨
chị	ci˧˨
chị	ci˨ˀ˩ʔ
chịu	ciw˨ˀ˩ʔ
chọc	cɔkp˨ˀ˩
chọi	cɔj˨ˀ˩ʔ
chọn	cɔn˨ˀ˩ʔ
chỏm	cɔm˧˩˨
chỏn	cɔn˧˩˨
chỏng	cɔŋm˧˩˨
chốc	cokp˦˥
chối	coj˨˦
chốn	con˨˦
chống	coŋm˨˦
chốt	cot˦˥
chồi	coj˧˨
chồm	com˧˨
chồn	con˧˨
chồng	coŋm˧˨
chổi	coj˧˩˨
chổng	coŋm˧˩˨
chỗ	co˧ˀ˥
chỗ	cə˧˨
chộn	con˨ˀ˩ʔ
chộp	cop˨ˀ˩
chột	cot˨ˀ˩
chớ	cɤ˨˦
chới	cɤj˨˦
chớm	cɤm˨˦
chớp	cɤp˦˥
chớt	cɤt˦˥
chờ	cɤ˧˨
chờm	cɤm˧˨
chờn	cɤn˧˨
chở	cɤ˧˩˨
chợ	cɤ˨ˀ˩ʔ
chợp	cɤp˨ˀ˩
chục	cukp˨ˀ˩
chụm	cum˨ˀ˩ʔ
chụp	cup˨ˀ˩
chụt	cut˨ˀ˩
chủ	cu˧˩˨
chủn	cun˧˩˨
chủng	cuŋm˧˩˨
chứ	cɨ˧˥
chứ	cɯ˨˦
chứa	cɯə˨˦
chức	cɯk˦˥
chứng	cɯŋ˨˦
chừ	cɯ˧˨
chừa	cɯə˧˨
chừng	cɯŋ˧˨
chửa	cɯə˧˩˨
chửi	cɯj˧˩˨
chữ	cɯ˧ˀ˥
chữa	cɯə˧ˀ˥
chững	cɯŋ˧ˀ˥
chực	cɯk˨ˀ˩
co	kɔ˧
co	kɔ˧˧
coi	kɔj˧˧
com	kɔm˧˧
con	kɔn˧
con	kɔn˧˧
cong	kɔŋm˧˧
coóc	kɔkp˦˥
cu	ku˧˧
cua	kuə˧˧
cui	kuj˧˧
cum	kum˧˧
cun	kun˧˧
cung	kuŋm˧˧
cuốc	kuək˦˥
cuối	kuəj˨˦
cuốn	kuən˨˦
cuống	kuəŋ˨˦
cuồn	kuən˧˨
cuồng	kuəŋ˧˨
cuộc	kuək˨ˀ˩
cuội	kuəj˨ˀ˩ʔ
cuộn	kuən˨ˀ˩ʔ
cuộng	kuəŋ˨ˀ˩ʔ
cà	ka˧˨
cà-phê	ka˧˨-fe˧˧
cài	kaj˧˨
càn	kan˧˨
càng	kaŋ˧˨
cành	kɛŋ˧˨
cào	kaw˧˨
càu	kăw˧˨
cày	kăj˧˨
cá	ka˨˦
các	kak˦˥
các-tông	kak˦˥-toŋm˧˧
cách	kajk˧˥
cách	kɛk˦˥
cái	kaj˨˦
cám	kam˨˦
cán	kan˨˦
cáng	kaŋ˨˦
cánh	kɛŋ˨˦
cáo	kaw˨˦
cáp	kap˦˥
cát	kat˦˥
cáu	kăw˨˦
cáy	kăj˨˦
câm	kɤ̆m˧˧
cân	kɤ̆n˧˧
câng	kɤ̆ŋ˧˧
câu	kɤ̆w˧˧
cây	kɤ̆j˧˧
cãi	kaj˧ˀ˥
cò	kɔ˧˨
còi	kɔj˧˨
còm	kɔm˧˨
còn	kɔn˧
còn	kɔn˧˨
còng	kɔŋm˧˨
có	kɔ˧˥
có	kɔ˨˦
cóc	kɔkp˦˥
cói	kɔj˨˦
cóm	kɔm˨˦
cóng	kɔŋm˨˦
cóp	kɔp˦˥
cót	kɔt˦˥
cô	ko˧
cô	ko˧˧
cô-đê	ko˧˧-de˧˧
côi	koj˧˧
côm	kom˧˧
côn	kon˧˧
công	koŋm˧˧
công-xinh	koŋm˧˧-siŋ˧˧
cõi	kɔj˧ˀ˥
cõng	kɔŋm˧ˀ˥
cù	ku˧˨
cùi	kuj˧˨
cùm	kum˧˨
cùn	kun˧˨
cùng	kuŋm˧˨
cú	ku˨˦
cúc	kukp˦˥
cúi	kuj˨˦
cúm	kum˨˦
cúng	kuŋm˨˦
cúp	kup˦˥
cút	kut˦˥
căm	kăm˧˧
căn	kăn˧˧
căng	kăŋ˧˧
cũ	ku˧ˀ˥
cũ	ku˧˨
cũi	kuj˧ˀ˥
cũn	kun˧ˀ˥
cũng	kuŋm˧ˀ˥
cơ	kɤ˧˧
cơi	kɤj˧˧
cơm	kɤm˧˧
cơn	kɤn˧˧
cư	kɯ˧˧
cưa	kɯə˧˧
cưng	kɯŋ˧˧
cưu	kɯw˧˧
cương	kɯəŋ˧˧
cước	kɯək˦˥
cưới	kɯəj˨˦
cướp	kɯəp˦˥
cười	kɯəj˧˨
cườm	kɯəm˧˨
cường	kɯəŋ˧˨
cưỡi	kɯəj˧ˀ˥
cưỡng	kɯəŋ˧ˀ˥
cạc	kak˨ˀ˩
cạch	kɛk˨ˀ˩
cạm	kam˨ˀ˩ʔ
cạn	kan˨ˀ˩ʔ
cạnh	kɛŋ˨ˀ˩ʔ
cạo	kaw˨ˀ˩ʔ
cạp	kap˨ˀ˩
cạy	kăj˨ˀ˩ʔ
cả	ka˧˩˨
cải	kaj˧˩˨
cảm	kam˧˩˨
cản	kan˧˩˨
cảng	kaŋ˧˩˨
cảnh	kɛŋ˧˩˨
cảo	kaw˧˩˨
cảu	kăw˧˩˨
cảy	kăj˧˩˨
cấc	kɤ̆k˦˥
cấm	kɤ̆m˨˦
cấn	kɤ̆n˨˦
cấp	kɤ̆p˦˥
cất	kɤ̆t˦˥
cấu	kəw˧˥
cấu	kɤ̆w˨˦
cấy	kɤ̆j˨˦
cầm	kəm˧
cầm	kɤ̆m˧˨
cần	kɤ̆n˧˨
cầu	kɤ̆w˧˨
cầy	kɤ̆j˧˨
cẩm	kɤ̆m˧˩˨
cẩn	kɤ̆n˧˩˨
cẩu	kɤ̆w˧˩˨
cậm	kɤ̆m˨ˀ˩ʔ
cận	kɤ̆n˨ˀ˩ʔ
cập	kɤ̆p˨ˀ˩
cật	kɤ̆t˨ˀ˩
cậu	kɤ̆w˨ˀ˩ʔ
cậy	kɤ̆j˨ˀ˩ʔ
cắc	kăk˦˥
cắm	kăm˨˦
cắn	kăn˨˦
cắp	kăp˦˥
cắt	kat˧˥
cắt	kăt˦˥
cằm	kăm˧˨
cằn	kăn˧˨
cẳn	kăn˧˩˨
cẳng	kăŋ˧˩˨
cặc	kăk˨ˀ˩
cặm	kăm˨ˀ˩ʔ
cặn	kăn˨ˀ˩ʔ
cặp	kăp˨ˀ˩
cọ	kɔ˨ˀ˩ʔ
cọc	kɔkp˨ˀ˩
cọm	kɔm˨ˀ˩ʔ
cọp	kɔp˨ˀ˩
cọt	kɔt˨ˀ˩
cỏ	kɔ˧˨
cỏ	kɔ˧˩˨
cỏm	kɔm˧˩˨
cỏn	kɔn˧˩˨
cỏng	kɔŋm˧˩˨
cố	ko˧˥
cố	ko˨˦
cốc	kokp˦˥
cối	koj˧˨
cối	koj˨˦
cốm	kom˨˦
cống	koŋm˨˦
cốp	kop˦˥
cốt	kot˦˥
cồ	ko˧˨
cồm	kom˧˨
cồn	kon˧˨
cồng	koŋm˧˨
cổ	ko˧˨
cổ	ko˧˩˨
cổi	koj˧˩˨
cổn	kon˧˩˨
cổng	koŋm˧˩˨
cỗ	ko˧ˀ˥
cỗi	koj˧ˀ˥
cộc	kokp˨ˀ˩
cội	koj˨ˀ˩ʔ
cộng	koŋm˨ˀ˩ʔ
cột	kot˨ˀ˩
cớ	kɤ˨˦
cớn	kɤn˨˦
cớt	kɤt˦˥
cờ	kɤ˧˨
cời	kɤj˧˨
cờn	kɤn˧˨
cởi	kɤj˧˩˨
cỡn	kɤn˧ˀ˥
cợt	kɤt˨ˀ˩
cụ	ku˨ˀ˩ʔ
cục	kukp˨ˀ˩
cụi	kuj˨ˀ˩ʔ
cụm	kum˨ˀ˩ʔ
cụng	kuŋm˨ˀ˩ʔ
cụp	kup˨ˀ˩
cụt	kut˨ˀ˩
củ	ku˧˩˨
của	kuə˧˩˨
củi	kuj˧˩˨
củng	kuŋm˧˩˨
cứ	kɨ˧˥
cứ	kɯ˨˦
cứa	kɯə˨˦
cức	kɯk˦˥
cứng	kɯŋ˨˦
cứt	kɯt˦˥
cứu	kɯw˨˦
cừ	kɯ˧˨
cừu	kɯw˧˨
cử	kɨ˧˨
cử	kɯ˧˩˨
cửa	kɯə˧˩˨
cửi	kɯj˧˩˨
cửu	kɯw˧˩˨
cự	kɯ˨ˀ˩ʔ
cựa	kɯə˨ˀ˩ʔ
cực	kɯk˨ˀ˩
cựu	kɯw˨ˀ˩ʔ
da	zaː˧
da	za˧˧
dai	zaj˧˧
dan	zan˧˧
dang	zaŋ˧˧
danh	zɛŋ˧˧
dao	zaw˧˧
day	zăj˧˧
de	zɛ˧˧
deo	zeo˧˧
di	zi˧˧
dinh	ziŋ˧˧
diêm	ziəm˧˧
diên	ziən˧˧
diếc	ziək˦˥
diếp	ziəp˦˥
diềm	ziəm˧˨
diều	ziəw˧˨
diễm	ziəm˧ˀ˥
diễn	ziən˧ˀ˥
diễu	ziəw˧ˀ˥
diệc	ziək˨ˀ˩
diệm	ziəm˨ˀ˩ʔ
diện	ziən˨ˀ˩ʔ
diệp	ziəp˨ˀ˩
diệt	ziət˨ˀ˩
diệu	ziəw˨ˀ˩ʔ
do	zɔ˧˧
doanh	zwɛŋ˧˧
doi	zɔj˧˧
dong	zɔŋm˧˧
doạ	zwa˨ˀ˩ʔ
du	zu˧˧
dua	zuə˧˧
dun	zun˧˧
dung	zuŋm˧˧
duy	zwi˧˧
duyên	zwiən˧˧
duyệt	zwiət˨ˀ˩
duật	zwɤ̆t˨ˀ˩
duềnh	zweŋ˧˨
duốc	zuək˦˥
duỗi	zuəj˧ˀ˥
dà	za˧˨
dài	zaj˧˨
dàn	zan˧˨
dàng	zaŋ˧˨
dành	zɛŋ˧˨
dào	zaw˧˨
dàu	zăw˧˨
dày	zăj˧˨
dái	zaj˨˦
dám	zam˨˦
dán	zan˨˦
dáng	zaŋ˨˦
dáo	zaw˨˦
dát	zat˦˥
dáu	zăw˨˦
dâm	zɤ̆m˧˧
dân	zɤ̆n˧˧
dâng	zɤ̆ŋ˧˧
dâu	zɤ̆w˧˧
dây	zɤ̆j˧˧
dã	za˧ˀ˥
dãi	zaj˧ˀ˥
dãn	zan˧ˀ˥
dãy	zăj˧ˀ˥
dè	zɛ˧˨
dèn	zɛn˧˨
dé	zɛ˨˦
dép	zɛp˦˥
dê	ze˧˧
dì	zi˧˨
dìu	ziw˧˨
dí	zi˨˦
dích	zik˦˥
dính	ziŋ˨˦
díp	zip˦˥
díu	ziw˨˦
dò	zɔ˧˨
dòi	zɔj˧˨
dòm	zɔm˧˨
dòng	zɔŋm˧˨
dó	zɔ˨˦
dóc	zɔkp˦˥
dóng	zɔŋm˨˦
dô	zo˧˧
dôi	zoj˧˧
dông	zoŋm˧˧
dõi	zɔj˧ˀ˥
dõng	zɔŋm˧ˀ˥
dù	zu˧˨
dùi	zuj˧˨
dùng	zuŋm˧˨
dúi	zuj˨˦
dúm	zum˨˦
dún	zun˨˦
dúng	zuŋm˨˦
dút	zut˦˥
dăm	zăm˧˧
dăn	zăn˧˧
dăng	zăŋ˧˧
dĩ	zi˧ˀ˥
dĩnh	ziŋ˧ˀ˥
dũ	zu˧ˀ˥
dũng	zuŋm˧ˀ˥
dơ	zɤ˧˧
dơi	zɤj˧˧
dư	zɯ˧˧
dưa	zɯə˧˧
dưng	zɯŋ˧˧
dương	zɯəŋ˧˧
dưới	zɯəj˨˦
dường	zɯəŋ˧˨
dưỡng	zɯəŋ˧ˀ˥
dược	zɯək˨ˀ˩
dạ	za˨ˀ˩ʔ
dạc	zak˨ˀ˩
dại	zaj˨ˀ˩ʔ
dạm	zam˨ˀ˩ʔ
dạn	zan˨ˀ˩ʔ
dạng	zaŋ˨ˀ˩ʔ
dạo	zaw˨ˀ˩ʔ
dạt	zat˧˥
dạt	zat˨ˀ˩
dạy	zăj˨ˀ˩ʔ
dải	zaj˧˩˨
dảy	zăj˧˩˨
dấm	zɤ̆m˨˦
dấn	zɤ̆n˨˦
dấp	zɤ̆p˦˥
dấu	zɤ̆w˨˦
dấy	zɤ̆j˨˦
dầm	zɤ̆m˧˨
dần	zɤ̆n˧˨
dầu	zɤ̆w˧˨
dẫm	zɤ̆m˧ˀ˥
dẫn	zɤ̆n˧ˀ˥
dẫu	zɤ̆w˧ˀ˥
dẫy	zɤ̆j˧ˀ˥
dậm	zɤ̆m˨ˀ˩ʔ
dận	zɤ̆n˨ˀ˩ʔ
dập	zɤ̆p˨ˀ˩
dật	zɤ̆t˨ˀ˩
dậu	zɤ̆w˨ˀ˩ʔ
dậy	zəj˧˥
dậy	zɤ̆j˨ˀ˩ʔ
dắm	zăm˨˦
dắt	zăt˦˥
dằn	zăn˧˨
dằng	zăŋ˧˨
dẳn	zăn˧˩˨
dẳng	zăŋ˧˩˨
dặc	zăk˨ˀ˩
dặm	zăm˨ˀ˩ʔ
dặn	zăn˨ˀ˩ʔ
dặng	zăŋ˨ˀ˩ʔ
dặt	zăt˨ˀ˩
dẹp	zɛp˨ˀ˩
dẹt	zɛt˨ˀ˩
dẻ	zɛ˧˩˨
dẻo	zeo˧˩˨
dẽ	zɛ˧ˀ˥
dế	ze˨˦
dề	ze˧˨
dền	zen˧˨
dềnh	zeŋ˧˨
dể	ze˧˩˨
dễ	ze˧ˀ˥
dệnh	zeŋ˨ˀ˩ʔ
dệt	zet˨ˀ˩
dỉ	zi˧˩˨
dị	zi˨ˀ˩ʔ
dịch	zik˨ˀ˩
dịch	zɪk˧˥
dịp	zip˨ˀ˩
dịu	ziw˨ˀ˩ʔ
dọ	zɔ˨ˀ˩ʔ
dọa	zwa˨ˀ˩ʔ
dọc	zɔkp˨ˀ˩
dọn	zɔn˨ˀ˩ʔ
dốc	zokp˦˥
dối	zoj˨˦
dốt	zot˦˥
dồi	zoj˧˨
dồn	zon˧˨
dồng	zoŋm˧˨
dỗ	zo˧ˀ˥
dội	zoj˨ˀ˩ʔ
dộng	zoŋm˨ˀ˩ʔ
dột	zot˨ˀ˩
dớ	zɤ˨˦
dớn	zɤn˨˦
dời	zɤj˧˨
dờn	zɤn˧˨
dở	zɤ˧˩˨
dỡ	zɤ˧ˀ˥
dụ	zu˧˨
dụ	zu˨ˀ˩ʔ
dục	zukp˨ˀ˩
dụm	zum˨ˀ˩ʔ
dụng	zuŋm˨ˀ˩ʔ
dứa	zɯə˨˦
dức	zɯk˦˥
dứt	zɨt˧˥
dứt	zɯt˦˥
dừ	zɯ˧˨
dừa	zɯə˧˨
dừng	zɯŋ˧˨
dử	zɯ˧˩˨
dửng	zɯŋ˧˩˨
dữ	zɯ˧ˀ˥
dự	zɯ˨ˀ˩ʔ
dựa	zɯə˨ˀ˩ʔ
dựng	zɯŋ˨ˀ˩ʔ
e	ɛ˧˧
em	ɛm˧
em	ɛm˧˧
en	ɛn˧˧
eng	ɛŋ˧˧
eo	eo˧˧
ga	ɣa˧˧
gai	ɣaj˧˧
gan	ɣan˧˧
gang	ɣaŋ˧˧
ganh	ɣɛŋ˧˧
gau	ɣăw˧˧
gay	ɣăj˧˧
ghe	ɣɛ˧˧
ghen	ɣɛn˧˧
ghi	ɣi˧˧
ghim	ɣim˧˧
ghiền	ɣiən˧˨
ghè	ɣɛ˧˨
ghèn	ɣɛn˧˨
ghé	ɣɛ˨˦
ghép	ɣɛp˦˥
ghét	ɣɛt˦˥
ghê	ɣe˧˧
ghẹ	ɣɛ˨ˀ˩ʔ
ghẹo	ɣeo˨ˀ˩ʔ
ghẻ	ɣɛ˧˩˨
ghế	ɣe˨˦
ghểnh	ɣeŋ˧˩˨
gi	zi˧˧
gia	za˧˧
giai	zaj˧˧
giam	zam˧˧
gian	zan˧˧
giang	zaŋ˧˧
giao	zaw˧˧
giau	zăw˧˧
gieo	zeo˧˧
gio	zɔ˧˧
gion	zɔn˧˧
giong	zɔŋm˧˧
giu	zu˧˧
giun	zun˧˧
già	zaː˧
già	za˧˨
giàn	zan˧˨
giàng	zaŋ˧˨
giành	zɛŋ˧˨
giàu	zăw˧˨
giày	zăj˧˨
giá	zaː˧
giá	za˨˦
giác	zak˦˥
giám	zam˨˦
gián	zan˨˦
giáng	zaŋ˨˦
giáo	zaw˨˦
giáp	zap˦˥
giát	zat˦˥
giâu	zɤ̆w˧˧
giây	zɤ̆j˧˧
giã	za˧ˀ˥
giãi	zaj˧ˀ˥
giãn	zan˧ˀ˥
giãy	zăj˧ˀ˥
gièm	zɛm˧˨
giéo	zeo˨˦
giêng	zeŋ˧˧
giò	zɔ˧˨
giòi	zɔj˧˨
giòn	zɔn˧˨
gió	zɔ˧˥
gió	zɔ˨˦
gióng	zɔŋm˨˦
giôn	zon˧˧
giông	zoŋm˧˧
giùi	zuj˧˨
giùm	zum˧˨
giúi	zuj˨˦
giúp	zup˦˥
giúp	zup˧˥
giăm	zăm˧˧
giăng	zăŋ˧˧
giũ	zu˧ˀ˥
giũa	zuə˧ˀ˥
giơ	zɤ˧˧
giương	zɯəŋ˧˧
giường	zɯəŋ˧˨
giạc	zak˨ˀ˩
giạng	zaŋ˨ˀ˩ʔ
giạt	zat˨ˀ˩
giả	za˧˩˨
giải	zaj˧˩˨
giảm	zam˧˩˨
giản	zan˧˩˨
giảng	zaŋ˧˩˨
giảo	zaw˧˩˨
giảu	zăw˧˩˨
giấc	zək˧˥
giấc	zɤ̆k˦˥
giấm	zɤ̆m˨˦
giấn	zɤ̆n˨˦
giấp	zɤ̆p˦˥
giấu	zɤ̆w˨˦
giấy	zɤ̆j˨˦
giầm	zɤ̆m˧˨
giần	zɤ̆n˧˨
giầu	zɤ̆w˧˨
giầy	zɤ̆j˧˨
giẫm	zɤ̆m˧ˀ˥
giẫy	zɤ̆j˧ˀ˥
giậm	zɤ̆m˨ˀ˩ʔ
giận	zɤ̆n˨ˀ˩ʔ
giập	zɤ̆p˨ˀ˩
giật	zət˧˥
giật	zɤ̆t˨ˀ˩
giậu	zɤ̆w˨ˀ˩ʔ
giắm	zăm˨˦
giắng	zăŋ˨˦
giắt	zăt˦˥
giằn	zăn˧˨
giằng	zăŋ˧˨
giặc	zăk˨ˀ˩
giặt	zăt˨ˀ˩
giẹo	zeo˨ˀ˩ʔ
giẹp	zɛp˨ˀ˩
giẻ	zɛ˧˩˨
giếc	zek˦˥
giếng	zeŋ˨˦
giết	zet˦˥
giền	zen˧˨
giềng	zeŋ˧˨
giễu	zɛu˧ˀ˥
giọng	zɔŋm˨ˀ˩ʔ
giọt	zɔt˨ˀ˩
giỏ	zɔ˧˩˨
giỏi	zɔj˧˩˨
giỏng	zɔŋm˧˩˨
giối	zoj˨˦
giống	zoŋm˨˦
giồi	zoj˧˨
giồng	zoŋm˧˨
giỗ	zo˧ˀ˥
giội	zoj˨ˀ˩ʔ
giới	zɤj˨˦
giờ	zɤ˧˨
giời	zɤj˧˨
giở	zɤ˧˩˨
giục	zukp˨ˀ˩
giữ	zɯ˧ˀ˥
giữa	zɯə˧ˀ˥
gom	ɣɔm˧˧
goá	ɣwa˨˦
goòng	ɣɔŋm˧˨
guốc	ɣuək˦˥
guồng	ɣuəŋ˧˨
guột	ɣuət˨ˀ˩
gà	ɣa˧˨
gài	ɣaj˧˨
gàn	ɣan˧˨
gào	ɣaw˧˨
gàu	ɣăw˧˨
gày	ɣăj˧˨
gá	ɣa˨˦
gác	ɣak˦˥
gái	ɣaj˨˦
gán	ɣan˨˦
gánh	ɣɛŋ˨˦
gáo	ɣaw˨˦
gáy	ɣăj˨˦
gâm	ɣɤ̆m˧˧
gân	ɣɤ̆n˧˧
gâu	ɣɤ̆w˧˧
gây	ɣɤ̆j˧˧
gãi	ɣaj˧ˀ˥
gãy	ɣăj˧ˀ˥
gì	ɣi˧˨
gìn	zin˧˨
gò	ɣɔ˧˨
gòn	ɣɔn˧˨
gòn-gia	ɣɔn˧˨-za˧˧
góa	ɣwa˨˦
góc	ɣɔkp˦˥
gói	ɣɔj˨˦
góp	ɣɔp˦˥
gót	ɣɔt˦˥
gô	ɣo˧˧
gôm	ɣom˧˧
gông	ɣoŋm˧˧
gõ	ɣɔ˧ˀ˥
gùn	ɣun˧˨
gút	ɣut˦˥
găm	ɣăm˧˧
găn	ɣăn˧˧
găng	ɣăŋ˧˧
gươm	ɣɯəm˧˧
gương	ɣɯəŋ˧˧
gườm	ɣɯəm˧˨
gường	ɣɯəŋ˧˨
gượng	ɣɯəŋ˨ˀ˩ʔ
gạ	ɣa˨ˀ˩ʔ
gạc	ɣak˨ˀ˩
gạch	ɣɛk˨ˀ˩
gạn	ɣan˨ˀ˩ʔ
gạo	ɣaw˨ˀ˩ʔ
gạt	ɣat˨ˀ˩
gả	ɣa˧˩˨
gảy	ɣăj˧˩˨
gấm	ɣɤ̆m˨˦
gấp	ɣɤ̆p˦˥
gấu	ɣɤ̆w˨˦
gấy	ɣɤ̆j˨˦
gầm	ɣɤ̆m˧˨
gần	ɣɤ̆n˧˨
gầu	ɣɤ̆w˧˨
gầy	ɣɤ̆j˧˨
gẩy	ɣɤ̆j˧˩˨
gẫu	ɣɤ̆w˧ˀ˥
gẫy	ɣɤ̆j˧ˀ˥
gậm	ɣɤ̆m˨ˀ˩ʔ
gập	ɣɤ̆p˨ˀ˩
gật	ɣɤ̆t˨ˀ˩
gậy	ɣɤ̆j˨ˀ˩ʔ
gắm	ɣăm˨˦
gắn	ɣăn˨˦
gắng	ɣăŋ˨˦
gắp	ɣăp˦˥
gắt	ɣăt˦˥
gằm	ɣăm˧˨
gằn	ɣăn˧˨
gặc	ɣăk˨ˀ˩
gặm	ɣăm˨ˀ˩ʔ
gặng	ɣăŋ˨ˀ˩ʔ
gặp	ɣăp˨ˀ˩
gặt	ɣăt˨ˀ˩
gỉ	ɣi˧˩˨
gọ	ɣɔ˨ˀ˩ʔ
gọi	ɣɔj˨ˀ˩ʔ
gọn	ɣɔn˨ˀ˩ʔ
gọng	ɣɔŋm˨ˀ˩ʔ
gọt	ɣɔt˨ˀ˩
gỏi	ɣɔj˧˩˨
gốc	ɣokp˦˥
gối	ɣoj˨˦
gồ	ɣo˧˨
gồng	ɣoŋm˧˨
gỗ	ɣo˧ˀ˥
gội	ɣoj˨ˀ˩ʔ
gộp	ɣop˨ˀ˩
gột	ɣot˨ˀ˩
gớm	ɣɤm˨˦
gờ	ɣɤ˧˨
gờm	ɣɤm˧˨
gờn	ɣɤn˧˨
gở	ɣɤ˧˩˨
gởi	ɣɤj˧˩˨
gỡ	ɣɤ˧ˀ˥
gợi	ɣɤj˨ˀ˩ʔ
gợn	ɣɤn˨ˀ˩ʔ
gục	ɣukp˨ˀ˩
gừ	ɣɯ˧˨
gừng	ɣɯŋ˧˨
gửi	ɣɯj˧˩˨
ha	ha˧˧
hai	haj˧˧
ham	ham˧˧
han	han˧˧
hang	haŋ˧˧
hanh	hɛŋ˧˧
hao	haw˧˧
hau	hăw˧˧
hay	hăj˧˧
hen	hɛn˧˧
heo	heo˧˧
hi	hi˧˧
him	him˧˧
hinh	hiŋ˧˧
hiu	hiw˧˧
hiên	hiən˧˧
hiêng	hiəŋ˧˧
hiếm	hiəm˨˦
hiến	hiən˨˦
hiếp	hiəp˦˥
hiếu	hiəw˨˦
hiềm	hiəm˧˨
hiền	hiən˧˨
hiểm	hiəm˧˩˨
hiển	hiən˧˩˨
hiểu	hiəw˧˩˨
hiện	hiən˨ˀ˩ʔ
hiệp	hiəp˨ˀ˩
hiệu	hiəw˨ˀ˩ʔ
ho	hɔ˧˧
hoa	hwa˧˧
hoan	hwan˧˧
hoang	hwaŋ˧˧
hoay	hwăj˧˧
hoe	hwe˧˧
hoen	hwen˧˧
hoi	hɔj˧˧
hom	hɔm˧˧
hon	hɔn˧˧
hong	hɔŋm˧˧
hoà	hwa˧˨
hoài	hwaj˧˨
hoàn	hwan˧˨
hoàng	hwaŋ˧˨
hoành	hwɛŋ˧˨
hoá	hwa˨˦
hoác	hwak˦˥
hoán	hwan˨˦
hoãn	hwan˧ˀ˥
hoè	hwe˧˨
hoăm	hwăm˧˧
hoăng	hwăŋ˧˧
hoạ	hwa˨ˀ˩ʔ
hoạch	hwɛk˨ˀ˩
hoại	hwaj˨ˀ˩ʔ
hoạn	hwan˨ˀ˩ʔ
hoạnh	hwɛŋ˨ˀ˩ʔ
hoạt	hwat˨ˀ˩
hoả	hwa˧˩˨
hoải	hwaj˧˩˨
hoảng	hwaŋ˧˩˨
hoắc	hwăk˦˥
hoắm	hwăm˨˦
hoặc	hwăk˨ˀ˩
hoặc	hɔk˧˥
hoặn	hwăn˨ˀ˩ʔ
hu	hu˧˧
hui	huj˧˧
hum	hum˧˧
hun	hun˧˧
hung	huŋm˧˧
huy	hwi˧˧
huynh	hwiŋ˧˧
huyên	hwiən˧˧
huyết	hwiət˦˥
huyền	hwiən˧˨
huyễn	hwiən˧ˀ˥
huyện	hwiən˨ˀ˩ʔ
huyệt	hwiət˨ˀ˩
huân	hwɤ̆n˧˧
huê	hwe˧˧
huênh	hweŋ˧˧
huý	hwi˨˦
huých	hwik˦˥
huýt	hwit˦˥
huơ	huə˧˧
huấn	hwɤ̆n˨˦
huếch	hwek˦˥
huề	hwe˧˨
huệ	hwe˨ˀ˩ʔ
huống	huəŋ˨˦
huỳnh	hwiŋ˧˨
huỵch	hwik˨ˀ˩
huỷ	hwi˧˩˨
hy	hi˧˧
hà	haː˧˨
hà	ha˧˨
hà-đông	ha˧˨-doŋm˧˧
hài	haj˧˨
hàm	ham˧˨
hàn	han˧˨
hàng	haŋ˧˨
hàng	haːŋ˧
hành	hɛŋ˧˨
hào	haw˧˨
há	ha˨˦
hách	hɛk˦˥
hái	haj˨˦
hám	ham˨˦
hán	han˨˦
hánh	hɛŋ˨˦
háo	haw˨˦
hát	hat˦˥
háu	hăw˨˦
háy	hăj˨˦
hâm	hɤ̆m˧˧
hân	hɤ̆n˧˧
hây	hɤ̆j˧˧
hãi	haj˧ˀ˥
hãm	ham˧ˀ˥
hãn	han˧ˀ˥
hãng	haŋ˧ˀ˥
hãnh	hɛŋ˧ˀ˥
hão	haw˧ˀ˥
hãy	hăj˧ˀ˥
hè	hɛ˧˨
hèm	hɛm˧˨
hèn	hɛn˧˨
hèo	heo˧˨
hé	hɛ˨˦
héc	hɛk˦˥
héo	heo˨˦
hét	hɛt˦˥
hên	hen˧˧
hênh	heŋ˧˧
hì	hi˧˨
hình	hiŋ˧˨
hí	hi˨˦
híp	hip˦˥
hít	hit˦˥
hò	hɔ˧˨
hòa	hwa˧˨
hòm	hɔm˧˨
hòn	hɔn˧˨
hòng	hɔŋm˧˨
hó	hɔ˨˦
hóa	hwa˨˦
hóc	hɔkp˦˥
hói	hɔj˨˦
hóm	hɔm˨˦
hóng	hɔŋm˨˦
hóp	hɔp˦˥
hót	hɔt˦˥
hô	ho˧˧
hôi	hoj˧˧
hôm	hom˧˧
hôn	hon˧˧
hông	hoŋm˧˧
hù	hu˧˨
hùi	huj˧˨
hùm	hum˧˨
hùn	hun˧˨
hùng	huŋm˧˨
hú	hu˨˦
húc	hukp˦˥
húng	huŋm˨˦
húp	hup˦˥
hút	hut˦˥
húy	huj˨˦
hăm	hăm˧˧
hăng	hăŋ˧˧
hũ	hu˧ˀ˥
hũ	hu˧˨
hơ	hɤ˧˧
hơi	hɤj˧˧
hơn	hɤn˧˧
hư	hɯ˧˧
hưng	hɯŋ˧˧
hưu	hɯw˧˧
hương	hɯəŋ˧˧
hươu	hɯəw˧˧
hướng	hɯəŋ˨˦
hưởng	hɯəŋ˧˩˨
hạ	ha˨ˀ˩ʔ
hạc	hak˨ˀ˩
hạch	hɛk˨ˀ˩
hại	haj˨ˀ˩ʔ
hạm	ham˨ˀ˩ʔ
hạn	han˨ˀ˩ʔ
hạng	haŋ˨ˀ˩ʔ
hạnh	hɛŋ˨ˀ˩ʔ
hạo	haw˨ˀ˩ʔ
hạp	hap˨ˀ˩
hạt	hat˨ˀ˩
hả	ha˧˩˨
hải	haj˧˩˨
hảo	haw˧˩˨
hấm	hɤ̆m˨˦
hấn	hɤ̆n˨˦
hấp	hɤ̆p˦˥
hất	hɤ̆t˦˥
hầm	hɤ̆m˧˨
hầu	hɤ̆w˧˨
hẩm	hɤ̆m˧˩˨
hẩu	hɤ̆w˧˩˨
hẫng	hɤ̆ŋ˧ˀ˥
hậm	hɤ̆m˨ˀ˩ʔ
hận	hɤ̆n˨ˀ˩ʔ
hậu	hɤ̆w˨ˀ˩ʔ
hắc	hăk˦˥
hắn	hăn˨˦
hắng	hăŋ˨˦
hắt	hăt˦˥
hằm	hăm˧˨
hằn	hăn˧˨
hằng	hăŋ˧˨
hẳn	hăn˧˩˨
hặc	hăk˨ˀ˩
hặm	hăm˨ˀ˩ʔ
hẹn	hɛn˨ˀ˩ʔ
hẹp	hɛp˨ˀ˩
hẻm	hɛm˧˩˨
hẻo	heo˧˩˨
hếch	hek˦˥
hết	het˦˥
hề	he˧
hề	he˧˨
hềnh	heŋ˧˨
hể	he˧˩˨
hểnh	heŋ˧˩˨
hểu	hɛu˧˩˨
hệ	he˨ˀ˩ʔ
hệch	hek˨ˀ˩
hỉ	hi˧˩˨
hỉnh	hiŋ˧˩˨
hịch	hik˨ˀ˩
họ	hɔ˨ˀ˩ʔ
họa	hwa˨ˀ˩ʔ
học	hɔkp˨ˀ˩
họng	hɔŋm˨ˀ˩ʔ
họp	hɔp˨ˀ˩
hỏa	hwa˧˩˨
hỏi	hɔj˧˩˨
hỏm	hɔm˧˩˨
hỏn	hɔn˧˩˨
hỏng	hɔŋm˧˩˨
hố	ho˨˦
hốc	hokp˦˥
hối	hoj˨˦
hống	hoŋm˨˦
hốt	hot˦˥
hồ	ho˧˨
hồ	hɔ˧
hồi	hoj˧˨
hồn	hon˧˨
hồng	hoŋm˧˨
hổ	ho˧˩˨
hổi	hoj˧˩˨
hổm	hom˧˩˨
hổn	hon˧˩˨
hổng	hoŋm˧˩˨
hỗ	ho˧ˀ˥
hỗn	hon˧ˀ˥
hỗng	hoŋm˧ˀ˥
hộ	ho˨ˀ˩ʔ
hộc	hokp˨ˀ˩
hội	hoj˨ˀ˩ʔ
hộn	hon˨ˀ˩ʔ
hộp	hop˨ˀ˩
hột	hot˨ˀ˩
hớ	hɤ˨˦
hớn	hɤn˨˦
hớp	hɤp˦˥
hớt	hɤt˦˥
hờ	hɤ˧˨
hời	hɤj˧˨
hờn	hɤn˧˨
hở	hɤ˧˩˨
hởi	hɤj˧˩˨
hỡi	hɤj˧ˀ˥
hợm	hɤm˨ˀ˩ʔ
hợp	hɤp˨ˀ˩
hục	hukp˨ˀ˩
hụp	hup˨ˀ˩
hụt	hut˨ˀ˩
hủ	hu˧˩˨
hủn	hun˧˩˨
hủng	huŋm˧˩˨
hủy	huj˧˩˨
hứa	hɯə˨˦
hứng	hɯŋ˨˦
hừ	hɯ˧˨
hừng	hɯŋ˧˨
hửng	hɯŋ˧˩˨
hững	hɯŋ˧ˀ˥
hữu	hɯw˧ˀ˥
hực	hɯk˨ˀ˩
i	i˧˧
i-ôn	i˧˧-on˧˧
ic	ik˧˧
im	im˧˧
in	in˧
in	in˧˧
inh	iŋ˧˧
iu	iw˧˧
ka	ka˧˧
ka-li	ka˧˧-li˧˧
ke	kɛ˧˧
kem	kɛm˧˧
ken	kɛn˧˧
keng	kɛŋ˧˧
keo	keo˧˧
kha	xa˧˧
khai	xaj˧˧
kham	xam˧˧
khan	xan˧˧
khang	xaŋ˧˧
khanh	xɛŋ˧˧
khao	xaw˧˧
khay	xăj˧˧
khe	xɛ˧˧
khem	xɛm˧˧
khen	xɛn˧˧
kheo	xeo˧˧
khi	xi˧
khi	xi˧˧
khin	xin˧˧
khinh	xiŋ˧˧
khiêm	xiəm˧˧
khiên	xiən˧˧
khiêng	xiəŋ˧˧
khiêu	xiəw˧˧
khiếm	xiəm˨˦
khiếp	xiəp˦˥
khiếu	xiəw˨˦
khiển	xiən˧˩˨
kho	xɔ˧˧
khoa	xwa˧˧
khoai	xwaj˧˧
khoan	xwan˧˧
khoang	xwaŋ˧˧
khoanh	xwɛŋ˧˧
khoe	xwe˧˧
khoen	xwen˧˧
khoeo	xwew˧˧
khom	xɔm˧˧
khoành	xwɛŋ˧˨
khoá	xwa˨˦
khoác	xwak˦˥
khoái	xwaj˨˦
khoán	xwan˨˦
khoáng	xwaŋ˨˦
khoát	xwat˦˥
khoèo	xwew˧˨
khoé	xwe˨˦
khoét	xwet˦˥
khoăm	xwăm˧˧
khoả	xwa˧˩˨
khoản	xwan˧˩˨
khoảng	xwaŋ˧˩˨
khoảnh	xwɛŋ˧˩˨
khoằm	xwăm˧˨
khoẻ	xwe˧˩˨
khu	xu˧˧
khua	xuə˧˧
khum	xum˧˧
khung	xuŋm˧˧
khuy	xwi˧˧
khuya	xwiə˧˧
khuynh	xwiŋ˧˧
khuyên	xwiən˧˧
khuyến	xwiən˨˦
khuyết	xwiət˦˥
khuyển	xwiən˧˩˨
khuân	xwɤ̆n˧˧
khuây	xwɤ̆j˧˧
khuê	xwe˧˧
khuôn	xuən˧˧
khuông	xuəŋ˧˧
khuất	xwɤ̆t˦˥
khuấy	xwɤ̆j˨˦
khuẩn	xwɤ̆n˧˩˨
khuếch	xwek˦˥
khuờ	xuə˧˨
khuỳnh	xwiŋ˧˨
khyển	xiɛn˧˩˨
khà	xa˧˨
khàn	xan˧˨
khành	xɛŋ˧˨
khá	xa˨˦
khác	xak˦˥
khác	xak˧˥
khách	xɛk˦˥
khái	xaj˨˦
khám	xam˨˦
khán	xan˨˦
kháng	xaŋ˨˦
khánh	xɛŋ˨˦
khánh-hạ	xɛŋ˨˦-ha˨ˀ˩ʔ
khát	xat˦˥
kháu	xăw˨˦
khâm	xɤ̆m˧˧
khâng	xɤ̆ŋ˧˧
khâu	xɤ̆w˧˧
khè	xɛ˧˨
khèn	xɛn˧˨
khèng	xɛŋ˧˨
khé	xɛ˨˦
khéo	xeo˨˦
khép	xɛp˦˥
khét	xɛt˦˥
khê	xe˧˧
khêu	xɛu˧˧
khì	xi˧˨
khìn	xin˧˨
khí	xi˨˦
khía	xiə˨˦
khích	xik˦˥
khít	xit˦˥
khò	xɔ˧˨
khòe	xwe˧˨
khòm	xɔm˧˨
khòng	xɔŋm˧˨
khó	xɔ˧˥
khó	xɔ˨˦
khóa	xwa˨˦
khóc	xɔkp˦˥
khóe	xwe˨˦
khói	xɔj˨˦
khô	xo˧˧
khôi	xoj˧˧
khôn	xon˧˧
không	xoŋm˧˧
khù	xu˧˨
khùng	xuŋm˧˨
khú	xu˨˦
khúc	xukp˦˥
khúm	xum˨˦
khúng	xuŋm˨˦
khăm	xăm˧˧
khăn	xăn˧˧
khăng	xăŋ˧˧
khơ	xɤ˧˧
khơ-me	xɤ˧˧-mɛ˧˧
khơ-mú	xɤ˧˧-mu˨˦
khơi	xɤj˧˧
khư	xɯ˧˧
khươm	xɯəm˧˧
khước	xɯək˦˥
khướt	xɯət˦˥
khướu	xɯəw˨˦
khạ	xa˨ˀ˩ʔ
khạc	xak˨ˀ˩
khạng	xaŋ˨ˀ˩ʔ
khả	xa˧˩˨
khảch	xɛk˧˩˨
khải	xaj˧˩˨
khảm	xam˧˩˨
khản	xan˧˩˨
khảng	xaŋ˧˩˨
khảnh	xɛŋ˧˩˨
khảo	xaw˧˩˨
khấm	xɤ̆m˨˦
khấn	xɤ̆n˨˦
khấp	xɤ̆p˦˥
khất	xɤ̆t˦˥
khấu	xɤ̆w˨˦
khầng	xɤ̆ŋ˧˨
khẩn	xɤ̆n˧˩˨
khẩu	xɤ̆w˧˩˨
khậm	xɤ̆m˨ˀ˩ʔ
khập	xɤ̆p˨ˀ˩
khật	xɤ̆t˨ˀ˩
khắc	xăk˦˥
khắm	xăm˨˦
khắn	xăn˨˦
khắng	xăŋ˨˦
khắp	xăp˦˥
khắt	xăt˦˥
khằng	xăŋ˧˨
khẳn	xăn˧˩˨
khẳng	xăŋ˧˩˨
khặc	xăk˨ˀ˩
khẻ	xɛ˧˩˨
khẽ	xɛ˧ˀ˥
khế	xe˨˦
khề	xe˧˨
khềnh	xeŋ˧˨
khều	xɛu˧˨
khểnh	xeŋ˧˩˨
khễnh	xeŋ˧ˀ˥
khệ	xe˨ˀ˩ʔ
khệnh	xeŋ˨ˀ˩ʔ
khỉ	xi˧˩˨
khịt	xit˨ˀ˩
khọm	xɔm˨ˀ˩ʔ
khỏa	xwa˧˩˨
khỏe	xwe˧˩˨
khỏi	xɔj˧˩˨
khố	xo˨˦
khốc	xokp˦˥
khối	xoj˨˦
khốn	xon˨˦
khống	xoŋm˨˦
khổ	xo˧˩˨
khổn	xon˧˩˨
khổng	xoŋm˧˩˨
khớp	xɤp˦˥
khờ	xɤ˧˨
khởi	xɤj˧˩˨
khụ	xu˨ˀ˩ʔ
khục	xukp˨ˀ˩
khụng	xuŋm˨ˀ˩ʔ
khụt	xut˨ˀ˩
khủ	xu˧˩˨
khủng	xuŋm˧˩˨
khứ	xɯ˨˦
khứu	xɯw˨˦
khừ	xɯ˧˨
khử	xɯ˧˩˨
khự	xɯ˨ˀ˩ʔ
ki	ki˧˧
ki-lô	ki˧˧-lo˧˧
ki-lô-oát	ki˧˧-lo˧˧-wat˦˥
ki-tô	ki˧˧-to˧˧
kia	kiə˧˧
kim	kim˧˧
kin	kin˧˧
kinh	kiŋ˧˧
kiêm	kiəm˧˧
kiên	kiən˧˧
kiêng	kiəŋ˧˧
kiêu	kiəw˧˧
kiếm	kiəm˨˦
kiến	kiən˨˦
kiếp	kiəp˦˥
kiết	kiət˦˥
kiếu	kiəw˨˦
kiềm	kiəm˧˨
kiền	kiən˧˨
kiềng	kiəŋ˧˨
kiều	kiəw˧˨
kiểm	kiəm˧˩˨
kiểu	kiəw˧˩˨
kiệm	kiəm˨ˀ˩ʔ
kiện	kiən˨ˀ˩ʔ
kiệt	kiət˨ˀ˩
kiệu	kiəw˨ˀ˩ʔ
ky	ki˧˧
kè	kɛ˧˨
kèm	kɛm˧˨
kèn	kɛn˧˨
kèo	keo˧˨
ké	kɛ˨˦
kém	kɛm˨˦
kén	kɛn˨˦
kéo	keo˨˦
kép	kɛp˦˥
két	kɛt˦˥
kê	ke˧˧
kên	ken˧˧
kênh	keŋ˧˧
kêu	kɛu˧˧
kì	ki˧˨
kìa	kiə˧˨
kìm	kim˧˨
kìn	kin˧˨
kình	kiŋ˧˨
kí	ki˨˦
kích	kik˦˥
kín	kin˨˦
kính	kiŋ˨˦
kíp	kip˦˥
kíu	kiw˨˦
ký	ki˧˥
ký	ki˨˦
kĩ	ki˧ˀ˥
kĩu	kiw˧ˀ˥
kẹn	kɛn˨ˀ˩ʔ
kẹo	keo˨ˀ˩ʔ
kẹp	kɛp˨ˀ˩
kẹt	kɛt˨ˀ˩
kẻ	kɛ˧˩˨
kẻm	kɛm˧˩˨
kẻo	keo˧˩˨
kẽ	kɛ˧ˀ˥
kẽm	kɛm˧ˀ˥
kẽo	keo˧ˀ˥
kế	ke˨˦
kếch	kek˦˥
kết	ket˦˥
kề	ke˧˨
kềm	kem˧˨
kền	ken˧˨
kềnh	keŋ˧˨
kể	ke˧˩˨
kễnh	keŋ˧ˀ˥
kệ	ke˨ˀ˩ʔ
kệch	kek˨ˀ˩
kỉ	ki˧˩˨
kị	ki˨ˀ˩ʔ
kịch	kik˨ˀ˩
kịp	kip˨ˀ˩
kỳ	ki˧˨
kỵ	ki˨ˀ˩ʔ
kỷ	ki˧˩˨
kỹ	ki˧ˀ˥
la	la˧˧
la-mã	la˧˧-ma˧ˀ˥
la-tinh	la˧˧-tiŋ˧˧
la-tê-rít	la˧˧-te˧˧-zit˦˥
lai	laj˧˧
lai-ly	laj˧˧-li˧˧
lai-đa	laj˧˧-da˧˧
lam	lam˧˧
lan	lan˧˧
lang	laŋ˧˧
lanh	lɛŋ˧˧
lao	law˧˧
lao	laːw˧
lau	lăw˧˧
lay	lăj˧˧
le	lɛ˧˧
lem	lɛm˧˧
len	lɛn˧˧
leng	lɛŋ˧˧
leo	leo˧˧
li	li˧˧
lia	liə˧˧
lim	lim˧˧
linh	liŋ˧
linh	liŋ˧˧
liu	liw˧˧
liêm	liəm˧˧
liên	liən˧˧
liêng	liəŋ˧˧
liêu	liəw˧˧
liếc	liək˦˥
liếm	liəm˨˦
liến	liən˨˦
liếp	liəp˦˥
liếu	liəw˨˦
liềm	liəm˧˨
liền	liən˧˨
liều	liəw˧˨
liểng	liəŋ˧˩˨
liễu	liəw˧ˀ˥
liệm	liəm˨ˀ˩ʔ
liệt	liət˨ˀ˩
liệu	liəw˨ˀ˩ʔ
lo	lɔ˧
lo	lɔ˧˧
loa	lwa˧˧
loai	lwaj˧˧
loan	lwan˧˧
loang	lwaŋ˧˧
loanh	lwɛŋ˧˧
loay	lwăj˧˧
loe	lwe˧˧
loen	lwen˧˧
loi	lɔj˧˧
lom	lɔm˧˧
lon	lɔn˧˧
long	lɔŋm˧˧
loong	lɔŋm˧˧
loà	lwa˧˨
loài	lwaj˧˨
loàng	lwaŋ˧˨
loá	lwa˨˦
loáng	lwaŋ˨˦
loáo	lwaw˨˦
loát	lwat˦˥
loáy	lwăj˨˦
loã	lwa˧ˀ˥
loãng	lwaŋ˧ˀ˥
loè	lwe˧˨
loé	lwe˨˦
loét	lwet˦˥
loăn	lwăn˧˧
loăng	lwăŋ˧˧
loạc	lwak˨ˀ˩
loạch	lwɛk˨ˀ˩
loại	lwaj˨ˀ˩ʔ
loạn	lwan˨ˀ˩ʔ
loạng	lwaŋ˨ˀ˩ʔ
loạt	lwat˨ˀ˩
loả	lwa˧˩˨
loảng	lwaŋ˧˩˨
loắn	lwăn˨˦
loắt	lwăt˦˥
loằn	lwăn˧˨
loằng	lwăŋ˧˨
loẹt	lwet˨ˀ˩
loẻng	lweŋ˧˩˨
loẻo	lwew˧˩˨
lu	lu˧˧
lua	luə˧˧
lui	luj˧˧
lum	lum˧˧
lung	luŋm˧˧
luy	lwi˧˧
luyên	lwiən˧˧
luyến	lwiən˨˦
luyện	lwiən˨ˀ˩ʔ
luân	lwɤ̆n˧˧
luôm	luəm˧˧
luôn	luən˧˧
luông	luəŋ˧˧
luýnh	lwiŋ˨˦
luấn	lwɤ̆n˨˦
luẩn	lwɤ̆n˧˩˨
luận	lwɤ̆n˨ˀ˩ʔ
luật	lwɤ̆t˨ˀ˩
luống	luəŋ˨˦
luốt	luət˦˥
luồn	luən˧˨
luồng	luəŋ˧˨
luộm	luəm˨ˀ˩ʔ
luỵ	lwi˨ˀ˩ʔ
luỹ	lwi˧ˀ˥
ly	li˧˧
là	laː˧˨
là	la˧˨
lài	laj˧˨
làm	lam˧˨
làn	lan˧˨
làng	laŋ˧˨
lành	lɛŋ˧˨
lào	law˧˨
làu	lăw˧˨
lày	lăj˧˨
lá	la˨˦
lác	lak˦˥
lách	lɛk˦˥
lái	laj˨˦
lán	lan˨˦
láng	laŋ˨˦
lánh	lɛŋ˨˦
láo	law˨˦
láp	lap˦˥
lát	lat˦˥
láu	lăw˨˦
láy	lăj˨˦
lâm	lɤ̆m˧˧
lân	lɤ̆n˧˧
lâng	lɤ̆ŋ˧˧
lâp	lɤ̆p˧˧
lâu	lɤ̆w˧˧
lây	lɤ̆j˧˧
lã	la˧ˀ˥
lãi	laj˧ˀ˥
lãm	lam˧ˀ˥
lãn	lan˧ˀ˥
lãng	laŋ˧ˀ˥
lãnh	lɛŋ˧ˀ˥
lão	law˧ˀ˥
lè	lɛ˧˨
lèm	lɛm˧˨
lèn	lɛn˧˨
lèo	leo˧˨
lé	lɛ˨˦
lém	lɛm˨˦
lén	lɛn˨˦
léng	lɛŋ˨˦
léo	leo˨˦
lép	lɛp˦˥
lét	lɛt˦˥
lê	le˧˧
lên	len˧˧
lênh	leŋ˧˧
lêu	lɛu˧˧
lì	li˧˨
lìa	liə˧˨
lìm	lim˧˨
lình	liŋ˧˨
lí	li˨˦
lích	lik˦˥
lính	liŋ˨˦
líp	lip˦˥
lít	lit˦˥
líu	liw˨˦
lò	lɔ˧˨
lòa	lwa˧˨
lòe	lwe˧˨
lòi	lɔj˧˨
lòm	lɔm˧˨
lòn	lɔn˧˨
lòng	lɔŋm˧˨
ló	lɔ˨˦
lóc	lɔkp˦˥
lóm	lɔm˨˦
lóng	lɔŋm˨˦
lóp	lɔp˦˥
lót	lɔt˦˥
lô	lo˧˧
lô-gích	lo˧˧-ɣik˦˥
lôi	loj˧˧
lôm	lom˧˧
lông	loŋm˧˧
lõ	lɔ˧ˀ˥
lõa	lwa˧ˀ˥
lõi	lɔj˧ˀ˥
lõm	lɔm˧ˀ˥
lõng	lɔŋm˧ˀ˥
lù	lu˧˨
lùi	luj˧˨
lùm	lum˧˨
lùn	lun˧˨
lùng	luŋm˧˨
lú	lu˨˦
lúa	luə˨˦
lúc	lukp˦˥
lúi	luj˨˦
lúm	lum˨˦
lún	lun˨˦
lúng	luŋm˨˦
lúp	lup˦˥
lút	lut˦˥
lý	li˨˦
lăm	lăm˧˧
lăn	lăn˧˧
lăng	lăŋ˧˧
lĩnh	liŋ˧ˀ˥
lũ	lu˧ˀ˥
lũ	lu˧˨
lũm	lum˧ˀ˥
lũn	lun˧ˀ˥
lũng	luŋm˧ˀ˥
lũy	luj˧ˀ˥
lơ	lɤ˧˧
lơi	lɤj˧˧
lơn	lɤn˧˧
lư	lɯ˧˧
lưa	lɯə˧˧
lưng	lɯŋ˧˧
lưu	lɯw˧˧
lươm	lɯəm˧˧
lươn	lɯən˧˧
lương	lɯəŋ˧˧
lưới	lɯəj˨˦
lướng	lɯəŋ˨˦
lướp	lɯəp˦˥
lướt	lɯət˦˥
lướu	lɯəw˨˦
lười	lɯəj˧˨
lườm	lɯəm˧˨
lường	lɯəŋ˧˨
lưởi	lɯəj˧˩˨
lưỡi	lɯəj˧ˀ˥
lưỡng	lɯəŋ˧ˀ˥
lược	lɯək˨ˀ˩
lượm	lɯəm˨ˀ˩ʔ
lượn	lɯən˨ˀ˩ʔ
lượng	lɯəŋ˨ˀ˩ʔ
lượt	lɯət˨ˀ˩
lạ	laː˧˨
lạ	la˨ˀ˩ʔ
lạc	lak˨ˀ˩
lạch	lɛk˨ˀ˩
lại	laj˨ˀ˩ʔ
lạm	lam˨ˀ˩ʔ
lạng	laŋ˨ˀ˩ʔ
lạnh	lɛŋ˨ˀ˩ʔ
lạo	law˨ˀ˩ʔ
lạp	lap˨ˀ˩
lạt	lat˧˥
lạt	lat˨ˀ˩
lạu	lăw˨ˀ˩ʔ
lạy	lăj˨ˀ˩ʔ
lả	la˧˩˨
lải	laj˧˩˨
lảm	lam˧˩˨
lảng	laŋ˧˩˨
lảnh	lɛŋ˧˩˨
lảo	law˧˩˨
lảu	lăw˧˩˨
lảy	lăj˧˩˨
lấc	lɤ̆k˦˥
lấm	lɤ̆m˨˦
lấn	lɤ̆n˨˦
lấp	lɤ̆p˦˥
lất	lɤ̆t˦˥
lấu	lɤ̆w˨˦
lấy	lɤ̆j˨˦
lầm	lɤ̆m˧˨
lần	lɤ̆n˧˨
lầu	lɤ̆w˧˨
lầy	lɤ̆j˧˨
lẩm	lɤ̆m˧˩˨
lẩn	lɤ̆n˧˩˨
lẩu	lɤ̆w˧˩˨
lẩy	lɤ̆j˧˩˨
lẫm	lɤ̆m˧ˀ˥
lẫn	lɤ̆n˧ˀ˥
lẫy	lɤ̆j˧ˀ˥
lận	lɤ̆n˨ˀ˩ʔ
lập	lɤ̆p˨ˀ˩
lật	lɤ̆t˨ˀ˩
lậu	lɤ̆w˨ˀ˩ʔ
lậy	lɤ̆j˨ˀ˩ʔ
lắc	lăk˦˥
lắc	lăk˧˥
lắm	lăm˨˦
lắng	lăŋ˨˦
lắp	lăp˦˥
lắt	lăt˦˥
lằm	lăm˧˨
lằn	lăn˧˨
lằng	lăŋ˧˨
lẳn	lăn˧˩˨
lẳng	lăŋ˧˩˨
lẵng	lăŋ˧ˀ˥
lặc	lăk˨ˀ˩
lặn	lăn˨ˀ˩ʔ
lặng	lăŋ˨ˀ˩ʔ
lặp	lăp˨ˀ˩
lặt	lăt˨ˀ˩
lẹ	lɛ˨ˀ˩ʔ
lẹm	lɛm˨ˀ˩ʔ
lẹo	leo˨ˀ˩ʔ
lẹp	lɛp˨ˀ˩
lẹt	lɛt˨ˀ˩
lẻ	lɛ˧˩˨
lẻn	lɛn˧˩˨
lẻng	lɛŋ˧˩˨
lẻo	leo˧˩˨
lẽ	lɛ˧ˀ˥
lẽo	leo˧ˀ˥
lếch	lek˦˥
lết	let˦˥
lếu	lɛu˨˦
lề	le˧˨
lềnh	leŋ˧˨
lều	lɛu˧˨
lể	le˧˩˨
lểu	lɛu˧˩˨
lễ	le˧ˀ˥
lễu	lɛu˧ˀ˥
lệ	le˨ˀ˩ʔ
lệch	lek˨ˀ˩
lệnh	leŋ˨ˀ˩ʔ
lệt	let˨ˀ˩
lỉnh	liŋ˧˩˨
lị	li˨ˀ˩ʔ
lịch	lik˨ˀ˩
lịu	liw˨ˀ˩ʔ
lọ	lɔ˨ˀ˩ʔ
lọc	lɔkp˨ˀ˩
lọi	lɔj˨ˀ˩ʔ
lọm	lɔm˨ˀ˩ʔ
lọn	lɔn˨ˀ˩ʔ
lọng	lɔŋm˨ˀ˩ʔ
lọp	lɔp˨ˀ˩
lọt	lɔt˨ˀ˩
lỏa	lwa˧˩˨
lỏm	lɔm˧˩˨
lỏn	lɔn˧˩˨
lỏng	lɔŋm˧˩˨
lố	lo˨˦
lốc	lokp˦˥
lối	loj˨˦
lốm	lom˨˦
lốn	lon˨˦
lốp	lop˦˥
lốt	lot˦˥
lồ	lo˧˨
lồi	loj˧˨
lồm	lom˧˨
lồn	lon˧˨
lồng	loŋm˧˨
lổ	lo˧˩˨
lổm	lom˧˩˨
lổn	lon˧˩˨
lổng	loŋm˧˩˨
lỗ	lo˧ˀ˥
lỗi	loj˧ˀ˥
lỗm	lom˧ˀ˥
lộ	lo˨ˀ˩ʔ
lộc	lokp˨ˀ˩
lội	loj˨ˀ˩ʔ
lộm	lom˨ˀ˩ʔ
lộn	lon˨ˀ˩ʔ
lộng	loŋm˨ˀ˩ʔ
lộp	lop˨ˀ˩
lột	lot˨ˀ˩
lớ	lɤ˨˦
lớn	lɤn˨˦
lớp	lɤp˦˥
lớt	lɤt˦˥
lờ	lɤ˧˨
lời	lɤj˧˨
lờm	lɤm˧˨
lờn	lɤn˧˨
lở	lɤ˧˩˨
lởm	lɤm˧˩˨
lởn	lɤn˧˩˨
lỡ	lə˧˨
lỡ	lɤ˧ˀ˥
lợ	lɤ˨ˀ˩ʔ
lợi	lɤj˨ˀ˩ʔ
lợm	lɤm˨ˀ˩ʔ
lợn	lɤn˨ˀ˩ʔ
lợp	lɤp˨ˀ˩
lợt	lɤt˨ˀ˩
lụ	lu˨ˀ˩ʔ
lụa	luə˨ˀ˩ʔ
lục	lukp˨ˀ˩
lụi	luj˨ˀ˩ʔ
lụm	lum˨ˀ˩ʔ
lụn	lun˨ˀ˩ʔ
lụng	luŋm˨ˀ˩ʔ
lụp	lup˨ˀ˩
lụt	lut˨ˀ˩
lụy	luj˨ˀ˩ʔ
lủ	lu˧˩˨
lủa	luə˧˩˨
lủi	luj˧˩˨
lủm	lum˧˩˨
lủn	lun˧˩˨
lủng	luŋm˧˩˨
lứa	lɯə˨˦
lừ	lɯ˧˨
lừa	lɯə˧˨
lừng	lɯŋ˧˨
lử	lɯ˧˩˨
lửa	lɯə˧˩˨
lửng	lɯŋ˧˩˨
lữ	lɯ˧ˀ˥
lững	lɯŋ˧ˀ˥
lự	lɯ˨ˀ˩ʔ
lựa	lɯə˨ˀ˩ʔ
lực	lɯk˨ˀ˩
lựng	lɯŋ˨ˀ˩ʔ
lựu	lɯw˨ˀ˩ʔ
lỵ	li˨ˀ˩ʔ
ma	maː˧
ma	ma˧˧
ma-cà-bông	ma˧˧-ka˧˨-boŋm˧˧
mai	maj˧˧
man	man˧˧
mang	maŋ˧˧
manh	mɛŋ˧˧
mao	maw˧˧
mau	măw˧˧
may	măj˧˧
me	mɛ˧˧
men	mɛn˧˧
meo	meo˧˧
mi	mi˧˧
mim	mim˧˧
minh	miŋ˧˧
miên	miən˧˧
miêu	miəw˧˧
miếng	miəŋ˨˦
miếu	miəw˨˦
miền	miən˧˨
miều	miəw˧˨
miễn	miən˧ˀ˥
miệng	miəŋ˨ˀ˩ʔ
miệt	miət˨ˀ˩
mo	mɔ˧˧
moay	mwăj˧˧
moi	mɔj˧˧
mon	mɔn˧˧
mong	mɔŋm˧˧
moóc	mɔkp˦˥
mua	muə˧˧
mui	muj˧˧
mum	mum˧˧
mun	mun˧˧
mung	muŋm˧˧
muôn	muən˧˧
muông	muəŋ˧˧
muối	muəj˨˦
muốn	muən˧˥
muốn	muən˨˦
muống	muəŋ˨˦
muồm	muəm˧˨
muỗi	muəj˧ˀ˥
muội	muəj˨ˀ˩ʔ
muộn	muən˨ˀ˩ʔ
mà	maː˧˨
mà	ma˧˨
mài	maj˧˨
màn	man˧˨
màng	maŋ˧˨
mành	mɛŋ˧˨
mào	maw˧˨
màu	măw˧˨
mày	măj˧˨
má	ma˨˦
mác	mak˦˥
mác-xít	mak˦˥-sit˦˥
mách	mɛk˦˥
mái	maj˨˦
mán	man˨˦
máng	maŋ˨˦
mánh	mɛŋ˨˦
mát	mat˦˥
máu	măw˨˦
máy	măj˨˦
mâm	mɤ̆m˧˧
mân	mɤ̆n˧˧
mâng	mɤ̆ŋ˧˧
mâu	mɤ̆w˧˧
mây	mɤ̆j˧˧
mã	ma˧ˀ˥
mãi	maj˧ˀ˥
mãn	man˧ˀ˥
mãng	maŋ˧ˀ˥
mãnh	mɛŋ˧ˀ˥
mè	mɛ˧˨
mèo	meo˧˨
méo	meo˨˦
mép	mɛp˦˥
mét	mɛt˦˥
mê	me˧˧
mên	men˧˧
mênh	meŋ˧˧
mì	mi˧˨
mìn	min˧˨
mình	miŋ˧˨
mía	miə˨˦
mích	mik˦˥
mít	mit˦˥
mò	mɔ˧˨
mòi	mɔj˧˨
mòm	mɔm˧˨
mòn	mɔn˧˨
mòng	mɔŋm˧˨
mó	mɔ˨˦
móc	mɔkp˦˥
móm	mɔm˨˦
món	mɔn˨˦
móng	mɔŋm˨˦
móp	mɔp˦˥
mót	mɔt˦˥
mô	mo˧˧
mô-bin	mo˧˧-bin˧˧
mô-men	mo˧˧-mɛn˧˧
mô-tô	mo˧˧-to˧˧
môi	moj˧˧
môn	mon˧˧
mông	moŋm˧˧
mõ	mɔ˧ˀ˥
mõm	mɔm˧ˀ˥
mù	mu˧˨
mùa	muə˧˨
mùi	muj˧˨
mùn	mun˧˨
mùng	muŋm˧˨
mú	mu˨˦
múa	muə˨˦
múi	muj˨˦
múm	mum˨˦
múp	mup˦˥
mút	mut˦˥
măm	măm˧˧
măn	măn˧˧
măng	măŋ˧˧
mĩ	mi˧ˀ˥
mũ	mu˧ˀ˥
mũi	muj˧ˀ˥
mũm	mum˧ˀ˥
mơ	mɤ˧˧
mơn	mɤn˧˧
mưa	mɯə˧˧
mưng	mɯŋ˧˧
mưu	mɯw˧˧
mươi	mɯəj˧˧
mươn	mɯən˧˧
mương	mɯəŋ˧˧
mướn	mɯən˨˦
mướp	mɯəp˦˥
mướt	mɯət˦˥
mười	mɯəj˧˨
mườn	mɯən˧˨
mường	mɯəŋ˧˨
mượn	mɯən˨ˀ˩ʔ
mượt	mɯət˨ˀ˩
mạ	ma˨ˀ˩ʔ
mạc	mak˨ˀ˩
mạc-sê	mak˨ˀ˩-se˧˧
mạch	mɛk˨ˀ˩
mại	maj˨ˀ˩ʔ
mạn	man˨ˀ˩ʔ
mạng	maŋ˨ˀ˩ʔ
mạnh	mɛŋ˨ˀ˩ʔ
mạo	maw˨ˀ˩ʔ
mạt	mat˨ˀ˩
mạy	măj˨ˀ˩ʔ
mả	ma˧˩˨
mải	maj˧˩˨
mảng	maŋ˧˩˨
mảnh	mɛŋ˧˩˨
mảy	măj˧˩˨
mấn	mɤ̆n˨˦
mấp	mɤ̆p˦˥
mất	mət˧˥
mất	mɤ̆t˦˥
mấu	mɤ̆w˨˦
mấy	mɤ̆j˨˦
mầm	mɤ̆m˧˨
mần	mɤ̆n˧˨
mầu	mɤ̆w˧˨
mầy	mɤ̆j˧˨
mẩm	mɤ̆m˧˩˨
mẩn	mɤ̆n˧˩˨
mẩy	mɤ̆j˧˩˨
mẫm	mɤ̆m˧ˀ˥
mẫn	mɤ̆n˧ˀ˥
mẫu	mɤ̆w˧ˀ˥
mận	mɤ̆n˨ˀ˩ʔ
mập	mɤ̆p˨ˀ˩
mật	mɤ̆t˨ˀ˩
mậu	mɤ̆w˨ˀ˩ʔ
mắc	măk˦˥
mắc	măk˧˥
mắm	măm˨˦
mắn	măn˨˦
mắng	măŋ˨˦
mắt	mat˧˥
mắt	măt˦˥
mằn	măn˧˨
mẵm	măm˧ˀ˥
mặc	măk˧˥
mặc	măk˨ˀ˩
mặn	măn˨ˀ˩ʔ
mặt	mat˧˨
mặt	măt˨ˀ˩
mẹ	mɛ˨ˀ˩ʔ
mẹo	meo˨ˀ˩ʔ
mẻ	mɛ˧˩˨
mẽ	mɛ˧ˀ˥
mếch	mek˦˥
mến	men˨˦
mếu	mɛu˨˦
mề	me˧˨
mềm	mem˧˨
mền	men˧˨
mễ	me˧ˀ˥
mệnh	meŋ˨ˀ˩ʔ
mệt	met˨ˀ˩
mỉ	mi˧˩˨
mỉa	miə˧˩˨
mỉm	mim˧˩˨
mỉu	miw˧˩˨
mị	mi˨ˀ˩ʔ
mịn	min˨ˀ˩ʔ
mịt	mit˨ˀ˩
mọc	mɔkp˨ˀ˩
mọi	mɔj˨ˀ˩ʔ
mọng	mɔŋm˨ˀ˩ʔ
mọt	mɔt˨ˀ˩
mỏ	mɔ˧˩˨
mỏi	mɔj˧˩˨
mỏm	mɔm˧˩˨
mỏng	mɔŋm˧˩˨
mố	mo˨˦
mốc	mokp˦˥
mối	moj˨˦
mống	moŋm˨˦
mốt	mot˦˥
mồ	mo˧
mồ	mo˧˨
mồi	moj˧˨
mồm	mom˧˨
mồn	mon˧˨
mồng	moŋm˧˨
mổ	mo˧˩˨
mỗi	moj˧ˀ˥
mộ	mo˨ˀ˩ʔ
mộc	mokp˨ˀ˩
mộng	moŋm˨ˀ˩ʔ
một	mot˨ˀ˩
mớ	mɤ˨˦
mới	mɤj˨˦
mớm	mɤm˨˦
mớn	mɤn˨˦
mờ	mɤ˧˨
mời	mɤj˧˨
mở	mɤ˧˩˨
mởn	mɤn˧˩˨
mỡ	mɤ˧ˀ˥
mụ	mu˨ˀ˩ʔ
mục	mukp˨ˀ˩
mục	muk˧˥
mụn	mun˨ˀ˩ʔ
mụt	mut˨ˀ˩
mủ	mu˧˩˨
mủi	muj˧˩˨
mủm	mum˧˩˨
mủng	muŋm˧˩˨
mức	mɯk˦˥
mứn	mɯn˨˦
mứt	mɯt˦˥
mừng	mɯŋ˧˨
mửa	mɯə˧˩˨
mực	mɯk˨ˀ˩
mỹ	mi˧ˀ˥
na	naː˧
na	na˧˧
nai	naj˧˧
nam	nam˧
nam	nam˧˧
nam-hạ	nam˧˧-ha˨ˀ˩ʔ
nam-sang	nam˧˧-saŋ˧˧
nam-đà	nam˧˧-da˧˨
nan	nan˧˧
nang	naŋ˧˧
nanh	nɛŋ˧˧
nao	naw˧˧
nay	năj˧˧
ne	nɛ˧˧
nem	nɛm˧˧
nen	nɛn˧˧
neo	neo˧˧
nga	ŋa˧˧
ngai	ŋaj˧˧
ngam	ŋam˧˧
ngan	ŋan˧˧
ngang	ŋaŋ˧˧
ngao	ŋaw˧˧
ngau	ŋăw˧˧
ngay	ŋăj˧˧
nghe	ŋɛ˧˧
nghi	ŋi˧˧
nghim	ŋim˧˧
nghinh	ŋiŋ˧˧
nghiêm	ŋiəm˧˧
nghiên	ŋiən˧˧
nghiêng	ŋiəŋ˧˧
nghiêu	ŋiəw˧˧
nghiến	ŋiən˨˦
nghiền	ŋiən˧˨
nghiễm	ŋiəm˧ˀ˥
nghiệm	ŋiəm˨ˀ˩ʔ
nghiện	ŋiən˨ˀ˩ʔ
nghiệp	ŋiəp˨ˀ˩
nghiệt	ŋiət˨ˀ˩
nghè	ŋɛ˧˨
nghèn	ŋɛn˧˨
nghèo	ŋeo˧˨
nghé	ŋɛ˨˦
nghê	ŋe˧˧
nghênh	ŋeŋ˧˧
nghêu	ŋɛu˧˧
nghì	ŋi˧˨
nghìn	ŋin˧˨
nghí	ŋi˨˦
nghĩ	ŋi˧ˀ˥
nghĩa	ŋiə˧ˀ˥
nghẹn	ŋɛn˨ˀ˩ʔ
nghẹt	ŋɛt˨ˀ˩
nghẽn	ŋɛn˧ˀ˥
nghếch	ŋek˦˥
nghề	ŋe˧˨
nghền	ŋen˧˨
nghềnh	ŋeŋ˧˨
nghều	ŋɛu˧˨
nghể	ŋe˧˩˨
nghển	ŋen˧˩˨
nghễnh	ŋeŋ˧ˀ˥
nghễu	ŋɛu˧ˀ˥
nghệ	ŋe˨ˀ˩ʔ
nghệch	ŋek˨ˀ˩
nghệt	ŋet˨ˀ˩
nghỉ	ŋi˧˩˨
nghỉu	ŋiw˧˩˨
nghị	ŋi˨ˀ˩ʔ
nghịch	ŋik˨ˀ˩
ngo	ŋɔ˧˧
ngoa	ŋwa˧˧
ngoai	ŋwaj˧˧
ngoam	ŋwam˧˧
ngoan	ŋwan˧˧
ngoang	ŋwaŋ˧˧
ngoao	ŋwaw˧˧
ngoay	ŋwăj˧˧
ngoe	ŋwe˧˧
ngoem	ŋwem˧˧
ngoen	ŋwen˧˧
ngoeo	ŋwew˧˧
ngoi	ŋɔj˧˧
ngon	ŋɔn˧˧
ngong	ŋɔŋm˧˧
ngoài	ŋwaj˧˨
ngoái	ŋwaj˨˦
ngoáo	ŋwaw˨˦
ngoã	ŋwa˧ˀ˥
ngoèo	ŋwew˧˨
ngoéo	ŋwew˨˦
ngoăn	ŋwăn˧˧
ngoạ	ŋwa˨ˀ˩ʔ
ngoạch	ŋwɛk˨ˀ˩
ngoại	ŋwaj˨ˀ˩ʔ
ngoạn	ŋwan˨ˀ˩ʔ
ngoảnh	ŋwɛŋ˧˩˨
ngoắc	ŋwăk˦˥
ngoắt	ŋwăt˦˥
ngoằn	ŋwăn˧˨
ngoằng	ŋwăŋ˧˨
ngoặc	ŋwăk˨ˀ˩
ngoặt	ŋwăt˨ˀ˩
ngoẻo	ŋwew˧˩˨
ngu	ŋu˧˧
ngun	ŋun˧˧
nguy	ŋwi˧˧
nguyên	ŋwiən˧˧
nguyền	ŋwiən˧˨
nguyện	ŋwiən˨ˀ˩ʔ
nguyệt	ŋwiət˨ˀ˩
nguây	ŋwɤ̆j˧˧
nguôi	ŋuəj˧˧
nguých	ŋwik˦˥
nguýt	ŋwit˦˥
nguầy	ŋwɤ̆j˧˨
nguẩy	ŋwɤ̆j˧˩˨
nguếch	ŋwek˦˥
nguệch	ŋwek˨ˀ˩
nguồi	ŋuəj˧˨
nguồn	ŋuən˧˨
nguội	ŋuəj˨ˀ˩ʔ
nguỵ	ŋwi˨ˀ˩ʔ
ngà	ŋa˧˨
ngài	ŋaj˧˨
ngàm	ŋam˧˨
ngàn	ŋan˧˨
ngành	ŋɛŋ˧˨
ngào	ŋaw˧˨
ngàu	ŋăw˧˨
ngày	ŋăj˧˨
ngác	ŋak˦˥
ngái	ŋaj˨˦
ngán	ŋan˨˦
ngáng	ŋaŋ˨˦
ngáo	ŋaw˨˦
ngáp	ŋap˦˥
ngát	ŋat˦˥
ngáy	ŋăj˨˦
ngâm	ŋɤ̆m˧˧
ngân	ŋɤ̆n˧˧
ngâu	ŋɤ̆w˧˧
ngây	ŋɤ̆j˧˧
ngã	ŋa˧ˀ˥
ngãi	ŋaj˧ˀ˥
ngãng	ŋaŋ˧ˀ˥
ngò	ŋɔ˧˨
ngòi	ŋɔj˧˨
ngòm	ŋɔm˧˨
ngòn	ŋɔn˧˨
ngòng	ŋɔŋm˧˨
ngó	ŋɔ˨˦
ngóc	ŋɔkp˦˥
ngóeo	ŋwew˨˦
ngói	ŋɔj˨˦
ngón	ŋɔn˨˦
ngóng	ŋɔŋm˨˦
ngót	ŋɔt˦˥
ngô	ŋo˧˧
ngôi	ŋoj˧˧
ngôn	ŋon˧˧
ngông	ŋoŋm˧˧
ngõ	ŋɔ˧ˀ˥
ngù	ŋu˧˨
ngùi	ŋuj˧˨
ngùn	ŋun˧˨
ngú	ŋu˨˦
ngúc	ŋukp˦˥
ngúng	ŋuŋm˨˦
ngút	ŋut˦˥
ngăm	ŋăm˧˧
ngăn	ŋăn˧˧
ngũ	ŋu˧ˀ˥
ngũn	ŋun˧ˀ˥
ngũng	ŋuŋm˧ˀ˥
ngơ	ŋɤ˧˧
ngơi	ŋɤj˧˧
ngơm	ŋɤm˧˧
ngơn	ŋɤn˧˧
ngư	ŋɯ˧˧
ngưa	ŋɯə˧˧
ngưng	ŋɯŋ˧˧
ngưu	ŋɯw˧˧
ngươi	ŋɯəj˧˧
ngước	ŋɯək˦˥
ngườ	ŋɯə˧˨
người	ŋɯəj˧˨
ngường	ŋɯəŋ˧˨
ngưỡng	ŋɯəŋ˧ˀ˥
ngược	ŋɯək˨ˀ˩
ngượng	ŋɯəŋ˨ˀ˩ʔ
ngạc	ŋak˨ˀ˩
ngạch	ŋɛk˨ˀ˩
ngại	ŋaj˨ˀ˩ʔ
ngạn	ŋan˨ˀ˩ʔ
ngạo	ŋaw˨ˀ˩ʔ
ngạt	ŋat˨ˀ˩
ngả	ŋa˧˩˨
ngải	ŋaj˧˩˨
ngảnh	ŋɛŋ˧˩˨
ngấc	ŋɤ̆k˦˥
ngấm	ŋɤ̆m˨˦
ngấn	ŋɤ̆n˨˦
ngấp	ŋɤ̆p˦˥
ngất	ŋɤ̆t˦˥
ngấu	ŋɤ̆w˨˦
ngấy	ŋɤ̆j˨˦
ngầm	ŋɤ̆m˧˨
ngần	ŋɤ̆n˧˨
ngầu	ŋɤ̆w˧˨
ngầy	ŋɤ̆j˧˨
ngẩm	ŋɤ̆m˧˩˨
ngẩn	ŋɤ̆n˧˩˨
ngẩng	ŋɤ̆ŋ˧˩˨
ngẫm	ŋɤ̆m˧ˀ˥
ngẫu	ŋɤ̆w˧ˀ˥
ngậm	ŋɤ̆m˨ˀ˩ʔ
ngận	ŋɤ̆n˨ˀ˩ʔ
ngập	ŋɤ̆p˨ˀ˩
ngật	ŋɤ̆t˨ˀ˩
ngậu	ŋɤ̆w˨ˀ˩ʔ
ngắc	ŋăk˦˥
ngắm	ŋăm˨˦
ngắn	ŋăn˨˦
ngắt	ŋăt˦˥
ngằn	ŋăn˧˨
ngẳng	ŋăŋ˧˩˨
ngặt	ŋăt˨ˀ˩
ngọ	ŋɔ˨ˀ˩ʔ
ngọc	ŋɔkp˨ˀ˩
ngọn	ŋɔn˨ˀ˩ʔ
ngọng	ŋɔŋm˨ˀ˩ʔ
ngọt	ŋɔt˨ˀ˩
ngỏ	ŋɔ˧˩˨
ngỏm	ŋɔm˧˩˨
ngỏn	ŋɔn˧˩˨
ngỏng	ŋɔŋm˧˩˨
ngốc	ŋokp˦˥
ngốn	ŋon˨˦
ngốt	ŋot˦˥
ngồ	ŋo˧˨
ngồi	ŋoj˧˨
ngồm	ŋom˧˨
ngồn	ŋon˧˨
ngồng	ŋoŋm˧˨
ngổ	ŋo˧˩˨
ngổm	ŋom˧˩˨
ngổn	ŋon˧˩˨
ngổng	ŋoŋm˧˩˨
ngỗ	ŋo˧ˀ˥
ngỗng	ŋoŋm˧ˀ˥
ngộ	ŋo˨ˀ˩ʔ
ngộc	ŋokp˨ˀ˩
ngột	ŋot˨ˀ˩
ngớ	ŋɤ˨˦
ngớt	ŋɤt˦˥
ngờ	ŋɤ˧˨
ngời	ŋɤj˧˨
ngờm	ŋɤm˧˨
ngỡ	ŋɤ˧ˀ˥
ngợi	ŋɤj˨ˀ˩ʔ
ngợm	ŋɤm˨ˀ˩ʔ
ngợp	ŋɤp˨ˀ˩
ngụ	ŋu˨ˀ˩ʔ
ngục	ŋukp˨ˀ˩
ngụp	ŋup˨ˀ˩
ngụy	ŋuj˨ˀ˩ʔ
ngủ	ŋu˧˩˨
ngủn	ŋun˧˩˨
ngủng	ŋuŋm˧˩˨
ngứa	ŋɯə˨˦
ngừng	ŋɯŋ˧˨
ngửa	ŋɯə˧˩˨
ngửi	ŋɯj˧˩˨
ngửng	ŋɯŋ˧˩˨
ngữ	ŋɯ˧ˀ˥
ngự	ŋɯ˨ˀ˩ʔ
ngựa	ŋɯə˨ˀ˩ʔ
ngực	ŋɯk˨ˀ˩
nha	ɲa˧˧
nhai	ɲaj˧˧
nham	ɲam˧˧
nhan	ɲan˧˧
nhang	ɲaŋ˧˧
nhanh	ɲɛŋ˧˧
nhao	ɲaw˧˧
nhau	ɲăw˧˧
nhay	ɲăj˧˧
nhe	ɲɛ˧˧
nhem	ɲɛm˧˧
nhen	ɲɛn˧˧
nheo	ɲeo˧˧
nhi	ɲi˧˧
nhinh	ɲiŋ˧˧
nhiu	ɲiw˧˧
nhiên	ɲiən˧˧
nhiêu	ɲiəw˧˧
nhiếc	ɲiək˦˥
nhiếp	ɲiəp˦˥
nhiều	ɲiəw˧˨
nhiễm	ɲiəm˧ˀ˥
nhiễu	ɲiəw˧ˀ˥
nhiệm	ɲiəm˨ˀ˩ʔ
nhiệt	ɲiət˨ˀ˩
nho	ɲɔ˧˧
nhoang	ɲwaŋ˧˧
nhoay	ɲwăj˧˧
nhoe	ɲwe˧˧
nhoen	ɲwen˧˧
nhoi	ɲɔj˧˧
nhom	ɲɔm˧˧
nhon	ɲɔn˧˧
nhong	ɲɔŋm˧˧
nhoáng	ɲwaŋ˨˦
nhoè	ɲwe˧˨
nhoét	ɲwet˦˥
nhoẻn	ɲwen˧˩˨
nhu	ɲu˧˧
nhun	ɲun˧˧
nhung	ɲuŋm˧˧
nhuyễn	ɲwiən˧ˀ˥
nhuôm	ɲuəm˧˧
nhuần	ɲwɤ̆n˧˨
nhuận	ɲwɤ̆n˨ˀ˩ʔ
nhuế	ɲwe˨˦
nhuệ	ɲwe˨ˀ˩ʔ
nhuốc	ɲuək˦˥
nhuốm	ɲuəm˨˦
nhuộm	ɲuəm˨ˀ˩ʔ
nhà	ɲaː˧˨
nhà	ɲa˧˨
nhài	ɲaj˧˨
nhàm	ɲam˧˨
nhàn	ɲan˧˨
nhàng	ɲaŋ˧˨
nhào	ɲaw˧˨
nhàu	ɲăw˧˨
nhày	ɲăj˧˨
nhá	ɲa˨˦
nhác	ɲak˦˥
nhái	ɲaj˨˦
nhám	ɲam˨˦
nháo	ɲaw˨˦
nhát	ɲat˦˥
nháy	ɲăj˨˦
nhâm	ɲɤ̆m˧˧
nhân	ɲɤ̆n˧˧
nhâng	ɲɤ̆ŋ˧˧
nhâu	ɲɤ̆w˧˧
nhây	ɲɤ̆j˧˧
nhã	ɲa˧ˀ˥
nhãi	ɲaj˧ˀ˥
nhãn	ɲan˧ˀ˥
nhãng	ɲaŋ˧ˀ˥
nhão	ɲaw˧ˀ˥
nhè	ɲɛ˧˨
nhèm	ɲɛm˧˨
nhèn	ɲɛn˧˨
nhèo	ɲeo˧˨
nhênh	ɲeŋ˧˧
nhì	ɲi˧˨
nhìn	ɲin˧˨
nhí	ɲi˨˦
nhím	ɲim˨˦
nhíp	ɲip˦˥
nhòe	ɲwe˧˨
nhòm	ɲɔm˧˨
nhóc	ɲɔkp˦˥
nhóm	ɲɔm˨˦
nhón	ɲɔn˨˦
nhóng	ɲɔŋm˨˦
nhóp	ɲɔp˦˥
nhót	ɲɔt˦˥
nhôm	ɲom˧˧
nhôn	ɲon˧˧
nhông	ɲoŋm˧˧
nhõng	ɲɔŋm˧ˀ˥
nhù	ɲu˧˨
nhùn	ɲun˧˨
nhùng	ɲuŋm˧˨
nhúc	ɲukp˦˥
nhúm	ɲum˨˦
nhún	ɲun˨˦
nhúng	ɲuŋm˨˦
nhút	ɲut˦˥
nhăm	ɲăm˧˧
nhăn	ɲăn˧˧
nhăng	ɲăŋ˧˧
nhĩ	ɲi˧ˀ˥
nhũ	ɲu˧ˀ˥
nhũn	ɲun˧ˀ˥
nhũng	ɲuŋm˧ˀ˥
nhơ	ɲɤ˧˧
nhơm	ɲɤm˧˧
nhơn	ɲɤn˧˧
như	ɲɯ˧˧
nhưng	ɲɯŋ˧˧
nhường	ɲɯəŋ˧˨
nhưỡng	ɲɯəŋ˧ˀ˥
nhược	ɲɯək˨ˀ˩
nhượng	ɲɯəŋ˨ˀ˩ʔ
nhạc	ɲak˨ˀ˩
nhạn	ɲan˨ˀ˩ʔ
nhạo	ɲaw˨ˀ˩ʔ
nhạt	ɲat˨ˀ˩
nhạy	ɲăj˨ˀ˩ʔ
nhả	ɲa˧˩˨
nhảm	ɲam˧˩˨
nhảu	ɲăw˧˩˨
nhảy	ɲăj˧˩˨
nhấc	ɲɤ̆k˦˥
nhấm	ɲɤ̆m˨˦
nhấn	ɲɤ̆n˨˦
nhấp	ɲɤ̆p˦˥
nhất	ɲɤ̆t˦˥
nhầm	ɲɤ̆m˧˨
nhần	ɲɤ̆n˧˨
nhầu	ɲɤ̆w˧˨
nhầy	ɲɤ̆j˧˨
nhẩn	ɲɤ̆n˧˩˨
nhẩy	ɲɤ̆j˧˩˨
nhẫn	ɲɤ̆n˧ˀ˥
nhậm	ɲɤ̆m˨ˀ˩ʔ
nhận	ɲɤ̆n˨ˀ˩ʔ
nhập	ɲɤ̆p˨ˀ˩
nhật	ɲɤ̆t˨ˀ˩
nhậu	ɲɤ̆w˨ˀ˩ʔ
nhắc	ɲăk˦˥
nhắc	ɲăk˧˥
nhắm	ɲăm˧˥
nhắm	ɲăm˨˦
nhắn	ɲăn˨˦
nhắng	ɲăŋ˨˦
nhắp	ɲăp˦˥
nhằm	ɲăm˧˨
nhằng	ɲăŋ˧˨
nhẳn	ɲăn˧˩˨
nhẳng	ɲăŋ˧˩˨
nhẵn	ɲăn˧ˀ˥
nhặm	ɲăm˨ˀ˩ʔ
nhặng	ɲăŋ˨ˀ˩ʔ
nhặt	ɲăt˨ˀ˩
nhẹ	ɲɛ˨ˀ˩ʔ
nhẻ	ɲɛ˧˩˨
nhẻm	ɲɛm˧˩˨
nhẽ	ɲɛ˧ˀ˥
nhẽo	ɲeo˧ˀ˥
nhếch	ɲek˦˥
nhếu	ɲɛu˨˦
nhều	ɲɛu˧˨
nhễ	ɲe˧ˀ˥
nhện	ɲen˨ˀ˩ʔ
nhệu	ɲɛu˨ˀ˩ʔ
nhị	ɲi˨ˀ˩ʔ
nhịn	ɲin˨ˀ˩ʔ
nhịp	ɲip˨ˀ˩
nhịu	ɲiw˨ˀ˩ʔ
nhọ	ɲɔ˨ˀ˩ʔ
nhọc	ɲɔkp˨ˀ˩
nhọn	ɲɔn˨ˀ˩ʔ
nhọt	ɲɔt˨ˀ˩
nhỏ	ɲɔ˧˨
nhỏ	ɲɔ˧˩˨
nhỏm	ɲɔm˧˩˨
nhỏn	ɲɔn˧˩˨
nhỏng	ɲɔŋm˧˩˨
nhố	ɲo˨˦
nhốn	ɲon˨˦
nhồi	ɲoj˧˨
nhồm	ɲom˧˨
nhồn	ɲon˧˨
nhổ	ɲo˧˩˨
nhộn	ɲon˨ˀ˩ʔ
nhộng	ɲoŋm˨ˀ˩ʔ
nhột	ɲot˨ˀ˩
nhớ	ɲɤ˨˦
nhớn	ɲɤn˨˦
nhớp	ɲɤp˦˥
nhớt	ɲɤt˦˥
nhờ	ɲɤ˧˨
nhời	ɲɤj˧˨
nhờn	ɲɤn˧˨
nhởn	ɲɤn˧˩˨
nhỡ	ɲɤ˧ˀ˥
nhỡn	ɲɤn˧ˀ˥
nhợt	ɲɤt˨ˀ˩
nhục	ɲukp˨ˀ˩
nhụng	ɲuŋm˨ˀ˩ʔ
nhụt	ɲut˨ˀ˩
nhủ	ɲu˧˩˨
nhủn	ɲun˧˩˨
nhủng	ɲuŋm˧˩˨
nhức	ɲɯk˦˥
nhừ	ɲɯ˧˨
nhửng	ɲɯŋ˧˩˨
nhữ	ɲɯ˧ˀ˥
những	ɲɯŋ˧ˀ˥
nhựa	ɲɯə˨ˀ˩ʔ
nhựt	ɲɯt˨ˀ˩
ni	ni˧
ni	ni˧˧
nin	nin˧˧
ninh	niŋ˧˧
niu	niw˧˧
niêm	niəm˧˧
niên	niən˧˧
niêu	niəw˧˧
niết	niət˦˥
niềm	niəm˧˨
niềng	niəŋ˧˨
niệm	niəm˨ˀ˩ʔ
niệu	niəw˨ˀ˩ʔ
no	nɔ˧˧
no,	nɔ˧
noi	nɔj˧˧
non	nɔn˧˧
nong	nɔŋm˧˧
noong	nɔŋm˧˧
noãn	nwan˧ˀ˥
nu	nu˧˧
nua	nuə˧˧
num	num˧˧
nung	nuŋm˧˧
nuôi	nuəj˧˧
nuông	nuəŋ˧˧
nuối	nuəj˨˦
nuốt	nuət˦˥
nuột	nuət˨ˀ˩
nà	na˧˨
nài	naj˧˨
nàng	naŋ˧˨
nào	naw˧˨
này	năj˧˨
ná	na˨˦
nách	nɛk˦˥
nái	naj˨˦
náo	naw˨˦
náp	nap˦˥
nát	nat˦˥
náu	năw˨˦
nân	nɤ̆n˧˧
nâng	nɤ̆ŋ˧˧
nâu	nɤ̆w˧˧
nây	nɤ̆j˧˧
não	naw˧ˀ˥
nãy	năj˧ˀ˥
né	nɛ˨˦
ném	nɛm˨˦
nén	nɛn˨˦
néo	neo˨˦
nét	nɛt˦˥
nê	ne˧˧
nêm	nem˧˧
nên	nen˧
nên	nen˧˧
nêu	nɛu˧˧
nì	ni˧˨
nình	niŋ˧˨
ních	nik˦˥
nín	nin˨˦
níu	niw˨˦
nòi	nɔj˧˨
nòng	nɔŋm˧˨
nó	nɔ˧˥
nó	nɔ˨˦
nóc	nɔkp˦˥
nói	nɔj˧˥
nói	nɔj˨˦
nón	nɔn˨˦
nóng	nɔŋm˨˦
nót	nɔt˦˥
nô	no˧˧
nôm	nom˧˧
nôn	non˧˧
nông	noŋm˧˧
nõ	nɔ˧ˀ˥
nõn	nɔn˧ˀ˥
nùng	nuŋm˧˨
núa	nuə˨˦
núc	nukp˦˥
núi	nuj˨˦
núm	num˨˦
núng	nuŋm˨˦
núp	nup˦˥
nút	nut˦˥
năm	năm˧˧
năn	năn˧˧
năng	năŋ˧˧
nũng	nuŋm˧ˀ˥
nơ	nɤ˧˧
nơi	nɤj˧˧
nơm	nɤm˧˧
nưng	nɯŋ˧˧
nương	nɯəŋ˧˧
nước	nɯək˦˥
nướng	nɯəŋ˨˦
nườm	nɯəm˧˨
nạ	na˨ˀ˩ʔ
nạc	nak˨ˀ˩
nại	naj˨ˀ˩ʔ
nạm	nam˨ˀ˩ʔ
nạn	nan˨ˀ˩ʔ
nạng	naŋ˨ˀ˩ʔ
nạo	naw˨ˀ˩ʔ
nạp	nap˨ˀ˩
nạt	nat˨ˀ˩
nản	nan˧˩˨
nảo	naw˧˩˨
nảy	năj˧˩˨
nấc	nɤ̆k˦˥
nấm	nɤ̆m˨˦
nấn	nɤ̆n˨˦
nấp	nɤ̆p˦˥
nấu	nɤ̆w˨˦
nấy	nɤ̆j˨˦
nầm	nɤ̆m˧˨
nần	nɤ̆n˧˨
nẩy	nɤ̆j˧˩˨
nẫng	nɤ̆ŋ˧ˀ˥
nẫu	nɤ̆w˧ˀ˥
nắc	năk˦˥
nắm	năm˨˦
nắn	năn˨˦
nắng	năŋ˧˥
nắng	năŋ˨˦
nắp	năp˦˥
nằm	năm˧˨
nằn	năn˧˨
nằng	năŋ˧˨
nặc	năk˨ˀ˩
nặn	năn˨ˀ˩ʔ
nặng	năŋ˨ˀ˩ʔ
nẹp	nɛp˨ˀ˩
nẹt	nɛt˨ˀ˩
nẻ	nɛ˧˩˨
nẻo	neo˧˩˨
nếm	nem˨˦
nến	nen˨˦
nếp	nep˦˥
nết	net˦˥
nếu	nɛu˨˦
nếu	nɯək˧˥
nề	ne˧˨
nền	nen˧˨
nể	ne˧˩˨
nệ	ne˨ˀ˩ʔ
nệm	nem˨ˀ˩ʔ
nỉ	ni˧˩˨
nịch	nik˨ˀ˩
nịnh	niŋ˨ˀ˩ʔ
nịt	nit˨ˀ˩
nọ	nɔ˨ˀ˩ʔ
nọc	nɔkp˨ˀ˩
nỏ	nɔ˧˩˨
nốc	nokp˦˥
nối	noj˨˦
nốt	not˦˥
nồi	noj˧˨
nồng	noŋm˧˨
nổ	no˧˩˨
nổi	noj˧˩˨
nỗ	no˧ˀ˥
nỗi	noj˧ˀ˥
nộ	no˨ˀ˩ʔ
nội	noj˨ˀ˩ʔ
nộn	non˨ˀ˩ʔ
nộp	nop˨ˀ˩
nới	nɤj˨˦
nớp	nɤp˦˥
nờm	nɤm˧˨
nở	nɤ˧˩˨
nỡ	nɤ˧ˀ˥
nợ	nɤ˨ˀ˩ʔ
nụ	nu˧˨
nụ	nu˨ˀ˩ʔ
nục	nukp˨ˀ˩
nứa	nɯə˨˦
nức	nɯk˦˥
nứt	nɯt˦˥
nử	nɯ˧˩˨
nửa	nɯə˧˩˨
nữ	nɯ˧ˀ˥
nữa	nɯə˧ˀ˥
nực	nɯk˨ˀ˩
nựng	nɯŋ˨ˀ˩ʔ
o	ɔ˧˧
o-xi	ɔ˧˧-si˧˧
o-xy	ɔ˧˧-si˧˧
o-xít	ɔ˧˧-sit˦˥
oa	wa˧˧
oai	waj˧˧
oan	wan˧˧
oang	waŋ˧˧
oanh	wɛŋ˧˧
oe	we˧˧
oeng	weŋ˧˧
oi	ɔj˧˧
om	ɔm˧˧
ong	ɔŋm˧˧
oong	ɔŋm˧˧
oàm	wam˧˨
oàng	waŋ˧˨
oành	wɛŋ˧˨
oác	wak˦˥
oái	waj˨˦
oán	wan˨˦
oát	wat˦˥
oé	we˨˦
oăn	wăn˧˧
oăng	wăŋ˧˧
oải	waj˧˩˨
oản	wan˧˩˨
oắt	wăt˦˥
oằn	wăn˧˨
oẳn	wăn˧˩˨
oặt	wăt˨ˀ˩
oẻ	we˧˩˨
pa	pa˧˧
pe-man-ga-nát	pɛ˧˧-man˧˧-ɣa˧˧-nat˦˥
pen	pɛn˧˧
pha	fa˧˧
phai	faj˧˧
phang	faŋ˧˧
phanh	fɛŋ˧˧
phao	faw˧˧
phau	făw˧˧
phay	făj˧˧
phe	fɛ˧˧
phi	fi˧˧
phim	fim˧˧
phin	fin˧˧
phinh	fiŋ˧˧
phiên	fiən˧˧
phiêu	fiəw˧˧
phiếm	fiəm˨˦
phiến	fiən˨˦
phiếu	fiəw˨˦
phiền	fiən˧˨
phiệt	fiət˨ˀ˩
pho	fɔ˧˧
phong	fɔŋm˧˧
phoóc	fɔkp˦˥
phu	fu˧˧
phui	fuj˧˧
phun	fun˧˧
phung	fuŋm˧˧
phà	fa˧˨
phàm	fam˧˨
phàn	fan˧˨
phành	fɛŋ˧˨
phá	fa˨˦
phác	fak˦˥
phách	fɛk˦˥
phái	faj˨˦
phán	fan˨˦
pháo	faw˨˦
pháp	fap˦˥
phát	fat˦˥
phân	fɤ̆n˧˧
phây	fɤ̆j˧˧
phè	fɛ˧˨
phèn	fɛn˧˨
phèng	fɛŋ˧˨
phéc	fɛk˦˥
phép	fɛp˦˥
phét	fɛt˦˥
phê	fe˧˧
phên	fen˧˧
phì	fi˧˨
phìa	fiə˧˨
phìn	fin˧˨
phình	fiŋ˧˨
phí	fi˨˦
phím	fim˨˦
phò	fɔ˧˨
phòi	fɔj˧˨
phòng	fɔŋm˧˨
phó	fɔ˨˦
phóng	fɔŋm˨˦
phô	fo˧˧
phôi	foj˧˧
phôm	fom˧˧
phông	foŋm˧˧
phù	fu˧˨
phùn	fun˧˨
phùng	fuŋm˧˨
phú	fu˨˦
phúc	fukp˦˥
phún	fun˨˦
phúng	fuŋm˨˦
phút	fut˦˥
phăm	făm˧˧
phăn	făn˧˧
phăng	făŋ˧˧
phĩnh	fiŋ˧ˀ˥
phũ	fu˧ˀ˥
phơ	fɤ˧˧
phơi	fɤj˧˧
phơn	fɤn˧˧
phưng	fɯŋ˧˧
phương	fɯəŋ˧˧
phước	fɯək˦˥
phướn	fɯən˨˦
phường	fɯəŋ˧˨
phượng	fɯəŋ˨ˀ˩ʔ
phạch	fɛk˨ˀ˩
phạm	fam˨ˀ˩ʔ
phạn	fan˨ˀ˩ʔ
phạt	fat˨ˀ˩
phả	fa˧˩˨
phải	faj˧˩˨
phản	fan˧˩˨
phảng	faŋ˧˩˨
phấn	fɤ̆n˨˦
phấp	fɤ̆p˦˥
phất	fɤ̆t˦˥
phầm	fɤ̆m˧˨
phần	fɤ̆n˧˨
phẩm	fɤ̆m˧˩˨
phẩy	fɤ̆j˧˩˨
phẫn	fɤ̆n˧ˀ˥
phẫu	fɤ̆w˧ˀ˥
phận	fɤ̆n˨ˀ˩ʔ
phập	fɤ̆p˨ˀ˩
phật	fɤ̆t˨ˀ˩
phắc	făk˦˥
phắt	făt˦˥
phẳng	făŋ˧˩˨
phẹt	fɛt˨ˀ˩
phế	fe˨˦
phề	fe˧˨
phềnh	feŋ˧˨
phều	fɛu˧˨
phệ	fe˨ˀ˩ʔ
phệnh	feŋ˨ˀ˩ʔ
phỉ	fi˧˩˨
phỉnh	fiŋ˧˩˨
phịu	fiw˨ˀ˩ʔ
phọng	fɔŋm˨ˀ˩ʔ
phọt	fɔt˨ˀ˩
phỏng	fɔŋm˧˩˨
phố	fo˨˦
phốc	fokp˦˥
phối	foj˨˦
phốp	fop˦˥
phốt	fot˦˥
phồm	fom˧˨
phồn	fon˧˨
phồng	foŋm˧˨
phổ	fo˧˩˨
phổi	foj˧˩˨
phổng	foŋm˧˩˨
phỗng	foŋm˧ˀ˥
phộng	foŋm˨ˀ˩ʔ
phới	fɤj˨˦
phớn	fɤn˨˦
phớt	fɤt˦˥
phờ	fɤ˧˨
phở	fɤ˧˩˨
phởn	fɤn˧˩˨
phụ	fu˨ˀ˩ʔ
phục	fukp˨ˀ˩
phụng	fuŋm˨ˀ˩ʔ
phủ	fu˧˩˨
phủi	fuj˧˩˨
phứa	fɯə˨˦
phức	fɯk˦˥
phừn	fɯn˧˨
phừng	fɯŋ˧˨
pi	pi˧˧
pin	pin˧˧
pom	pɔm˧˧
pu	pu˧˧
puốc	puək˦˥
pà	pa˧˨
pác	pak˦˥
pát	pat˦˥
pâu	pɤ̆w˧˧
pê	pe˧˧
pít	pit˦˥
pô	po˧˧
pô-li-me	po˧˧-li˧˧-mɛ˧˧
pơ	pɤ˧˧
qua	kwaː˧
qua	kwa˧˧
quai	kwaj˧˧
quan	kwan˧˧
quang	kwaŋ˧˧
quanh	kwɛŋ˧˧
quau	kwăw˧˧
quay	kwăj˧˧
que	kwɛ˧˧
quen	kwɛn˧˧
queng	kwɛŋ˧˧
queo	kweo˧˧
qui	kwi˧˧
quy	kwi˧˧
quyên	kwiɛn˧˧
quyến	kwiɛn˨˦
quyết	kwiɛt˦˥
quyền	kwiɛn˧˨
quyển	kwiɛn˧˩˨
quà	kwa˧˨
quài	kwaj˧˨
quàng	kwaŋ˧˨
quành	kwɛŋ˧˨
quàu	kwăw˧˨
quày	kwăj˧˨
quá	kwa˨˦
quác	kwak˦˥
quách	kwɛk˦˥
quái	kwaj˨˦
quán	kwan˨˦
quáng	kwaŋ˨˦
quánh	kwɛŋ˨˦
quát	kwat˦˥
quân	kwɤ̆n˧˧
quây	kwɤ̆j˧˧
quãng	kwaŋ˧ˀ˥
què	kwɛ˧˨
quèn	kwɛn˧˨
quèo	kweo˧˨
quét	kwɛt˦˥
quê	kwe˧˧
quên	kwen˧˧
quì	kwi˧˨
quình	kwiŋ˧˨
quí	kwi˨˦
quít	kwit˦˥
quý	kwi˨˦
quýnh	kwiŋ˨˦
quýt	kwit˦˥
quăm	kwăm˧˧
quăn	kwăn˧˧
quăng	kwăŋ˧˧
quĩ	kwi˧ˀ˥
quơ	kwɤ˧˧
quạ	kwa˨ˀ˩ʔ
quạc	kwak˨ˀ˩
quạnh	kwɛŋ˨ˀ˩ʔ
quạt	kwat˨ˀ˩
quạu	kwăw˨ˀ˩ʔ
quả	kwa˧˩˨
quải	kwaj˧˩˨
quản	kwan˧˩˨
quảng	kwaŋ˧˩˨
quảy	kwăj˧˩˨
quấn	kwɤ̆n˨˦
quất	kwɤ̆t˦˥
quấy	kwɤ̆j˨˦
quần	kwɤ̆n˧˨
quầng	kwɤ̆ŋ˧˨
quầy	kwɤ̆j˧˨
quẩn	kwɤ̆n˧˩˨
quẩng	kwɤ̆ŋ˧˩˨
quẫn	kwɤ̆n˧ˀ˥
quận	kwɤ̆n˨ˀ˩ʔ
quật	kwɤ̆t˨ˀ˩
quậy	kwɤ̆j˨ˀ˩ʔ
quắc	kwăk˦˥
quắp	kwăp˦˥
quắt	kwăt˦˥
quằm	kwăm˧˨
quằn	kwăn˧˨
quẳng	kwăŋ˧˩˨
quặm	kwăm˨ˀ˩ʔ
quặn	kwăn˨ˀ˩ʔ
quặp	kwăp˨ˀ˩
quặt	kwăt˨ˀ˩
quẹo	kweo˨ˀ˩ʔ
quẹt	kwɛt˨ˀ˩
quẻ	kwɛ˧˩˨
quế	kwe˨˦
quếch	kwek˦˥
quến	kwen˨˦
quếnh	kweŋ˨˦
quết	kwet˦˥
quếu	kwɛu˨˦
quề	kwe˧˨
quềnh	kweŋ˧˨
quều	kwɛu˧˨
quệch	kwek˨ˀ˩
quệnh	kweŋ˨ˀ˩ʔ
quỉ	kwi˧˩˨
quị	kwi˨ˀ˩ʔ
quốc	kwokp˦˥
quới	kwɤj˨˦
quờ	kwɤ˧˨
quờn	kwɤn˧˨
quở	kwɤ˧˩˨
quỳ	kwi˧˨
quỳnh	kwiŋ˧˨
quỵ	kwi˨ˀ˩ʔ
quỷ	kwi˧˩˨
quỹ	kwi˧ˀ˥
ra	za˧˧
ra-đi-ô	za˧˧-di˧˧-o˧˧
ram	zam˧˧
ran	zan˧˧
rang	zaŋ˧˧
ranh	zɛŋ˧˧
rao	zaw˧˧
rau	zăw˧˧
ray	zăj˧˧
re	zɛ˧˧
ren	zɛn˧˧
reng	zɛŋ˧˧
reo	zeo˧˧
ri	zi˧˧
rin	zin˧˧
rinh	ziŋ˧˧
riu	ziw˧˧
riêng	ziəŋ˧˧
riêu	ziəw˧˧
riết	ziət˦˥
riềng	ziəŋ˧˨
ro	zɔ˧˧
roi	zɔj˧˧
rong	zɔŋm˧˧
ru	zu˧˧
run	zun˧˧
rung	zuŋm˧˧
ruôn	zuən˧˧
ruốc	zuək˦˥
ruồi	zuəj˧˨
ruồng	zuəŋ˧˨
ruổi	zuəj˧˩˨
ruỗng	zuəŋ˧ˀ˥
ruộng	zuəŋ˨ˀ˩ʔ
ruột	zuət˨ˀ˩
rà	za˧˨
ràn	zan˧˨
ràng	zaŋ˧˨
rành	zɛŋ˧˨
rào	zaw˧˨
rày	zăj˧˨
rá	za˨˦
rác	zak˦˥
rách	zɛk˦˥
rái	zaj˨˦
rám	zam˨˦
rán	zan˨˦
ráng	zaŋ˨˦
ráo	zaw˨˦
ráp	zap˦˥
rát	zat˦˥
ráu	zăw˨˦
ráy	zăj˨˦
râm	zɤ̆m˧˧
rân	zɤ̆n˧˧
râu	zɤ̆w˧˧
rã	za˧ˀ˥
rãi	zaj˧ˀ˥
rãnh	zɛŋ˧ˀ˥
rè	zɛ˧˨
rèn	zɛn˧˨
rèo	zeo˧˨
ré	zɛ˨˦
rén	zɛn˨˦
réo	zeo˨˦
rét	zɛt˦˥
rên	zen˧˧
rêu	zɛu˧˧
rì	zi˧˨
rìa	ziə˧˨
rình	ziŋ˧˨
rìu	ziw˧˨
rí	zi˨˦
rích	zik˦˥
rít	zit˦˥
ríu	ziw˨˦
rò	zɔ˧˨
ròm	zɔm˧˨
ròn	zɔn˧˨
ròng	zɔŋm˧˨
ró	zɔ˨˦
róc	zɔkp˦˥
rón	zɔn˨˦
rót	zɔt˦˥
rô	zo˧˧
rôm	zom˧˧
rôn	zon˧˧
rông	zoŋm˧˧
rõ	zɔ˧ˀ˥
rù	zu˧˨
rùa	zuə˧˨
rùm	zum˧˨
rùng	zuŋm˧˨
rú	zu˨˦
rúc	zukp˦˥
rúi	zuj˨˦
rúm	zum˨˦
rún	zun˨˦
rúng	zuŋm˨˦
rút	zut˦˥
răm	zăm˧˧
răn	zăn˧˧
răng	zăŋ˧˧
rĩ	zi˧ˀ˥
rũ	zu˧ˀ˥
rơ	zɤ˧˧
rơi	zɤj˧˧
rơm	zɤm˧˧
rơn	zɤn˧˧
rưa	zɯə˧˧
rưng	zɯŋ˧˧
rươi	zɯəj˧˧
rươm	zɯəm˧˧
rương	zɯəŋ˧˧
rước	zɯək˦˥
rướn	zɯən˨˦
rười	zɯəj˧˨
rườm	zɯəm˧˨
rườn	zɯən˧˨
rường	zɯəŋ˧˨
rượn	zɯən˨ˀ˩ʔ
rượu	zɯəw˨ˀ˩ʔ
rạ	za˨ˀ˩ʔ
rạc	zak˨ˀ˩
rạch	zɛk˨ˀ˩
rạn	zan˨ˀ˩ʔ
rạng	zaŋ˨ˀ˩ʔ
rạo	zaw˨ˀ˩ʔ
rạp	zap˨ˀ˩
rả	za˧˩˨
rải	zaj˧˩˨
rảnh	zɛŋ˧˩˨
rảo	zaw˧˩˨
rấm	zɤ̆m˨˦
rấn	zɤ̆n˨˦
rấp	zɤ̆p˦˥
rất	zət˧˥
rất	zɤ̆t˦˥
rầm	zɤ̆m˧˨
rần	zɤ̆n˧˨
rầu	zɤ̆w˧˨
rầy	zɤ̆j˧˨
rẫy	zɤ̆j˧ˀ˥
rậm	zɤ̆m˨ˀ˩ʔ
rận	zɤ̆n˨ˀ˩ʔ
rập	zɤ̆p˨ˀ˩
rắc	zăk˦˥
rắm	zăm˨˦
rắn	zăn˨˦
rắp	zăp˦˥
rằm	zăm˧
rằm	zăm˧˨
rằn	zăn˧˨
rằng	zăŋ˧˨
rặm	zăm˨ˀ˩ʔ
rặt	zăt˨ˀ˩
rẹo	zeo˨ˀ˩ʔ
rẻ	zɛ˧˩˨
rẻo	zeo˧˩˨
rẽ	zɛ˧ˀ˥
rế	ze˨˦
rếch	zek˦˥
rết	zet˦˥
rề	ze˧˨
rền	zen˧˨
rềnh	zeŋ˧˨
rể	ze˧˩˨
rểnh	zeŋ˧˩˨
rễ	ze˧ˀ˥
rệp	zep˨ˀ˩
rệu	zɛu˨ˀ˩ʔ
rỉ	zi˧˩˨
rỉa	ziə˧˩˨
rị	zi˨ˀ˩ʔ
rịa-vũng	ziə˨ˀ˩ʔ-vuŋm˧ˀ˥
rịch	zik˨ˀ˩
rọ	zɔ˨ˀ˩ʔ
rọc	zɔkp˨ˀ˩
rọt	zɔt˨ˀ˩
rỏ	zɔ˧˩˨
rốc	zokp˦˥
rối	zoj˨˦
rốn	zon˨˦
rống	zoŋm˨˦
rốt	rot˧˥
rốt	zot˦˥
rồ	zo˧
rồ	zo˧˨
rồi	zoj˧˨
rồm	zom˧˨
rồn	zon˧˨
rồng	zoŋm˧˨
rổ	zo˧˩˨
rổn	zon˧˩˨
rỗ	zo˧ˀ˥
rỗi	zoj˧ˀ˥
rỗng	zoŋm˧ˀ˥
rộ	zo˨ˀ˩ʔ
rộc	zokp˨ˀ˩
rộn	zon˨ˀ˩ʔ
rộng	zoŋm˨ˀ˩ʔ
rột	zot˨ˀ˩
rớt	zɤt˦˥
rờ	zɤ˧˨
rời	zɤj˧˨
rờm	zɤm˧˨
rờn	zɤn˧˨
rởm	zɤm˧˩˨
rởn	zɤn˧˩˨
rỡ	zɤ˧ˀ˥
rợ	zɤ˨ˀ˩ʔ
rợn	zɤn˨ˀ˩ʔ
rợp	zɤp˨ˀ˩
rụ	zu˨ˀ˩ʔ
rục	zukp˨ˀ˩
rụng	zuŋm˨ˀ˩ʔ
rụp	zup˨ˀ˩
rụt	zut˨ˀ˩
rủ	zu˧˩˨
rủa	zuə˧˩˨
rủi	zuj˧˩˨
rủn	zun˧˩˨
rủng	zuŋm˧˩˨
rứt	zɯt˦˥
rừng	zɯŋ˧˨
rửa	zɯə˧˩˨
rửng	zɯŋ˧˩˨
rữa	zɯə˧ˀ˥
rựa	zɯə˨ˀ˩ʔ
rực	zɯk˨ˀ˩
sa	sa˧˧
sai	saj˧˧
sam	sam˧˧
san	san˧˧
sang	saŋ˧˧
sanh	sɛŋ˧˧
sao	saw˧˧
sau	săw˧˧
say	săj˧˧
se	sɛ˧˧
sen	sɛn˧˧
seo	seo˧˧
si	si˧˧
sim	sim˧˧
sin	sin˧˧
sinh	siŋ˧˧
siêng	siəŋ˧˧
siêu	siəw˧˧
siết	siət˦˥
siểm	siəm˧˩˨
so	sɔ˧˧
soi	sɔj˧˧
son	sɔn˧˧
song	sɔŋm˧˧
soàm	swam˧˨
soàn	swan˧˨
soái	swaj˨˦
soán	swan˨˦
soát	swat˦˥
soạn	swan˨ˀ˩ʔ
su	su˧˧
sui	suj˧˧
sum	sum˧˧
sun	sun˧˧
sun-phát	sun˧˧-fat˦˥
sung	suŋm˧˧
suy	swi˧˧
suôn	suən˧˧
suông	suəŋ˧˧
suý	swi˨˦
suýt	swit˦˥
suất	swɤ̆t˦˥
suối	suəj˨˦
suốt	suət˦˥
suốt	suət˧˥
suồng	suəŋ˧˨
suỵt	swit˨ˀ˩
sà	sa˧˨
sài	saj˧˨
sàm	sam˧˨
sàn	san˧˨
sàng	saŋ˧˨
sành	sɛŋ˧˨
sào	saw˧˨
sá	sa˨˦
sách	sɛk˦˥
sái	saj˨˦
sám	sam˨˦
sán	san˨˦
sáng	saŋ˨˦
sánh	sɛŋ˨˦
sáo	saw˨˦
sáp	sap˦˥
sát	sat˦˥
sáu	săw˨˦
sâm	sɤ̆m˧˧
sân	sɤ̆n˧˧
sâu	sɤ̆w˧˧
sây	sɤ̆j˧˧
sã	sa˧ˀ˥
sãi	saj˧ˀ˥
sè	sɛ˧˨
sém	sɛm˨˦
sét	sɛt˦˥
sê	se˧˧
sên	sen˧˧
sênh	seŋ˧˧
sêu	sɛu˧˧
sì	si˧˨
sìn	sin˧˨
sình	siŋ˧˨
sín	sin˨˦
sính	siŋ˨˦
sít	sit˦˥
sò	sɔ˧˨
sòm	sɔm˧˨
sòn	sɔn˧˨
sòng	sɔŋm˧˨
sóc	sɔkp˦˥
sói	sɔj˨˦
sóm	sɔm˨˦
sóng	sɔŋm˨˦
sót	sɔt˦˥
sô	so˧˧
sô-vanh	so˧˧-vɛŋ˧˧
sôi	soj˧˧
sông	soŋm˧˧
sõi	sɔj˧ˀ˥
sõng	sɔŋm˧ˀ˥
sù	su˧˨
sùi	suj˧˨
sùm	sum˧˨
sùng	suŋm˧˨
sú	su˨˦
súc	sukp˦˥
sún	sun˨˦
súng	suŋm˨˦
súp	sup˦˥
sút	sut˦˥
súy	suj˨˦
săm	săm˧˧
săn	săn˧˧
săng	săŋ˧˧
sĩ	si˧ˀ˥
sơ	sɤ˧˧
sơm	sɤm˧˧
sơn	sɤn˧˧
sư	sɯ˧˧
sưng	sɯŋ˧˧
sưu	sɯw˧˧
sương	sɯəŋ˧˧
sướng	sɯəŋ˨˦
sướt	sɯət˦˥
sườn	sɯən˧˨
sường	sɯəŋ˧˨
sưởi	sɯəj˧˩˨
sượng	sɯəŋ˨ˀ˩ʔ
sạch	sɛk˨ˀ˩
sạm	sam˨ˀ˩ʔ
sạn	san˨ˀ˩ʔ
sạo	saw˨ˀ˩ʔ
sạp	sap˨ˀ˩
sạt	sat˨ˀ˩
sả	sa˧˩˨
sải	saj˧˩˨
sản	san˧˩˨
sảng	saŋ˧˩˨
sảnh	sɛŋ˧˩˨
sảo	saw˧˩˨
sảy	săj˧˩˨
sấm	sɤ̆m˨˦
sấn	sɤ̆n˨˦
sấp	sɤ̆p˦˥
sấy	sɤ̆j˨˦
sầm	sɤ̆m˧˨
sần	sɤ̆n˧˨
sầu	sɤ̆w˧˨
sầy	sɤ̆j˧˨
sẩm	sɤ̆m˧˩˨
sẩy	sɤ̆j˧˩˨
sậm	sɤ̆m˨ˀ˩ʔ
sập	sɤ̆p˨ˀ˩
sắc	săk˦˥
sắm	săm˨˦
sắn	săn˨˦
sắp	săp˦˥
sắt	săt˦˥
sằng	săŋ˧˨
sẵn	săn˧ˀ˥
sẵp	săp˧ˀ˥
sặc	săk˨ˀ˩
sặm	săm˨ˀ˩ʔ
sặt	săt˨ˀ˩
sẹo	seo˨ˀ˩ʔ
sẻ	sɛ˧˩˨
sẻn	sɛn˧˩˨
sẽ	sɛ˧ˀ˥
sến	sen˨˦
sếp	sep˦˥
sếu	sɛu˨˦
sề	se˧˨
sền	sen˧˨
sềnh	seŋ˧˨
sểnh	seŋ˧˩˨
sệ	se˨ˀ˩ʔ
sỉ	si˧˩˨
sỉa	siə˧˩˨
sịt	sit˨ˀ˩
sọ	sɔ˨ˀ˩ʔ
sọm	sɔm˨ˀ˩ʔ
sọt	sɔt˨ˀ˩
sỏi	sɔj˧˩˨
số	so˨˦
sống	soŋm˨˦
sốp	sop˦˥
sốt	sot˦˥
sồ	so˧˨
sồi	soj˧˨
sồn	son˧˨
sồng	soŋm˧˨
sổ	so˧˩˨
sổng	soŋm˧˩˨
sỗ	so˧ˀ˥
sộc	sokp˨ˀ˩
sột	sot˨ˀ˩
sớ	sɤ˨˦
sớm	sɤm˨˦
sớn	sɤn˨˦
sờ	sɤ˧˨
sờm	sɤm˧˨
sờn	sɤn˧˨
sở	sɤ˧˩˨
sởn	sɤn˧˩˨
sợ	sə˧˨
sợ	sɤ˨ˀ˩ʔ
sợi	sɤj˨ˀ˩ʔ
sụ	su˨ˀ˩ʔ
sục	sukp˨ˀ˩
sụm	sum˨ˀ˩ʔ
sụn	sun˨ˀ˩ʔ
sụp	sup˨ˀ˩
sụt	sut˨ˀ˩
sủ	su˧˩˨
sủa	suə˧˩˨
sủi	suj˧˩˨
sủng	suŋm˧˩˨
sứ	sɯ˨˦
sứa	sɯə˨˦
sức	sɨk˧˥
sức	sɯk˦˥
sứt	sɯt˦˥
sừn	sɯn˧˨
sừng	sɯŋ˧˨
sử	sɯ˧˩˨
sửa	sɯə˧˩˨
sửng	sɯŋ˧˩˨
sữa	sɯə˧ˀ˥
sững	sɯŋ˧ˀ˥
sự	su˧˨
sự	sɯ˨ˀ˩ʔ
sực	sɯk˨ˀ˩
sựng	sɯŋ˨ˀ˩ʔ
sỹ	si˧ˀ˥
ta	taː˧
ta	ta˧˧
tai	taj˧˧
tam	tam˧˧
tan	tan˧˧
tang	taŋ˧˧
tanh	tɛŋ˧˧
tao	taw˧˧
tao	taːw˧
tay	tăj˧˧
te	tɛ˧˧
tem	tɛm˧˧
ten	tɛn˧˧
teng	tɛŋ˧˧
teo	teo˧˧
tha	tʰa˧˧
thai	tʰaj˧˧
tham	tʰam˧˧
than	tʰan˧˧
thang	tʰaŋ˧˧
thanh	tʰɛŋ˧˧
thao	tʰaw˧˧
thau	tʰăw˧˧
thay	tʰăj˧˧
the	tʰɛ˧˧
then	tʰɛn˧˧
theo	tʰeo˧˧
thi	tʰi˧˧
thia	tʰiə˧˧
thin	tʰin˧˧
thinh	tʰiŋ˧˧
thiu	tʰiw˧˧
thiêm	tʰiəm˧˧
thiên	tʰiən˧˧
thiêng	tʰiəŋ˧˧
thiêu	tʰiəw˧˧
thiếc	tʰiək˦˥
thiếp	tʰiəp˦˥
thiết	tʰiət˦˥
thiếu	tʰiəw˨˦
thiềm	tʰiəm˧˨
thiền	tʰiən˧˨
thiều	tʰiəw˧˨
thiểm	tʰiəm˧˩˨
thiển	tʰiən˧˩˨
thiểu	tʰiəw˧˩˨
thiện	tʰiən˨ˀ˩ʔ
thiệp	tʰiəp˨ˀ˩
thiệt	tʰiət˨ˀ˩
thiệu	tʰiəw˨ˀ˩ʔ
thoa	tʰwa˧˧
thoai	tʰwaj˧˧
thoang	tʰwaŋ˧˧
thoi	tʰɔj˧˧
thom	tʰɔm˧˧
thon	tʰɔn˧˧
thong	tʰɔŋm˧˧
thoá	tʰwa˨˦
thoái	tʰwaj˨˦
thoán	tʰwan˨˦
thoáng	tʰwaŋ˨˦
thoát	tʰwat˦˥
thoòng	tʰɔŋm˧˨
thoăn	tʰwăn˧˧
thoại	tʰwaj˨ˀ˩ʔ
thoạt	tʰwat˨ˀ˩
thoả	tʰwa˧˩˨
thoải	tʰwaj˧˩˨
thoảng	tʰwaŋ˧˩˨
thoắt	tʰwăt˦˥
thu	tʰu˧˧
thua	tʰuə˧˧
thui	tʰuj˧˧
thum	tʰum˧˧
thun	tʰun˧˧
thung	tʰuŋm˧˧
thuyên	tʰwiən˧˧
thuyết	tʰwiət˦˥
thuyền	tʰwiən˧˨
thuê	tʰwe˧˧
thuôn	tʰuən˧˧
thuông	tʰuəŋ˧˧
thuý	tʰwi˨˦
thuần	tʰwɤ̆n˧˨
thuận	tʰwɤ̆n˨ˀ˩ʔ
thuật	tʰwɤ̆t˨ˀ˩
thuế	tʰwe˨˦
thuể	tʰwe˧˩˨
thuốc	tʰuək˦˥
thuồi	tʰuəj˧˨
thuồn	tʰuən˧˨
thuồng	tʰuəŋ˧˨
thuộc	tʰuək˨ˀ˩
thuở	tʰuə˧˩˨
thuỳ	tʰwi˧˨
thuỵ	tʰwi˨ˀ˩ʔ
thuỷ	tʰwi˧˩˨
thà	tʰa˧˨
thài	tʰaj˧˨
thàm	tʰam˧˨
thành	tʰɛŋ˧˨
thào	tʰaw˧˨
thày	tʰăj˧˨
thác	tʰak˦˥
thách	tʰɛk˦˥
thái	tʰaj˨˦
thám	tʰam˨˦
thán	tʰan˨˦
tháng	tʰaŋ˨˦
thánh	tʰɛŋ˨˦
tháo	tʰaw˨˦
tháp	tʰap˦˥
thát	tʰat˦˥
tháu	tʰăw˨˦
tháy	tʰăj˨˦
thâm	tʰɤ̆m˧˧
thân	tʰɤ̆n˧˧
thâu	tʰɤ̆w˧˧
thây	tʰɤ̆j˧˧
thè	tʰɛ˧˨
thèm	tʰɛm˧˨
thèn	tʰɛn˧˨
thèo	tʰeo˧˨
thép	tʰɛp˦˥
thét	tʰɛt˦˥
thê	tʰe˧˧
thêm	tʰem˧˧
thênh	tʰeŋ˧˧
thêu	tʰɛu˧˧
thì	tʰi˧˨
thìa	tʰiə˧˨
thình	tʰiŋ˧˨
thí	tʰi˨˦
thích	tʰik˦˥
thính	tʰiŋ˨˦
thít	tʰit˦˥
thò	tʰɔ˧˨
thòi	tʰɔj˧˨
thòm	tʰɔm˧˨
thòng	tʰɔŋm˧˨
thóa	tʰwa˨˦
thóc	tʰɔkp˦˥
thói	tʰɔj˨˦
thô	tʰo˧˧
thôi	tʰoj˧˧
thôn	tʰon˧˧
thông	tʰoŋm˧˧
thõng	tʰɔŋm˧ˀ˥
thù	tʰu˧˨
thùa	tʰuə˧˨
thùi	tʰuj˧˨
thùm	tʰum˧˨
thùn	tʰun˧˨
thùng	tʰuŋm˧˨
thùy	tʰuj˧˨
thú	tʰu˨˦
thúc	tʰukp˦˥
thúng	tʰuŋm˨˦
thút	tʰut˦˥
thăm	tʰăm˧˧
thăn	tʰăn˧˧
thăng	tʰăŋ˧˧
thũng	tʰuŋm˧ˀ˥
thơ	tʰɤ˧˧
thơm	tʰɤm˧˧
thơn	tʰɤn˧˧
thư	tʰɯ˧˧
thưa	tʰɯə˧˧
thưng	tʰɯŋ˧˧
thương	tʰɯəŋ˧˧
thước	tʰɯək˦˥
thướt	tʰɯət˦˥
thười	tʰɯəj˧˨
thườn	tʰɯən˧˨
thường	tʰɯəŋ˧˨
thưởng	tʰɯəŋ˧˩˨
thưỡn	tʰɯən˧ˀ˥
thược	tʰɯək˨ˀ˩
thượng	tʰɯəŋ˨ˀ˩ʔ
thạc	tʰak˨ˀ˩
thạch	tʰɛk˨ˀ˩
thạnh	tʰɛŋ˨ˀ˩ʔ
thạo	tʰaw˨ˀ˩ʔ
thả	tʰa˧˩˨
thải	tʰaj˧˩˨
thảm	tʰam˧˩˨
thản	tʰan˧˩˨
thảng	tʰaŋ˧˩˨
thảnh	tʰɛŋ˧˩˨
thảo	tʰaw˧˩˨
thảy	tʰăj˧˩˨
thấm	tʰɤ̆m˨˦
thấp	tʰɤ̆p˦˥
thất	tʰɤ̆t˦˥
thấu	tʰɤ̆w˨˦
thấy	tʰɤ̆j˨˦
thầm	tʰɤ̆m˧˨
thần	tʰɤ̆n˧˨
thầu	tʰɤ̆w˧˨
thầy	tʰɤ̆j˧˨
thẩm	tʰɤ̆m˧˩˨
thẩn	tʰɤ̆n˧˩˨
thẩu	tʰɤ̆w˧˩˨
thẫn	tʰɤ̆n˧ˀ˥
thậm	tʰɤ̆m˨ˀ˩ʔ
thận	tʰɤ̆n˨ˀ˩ʔ
thập	tʰɤ̆p˨ˀ˩
thật	tʰət˧˥
thật	tʰɤ̆t˨ˀ˩
thắc	tʰăk˦˥
thắm	tʰăm˨˦
thắng	tʰăŋ˨˦
thắp	tʰăp˦˥
thắt	tʰăt˦˥
thằn	tʰăn˧˨
thằng	tʰăŋ˧˨
thẳm	tʰăm˧˩˨
thẳng	tʰăŋ˧˩˨
thặng	tʰăŋ˨ˀ˩ʔ
thẹn	tʰɛn˨ˀ˩ʔ
thẹp	tʰɛp˨ˀ˩
thẻ	tʰɛ˧˩˨
thẽ	tʰɛ˧ˀ˥
thế	tʰe˨˦
thếp	tʰep˦˥
thết	tʰet˦˥
thề	tʰe˧˨
thềm	tʰem˧˨
thều	tʰɛu˧˨
thể	tʰe˧˩˨
thệ	tʰe˨ˀ˩ʔ
thỉ	tʰi˧˩˨
thỉnh	tʰiŋ˧˩˨
thị	tʰi˨ˀ˩ʔ
thịch	tʰik˨ˀ˩
thịnh	tʰiŋ˨ˀ˩ʔ
thịt	tʰit˨ˀ˩
thọ	tʰɔ˨ˀ˩ʔ
thọc	tʰɔkp˨ˀ˩
thỏ	tʰɔ˧˩˨
thỏa	tʰwa˧˩˨
thố	tʰo˨˦
thốc	tʰokp˦˥
thối	tʰoj˨˦
thốn	tʰon˨˦
thống	tʰoŋm˨˦
thốt	tʰot˦˥
thồ	tʰo˧˨
thồm	tʰom˧˨
thồn	tʰon˧˨
thổ	tʰo˧˩˨
thổi	tʰoj˧˩˨
thổn	tʰon˧˩˨
thỗn	tʰon˧ˀ˥
thộp	tʰop˨ˀ˩
thớ	tʰɤ˨˦
thới	tʰɤj˨˦
thớt	tʰɤt˦˥
thờ	tʰɤ˧˨
thời	tʰɤj˧˨
thờn	tʰɤn˧˨
thở	tʰɤ˧˩˨
thợ	tʰɤ˨ˀ˩ʔ
thụ	tʰu˨ˀ˩ʔ
thục	tʰukp˨ˀ˩
thụng	tʰuŋm˨ˀ˩ʔ
thụp	tʰup˨ˀ˩
thụt	tʰut˨ˀ˩
thụy	tʰuj˨ˀ˩ʔ
thủ	tʰu˧˩˨
thủa	tʰuə˧˩˨
thủi	tʰuj˧˩˨
thủng	tʰuŋm˧˩˨
thủy	tʰuj˧˩˨
thứ	tʰɨ˧˥
thứ	tʰɯ˨˦
thức	tʰɯk˦˥
thừa	tʰɯə˧˨
thừng	tʰɯŋ˧˨
thử	tʰɯ˧˩˨
thự	tʰɯ˨ˀ˩ʔ
thực	tʰɯk˨ˀ˩
ti	ti˧˧
tia	tiə˧˧
tim	tim˧˧
tin	tin˧˧
tinh	tiŋ˧˧
tiu	tiw˧˧
tiêm	tiəm˧˧
tiên	tiən˧˧
tiêng	tiəŋ˧˧
tiêu	tiəw˧˧
tiếc	tiək˦˥
tiếm	tiəm˨˦
tiến	tiən˨˦
tiếng	tiəŋ˨˦
tiếp	tiəp˦˥
tiết	tiət˦˥
tiếu	tiəw˨˦
tiềm	tiəm˧˨
tiền	tiən˧˨
tiều	tiəw˧˨
tiểu	tiəw˧˩˨
tiễn	tiən˧ˀ˥
tiễu	tiəw˧ˀ˥
tiệc	tiək˨ˀ˩
tiệm	tiəm˨ˀ˩ʔ
tiện	tiən˨ˀ˩ʔ
tiệp	tiəp˨ˀ˩
tiệt	tiət˨ˀ˩
to	tɔ˧˧
toa	twa˧˧
toan	twan˧˧
toang	twaŋ˧˧
toe	twe˧˧
toen	twen˧˧
toi	tɔj˧˧
tom	tɔm˧˧
ton	tɔn˧˧
tong	tɔŋm˧˧
toong	tɔŋm˧˧
top	tɔp˧˧
toà	twa˧˨
toàn	twan˧˨
toá	twa˨˦
toác	twak˦˥
toán	twan˨˦
toát	twat˦˥
toèn	twen˧˨
toé	twe˨˦
toét	twet˦˥
toòng	tɔŋm˧˨
toạ	twa˨ˀ˩ʔ
toạc	twak˨ˀ˩
toại	twaj˨ˀ˩ʔ
toả	twa˧˩˨
tra	ca˧˧
trai	caj˧˧
trang	caŋ˧˧
tranh	cɛŋ˧˧
trao	caw˧˧
trau	căw˧˧
tre	cɛ˧˧
treo	ceo˧˧
tri	ci˧˧
trinh	ciŋ˧˧
triêu	ciəw˧˧
triết	ciət˦˥
triền	ciən˧˨
triều	ciəw˧˨
triển	ciən˧˩˨
triệt	ciət˨ˀ˩
triệu	ciəw˨ˀ˩ʔ
tro	cɔ˧˧
trong	cɔŋm˧˧
tru	cu˧˧
trui	cuj˧˧
trung	cuŋm˧˧
truy	cwi˧˧
truyền	cwiən˧˨
truyện	cwiən˨ˀ˩ʔ
truân	cwɤ̆n˧˧
truông	cuəŋ˧˧
truất	cwɤ̆t˦˥
truồng	cuəŋ˧˨
truỵ	cwi˨ˀ˩ʔ
trà	ca˧˨
trài	caj˧˨
tràm	cam˧˨
tràn	can˧˨
tràng	caŋ˧˨
trào	caw˧˨
trày	căj˧˨
trá	ca˨˦
trác	cak˦˥
trách	cɛk˦˥
trái	caj˨˦
trám	cam˨˦
trán	can˨˦
tráng	caŋ˨˦
tránh	cɛŋ˨˦
tráo	caw˨˦
trát	cat˦˥
trâm	cɤ̆m˧˧
trân	cɤ̆n˧˧
trâng	cɤ̆ŋ˧˧
trâu	cɤ̆w˧˧
trây	cɤ̆j˧˧
trèn	cɛn˧˨
trèo	ceo˧˨
tréc	cɛk˦˥
trém	cɛm˨˦
tréo	ceo˨˦
trét	cɛt˦˥
trê	ce˧˧
trên	cen˧˧
trêu	cɛu˧˧
trì	ci˧˨
trình	ciŋ˧˨
trìu	ciw˧˨
trí	ci˨˦
trích	cik˦˥
trò	cɔ˧˨
tròi	cɔj˧˨
tròm	cɔm˧˨
tròn	cɔn˧˨
tròng	cɔŋm˧˨
tróc	cɔkp˦˥
trói	cɔj˨˦
tróm	cɔm˨˦
tróng	cɔŋm˨˦
trót	cɔt˦˥
trô	co˧˧
trôi	coj˧˧
trôn	con˧˧
trông	coŋm˧˧
trù	cu˧˨
trùi	cuj˧˨
trùm	cum˧˨
trùng	cuŋm˧˨
trú	cu˨˦
trúc	cukp˦˥
trúng	cuŋm˨˦
trút	cut˦˥
trăm	căm˧˧
trăn	căn˧˧
trăng	căŋ˧˧
trĩ	ci˧ˀ˥
trĩu	ciw˧ˀ˥
trơ	cɤ˧˧
trơn	cɤn˧˧
trưa	cɯə˧˧
trưng	cɯŋ˧˧
trương	cɯəŋ˧˧
trước	cɯək˦˥
trướng	cɯəŋ˨˦
trường	cɯəŋ˧˨
trưởng	cɯəŋ˧˩˨
trượng	cɯəŋ˨ˀ˩ʔ
trượt	cɯət˨ˀ˩
trạch	cɛk˨ˀ˩
trại	caj˨ˀ˩ʔ
trạm	cam˨ˀ˩ʔ
trạng	caŋ˨ˀ˩ʔ
trả	ca˧˩˨
trải	caj˧˩˨
trảm	cam˧˩˨
trảng	caŋ˧˩˨
trảo	caw˧˩˨
trấn	cɤ̆n˨˦
trất	cɤ̆t˦˥
trấu	cɤ̆w˨˦
trầm	cɤ̆m˧˨
trần	cɤ̆n˧˨
trầu	cɤ̆w˧˨
trầy	cɤ̆j˧˨
trẩu	cɤ̆w˧˩˨
trẩy	cɤ̆j˧˩˨
trẫm	cɤ̆m˧ˀ˥
trậm	cɤ̆m˨ˀ˩ʔ
trận	cɤ̆n˨ˀ˩ʔ
trập	cɤ̆p˨ˀ˩
trật	cɤ̆t˨ˀ˩
trắc	căk˦˥
trắm	căm˨˦
trắng	căŋ˨˦
trằm	căm˧˨
trằn	căn˧˨
trằng	căŋ˧˨
trẹo	ceo˨ˀ˩ʔ
trẹt	cɛt˨ˀ˩
trẻ	cɛ˧˩˨
trẽn	cɛn˧ˀ˥
trẽo	ceo˧ˀ˥
trết	cet˦˥
trếu	cɛu˨˦
trề	ce˧˨
trễ	ce˧ˀ˥
trệ	ce˨ˀ˩ʔ
trệt	cet˨ˀ˩
trệu	cɛu˨ˀ˩ʔ
trị	ci˨ˀ˩ʔ
trịch	cik˨ˀ˩
trịnh	ciŋ˨ˀ˩ʔ
trọ	cɔ˨ˀ˩ʔ
trọc	cɔkp˨ˀ˩
trọi	cɔj˨ˀ˩ʔ
trọn	cɔn˨ˀ˩ʔ
trọng	cɔŋm˨ˀ˩ʔ
trỏ	cɔ˧˩˨
trốc	cokp˦˥
trối	coj˨˦
trốn	con˨˦
trống	coŋm˨˦
trồng	coŋm˧˨
trổ	co˧˩˨
trổi	coj˧˩˨
trỗ	co˧ˀ˥
trỗi	coj˧ˀ˥
trộc	cokp˨ˀ˩
trội	coj˨ˀ˩ʔ
trộm	com˨ˀ˩ʔ
trộn	con˨ˀ˩ʔ
trớ	cɤ˨˦
trớn	cɤn˨˦
trớt	cɤt˦˥
trờ	cɤ˧˨
trời	cɤj˧˨
trờn	cɤn˧˨
trở	cɤ˧˩˨
trợ	cɤ˨ˀ˩ʔ
trợn	cɤn˨ˀ˩ʔ
trợt	cɤt˨ˀ˩
trụ	cu˨ˀ˩ʔ
trục	cukp˨ˀ˩
trụi	cuj˨ˀ˩ʔ
trụy	cuj˨ˀ˩ʔ
trủng	cuŋm˧˩˨
trứ	cɯ˨˦
trứng	cɯŋ˨˦
trừ	cɯ˧˨
trừng	cɯŋ˧˨
trừu	cɯw˧˨
trữ	cɯ˧ˀ˥
trực	cɯk˨ˀ˩
tu	tu˧˧
tua	tuə˧˧
tum	tum˧˧
tun	tun˧˧
tung	tuŋm˧˧
tuy	twi˧
tuy	twi˧˧
tuyên	twiən˧˧
tuyến	twiən˨˦
tuyết	twiət˦˥
tuyền	twiən˧˨
tuyển	twiən˧˩˨
tuyệt	twiət˨ˀ˩
tuân	twɤ̆n˧˧
tuôn	tuən˧˧
tuý	twi˨˦
tuýt	twit˦˥
tuấn	twɤ̆n˨˦
tuần	twɤ̆n˧˨
tuẫn	twɤ̆n˧ˀ˥
tuế	twe˨˦
tuếch	twek˦˥
tuềnh	tweŋ˧˨
tuệ	twe˨ˀ˩ʔ
tuệch	twek˨ˀ˩
tuốt	tuət˦˥
tuồn	tuən˧˨
tuồng	tuəŋ˧˨
tuổi	tuəj˧˩˨
tuột	tuət˨ˀ˩
tuỳ	twi˧˨
tuỷ	twi˧˩˨
ty	ti˧˧
tà	ta˧˨
tài	taj˧˨
tàm	tam˧˨
tàn	tan˧
tàn	tan˧˨
tàng	taŋ˧˨
tành	tɛŋ˧˨
tào	taw˧˨
tàu	tăw˧˨
tày	tăj˧˨
tá	ta˨˦
tác	tak˦˥
tách	tɛk˦˥
tái	taj˨˦
tám	tam˨˦
tán	tan˨˦
táng	taŋ˨˦
tánh	tɛŋ˨˦
táo	taw˨˦
táp	tap˦˥
tát	tat˦˥
táy	tăj˨˦
tâm	tɤ̆m˧˧
tân	tɤ̆n˧˧
tâng	tɤ̆ŋ˧˧
tâu	tɤ̆w˧˧
tây	tɤ̆j˧˧
tã	ta˧ˀ˥
tè	tɛ˧˨
tèm	tɛm˧˨
tèn	tɛn˧˨
tèng	tɛŋ˧˨
tèo	teo˧˨
té	tɛ˨˦
tén	tɛn˨˦
tép	tɛp˦˥
tê	te˧˧
têm	tem˧˧
tên	ten˧˧
tên	tən˧
tênh	teŋ˧˧
tì	ti˧˨
tìm	tim˧˨
tình	tiŋ˧
tình	tiŋ˧˨
tí	ti˨˦
tía	tiə˨˦
tích	tik˦˥
tím	tim˨˦
tín	tin˨˦
tính	tiŋ˨˦
típ	tip˦˥
tít	tit˦˥
tíu	tiw˨˦
tò	tɔ˧˨
tòa	twa˧˨
tòm	tɔm˧˨
tòn	tɔn˧˨
tòng	tɔŋm˧˨
tóc	tɔkp˦˥
tóe	twe˨˦
tóm	tɔm˨˦
tóp	tɔp˦˥
tót	tɔt˦˥
tô	to˧˧
tô-pô	to˧˧-po˧˧
tô-tem	to˧˧-tɛm˧˧
tôi	toj˧
tôi	toj˧˧
tôm	tom˧˧
tôn	ton˧˧
tông	toŋm˧˧
tù	tu˧˨
tùm	tum˧˨
tùng	tuŋm˧˨
tùy	tuj˧˨
tú	tu˨˦
túc	tukp˦˥
túi	tuj˨˦
túm	tum˨˦
túng	tuŋm˨˦
túp	tup˦˥
túy	tuj˨˦
tăm	tăm˧˧
tăng	tăŋ˧˧
tĩnh	tiŋ˧ˀ˥
tơ	tɤ˧˧
tơi	tɤj˧˧
tư	tɨ˧
tư	tɯ˧˧
tưng	tɯŋ˧˧
tươi	tɯəj˧˧
tươm	tɯəm˧˧
tương	tɯəŋ˧˧
tước	tɯək˦˥
tưới	tɯəj˨˦
tướng	tɯəŋ˨˦
tướt	tɯət˦˥
tườm	tɯəm˧˨
tường	tɯəŋ˧˨
tườu	tɯəw˧˨
tưởng	tɯəŋ˧˩˨
tượng	tɯəŋ˨ˀ˩ʔ
tạ	ta˨ˀ˩ʔ
tạc	tak˨ˀ˩
tại	taj˨ˀ˩ʔ
tạm	tam˧˨
tạm	tam˨ˀ˩ʔ
tạng	taŋ˨ˀ˩ʔ
tạnh	tɛŋ˨ˀ˩ʔ
tạo	taw˨ˀ˩ʔ
tạp	tap˨ˀ˩
tạt	tat˨ˀ˩
tả	ta˧˩˨
tải	taj˧˩˨
tản	tan˧˩˨
tảng	taŋ˧˩˨
tảo	taw˧˩˨
tấc	tɤ̆k˦˥
tấm	tɤ̆m˨˦
tấn	tɤ̆n˨˦
tấp	tɤ̆p˦˥
tất	tət˧˥
tất	tɤ̆t˦˥
tấu	tɤ̆w˨˦
tầm	təm˧
tầm	tɤ̆m˧˨
tần	tɤ̆n˧˨
tầng	tɤ̆ŋ˧˨
tầu	tɤ̆w˧˨
tầy	tɤ̆j˧˨
tẩm	tɤ̆m˧˩˨
tẩn	tɤ̆n˧˩˨
tẩu	tɤ̆w˧˩˨
tẩy	tɤ̆j˧˩˨
tậm	tɤ̆m˨ˀ˩ʔ
tận	tɤ̆n˨ˀ˩ʔ
tập	tɤ̆p˨ˀ˩
tật	tɤ̆t˨ˀ˩
tậu	tɤ̆w˨ˀ˩ʔ
tắc	tăk˦˥
tắm	tăm˨˦
tắp	tăp˦˥
tắt	tat˧˥
tắt	tăt˦˥
tằm	tăm˧˨
tằn	tăn˧˨
tằng	tăŋ˧˨
tẳn	tăn˧˩˨
tặc	tăk˨ˀ˩
tặng	tăŋ˨ˀ˩ʔ
tẹp	tɛp˨ˀ˩
tẹt	tɛt˨ˀ˩
tẻ	tɛ˧˩˨
tẻo	teo˧˩˨
tẽn	tɛn˧ˀ˥
tế	te˨˦
tếch	tek˦˥
tết	tet˦˥
tếu	tɛu˨˦
tề	te˧˨
tềnh	teŋ˧˨
tể	te˧˩˨
tễ	te˧ˀ˥
tệ	te˨ˀ˩ʔ
tỉ	ti˧˩˨
tỉa	tiə˧˩˨
tỉm	tim˧˩˨
tỉnh	tiŋ˧˩˨
tỉu	tiw˧˩˨
tị	ti˨ˀ˩ʔ
tịch	tik˨ˀ˩
tịnh	tiŋ˨ˀ˩ʔ
tịt	tit˨ˀ˩
tọa	twa˨ˀ˩ʔ
tọc	tɔkp˨ˀ˩
tọt	tɔt˨ˀ˩
tỏ	tɔ˧˩˨
tỏa	twa˧˩˨
tỏi	tɔj˧˩˨
tỏm	tɔm˧˩˨
tỏng	tɔŋm˧˩˨
tố	to˨˦
tốc	tokp˦˥
tối	toj˨˦
tốn	ton˨˦
tống	toŋm˨˦
tốp	top˦˥
tốt	tot˦˥
tốt	tot˧˥
tồ	to˧˨
tồi	toj˧˨
tồm	tom˧˨
tồn	ton˧˨
tồng	toŋm˧˨
tổ	to˧˩˨
tổn	ton˧˩˨
tổng	toŋm˧˩˨
tộc	tokp˨ˀ˩
tộc-ngôn	tokp˨ˀ˩-ŋon˧˧
tội	toj˨ˀ˩ʔ
tột	tot˨ˀ˩
tớ	tɤ˨˦
tới	tɤj˨˦
tớn	tɤn˨˦
tờ	tɤ˧˨
tở	tɤ˧˩˨
tởm	tɤm˧˩˨
tợn	tɤn˨ˀ˩ʔ
tụ	tu˨ˀ˩ʔ
tục	tukp˨ˀ˩
tụi	tuj˨ˀ˩ʔ
tụm	tum˨ˀ˩ʔ
tụng	tuŋm˨ˀ˩ʔ
tụt	tut˨ˀ˩
tụy	tuj˨ˀ˩ʔ
tủ	tu˧˩˨
tủa	tuə˧˩˨
tủi	tuj˧˩˨
tủm	tum˧˩˨
tủn	tun˧˩˨
tủng	tuŋm˧˩˨
tủy	tuj˧˩˨
tứ	tɯ˨˦
tức	tɯk˦˥
từ	tɨ˧˨
từ	tɯ˧˨
từa	tɯə˧˨
từng	tɯŋ˧˨
tử	tɯ˧˩˨
tửu	tɯw˧˩˨
tự	tɯ˨ˀ˩ʔ
tựa	tɯə˨ˀ˩ʔ
tựu	tɯw˨ˀ˩ʔ
tỳ	ti˧˨
tỵ	ti˨ˀ˩ʔ
tỷ	ti˧˩˨
u	u˧˧
ui	uj˧˧
um	um˧˧
un	un˧˧
ung	uŋm˧˧
uy	wi˧˧
uyên	wiən˧˧
uyển	wiən˧˩˨
uôm	uəm˧˧
uông	uəŋ˧˧
uý	wi˨˦
uất	wɤ̆t˦˥
uẩn	wɤ̆n˧˩˨
uế	we˨˦
uể	we˧˩˨
uốn	uən˨˦
uống	uəŋ˨˦
uổng	uəŋ˧˩˨
uỳnh	wiŋ˧˨
uỷ	wi˧˩˨
va	va˧˧
vai	vaj˧˧
van	van˧˧
vang	vaŋ˧
vang	vaŋ˧˧
vanh	vɛŋ˧˧
vay	văj˧˧
ve	vɛ˧˧
ven	vɛn˧˧
veo	veo˧˧
vi	vi˧˧
vi-rút	vi˧˧-zut˦˥
vi-đê-ô	vi˧˧-de˧˧-o˧˧
vin	vin˧˧
vinh	viŋ˧˧
viêm	viəm˧˧
viên	viən˧˧
viên	vɪən˧
viêng	viəŋ˧˧
viêt	vjet˧
viếng	viəŋ˨˦
viết	viət˦˥
viển	viən˧˩˨
viễn	viən˧ˀ˥
việc	viək˨ˀ˩
viện	viən˨ˀ˩ʔ
việt	viət˨ˀ˩
việt-nam	viət˨ˀ˩-nam˧˧
vo	vɔ˧˧
voi	vɔj˧˧
von	vɔn˧˧
vong	vɔŋm˧˧
voọc	vɔkp˨ˀ˩
vu	vu˧˧
vua	vuə˧˧
vui	vuj˧˧
vun	vun˧˧
vung	vuŋm˧˧
vuông	vuəŋ˧˧
vuốt	vuət˦˥
vuột	vuət˨ˀ˩
vy	vi˧˧
và	vaː˧˨
và	va˧˨
vài	vaj˧˨
vàm	vam˧˨
vàn	van˧˨
vàng	vaŋ˧˨
vành	vɛŋ˧˨
vào	vaw˧˨
vày	văj˧˨
vá	va˨˦
vác	vak˦˥
vách	vɛk˦˥
vái	vaj˨˦
ván	van˨˦
váng	vaŋ˨˦
váy	văj˨˦
vân	vɤ̆n˧˧
vâng	vɤ̆ŋ˧˧
vây	vɤ̆j˧˧
vã	va˧ˀ˥
vãi	vaj˧ˀ˥
vãn	van˧ˀ˥
vãng	vaŋ˧ˀ˥
vè	vɛ˧˨
vèo	veo˧˨
vé	vɛ˨˦
véc	vɛk˦˥
vén	vɛn˨˦
véo	veo˨˦
vét	vɛt˦˥
vê	ve˧˧
vên	ven˧˧
vênh	veŋ˧˧
vêu	vɛu˧˧
vì	vi˧˨
ví	vi˨˦
vía	viə˨˦
vò	vɔ˧˨
vòi	vɔj˧˨
vòm	vɔm˧˨
vòn	vɔn˧˨
vòng	vɔŋm˧˨
vó	vɔ˨˦
vóc	vɔkp˦˥
vót	vɔt˦˥
vô	vo˧˧
vôi	voj˧˧
vôn	von˧˧
vông	voŋm˧˧
võ	vɔ˧ˀ˥
võng	vɔŋm˧ˀ˥
vù	vu˧˨
vùa	vuə˧˨
vùi	vuj˧˨
vùn	vun˧˨
vùng	vuŋm˧˨
vú	vu˨˦
vúc	vukp˦˥
vút	vut˦˥
văn	văn˧˧
văng	văŋ˧˧
vĩ	vi˧ˀ˥
vĩnh	viŋ˧ˀ˥
vũ	vu˧ˀ˥
vũ	vu˧˨
vũng	vuŋm˧ˀ˥
vơ	vɤ˧˧
vơi	vɤj˧˧
vưu	vɯw˧˧
vươn	vɯən˧˧
vương	vɯəŋ˧˧
vướng	vɯəŋ˨˦
vườn	vɯən˧˨
vượn	vɯən˨ˀ˩ʔ
vượng	vɯəŋ˨ˀ˩ʔ
vượt	vɯət˨ˀ˩
vạ	va˨ˀ˩ʔ
vạc	vak˨ˀ˩
vạch	vɛk˨ˀ˩
vạm	vam˨ˀ˩ʔ
vạn	van˨ˀ˩ʔ
vạt	vat˨ˀ˩
vạy	văj˨ˀ˩ʔ
vả	va˧˩˨
vải	vaj˧˩˨
vảy	văj˧˩˨
vấn	vɤ̆n˨˦
vấp	vɤ̆p˦˥
vất	vɤ̆t˦˥
vấy	vɤ̆j˨˦
vần	vɤ̆n˧˨
vầng	vɤ̆ŋ˧˨
vầy	vɤ̆j˧˨
vẩn	vɤ̆n˧˩˨
vẫn	văn˧˨
vẫn	vɤ̆n˧ˀ˥
vẫy	vɤ̆j˧ˀ˥
vậm	vɤ̆m˨ˀ˩ʔ
vận	vɤ̆n˨ˀ˩ʔ
vập	vɤ̆p˨ˀ˩
vật	vɤ̆t˨ˀ˩
vậy	vɤ̆j˨ˀ˩ʔ
vắn	văn˨˦
vắng	văŋ˨˦
vắt	văt˦˥
vằm	văm˧˨
vằn	văn˧˨
vằng	văŋ˧˨
vặc	văk˨ˀ˩
vặn	văn˨ˀ˩ʔ
vặt	văt˨ˀ˩
vẹc	vɛk˨ˀ˩
vẹn	vɛn˨ˀ˩ʔ
vẹo	veo˨ˀ˩ʔ
vẹt	vɛt˨ˀ˩
vẻ	vɛ˧˩˨
vẻn	vɛn˧˩˨
vẽ	vɛ˧ˀ˥
vết	vet˦˥
về	ve˧˨
vền	ven˧˨
vểnh	veŋ˧˩˨
vệ	ve˨ˀ˩ʔ
vỉ	vi˧˩˨
vỉa	viə˧˩˨
vị	vi˧˨
vị	vi˨ˀ˩ʔ
vịt	vit˨ˀ˩
vọ	vɔ˨ˀ˩ʔ
vọc	vɔkp˨ˀ˩
vọng	vɔŋm˨ˀ˩ʔ
vọp	vɔp˨ˀ˩
vọt	vɔt˨ˀ˩
vỏ	vɔ˧˩˨
vỏn	vɔn˧˩˨
vốn	von˨˦
vồ	vo˧˨
vồi	voj˧˨
vồn	von˧˨
vỗ	vo˧ˀ˥
vội	voj˨ˀ˩ʔ
vớ	vɤ˨˦
với	vɤj˨˦
vớt	vɤt˦˥
vờ	vɤ˧˨
vời	vɤj˧˨
vở	vɤ˧˩˨
vỡ	vɤ˧ˀ˥
vợ	və˧˨
vợ	vɤ˨ˀ˩ʔ
vụ	vu˧˨
vụ	vu˨ˀ˩ʔ
vụn	vun˨ˀ˩ʔ
vụng	vuŋm˨ˀ˩ʔ
vụt	vut˨ˀ˩
vứt	vɯt˦˥
vừa	vɯə˧˨
vừng	vɯŋ˧˨
vữa	vɯə˧ˀ˥
vững	vɯŋ˧ˀ˥
vựa	vɯə˨ˀ˩ʔ
vực	vɯk˨ˀ˩
vựng	vɯŋ˨ˀ˩ʔ
xa	saː˧
xa	sa˧˧
xa,	saː˧
xam	sam˧˧
xanh	sɛŋ˧˧
xao	saw˧˧
xay	săj˧˧
xe	sɛ˧
xe	sɛ˧˧
xem	sɛm˧
xem	sɛm˧˧
xen	sɛn˧˧
xeo	seo˧˧
xi	si˧˧
xin	sin˧
xin	sin˧˧
xinh	siŋ˧˧
xiêm	siəm˧˧
xiên	siən˧˧
xiêu	siəw˧˧
xiết	siət˦˥
xiếu	siəw˨˦
xiềng	siəŋ˧˨
xiểm	siəm˧˩˨
xiển	siən˧˩˨
xiểng	siəŋ˧˩˨
xo	sɔ˧˧
xoa	swa˧˧
xoai	swaj˧˧
xoan	swan˧˧
xoang	swaŋ˧˧
xoay	swăj˧˧
xoen	swen˧˧
xoi	sɔj˧˧
xom	sɔm˧˧
xon	sɔn˧˧
xong	sɔŋm˧˧
xoong	sɔŋm˧˧
xoài	swaj˧˨
xoàn	swan˧˨
xoàng	swaŋ˧˨
xoành	swɛŋ˧˨
xoá	swa˨˦
xoáy	swăj˨˦
xoèn	swen˧˨
xoăn	swăn˧˧
xoạc	swak˨ˀ˩
xoắn	swăn˨˦
xoẳn	swăn˧˩˨
xu	su˧˧
xua	suə˧˧
xui	suj˧˧
xum	sum˧˧
xun	sun˧˧
xung	suŋm˧˧
xuy	swi˧˧
xuyên	swiən˧˧
xuân	swɤ̆n˧˧
xuê	swe˧˧
xuôi	suəj˧˧
xuý	swi˨˦
xuýt	swit˦˥
xuất	swɤ̆t˦˥
xuẩn	swɤ̆n˧˩˨
xuề	swe˧˨
xuềnh	sweŋ˧˨
xuệch	swek˨ˀ˩
xuống	suəŋ˨˦
xuồng	suəŋ˧˨
xà	sa˧˨
xài	saj˧˨
xàm	sam˧˨
xàng	saŋ˧˨
xành	sɛŋ˧˨
xào	saw˧˨
xá	sa˨˦
xác	sak˦˥
xách	sɛk˦˥
xái	saj˨˦
xám	sam˨˦
xán	san˨˦
xáo	saw˨˦
xáp	sap˦˥
xát	sat˦˥
xâm	sɤ̆m˧˧
xâu	sɤ̆w˧˧
xây	sɤ̆j˧˧
xã	sa˧ˀ˥
xè	sɛ˧˨
xèn	sɛn˧˨
xèo	seo˧˨
xé	sɛ˨˦
xén	sɛn˨˦
xéo	seo˨˦
xép	sɛp˦˥
xét	sɛt˦˥
xê	se˧˧
xênh	seŋ˧˧
xì	si˧˨
xình	siŋ˧˨
xìu	siw˧˨
xí	si˨˦
xích	sik˦˥
xín	sin˨˦
xính	siŋ˨˦
xít	sit˦˥
xíu	siw˨˦
xòm	sɔm˧˨
xòng	sɔŋm˧˨
xó	sɔ˨˦
xóc	sɔkp˦˥
xói	sɔj˨˦
xóm	sɔm˨˦
xóp	sɔp˦˥
xót	sɔt˦˥
xô	so˧˧
xô-viết	so˧˧-viət˦˥
xôi	soj˧˧
xôm	som˧˧
xôn	son˧
xôn	son˧˧
xông	soŋm˧˧
xõng	sɔŋm˧ˀ˥
xù	su˧˨
xùm	sum˧˨
xùng	suŋm˧˨
xú	su˨˦
xúc	sukp˦˥
xúi	suj˨˦
xúm	sum˨˦
xúng	suŋm˨˦
xúp	sup˦˥
xăm	săm˧˧
xăn	săn˧˧
xăng	săŋ˧˧
xơ	sɤ˧˧
xơi	sɤj˧˧
xơn	sɤn˧˧
xưa	sɯə˧˧
xưng	sɯŋ˧˧
xương	sɯəŋ˧˧
xước	sɯək˦˥
xướng	sɯəŋ˨˦
xười	sɯəj˧˨
xường	sɯəŋ˧˨
xưởng	sɯəŋ˧˩˨
xạ	sa˨ˀ˩ʔ
xạc	sak˨ˀ˩
xạch	sɛk˨ˀ˩
xạu	săw˨ˀ˩ʔ
xả	sa˧˩˨
xảo	saw˧˩˨
xảy	săj˧˩˨
xấc	sɤ̆k˦˥
xấp	sɤ̆p˦˥
xấu	sɤ̆w˨˦
xầm	sɤ̆m˧˨
xầu	sɤ̆w˧˨
xẩm	sɤ̆m˧˩˨
xẩn	sɤ̆n˧˩˨
xẩy	sɤ̆j˧˩˨
xậm	sɤ̆m˨ˀ˩ʔ
xập	sɤ̆p˨ˀ˩
xắc	săk˦˥
xắm	săm˨˦
xắn	săn˨˦
xằng	săŋ˧˨
xẵng	săŋ˧ˀ˥
xẹo	seo˨ˀ˩ʔ
xẹp	sɛp˨ˀ˩
xẻ	sɛ˧˩˨
xẻn	sɛn˧˩˨
xẻng	sɛŋ˧˩˨
xế	se˨˦
xếch	sek˦˥
xếp	sep˦˥
xề	se˧˨
xềm	sem˧˨
xềnh	seŋ˧˨
xều	sɛu˧˨
xệch	sek˨ˀ˩
xệu	sɛu˨ˀ˩ʔ
xỉ	si˧˩˨
xỉa	siə˧˩˨
xỉu	siw˧˩˨
xị	si˨ˀ˩ʔ
xịu	siw˨ˀ˩ʔ
xọ	sɔ˨ˀ˩ʔ
xọc	sɔkp˨ˀ˩
xỏ	sɔ˧˩˨
xỏng	sɔŋm˧˩˨
xốc	sokp˦˥
xối	soj˨˦
xốn	son˨˦
xống	soŋm˨˦
xốp	sop˦˥
xốt	sot˦˥
xồm	som˧˨
xồn	son˧˨
xồng	soŋm˧˨
xổ	so˧˩˨
xổi	soj˧˩˨
xổn	son˧˩˨
xổng	soŋm˧˩˨
xộc	sokp˨ˀ˩
xộn	son˨ˀ˩ʔ
xớ	sɤ˨˦
xới	sɤj˨˦
xớn	sɤn˨˦
xớt	sɤt˦˥
xờ	sɤ˧˨
xờm	sɤm˧˨
xởi	sɤj˧˩˨
xợp	sɤp˨ˀ˩
xụ	su˨ˀ˩ʔ
xục	sukp˨ˀ˩
xụi	suj˨ˀ˩ʔ
xủ	su˧˩˨
xủng	suŋm˧˩˨
xứ	sɯ˨˦
xức	sɯk˦˥
xứng	sɯŋ˨˦
xử	sɯ˧˩˨
xửa	sɯə˧˩˨
xửng	sɯŋ˧˩˨
y	i˧˧
yêm	iɛm˧˧
yên	iɛn˧˧
yêng	iɛŋ˧˧
yêu	iəw˧˧
yếm	iɛm˨˦
yến	iɛn˨˦
yết	iɛt˦˥
yếu	iəw˨˦
yểm	iɛm˧˩˨
yểng	iɛŋ˧˩˨
yểu	iəw˧˩˨
à	a˧˨
ành	ɛŋ˧˨
ào	aw˧˨
á	a˨˦
ác	ak˦˥
ác-bít	ak˦˥-bit˦˥
ác-ten	ak˦˥-tɛn˧˧
ách	ɛk˦˥
ái	aj˨˦
ám	am˨˦
án	an˨˦
áng	aŋ˨˦
ánh	ɛŋ˨˦
áo	aw˨˦
áp	ap˦˥
át	at˦˥
áy	ăj˨˦
â	ɤ̆˧˧
âm	ɤ̆m˧˧
ân	ɤ̆n˧˧
âu	ɤ̆w˧˧
è	ɛ˧˨
èng	ɛŋ˧˨
èo	eo˧˨
é	ɛ˨˦
éc	ɛk˦˥
ém	ɛm˨˦
én	ɛn˨˦
éo	eo˨˦
ép	ɛp˦˥
ét	ɛt˦˥
ê	e˧˧
êm	em˧˧
êu	ɛu˧˧
ì	i˧˨
ìn	in˧˨
ình	iŋ˧˨
í	i˨˦
ích	ik˦˥
ít	it˦˥
ò	ɔ˧˨
òi	ɔj˧˨
òm	ɔm˧˨
òng	ɔŋm˧˨
ó	ɔ˨˦
óc	ɔkp˦˥
ói	ɔj˨˦
óng	ɔŋm˨˦
óp	ɔp˦˥
ót	ɔt˦˥
ô	o˧˧
ô-tô	o˧˧-to˧˧
ôi	oj˧˧
ôm	om˧˧
ôn	on˧˧
ông	oŋm˧˧
õng	ɔŋm˧ˀ˥
ù	u˧˨
ùa	uə˧˨
ùm	um˧˨
ùn	un˧˨
ùng	uŋm˧˨
ú	u˨˦
úa	uə˨˦
úc	ukp˦˥
úi	uj˨˦
úm	um˨˦
úng	uŋm˨˦
úp	up˦˥
út	ut˦˥
ý	i˨˦
ý	ʔi˧˥
ăm	ăm˧˧
ăn	ăn˧˧
ăng	ăŋ˧˧
đa	da˧˧
đai	daj˧˧
đam	dam˧˧
đan	dan˧˧
đang	daŋ˧˧
đanh	dɛŋ˧˧
đao	daw˧˧
đau	dăw˧˧
đay	dăj˧˧
đe	dɛ˧˧
đem	dɛm˧˧
đen	dɛn˧˧
đeo	deo˧˧
đi	di˧
đi	di˧˧
đinh	diŋ˧˧
điên	diən˧˧
điêu	diəw˧˧
điếc	diək˦˥
điếm	diəm˨˦
điếu	diəw˨˦
điềm	diəm˧˨
điền	diən˧˨
điều	diəw˧˨
điểm	diəm˧˩˨
điển	diən˧˩˨
điểu	diəw˧˩˨
điện	diən˨ˀ˩ʔ
điệp	diəp˨ˀ˩
điệu	diəw˨ˀ˩ʔ
đo	dɔ˧˧
đoan	dwan˧˧
đoi	dɔj˧˧
đom	dɔm˧˧
đon	dɔn˧˧
đong	dɔŋm˧˧
đoàn	dwan˧˨
đoàng	dwaŋ˧˨
đoành	dwɛŋ˧˨
đoái	dwaj˨˦
đoán	dwan˨˦
đoạ	dwa˨ˀ˩ʔ
đoạn	dwan˨ˀ˩ʔ
đoạt	dwat˨ˀ˩
đoản	dwan˧˩˨
đoảng	dwaŋ˧˩˨
đu	du˧˧
đua	duə˧˧
đui	duj˧˧
đum	dum˧˧
đun	dun˧˧
đung	duŋm˧˧
đuôi	duəj˧˧
đuềnh	dweŋ˧˨
đuểnh	dweŋ˧˩˨
đuễnh	dweŋ˧ˀ˥
đuốc	duək˦˥
đuối	duəj˨˦
đuồn	duən˧˨
đuổi	duəj˧˩˨
đà	da˧˨
đài	daj˧˨
đàm	dam˧˨
đàn	dan˧˨
đàng	daŋ˧˨
đành	dɛŋ˧˨
đào	daw˧˨
đày	dăj˧˨
đá	da˨˦
đách	dɛk˦˥
đái	daj˨˦
đám	dam˨˦
đáng	daŋ˨˦
đánh	dɛŋ˨˦
đáo	daw˨˦
đáp	dap˦˥
đáy	dăj˨˦
đâm	dɤ̆m˧˧
đâu	dɤ̆w˧˧
đây	dɤ̆j˧˧
đã	da˧ˀ˥
đãi	daj˧ˀ˥
đãng	daŋ˧ˀ˥
đè	dɛ˧˨
đèm	dɛm˧˨
đèn	dɛn˧˨
đèo	deo˧˨
đéo	deo˨˦
đê	de˧˧
đêm	dem˧˧
đêm	ɗem˧
đì	di˧˨
đình	diŋ˧˨
đìu	diw˧˨
đí	di˨˦
đích	dik˦˥
đính	diŋ˨˦
đít	dit˦˥
đò	dɔ˧˨
đòi	dɔj˧˨
đòm	dɔm˧˨
đòn	dɔn˧˨
đòng	dɔŋm˧˨
đó	dɔ˨˦
đói	dɔj˨˦
đóm	dɔm˨˦
đón	dɔn˨˦
đóng	dɔŋm˨˦
đô	do˧˧
đôi	doj˧
đôi	doj˧˧
đôm	dom˧˧
đôn	don˧˧
đông	doŋm˧˧
đông-nam	doŋm˧˧-nam˧˧
đù	du˧˨
đùa	duə˧˨
đùi	duj˧˨
đùm	dum˧˨
đùn	dun˧˨
đùng	duŋm˧˨
đú	du˨˦
đúc	dukp˦˥
đún	dun˨˦
đúng	duŋm˨˦
đút	dut˦˥
đăm	dăm˧˧
đăng	dăŋ˧˧
đĩ	di˧ˀ˥
đĩa	diə˧ˀ˥
đĩnh	diŋ˧ˀ˥
đũa	duə˧ˀ˥
đũng	duŋm˧ˀ˥
đơm	dɤm˧˧
đơn	dɤn˧˧
đưa	dɯə˧˧
đương	dɯəŋ˧˧
đười	dɯəj˧˨
đườn	dɯən˧˨
đường	dɯəŋ˧˨
được	dɯək˨ˀ˩
được	ɗɯək˧˥
đượm	dɯəm˨ˀ˩ʔ
đạc	dak˨ˀ˩
đại	daj˨ˀ˩ʔ
đạm	dam˨ˀ˩ʔ
đạn	dan˨ˀ˩ʔ
đạo	daw˨ˀ˩ʔ
đạp	dap˨ˀ˩
đạt	dat˨ˀ˩
đạt-lai	dat˨ˀ˩-laj˧˧
đả	da˧˩˨
đảm	dam˧˩˨
đản	dan˧˩˨
đảng	daŋ˧˩˨
đảo	daw˧˩˨
đấm	dɤ̆m˨˦
đấng	dɤ̆ŋ˨˦
đất	dɤ̆t˦˥
đấu	dɤ̆w˨˦
đấy	dɤ̆j˨˦
đầm	dɤ̆m˧˨
đần	dɤ̆n˧˨
đầu	dɤ̆w˧˨
đầy	dɤ̆j˧˨
đẩu	dɤ̆w˧˩˨
đẩy	dɤ̆j˧˩˨
đẫm	dɤ̆m˧ˀ˥
đẫn	dɤ̆n˧ˀ˥
đẫy	dɤ̆j˧ˀ˥
đậm	dɤ̆m˨ˀ˩ʔ
đận	dɤ̆n˨ˀ˩ʔ
đập	dɤ̆p˨ˀ˩
đậu	dɤ̆w˨ˀ˩ʔ
đậy	dɤ̆j˨ˀ˩ʔ
đắc	dăk˦˥
đắm	dăm˨˦
đắn	dăn˨˦
đắng	dăŋ˨˦
đắp	dăp˦˥
đắt	dăt˦˥
đằm	dăm˧˨
đằng	dăŋ˧˨
đẳng	dăŋ˧˩˨
đẵm	dăm˧ˀ˥
đặc	dăk˨ˀ˩
đặm	dăm˨ˀ˩ʔ
đặt	dăt˨ˀ˩
đẹn	dɛn˨ˀ˩ʔ
đẹp	dɛp˨ˀ˩
đẹt	dɛt˨ˀ˩
đẻ	dɛ˧˩˨
đẽo	deo˧ˀ˥
đế	de˨˦
đếch	dek˦˥
đếm	dem˨˦
đến	den˨˦
đề	de˧˨
đền	den˧˨
đềnh	deŋ˧˨
đều	dɛu˧˨
để	de˧˩˨
đểnh	deŋ˧˩˨
đểu	dɛu˧˩˨
đễnh	deŋ˧ˀ˥
đệ	de˨ˀ˩ʔ
đệm	dem˨ˀ˩ʔ
đỉa	diə˧˩˨
đỉnh	diŋ˧˩˨
địa	diə˨ˀ˩ʔ
địch	dik˨ˀ˩
định	diŋ˨ˀ˩ʔ
địt	dit˨ˀ˩
đọ	dɔ˨ˀ˩ʔ
đọa	dwa˨ˀ˩ʔ
đọc	dɔkp˨ˀ˩
đọi	dɔj˨ˀ˩ʔ
đọng	dɔŋm˨ˀ˩ʔ
đỏ	dɔ˧˩˨
đỏm	dɔm˧˩˨
đỏng	dɔŋm˧˩˨
đố	do˨˦
đốc	dokp˦˥
đốc-tơ	dokp˦˥-tɤ˧˧
đối	doj˨˦
đốm	dom˨˦
đốn	don˨˦
đống	doŋm˨˦
đốp	dop˦˥
đốt	dot˦˥
đồ	do˧˨
đồi	doj˧˨
đồm	dom˧˨
đồn	don˧˨
đồng	doŋm˧˨
đổ	do˧˩˨
đổi	doj˧˩˨
đổng	doŋm˧˩˨
đỗ	do˧ˀ˥
đỗ	ɗo˧˨
độ	do˨ˀ˩ʔ
độc	dokp˨ˀ˩
đội	doj˨ˀ˩ʔ
độn	don˨ˀ˩ʔ
động	doŋm˨ˀ˩ʔ
độp	dop˨ˀ˩
đột	dot˨ˀ˩
đớ	dɤ˨˦
đới	dɤj˨˦
đớn	dɤn˨˦
đớp	dɤp˦˥
đờ	dɤ˧˨
đờ-mi	dɤ˧˨-mi˧˧
đời	dɤj˧˨
đờn	dɤn˧˨
đởm	dɤm˧˩˨
đỡ	də˧˨
đỡ	dɤ˧ˀ˥
đỡ	ɗə˧˨
đợ	dɤ˨ˀ˩ʔ
đợi	dɤj˨ˀ˩ʔ
đụ	du˨ˀ˩ʔ
đục	dukp˨ˀ˩
đụn	dun˨ˀ˩ʔ
đụng	duŋm˨ˀ˩ʔ
đủ	du˧˩˨
đủng	duŋm˧˩˨
đứ	dɯ˨˦
đứa	dɯə˨˦
đức	dɯk˦˥
đức	ɗɯk˧˥
đứng	dɯŋ˨˦
đứt	dɯt˦˥
đừng	dɯŋ˧˨
đử	dɯ˧˩˨
đực	dɯk˨ˀ˩
đựng	dɯŋ˨ˀ˩ʔ
ĩnh	iŋ˧ˀ˥
ơ	ɤ˧˧
ơi	ɤj˧˧
ơn	ɤn˧˧
ư	ɯ˧˧
ưa	ɯə˧˧
ưng	ɯŋ˧˧
ưu	ɯw˧˧
ươi	ɯəj˧˧
ươm	ɯəm˧˧
ươn	ɯən˧˧
ương	ɯəŋ˧˧
ước	ɯək˦˥
ướm	ɯəm˨˦
ướp	ɯəp˦˥
ướt	ɯət˦˥
ưỡn	ɯən˧ˀ˥
ạ	a˨ˀ˩ʔ
ạ	ʔa˧˨
ạch	ɛk˨ˀ˩
ạo	aw˨ˀ˩ʔ
ả	a˧˩˨
ải	aj˧˩˨
ảm	am˧˩˨
ảnh	ɛŋ˧˩˨
ảo	aw˧˩˨
ấm	ɤ̆m˨˦
ấm	ʔəm˧˥
ấn	ɤ̆n˨˦
ấp	ɤ̆p˦˥
ấp	ʔəp˧˥
ất	ɤ̆t˦˥
ấu	ɤ̆w˨˦
ấy	ɤ̆j˨˦
ầm	ɤ̆m˧˨
ầu	ɤ̆w˧˨
ẩm	ɤ̆m˧˩˨
ẩn	ɤ̆n˧˩˨
ẩn	ʔən˧
ẩu	ɤ̆w˧˩˨
ẫm	ɤ̆m˧ˀ˥
ậm	ɤ̆m˨ˀ˩ʔ
ập	ɤ̆p˨ˀ˩
ắc	ăk˦˥
ắc-coóc	ăk˦˥-kɔkp˦˥
ắng	ăŋ˨˦
ắt	ăt˦˥
ằng	ăŋ˧˨
ẳng	ăŋ˧˩˨
ẵm	ăm˧ˀ˥
ặc	ăk˨ˀ˩
ẹ	ɛ˨ˀ˩ʔ
ẹc	ɛk˨ˀ˩
ẹo	eo˨ˀ˩ʔ
ẻo	eo˧˩˨
ẽo	eo˧ˀ˥
ế	e˨˦
ếch	ek˦˥
ề	e˧˨
ềnh	eŋ˧˨
ễng	eŋ˧ˀ˥
ễnh	eŋ˧ˀ˥
ỉ	i˧˩˨
ỉa	iə˧˩˨
ỉm	im˧˩˨
ỉu	iw˧˩˨
ị	i˨ˀ˩ʔ
ịt	it˨ˀ˩
ọ	ɔ˨ˀ˩ʔ
ọc	ɔkp˨ˀ˩
ọp	ɔp˨ˀ˩
ọt	ɔt˨ˀ˩
ỏe	we˧˩˨
ỏi	ɔj˧˩˨
ỏm	ɔm˧˩˨
ỏn	ɔn˧˩˨
ỏng	ɔŋm˧˩˨
ố	o˨˦
ốc	okp˦˥
ối	oj˨˦
ốm	om˨˦
ốm	ʔom˧
ống	oŋm˨˦
ốp	op˦˥
ốt	ot˦˥
ồ	o˧˨
ồi	oj˧˨
ồm	om˧˨
ồn	on˧˨
ồng	oŋm˧˨
ổ	o˧˩˨
ổi	oj˧˩˨
ổm	om˧˩˨
ổn	on˧˩˨
ộ	o˨ˀ˩ʔ
ộc	okp˨ˀ˩
ộn	on˨ˀ˩ʔ
ộp	op˨ˀ˩
ớ	ɤ˨˦
ớn	ɤn˨˦
ớt	ɤt˦˥
ờ	ɤ˧˨
ời	ɤj˧˨
ờn	ɤn˧˨
ở	ɤ˧˩˨
ỡm	ɤm˧ˀ˥
ợ	ɤ˨ˀ˩ʔ
ụ	u˨ˀ˩ʔ
ụa	uə˨ˀ˩ʔ
ục	ukp˨ˀ˩
ụt	ut˨ˀ˩
ủ	u˧˩˨
ủi	uj˧˩˨
ủn	un˧˩˨
ủng	uŋm˧˩˨
ủy	uj˧˩˨
ứ	ɯ˨˦
ứa	ɯə˨˦
ức	ɯk˦˥
ứng	ɯŋ˨˦
ừ	ɯ˧˨
ừng	ɯŋ˧˨
ửng	ɯŋ˧˩˨
ỷ	i˧˩˨
