a	a
à	a
aba	apə
abaich	apɪç
abair	apɪɾʲ
abhag	afak
abhainn	aɪɲ
abhainn	awɪɲ
aca	aʰkə
acair	axkɪɾʲ
acaire	axkɪɾʲə
acasan	aʰkəs̪ən̪
acfhainn	axkɪɲ
achadh	ax
achadh	axəɣ
acras	aʰkʰɾəs̪
adag	at̪ak
adha	ɤə
àdhamh	aːɣəv
adhar	aəɾ
adharc	ɤəɾk
adhbharaich	ɤːvəɾɪç
adhbhar	ɤːvəɾ
adhbran	ɤːpɾan
adhbrann	ɤːpɾən̪ˠ
a	ə
afganastan	afɣanəst̪aːn
afghanastàn	afɣanəst̪aːn
agad	aət̪
agad	aɣəd
agad	ajət̪
agad	akət̪
agad	at̪
agadsa	ajət̪s̪ə
agadsa	akət̪s̪ə
agadsa	at̪s̪ə
ag	ag
agaibh	akɪ
agaibh	akɪv
agaibh	aku
agaibhse	akɪs̪ə
agaibhse	akɪvʃə
agaibhse	akuʃə
againn	aɣɪɲ
againn	aɪɲ
againn	akɪɲ
againn	aɲ
againne	akɪɲə
agair	akɪrʲ
agairt	akɪɾʲtʲ
agallamh	akəl̪ˠəv
agam	aəm
agam	aɣəm
agam	akəm
agam	am
agamsa	akəməs̪
agamsa	akəms̪ə
agamsa	aməs̪
agamsa	ams̪ə
aghaidh	ɤːɪ
agus	aɣəs
agus	akəs
aibhne	aivɲɪ
aice	ɛʰkʲə
aicese	ɛʰkʲəʃə
àicheadh	aːçəɣ
àicheidh	aːçɪ
aifreann	afrʲənˠ
aigeal	akʲəl̪ˠ
aige	ɛkʲə
aigesan	ɛkʲəs̪ən̪
aig	ɛkʲ
àigh	aːj
aighearach	aɪərəx
aigne	acɲə
aigneas	akʲn̪əs̪
ailbheanan	ɛl̪ɛvanən
ailbhean	ɛl̪ɛvan
ailbhein	ɛl̪ɛvɛɲ
àilean	aːlan
ailean	alan
ailean	ɛlɛn
ailidh	alɪ
ailig	alɪkʲ
ailis	alɪʃ
àille	aːʎə
àilleachd	aːʎəxk
àilleadh	aːʎəɣ
aillse	aɪlʃʲə
ailm	alam
ailp	aɫp
ailt	altʲ
ailtire	aʎtʲɪɾʲə
aimhleas	ãĩləs̪
aimhreid	aivɾʲɪtʲ
aimsir	ɛmɛʃɪɾʲ
aimsir	ɛmiʃɪɾʲ
ainbheach	ɛnɛvəx
aindeònach	aɲɔnəx
aingeal	ãĩŋʲəl̪ˠ
aingeal	ãĩŋʲkʲəl̪ˠ
ainm	anam
ainm	ɛnɛm
ainm	ɛɾʲɛm
ainmich	ɛnɛmjɪç
ainneamh	an̪ˠəv
ainneartaich	aɲəɾʃt̪ɪç
ainneart	aɲəɾʃt̪
aintighearna	aɲdʲɪjərˠn̪ˠə
aintighearnas	aɲdʲɪjərˠn̪ˠəs
àird	aːɾʃt̪
àirde	aːrˠtʲə
àireamh	aːɾʲəv
àireamhair	aːɾʲəvɛɾʲ
àireamhairean	aːɾʲəvɛɾʲən
àireamhan	aːɾʲəvən
aire	aɾʲə
air	ɛrʲ
airgead	ɛɾʲɛkʲət
airidh	arʲɪ
àirigh	aːɾʲɪ
airson	ərs̪ɔn
aiseag	aʃək
àisia	ɛːʃə
aisling	aʃlɪgʲ
aisling	aʃlɪɲ
aisling	aʃlɪŋʲgʲ
aiste	aʃtʲə
aistese	aʃtʲəʃə
àite	aːʰtʰʲɪ
àiteach	aːhtʲəx
aithne	aɲə
aithris	aɾʲɪʃ
aitreabh	ahtʰʲɾʲəv
àl	aːl̪ˠ
àlainn	aːɫ̪ɪɲ
àlainneachd	aːl̪ˠɪɲəxk
àlas	aːl̪ˠəs̪
alasdair	al̪ˠəs̪t̪ɪɾʲ
alba	al̪ˠəpə
albàinis	aɫ̪pɛːnɪʃ
albannach	al̪ˠapən̪ˠəx
alcolach	aɫ̪kʰɔɫ̪ax
alcol	aɫ̪kʰɔɫ̪
allaidh	aɫi
allas	al̪ˠəs̪
allmharach	al̪ˠavərəx
allt	auɫ̪t
amadan	amat̪an
amaideach	amatʲəx
amaideachd	amətʲəxk
àm	ãũm
amh	af
àmhainn	aːvɪɲ
amharc	ãũəɾk
amharc	ãvəɾk
amhran	ãũɾan
anabarrach	anaparˠəx
analachadh	ənaləxə
anam	anam
an	an
an	ən
angaidh	aŋkɪ
anmhann	anavən̪ˠ
anmoch	anaməx
anna	an̪ˠa
anna	an̪ˠə
annad	an̪ˠət̪
annad	un̪ˠət̪
annag	an̪ˠak
annaibh	an̪ˠɪv
annaibh	un̪ˠɪ
annaibh	un̪ˠɪv
annaibh	un̪ˠu
annainn	an̪ˠɪɲ
annainn	un̪ˠɪɲ
annam	an̪ˠəm
annam	un̪ˠəm
annasach	an̪ˠəs̪əx
ann	aun̪ˠ
ann	ãũn̪ˠ
anndra	ãũn̪ˠt̪ɾə
annta	an̪ˠt̪ə
annta	ɔun̪ˠt̪ə
annta	uːn̪ˠt̪ə
aodach	ɯːt̪əx
aodann	ɯːt̪ən̪ˠ
aodh	ɯːɣ
aoghaire	ɯːɛɾʲ
aoibhinn	ɤivɪɲ
aoibhneas	ɤjɲəs
aoigh	ɯiʲ
aoine	ɯːɲə
aonair	ɯ̃ːnəɾʲ
aonar	ɔ̃ːnəɾ
aonar	ɯ̃ːnəɾ
aon	ən
aonghas	n̪ˠɯəs̪
aonghas	ɯnɯəs̪
aontamhachd	ɯːn̪t̪ʰəvəxk
aontamhach	ɯːn̪t̪ʰəvəx
aon	ɯ̃ːn
aosda	ɯstə
aotrom	ɯːtɾəm
aotruime	ɯːtɾɪmə
àrach	aːɾəx
ar	aɾ
àras	aːɾəs̪
arbhar	aɾavəɾ
àrc	aːɾxk
arcaibh	aɾxkɪv
arc	arxk
àrd	aːrˠsˠt̪
àrd	aːrˠt̪
àrd	aːrʃt̪
ar	əɾn
arm	aɾam
arsa	arˠs̪ə
arsa	ɔrˠs̪ə
art	arˠʃt̪
art	arˠt̪
asad	as̪ət̪
asadsa	as̪ət̪s̪ə
asaibh	as̪əv
asaibhse	as̪əvʃə
asainn	as̪ɪɲ
asainne	as̪ɪɲə
asal	as̪al̪ˠ
asam	as̪əm
asamsa	as̪əms̪ə
asarbaideàn	asərpɪdʲaːn
às	as̪
asgaidh	as̪kɪ
asta	as̪t̪ə
astasan	as̪təs̪ən
athair	ahəɾʲ
athchuinge	axɪɲcə
babaidh	papɪ
bab	pap
bacach	paxkəx
bacadh	paʰkəɣ
bachall	paxəl̪ˠ
bachrain	baxrɛɲ
baga	bakə
bagairt	pakərʃtʲ
bàgh	paːɣ
bàidh	paːj
baile	palə
baile	pɛlə
bàillidh	paːʎi
bainne	paɲə
bainne	pɛɲə
bainne	pɔɲə
baintighearna	bantʃjarnə
bàirneach	paːɾʲɲəx
baisteadh	paʃtʲəɣ
baist	paʃtʲ
balach	pal̪ˠəx
balaich	pal̪ˠɪç
balbh	pal̪ˠav
balg	pal̪ˠak
balla	paɫ̪ə
ball	paul̪ˠ
banachdaichean	banəxgəxʲən
banail	pɑnəl
banais	pan̪ˠɪʃ
banais	pɛn̪ˠɪʃ
bann	paun̪ˠ
bàn	paːn
baoghalta	bɯːəltə
baoiseachd	pɯːʃaxk
baoth	pɯː
barabal	paɾapəl̪ˠ
barail	baral
bàrd	paːrˠʃt̪
barraigh	baraj
barra	parˠə
bàrr	paːrˠ
basan	pas̪an
basan	pas̪ən
basgaid	paskɪtʲ
bàs	paːs̪
bàta	paːʰt̪ə
bata	paʰtə
bathar	pahar
bàth	paː
beachan	pɛxan
beachdan	pɛxkən
beachd	pɛxk
beach	pɛx
beagan	pekan
beag	pek
bealach	pjaɫ̪əx
bealaidh	pɛl̪ˠɪ
bealaruisis	bjal̪ˠəruʃɪʃ
bealltainn	b̥jauɫ̪t̪ɪɲ
beann	pjaun̪ˠ
beanntan	pjãũn̪ˠt̪ən
bean	pɛn
beàrnaraigh	pjaːrˠn̪ˠaɾaj
beàrnaraigh	pjaun̪ˠt̪ɾaj
beàrn	pjaːrˠn̪ˠ
beartach	pjarˠʃtəx
beart	pjarˠʃt̪
beathach	pɛhəx
beathag	pɛhak
beathaichean	pɛhɪçən
beathan	pʲahan
beatha	pɛhə
beileag	pelak
beilear	bel̪əɾ
beileas	bel̪əs̪
beilg	əvelekʲ
beingidh	peiŋʲkʲɪ
being	peiŋʲkʲ
beinne	peɲə
beinn	peiɲ
beinn	pɤiɲ
beithir	peɪɾʲ
beith	peh
beò	pjɔː
beul	piaɫ̪
beurla	bjɤːrˠl̪ˠə
beusach	peːsəx
beus	peːs
bhalaich	val̪ˠɪç
bhall	vaul̪ˠ
bhatarsaigh	vahtərˠs̪aj
bhatar	vaʰt̪əɾ
bhathar	vaəɾ
bhathas	vaəs̪
bha	va
bha	vaː
bheachd	vɛxk
bheag	vek
bheag	vik
bhealach	vjaɫ̪əx
bhean	vɛn
bheatha	vɛhə
bheilear	vel̪əɾ
bheileas	vel̪əs̪
bheil	vel̪
bheinn	veiɲ
bheir	veɾʲ
bhiodh	vəɣ
bhiodh	viɣ
bhiodh	vjəɣ
bhiomaid	vimɪtʲ
bhios	vəs̪
bhitheadh	viəɣ
bhitheamaid	viəmɪtʲ
bhitheas	viəs̪
bhithinn	vihiɲ
bhithinn	viɪɲ
bhith	vih
bhi	vi
bhlàth	vl̪ˠaː
bhogsa	voks̪ə
bhon	vɔn̪ˠ
bhotal	vɔhtəl̪ˠ
bho	vɔ
bhreab	vɾʲep
bhreatainn	vɾʲɛht̪ɪɲ
bhriogais	vɾʲikɪʃ
bhriseadh	vɾʲiʃəɣ
bhriste	vɾʲiʃtʲə
bhris	vɾʲiʃ
bhruichealachd	vɾuçəl̪ˠəxk
bhruich	vɾuç
bhruidhinn	vɾiɪɲ
bhuail	vuɪl
bhuam	vuəm
bhuat	vuəht̪
bhuidhe	vujə
bhunadh	vunəɣ
bhuntàta	vən̪ˠt̪ʰaːht̪ə
bhun	vun
biadh	piəɣ
biastag	piəstak
bidh	pi
bidse	pɪtʲə
bigein	pikʲɪɲ
binn	piːɲ
bioda	bidə
bìodach	piːtəx
biodh	piɣ
biomaid	pimɪtʲ
bioran	pɪɾan
bior	piɾ
bi	pi
bi	piː
bir	piɾʲ
bitear	piʰtʲəɾ
bitheadh	piəɣ
bitheamaid	piəmɪtʲ
bitheam	piəm
bithear	piəɾ
bitheas	piəs̪
bithibh	piɪv
bithidh	pihi
bithinn	pihiɲ
blàr	bɫ̪aːɾ
blasta	pl̪ˠas̪t̪ə
blàth	pl̪ˠaː
bleideag	pletʲak
bliadhna	bliən̪ˠə
blialam	pliəɫ̪əm
bliochdan	plixkan
bòcan	bɔːxgan
bocan	bɔxgan
bòc	pɔːxk
boc	pɔxk
bodach	pɔt̪əx
bodhaig	poɪkʲ
bodhar	poəɾ
bod	pɔt
bògas	pɔːkəs
bogha	poə
bogsa	poks̪ə
bòid	b̊ɔːd̊ʲ
bòidhchead	pɔːçət̪
bòidheach	pɔːjəx
bòid	pɔːtʲ
boireannach	pɔɾʲən̪ˠəx
boireann	pɔɾʲən̪ˠ
bòl	pɔːɫ̪
bonaid	pɔnatʲ
bonnach	bonəx
bonn	pɔun̪ˠ
bó	poː
bò	poː
borb	pɔrɔp
bòrd	pɔːɾʃt̪
botal	pɔhtəl̪ˠ
bòtann	pɔːhtən̪ˠ
bothan	pɔhan
b	p
bracaist	pɾaxkəʃtʲ
bradan	pɾatan
braim	pɾɤim
brama	pɾamə
branndaidh	pɾãũn̪ˠt̪ɪ
braon	pɾɯːn
brà	pɾaː
bratach	pɾaht̪əx
bratag	prahtak
brath	pɾah
brat	pɾaht̪
breabadh	pɾʲepəɣ
breab	pɾʲep
breacag	pɾʲɛxkak
breac	pɾʲɛxk
brèagha	pɾʲiə
breatainn	pɾʲɛht̪ɪɲ
breisleachail	brɛʃlʲaxal
breith	pɾʲeh
briathar	pɾʲiəhəɾ
briathrach	prʲiərəx
brice	prʲiʰkʰʲə
brìde	pɾʲiːt̪ʲə
brìghde	pɾʲiːʝtʲə
briogais	pɾʲikɪʃ
briosgaid	pɾʲiskɪtʲ
briseadh	pɾʲiʃəɣ
brisg	pɾʲiʃc
bris	pɾʲiʃ
briste	pɾʲiʃtʲə
britheamh	pɾʲihəv
brocail	pɾɔxkal
brochan	pɾɔxan
broc	pɾɔʰk
brògan	pɾɔːkən
bròg	pɾɔːk
broilleach	pɾɔʎəx
broinn	pɾəiɲ
brònach	pɾɔːnəx
brot	pɾɔht̪
bruach	pɾuə̯x
bruadair	pɾuət̪ɪɾʲ
bruadar	pɾuət̪əɾ
bruichealachd	pɾuçəl̪ˠəxk
bruicheile	pruçalə
bruicheil	pruçal
bruich	pɾuç
bruic	pɾuçkʲ
brùid	b̥ruːdʲ
bruidhinn	pɾiɪɲ
bruidhnibh	pɾiɲɪv
bruis	pɾuʃ
buabhaill	puəəl
buabhall	puəəl̪ˠ
buachaill	puəçɪʎ
buadhair	puəɣɛɾʲ
buaidh	puəj
buail	puɪl
buain	puəɲ
bualadh	puəl̪ˠəɣ
buannachadh	puən̪ˠəxəɣ
buannaich	puən̪ˠɪç
buan	puən
buidhe	pujə
buidseachd	budʲʃəxg
buille	puʎə
buinneach	puɲəx
bunadh	punəɣ
bun	pun
buntàta	pən̪ˠt̪aːht̪ə
bu	pu
bùrach	puːrəx
bùrn	puːrˠn̪ˠ
burras	pʊrˠəs
bus	pəs̪
bus	pus̪
bùth	puː
cabadaich	kʰapət̪ɪç
cabar	kʰapəɾ
cabhag	kʰavak
cabhlach	kʰauɫ̪əx
cabhsair	kʰaus̪ɪɾʲ
cachaileith	kʰaxələ
càch	kʰaːx
cac	kʰaxk
cadal	kʰat̪aɫ̪
caidil	kʰatʲɪl
caidlidh	kʰatʲliɣ
caidreach	kʰatʲɾʲəx
caifean	kɛfan
caifein	kʰafɛɲ
cailc	kʰalçc
caileag	kʰalak
cailean	kʰalan
càil	kʰaːl
cailleach	kʰaʎəx
cailleannach	kʰaʎan̪ˠəx
caill	kʰaiʎ
caillte	kʰaiʎtʰʲɪ
caimbeul	kʰaimpəl̪ˠ
càineadh	kʰaːɲəɣ
càin	kʰaːɲ
cainnt	kʰaiɲtʰʲ
càirdeach	kʰaːrtʲəx
càirdean	kʰaːrˠtʲən
càirdeil	kʰaːrtʲal
cairteal	kʰarˠʃtʲal
cairt	kʰarˠʃtʲ
càise	kʰaːʃə
caisteal	kʰaʃtʲɛl̪ˠ
càite	kʰaːhtʲə
caitheamh	kʰɛhəv
caith	kʰɛh
càit	kʰaːhtʲ
càit'	kʰaːhtʲ
cait	kʰɛʰtʲ
cà	kʰaː
càl	kʰaːl̪ˠ
call	kʰaul̪ˠ
calltainn	kʰauɫ̪t̪ʰɪɲ
calma	kʰal̪ˠamə
calman	kʰaɫ̪aman
calpach	kʰal̪ˠpəx
caluim	kʰal̪ˠɪm
calum	kʰal̪ˠəm
caman	kaman
camara	kʰamaɾˠa
càmhal	kãːəl̪ˠ
cam	kaːm
cam	kʰaum
campadh	kʰãũmpəɣ
campa	kʰaumpʰə
camshron	kamarən
canaidh	kʰanɪ
canail	kanal
cana	kʰanə
cànan	kʰaːnan
cangaru	kʰaŋkəɾu
cangaruthan	kʰaŋkəɾuhən̪ˠ
cantail	kan̪ˠt̪al
cantainn	kan̪ˠt̪ɪɲ
caodachan	kʰɯːdəxan
caogad	kʰɯːkət̪
caog	kʰɯːk
caoile	kʰɯːlə
caoimhe	kɤivə
caoimhe	kʰɤivə
caoimhneas	kʰɯivɲəs̪
caoin	kʰɯːɲ
caol	kʰɯːɫ̪
caomh	kʰɯːv
caoraich	kʰɯːɾɪç
caora	kʰɯːɾə
capall	kʰahpəl̪ˠ
caractar	kʰaɾəkt̪əɾ
caraich	kʰaɾɪç
caraid	kʰaɾɪtʲ
caran	kʰaɾan
carbad	kʰaɾəpat̪
carbaid	kaɾˠəbˠədʲ
carbaid	kʰaɾəpɛtʲ
carghas	kʰaɾaəs̪
càr	kʰaːɾ
càrnadh	kʰaːɾnəɣ
càrn	kʰaːrˠn̪ˠ
carraig	kʰarˠɪc
carson	kʰarˠs̪ɔn
carthannas	kʰarˠən̪ˠəsˠ
casag	kʰasak
casaid	kasadʲ
casan	kʰas̪an
casan	kʰas̪ən
cas	kʰas
castan	kʰas̪t̪an
cathair	kʰahɪɾʲ
cath	kah
cat	kʰaʰt̪
catrìona	kʰatʰɾiənə
catrìona	kʰɔtʰɾiənə
cead	kʲʰet̪
ceanaidh	kʰenɪ
ceana	kʲʰɛnə
ceangail	kʲʰɛ̃al
ceangailte	kʲʰɛ̃əltʲə
ceangal	kʲʰɛ̃əl̪ˠ
ceannach	cʰan̪ˠəx
ceannaich	kʰʲan̪ˠɪç
ceannard	kʰʲan̪ˠaɾʃt̪
ceannasach	kʰʲan̪ˠəs̪əx
ceann	kʲʰaun
ceapaire	kʲʰɛhpəɾʲə
ceap	kʲʰɛhp
cearbanan	kʲʰaɾapanən
cearbanan	kʲʰɛɾɛpanən
cearban	kʲʰaɾapan
cearban	kʲʰɛɾɛpan
cearc	kʲʰɛrˠxk
cearclach	kʰʲɛrxkl̪ˠəx
ceàrnach	kʰʲaːrˠn̪ˠəx
cearr	kʰʲaːrˠ
ceàrr	kʲʰaːrˠ
ceart	kʲʰarˠs̪t̪
ceart	kʲʰarˠʃt̪
ceart	kʲʰarˠt̪
ceart	kʲʰas̪t̪
ceart	kʲʰɛs̪t̪
ceatharnach	cʰɛhərˠn̪ˠəx
ceathrad	cʰɛɾət̪
ceathraran	kʰʲɛɾəɾən
ceathrar	cʰɛɾəɾ
cèile	kʰʲeːlə
cèilidh	kʲʰeːli
ceilp	cʰelp
ceilpe	cʰelpə
ceilteach	cʰeltʲəx
cèireach	kʰʲeːɾʲəx
ceistean	cʰeʃtʲən
ceiteag	kʰehtʲak
cèitean	cʰeːhtʲan
ceithir	kʲehɪɾʲ
ceitidh	kʰeht̪ɪ
ceitidh	kʰehtʲɪ
ceit	kʰehtʲ
ceò	kʰʲɔː
ceòl	kʲʰɔːɫ̪
ceòthach	kʲɔːəx
ceudamh	kʰʲeːt̪əv
ceud	kʰʲiat̪
ceum	kʰʲeːm
chabar	xapəɾ
chaidh	xaɪ
chaidil	xatʲɪl
chaidreach	xatʲɾʲəx
chaill	xaiʎ
chaimbeul	xaimpəl̪ˠ
chàirdean	xaːrˠtʲən
chaitheamh	xɛhəv
chait	xɛʰtʲ
chaluim	xal̪ˠɪm
chalum	kʰal̪ˠəm
chamara	xamaɾˠa
chaneil	χanjel
chan	xan̪ˠ
chan	xaɲ
chaol	xɯːɫ̪
charactar	xaɾəkt̪əɾ
cha	xa
cheana	çɛnə
cheannaich	çan̪ˠɪç
chèitean	çeːhtʲan
chiad	çiə̯t̪
chian	xʲian
chiar	çʰiaɾ
chidsin	çitʲʃɪn
chirce	çiɾ̥cə
chladhaire	xl̪ˠɤɪɾʲə
chlas	xl̪ˠas̪
chlì	xliː
chnoc	xɾɔ̃xk
choinneamh	xɤɲəv
choire	xɤɾʲə
choire	xɔɾʲə
chòir	xɔːɾʲ
chompanaidh	xɔ̃ũmpənɪ
chom	xɔum
chorp	xɔɾp
chor	xɔɾ
chostagan	xɔst̪akan
chostag	xɔst̪ak
chostaige	xɔst̪ɛkʲə
cho	xɔ
chrannachan	xɾan̪ˠəxan
chreach	çɾʲɛx
chreid	çɾʲetʲ
chreid	çɾʲɤtʲ
chruth	xɾuh
chuairt	xuərˠʃtʲ
chuala	xuəl̪ˠə
chudromach	xut̪rəməx
chuimrigh	xumuɾɪ
chùirt	xuːrˠʃtʲ
chumail	xumal
chùm	xuːm
chunnaic	xun̪ˠɪc
chunnt	xũːn̪ˠt̪
chus	xus̪
ciad	kʲʰiə̯t̪
ciallach	kʰʲiəl̪ˠəx
ciall	kʰʲiaɫ̪
ciamar	kʰʲɪmaɾ
cian	kʰʲian
ciar	cʰiaɾ
cidhe	cʰiə
cidsin	kʲʰitʲʃɪn
cìl	kʰʲiːl
cill	cʰiːʎ
cinn	kʲʰiːɲ
cinnteach	kʰʲĩːɲtʲəx
cinnte	kʰʲĩːɲtʲə
cìobair	kʲʰiːpɛɾʲ
cìoch	kʰʲiəx
cion	cʲin
cionnas	kʰʲũn̪ˠəs̪
cionn	kʰʲũːn̪ˠ
ciontach	cʰin̪ˠt̪əx
ciorstaidh	kʲirˠs̪t̪ɪ
ciorstan	kʲirˠs̪t̪an
cipean	kʰʲiʰpʰan
cìr	kʰʲiːɾʲ
ciùil	kʰʲuːl
ciùin	kʰʲuːɲ
ciùrradh	kʰʲuːrˠəɣ
ciùrr	kʰʲuːrˠ
c	kʰ
clachair	kʰl̪ˠaxɛɾʲ
clach	kʰl̪ˠax
clàdan	kʰl̪ˠaːt̪an
cladhach	kʰl̪ˠɤəx
cladhaire	kʰl̪ˠɤɪɾʲə
cladh	kʰl̪ˠɤɣ
clàideag	kʰl̪ˠaːtʲak
claidheamh	kʰl̪ˠajəv
claigeann	kʰl̪ˠacən̪ˠ
clamhan	kʰl̪ˠavan
clann	kʰl̪ˠaun̪ˠ
claon	kʰl̪ˠɯːn
clàrsair	kʰlaːɻʂɛɾʲ
clas	kʰl̪ˠas̪
cleachdadh	kʰlɛxkəɣ
cleachd	kʰlɛxk
cleasaiche	kʰles̪ɪçə
cleas	kʰles
cleiteag	kʎeːhtʲak
cleiteag	kʎeːtʲak
cliabh	kliəv
cliath	kʰliə
clì	kʰliː
clis	kʰliʃ
cliùiteach	kʰluːhtʲəx
clobhd	kʰl̪ˠɔut̪
clòimhneag	kʰl̪ˠɔ̃ːɲak
cluichd	kʰl̪ˠuçkʲ
cluicheadair	kʰl̪ˠuçətɛrʲ
cluiche	kʰl̪ˠuçə
cluich	kʰl̪ˠɪç
cluinneadh	kɫ̪ɯɲəɣ
cluinntinn	kʰl̪ˠɯ̃ĩɲtʲɪɲ
cnagadh	kʰɾãkəɣ
cnàg	kʰɾ̃ãːk
cnag	kʰɾãk
cnàimh	kʰɾɛ̃ːv
cnàmh	kʰɾãːv
cnàmhlach	kʰrˠãːvl̪ˠəx
cnatan	kʰɾãhtan
cneap	krɛʰp
cneasda	kʰʲrʲes̪t̪ə
cneas	kʰɾʲẽs̪
cneasta	krʲes̪t̪ə
cnèatag	kʰɾiaʰt̪ʰak
cnoc	kʰɾɔ̃xk
cnòthan	kɾɔːən
cobhan	kʰoan
còcaireachd	kʰɔːxkɛɾʲəxk
còcaire	kʰɔːxkəɾʲə
cofaidh	kʰɔfɪ
cogadh	kʰokəɣ
coibhneil	kʰɤiɲal
còig	kʰoːkʲ
còignear	kʰoːkʲəɾ
còignear	kʰoːkʲɲəɾ
cóigneir	kʰoːkʲəɾʲ
coileach	kʰɤləx
coilleag	kʰɤʎak
coille	kʰɤʎə
coimheach	kʰɛ̃əx
coimheach	kʰɔ̃jəx
coimhead	kʰɔ̃jət̪
coimhearsnach	kʰɔ̃jərˠs̪n̪ˠəx
coimpiutair	kʰəmpʰjutʰəɾʲ
coineanach	kʰɔɲanəx
coinneach	kʰɤɲəx
coinneal	kʰɤɲəl̪ˠ
coinneamh	kʰɤɲəv
coinnlear	kɤ̃ĩɲʎɛr
coirce	kʰɔɾʲçkʲə
coire	kʰɤɾʲə
coire	kʰɔɾʲə
còir	kʰɔːɾʲ
coiseachd	kʰɔʃəxk
coisridh	kɔʃɾiː
colainn	kʰɔl̪ˠəɲ
colaiste	kʰɔɫ̪ɪʃtʲə
colann	kʰɔl̪ˠən̪ˠ
coll	kʰɔul̪ˠ
coltach	kʰɔl̪ˠəx
coltach	kʰɔl̪ˠt̪əx
coltas	kɔl̪ˠəs
coltas	kɔl̪ˠt̪əs
coma	kʰomə
comannach	kʰomən̪ˠəx
comann	kʰomən̪ˠ
comasach	kʰoməs̪əx
comhairle	kʰɔ̃ərˠʎə
comhaois	kɔɯːʃ
comhaois	kɯːʃ
còmhdhail	kʰɔ̃ːal
còmhdhail	kʰɔ̃ːɣal
còmhla	kʰɔ̃ːl̪ˠə
còmhla	kʰɔ̃ːl̪ˠəɣ
còmhlan	kʰɔ̃ːl̪ˠan
còmhnard	kɔ̃ːnərˠd
còmhrag	kʰɔ̃ːɾak
com	kʰɔum
companaidh	kʰɔ̃ũmpənɪ
connadh	kʰɔn̪ˠəɣ
connsachail	kʰɔ̃ũn̪ˠs̪əxal
connspaideach	kʰɔ̃ũn̪ˠs̪pɪtʲəx
consan	kʰɔns̪an
copar	kʰɔhpəɾ
cop	kʰɔhp
cor	kʰɔɾ
còrnais	kʰɔːrˠn̪ˠɪʃ
corp	kʰɔɾp
corrag	kʰɔrˠak
còrr	kʰɔːrˠ
cosail	kʰɔs̪al
cosgais	kosgɪʃ
cosg	kʰɔs̪k
cosnadh	kʰɔs̪n̪ˠəɣ
costagan	kʰɔst̪akan
costag	kʰɔst̪ak
costaige	kʰɔst̪ɛkʲə
cothromach	kʰɔrˠəməx
craic	kʰɾɛçc
craicte	kʰrɛçdʲə
crannachan	kʰɾan̪ˠəxan
crann	kʰɾau̯n̪ˠ
craobh	kʰɾɯːv
craoladh	kʰɾɯːl̪ˠəɣ
craosach	kʰɾɯːs̪əx
craos	kʰɾɯːs̪
creach	kʲʰɾʲɛx
creagan	kʰɾekən
creag	kʰɾek
creamh	kʰɾʲɛ̃v
creid	kʲʰɾʲetʲ
creid	kʲʰɾʲɤtʲ
crè	kʰrɛː
creutair	kʰɾeːʰt̪ɛɾʲ
cridheil	kʰɾʲial
cridhe	kʰɾʲiə
crìoch	kʰɾʲiəx
criosaidh	kʰɾʲis̪ɪ
crìosd	kʰɾʲiəs̪t̪
crios	kʰɾʲis̪
croch	kʰɾɔx
crodh	kʰɾoː
crogall	kʰɾˠokəl̪ˠ
cròileagan	krɔːlagan
cròilean	kʰɾɔːlan
croit	kʰɾohtʲ
croit	kʰɾɔhtʲ
croladh	kʰɾɔl̪ˠəɣ
crolaidh	kʰɾɔl̪ˠɪ
cromach	kroməx
crom	kʰɾɔum
cronaich	kʰɾɔnɪç
crosta	kʰɾɔs̪t̪ə
cròthais	əxrɔːɪʃ
cròthaisis	kʰɾɔːɪʃɪʃ
cruachan	kʰɾuəxan
cruachan	kʰɾuəxən
cruach	kʰɾuəx
cruadhtan	kʰɾuəjt̪an
cruaidh	kʰɾuəj
crùbag	kʰɾuːpak
cruidh	kʰɾɯj
cruinn	kʰruɪɲ
cruithneachd	kʰɾɯɲəxk
crùn	kruːn
cruthachail	kʰɾuhəxal
cruthaich	kʰɾuhɪç
cruth	kɾuh
cuaigear	kʰuəkʲəɾ
cuairt	kʰuərˠʃtʲ
cuala	kʰuəl̪ˠə
cuan	kʰuan
cudromach	kʰut̪ɾəməx
cudrom	kʰut̪rəm
cuideachadh	kʰutʲəxəɣ
cuideachail	kʰutʲəxal
cuideachd	kʰutʲəxk
cuideigin	kʰutʲecɪn
cuidich	kʰutʲɪç
cuid	kʰutʲ
cuilean	kʰulan
cuileann	kʰulən̪ˠ
cuimhneachadh	kʰuiɲəxəɣ
cuimhne	kʰuiɲə
cuimreach	kumuɾəx
cuimrich	kumuɾɪç
cuimrigh	kʰumuɾɪ
cuimris	kʰɯmɯrʲɪʃ
cuine	kʰuɲə
cuing	kʰɯ̃ĩŋʲkʲ
cuin	kʰuɲ
cuip	kʰuiʰp
cuireadh	kʰuɾʲəɣ
cuir	kʰuɾʲ
cùirtear	kʰuːrˠʃtʲəɾ
cùirt	kʰuːrˠʃtʲ
cùiseach	kʰuːʃəx
cùis	kʰuːʃ
cuislean	kʰuʃlan
cù	kʰuː
cùl	kʰuːɫ̪
cultarach	kʰul̪ˠt̪əɾəx
cumail	kʰumal
cumanta	kʰumən̪ˠt̪ə
cumhachdach	kʰũəxgəx
cumhachd	kʰũəxg
cumha	kʰũə
cumhang	kʰũəŋk
cùm	kʰaum
cum	kʰuːm
cùm	kʰuːm
cùm	kʰum
cùm	kʰumː
cunnartach	kʰun̪ˠərˠʃtəx
cunntadh	kʰũːn̪ˠt̪əɣ
cunnt	kʰũːn̪ˠt̪
cupa	kʰuʰpʰə
cùramach	kʰuːɾəməx
cùram	kʰuːɾəm
curran	kʰurˠan
curstaidh	kʰurˠs̪t̪ɪ
cus	kʰus̪
dàbhaidh	t̪aːvɪ
dachaigh	t̪axɪ
dadamach	dadəməx
dad	tat
daibhidh	t̪aivɪ
daibhsan	t̪ai̯vs̪ən
daibh	t̪ai̯
daibh	t̪ai̯v
dàidh	t̪aːj
dàil	t̪aːl
dàimheach	daivəx
dàimh	t̪aiv
dair	t̪aɾʲ
dallag	taɫ̪ak
dall	t̪aul̪ˠ
dalma	dal̪ˠamə
dalm	dal̪ˠam
damh	tav
dàn	d̥aːn
dannsair	tãũn̪ˠs̪ɛɾʲ
dannsa	t̪ãũn̪ˠs̪ə
daoine	t̪ɯːnə
daol	t̪ɯːl̪ˠ
daonnan	t̪ɯːn̪ˠan
daorach	tɯːɾəx
daor	t̪ɯːɾ
dara	t̪aɾˠə
dàrnach	daːrˠn̪ˠəx
dàrna	t̪aːrˠn̪ˠə
dar	t̪ar
dar	t̪ər
da	t̪a
da	t̪aː
dà	t̪aː
dathach	t̪ahəx
dath	tah
deagh	tʲoː
dealaich	dʲalˠiç
dealain	tʲal̪ˠɛɲ
dealanach	tʲal̪ˠanəx
dealanaich	tʲal̪ˠanəxʲ
dealanan	tʲal̪ˠan̪ˠən̪ˠ
dealan	tʲal̪ˠan̪ˠ
dealbhadair	tʲal̪ˠavətɛɾʲ
dealg	tʲal̪ˠak
dealuich	dʲalˠiç
deamhan	tʲãũan
dèanamh	tʲianəv
dèanamh	tʲianʊ
dèan	tʲian
dearcag	tʲɛɾçkʲak
dearc	tʲɛɾçkʲ
dearg	tʲɛɾɛk
dearmad	tʲɛɾɛmət̪
dearrsach	tʲaːrˠsəx
dearrsadh	t̪ʲaːrˠs̪əɣ
dearrs	tʲaːrˠs̪
deàrsadh	t̪ʲaːrˠs̪əɣ
deasg	tʲɛs̪k
deas	tʃɛs̪
deicheach	dʲeçəx
deichnearan	tʲeçnəɾən
deichnear	tʲeçnəɾ
deichnear	tʲeɲəɾ
deichneir	tʲeçnəɾʲ
deich	tʲeç
dèidh	tʲeː
deigh	tʲej
deilbh	tʲelev
deilgneach	tʲelecnəx
dèine	tʲeːnə
dèine	tʲɛːɲʲə
deirdre	tʲɛrtɾə
deirdre	tʲɛʈɾə
deirge	tʲeɾʲeɟə
deiseil	tʲeʃal
deise	tʲeʃə
deocan	tʲɔxkan
deoch	tʲɔx
deoghail	tʲoal
deòin	dʲɔːɲ
deònach	tʲɔːnəx
deòrsa	tʲɔːɾs̪ə
dè	t̪eː
de	tʲe
dè	tʲeː
dè	tʃeː
deud	t̪ʰʲeːt̪
deug	tʲiək
deug	tʃiək
deur	d̥ʲiaɾ
dhachaigh	ɣaxɪ
dha	ɣa
dha	ɣaː
dhà	ɣaː
dhaibh	ɣai
dhaibh	ɣaiv
dhaibh	ɣav
dhaibhsan	ɣai̯vs̪ən
dhan	ɣan̪ˠ
dhàsan	ɣaːs̪ən̪ˠ
dhathach	ɣahəx
dhath	ɣah
dhealaich	ʝalˠiç
dhearg	ʝɛɾɛk
dheas	ʝɛs
dh'èist	ʝeːʃtʲ
dhen	ʝen
dheth	ʝɛh
dh'fhàg	ɣaːk
dh'fhalbh	ɣaɫ̪av
dh'fhosgail	ɣɔskal
dh'	ɣ
dhi	ʝi
dhi	ʝiː
dhìol	ʝiəɫ̪
dhìot	ʝiə̯ʰt̪
dhìse	ʝiːʃə
dh'ith	jiç
dhìth	ʝiː
dh'ith	ʝiç
dh'	ʝ
dh'òl	ɣɔːl̪ˠ
dhomh	ɣõ
dhomh	ɣɔ̃
dhòmhnaill	ɣɔ̃ːɪʎ
dhòmhsa	ɣõːs̪ə
dhòmhsa	ɣɔ̃ːs̪ə
dhona	ɣɔnə
dhorcha	ɣɔɾɔxə
dhubh	ɣuh
dhuibh	ɣɯi
dhuibh	ɣɯiv
dhuibh	ɣɯv
dhuibhse	ɣɯi̯vʃə
dhuilich	ɣɯlʲɪç
dhùin	ɣuːɲ
dhuinne	ɣɯɲːə
dhuinne	ɣɯɲə
dhuinn	ɣiɲ
dhuinn	ɣɯi̯ɲ
dhuit	ɣuʰtʲ
dhuitsa	ɣuʰtʲs̪ə
dhut	ɣuht̪
dhut	ɣuhtʲ
dhutsa	ɣuʰt̪s̪ə
diabhal	tʲiəvəl̪ˠ
dian	tʃian
diathad	tʲiəhət̪
dia	tʲia
dìbhe	tʲivə
dìcheallach	tʲiːçəl̪ˠəx
dìcheall	tʲiːçəɫ̪
didòmhnaich	tʲɪt̪ɔ̃nɪç
dìle	dʲiːlə
dìlleachdach	tʲiːʎəxgəx
dìlleachdanachd	tʲiːʎəxganəxg
dìlleachdan	tʲiːʎəxgan
dìlleachdas	tʲiːʎəxgəs̪
dìlleachd	tʲiːʎəxg
dìoghaltach	tʲiəəl̪ˠt̪ʰəx
dìoghaltas	tʲiəl̪ˠt̪əs̪
diog	tʲik
dìol	tʃiːlˠ
dìomhain	tʲiəvɛɲ
dìomhair	tʲiəvɪɾʲ
dìonadair	dʲiənədɛrʲ
diorbhail	tʲirivəl̪ˠ
diorta	tʲər̪ˠʃt̪ə
dìosal	tʲiːs̪əl̪ˠ
dìreach	tʲiːɾʲəx
dìreach	tʲɪɾəx
dithisean	tʲiɪʃən
dithis	tʲiɪʃ
di	tʲi
di	tʲiː
diùid	tʲuːtʲ
diùra	tʲuːɾa
diù	tʲuː
dligheach	tʲliəx
dlighe	t̪liə
dòbhran	t̪ɔːɾan
dochaidh	t̪oxɪ
dochaidh	t̪ɔxɪ
dòchasach	t̪ɔːxəs̪əx
dòchas	t̪ɔːxəs
dòigheil	t̪ɔːjalˠ
dòigh	t̪ˠɔːj
doileag	t̪ɔlak
doilgheas	t̪ɔlɔjəs̪
doilidh	t̪ɔlɪ
doilleir	dɔɪʎɛr
doilleir	dɔʎɛr
doimhneachd	t̪ɔiɲəxk
doimhne	t̪ɤĩnə
doineann	t̪ɤɲan̪ˠ
doirbh	t̪ɤɾʲɤv
dòirt	tɔːrˠʃtʲ
dolaidh	t̪ɔl̪ˠɪ
dòmhnallan	t̪ɔ̃ːəl̪ˠan
dòmhnall	t̪ɔ̃ːəl̪ˠ
domhsa	t̪ɔ̃ːs̪ə
domh	t̪ɔ̃
donaidh	t̪ɔnɪ
dona	t̪ɔnə
donnchadh	t̪ɔn̪ˠɔxəɣ
donn	t̪ɔun̪ˠ
don	t̪ɔn̪ˠ
dòrainneach	t̪ɔːɾəɲəx
doras	t̪aɾəs̪
doras	t̪ɔɾəs̪
doras	t̪ɔɾəs̪t̪
doras	t̪ɔɾs̪
dorchadas	t̪ɔɾɔxət̪əs̪
dorcha	t̪ɔɾɔxə
dòrnan	t̪ɔːɾnan
dorra	t̪ɔrˠə
dòrtadh	t̪ɔːrˠʃt̪əɣ
dotair	t̪ɔht̪ɛɾʲ
do	t̪ə
do	t̪ɔ
drabasdachd	t̪rˠapas̪t̪axk
drabasdach	t̪ɾapəs̪t̪əx
drabasda	t̪ɾapəs̪t̪ə
dragh	t̪ɾɤɣ
draibheadh	t̪ˠɾaivəɣ
draibhear	t̪ɾaivəɾ
draibh	t̪ɾaiv
dràma	t̪ɾaːmə
drama	t̪ɾamə
dranndanach	t̪ɾãũn̪ˠtanəx
dranndan	t̪ɾãũn̪ˠt̪an
draoidh	drɯj
draoidheachd	drɯɪʲaxk
drathais	t̪ɾaɪʃ
dreach	t̪ɾɛx
dreasa	t̪ɾes̪ə
dreuchd	t̪ɾʲiaxk
dril	tɾil
driùchd	t̪ɾuːxk
droigheann	t̪ɾɔjən̪ˠ
dròn	trɔːn
drùidh	druːj
drùidhteach	druːdʲəx
druim	t̪ɾɯim
drùin	t̪ɾuːɲ
drùiseach	t̪ɾuːʃax
drùisealachd	t̪rˠuːʃɛl̪ˠaxk
drùiseantachd	t̪rˠuːʃən̪t̪ʰaxk
drùisearachd	t̪rˠuːʃɛrˠaxk
drùisear	t̪rˠuːʃɛrˠ
drùiseil	truːʃɛl
drùisire	t̪rˠuːʃiɾə
drùis	t̪ɾuːʃ
drumaichean	t̪ɾumɪçən
druma	t̪ɾumə
d	t̪
d'	t̪
d'	tʲ
duais	t̪uəʃ
dualchasach	tuəl̪ˠxəs̪əx
dual	t̪uəɫ̪
duan	t̪uən
dubhach	t̪uəx
dubhan	t̪uan
dubh	t̪uh
duda	t̪ət̪ə
duf	t̪əf
dùghall	t̪uːəl̪ˠ
duibhse	t̪ɯi̯vʃə
duibh	t̪iː
duibh	t̪ɯi̯v
duilich	tɯlʲɪç
duilleach	tɯʎəx
duilleag	tɯʎak
dùil	tuːl
duine	t̪ɯɲ
duine	t̪ɯɲə
duinne	t̪ɯi̯ɲə
duinn	t̪iɲ
duinn	t̪ɯi̯ɲ
dùinte	t̪uːɲtʲə
dùin	t̪uːɲ
dùisg	t̪uːʃkʲ
duitsa	t̪uʰtʲs̪ə
duit	t̪uʰtʲ
dul	t̪ul̪ˠ
dunnchadh	t̪un̪ˠuxəɣ
dùn	t̪uːn
dùrd	t̪uːrˠt̪
dust	t̪us̪t̪
dùthaich	tuːɪç
dùthchas	t̪uːxəs̪
dùth	t̪uː
dutsa	t̪uʰt̪s̪ə
dut	t̪uʰt̪
dut	t̪ut̪
e	a
eabhrac	joːɾək
eabhraig	joːɾɪkʲ
eachann	ɛxən̪ˠ
eachdraidh	ɛxkɾɪ
eachdraidh	ɛxt̪ɾɪ
each	ɛx
eaconomaidh	ɛkʰɔnəmɪ
eadailteach	etaʎtʲəx
eadailt	etaltʲ
eadar	et̪əɾ
eadha	eə
eadhan	ɛɣən
eadh	ɤɣ
eagalach	ekəl̪ˠəx
eagal	ekəl
eaglais	ekl̪ˠɪʃ
eairdsidh	ɛːrˠʃtʲʃɪ
ealachan	jal̪ˠəxən
eala	jal̪ˠə
ealasaid	ɛl̪ˠəs̪ɪtʲ
ealasaid	jal̪ˠəsˠɪtʲ
eallach	jaɫ̪əx
eanraig	ɛnɛɾɪkʲ
earball	ɛɾɛpəl̪ˠ
earrach	jarˠəx
earrann	ɛrˠən̪ˠ
earrann	jarˠən̪ˠ
easbhaidh	es̪vɪ
eathan	ean
e	ɛ
èibhinn	eːvɪɲ
eideard	etʲərˠʃt̪
eideard	etʲərˠt̪
eidheann	eən̪ˠ
èigh	eːv
èigheachd	eːvəxk
eigh	ej
èighich	iːɪç
eilbheis	elevɪʃ
eileanach	elanəx
eilear	el̪əɾ
eileas	el̪əs̪
eile	elə
eil	elʲ
eilid	elɪtʲ
eilidh	elɪ
èille	eːʎə
eimhir	evɪɾʲ
eireag	eɾʲak
eiridinn	eɾɪtʲɪɲ
eiridnich	erʲɪdʲnɪç
èirigh	eːɾʲɪ
èirinn	eːɾʲɪɲ
èirisgeigh	eɾʲɪʃkʲaj
èirisgeigh	eɾʲɪʃkʲej
eisimeileachd	eʃɪmələxg
èist	eːʃtʲ
èisteachd	eːʃtʲəxk
èistibh	eːʃtʲɪv
eithne	ɛnʲə
eithre	eɾʲə
eòghainn	joːɪɲ
eòghann	joːən̪ˠ
eòin	jɔːn
eòin	jɔːɲ
eò	jɔː
eòlach	jɔːl̪ˠəx
eòlas	jɔːɫ̪əs̪
eòrna	jɔːrˠn̪ˠə
eòrpach	jɔːrbəx
eòsaiph	jɔːs̪ɪf
eòsaph	jɔːs̪əf
esan	ɛs̪ən̪ˠ
esan	ɛʃən̪ˠ
eubha	iəvə
eudail	eːt̪al
eudail	iət̪al
eug	eːk
eul	iəl̪ˠ
eun	ian
eunlaith	ĩãl̪ˠɪ
eunlaith	ian̪ˠl̪ˠɪ
facal	faxkəɫ
faclair	faxklˠ̪əɾʲ
faclan	faxkl̪ˠən
fada	fat̪ə
fadalach	fatəl̪ˠəx
fad	fat̪
fàgail	faːkal
fàg	faːk
faiceallach	façkʲəl̪ˠəx
faicinn	fɛçcɪɲ
faide	fatʲə
fáidh	fˠaːj
fáidh	fˠɑːj
fáidh	fˠɑːɟ
faidhle	failə
faidhlichean	failɪçən
faigh	faʝ
faighinn	fajɪɲ
fàileadh	faːləɣ
fàilte	faːltʲə
faing	faiŋʲkʲ
fàinne	faːɲə
fàinne	faːɲtʲə
faireachdainn	faɾəxkɪɲ
faire	faɾʲə
fairge	farˠakʲə
fairich	faɾʲəxʲ
faisg	faʃc
falamh	fal̪ˠəv
falamh	fal̪ˠɪ
falamh	fal̪ˠʊ
falbh	faɫ̪av
fallain	fal̪ˠəɲ
falt	fal̪ˠt̪
fang	faŋk
faobhar	fɯːvəɾ
faobh	fɯːv
faod	fɯːt̪
faoileag	fɯːlak
faoilleach	fɯːʎəx
faoin	fɯːɲ
faramach	farəməx
farpais	faɾpɪʃ
farsaing	faɾs̪ɪŋʲkʲ
fasanta	fas̪an̪ˠt̪ə
fàs	faːs
fastaidh	fas̪t̪ɪ
fathan	fahan
feabhasach	fjoəsəx
feabhas	fjoəs̪
fead	fet̪
feadhainn	feʊɪɲ
feadhainn	fɤɣɪɲ
feadhainn	fɤʊɪɲ
feadhainn	fjɤɣɪɲ
feadhainn	fjoɪɲ
feadh	fjɤɣ
feagal	fekəl
feamainn	femɪɲ
feannag	fjan̪ˠak
feansa	fɛns̪ə
fearachas	fɛrəxəs
fearail	fɛral
fearann	fɛɾən̪ˠ
fearchar	fɛɾaxəɾ
fearchar	fɛɾɛxəɾ
fear	fɛɾ
fearg	fɛɾɛk
fearghas	fɛraɣəs
fearghas	fɛrɛɣəs
feàrna	fjaːrˠn̪ˠə
feàrr	fjaːrˠ
feasgar	fes̪kəɾ
fèidh	feːʝ
fèileadh	feːləɣ
féill	feːʎ
fèill	feːʎ
fèineag	fʲeːnʲək
fèis	feːʃ
feis	feʃ
feitheamh	fehəv
feitheamh	fehʊ
feith	feh
feòil	fjɔːl
feòladair	fjɔːl̪ˠət̪əɾʲ
feòl	fjɔːɫ̪
feòrag	fjɔːɾak
feud	feːt̪
feumach	feːməx
feumaidh	feːmɪ
feum	feːm
feur	fiəɾ
fhada	at̪ə
fhaide	atʲə
fhaighinn	ajɪɲ
fhaire	aɾʲə
fhaoilleach	ɯːʎəx
fhasanta	as̪an̪ˠt̪ə
fhathast	haəs̪t̪
fheabhas	joəs̪
fheamainn	emɪɲ
fhearaibh	ɛɾɪv
fhearaibh	ɛɾʊ
fhear	ɛɾ
fheàrr	jaːrˠ
fheàrr	jɛːrˠ
fheis	eʃ
fheòladair	jɔːl̪ˠət̪əɾʲ
fheum	eːm
fheur	iəɾ
fhionn	jũːn̪ˠ
fhionnlaigh	jũːl̪ˠaj
fhios	is̪
fhliuch	lux
fhraing	rˠaŋʲkʲ
fhreagair	ɾʲekɪɾʲ
fhreagarrach	ɾʲekərˠəx
fhuair	huəɾʲ
fhuaras	huəɾəs̪
fhuar	uəɾ
fiabhrais	fiəvɾəʃ
fiabhras	fiəvɾəs̪
fiacaill	fiəxkɪʎ
fiacais	fiəxkɪʃ
fiach	fia̯x
fiaclan	fiəxkl̪ˠən
fiadhach	fiəəx
fiadhaich	fiəɪç
fiadh	fiə̯ɣ
fianais	fianɪʃ
fiar	fiəɾ
fichead	fiçət̪
fichead	fiət̪
fichead	fit̪
figheadair	fiət̪ɛɾʲ
figh	fi
fìgis	fiːkʲɪʃ
fileanta	filən̪ˠt̪ə
fill	fiːʎ
film	filim
fìobha	fiːvə
fìon	fiən
fionnadh	fjũn̪ˠəɣ
fionnaradair	fjũn̪ˠəɾətɛɾʲ
fionnar	fjun̪ˠəɾ
fionn	fjũːn̪ˠ
fionnghal	fin̪ˠəɣəl̪ˠ
fionnghal	fjũn̪ˠũɣəl̪ˠ
fionnlagh	fjũːl̪ˠəɣ
fionntach	fjuːn̪ˠt̪ʰəx
fìor	fiːɾ
fios	fis̪
fireann	fiɾʲən̪ˠ
fìrinn	fiːɾʲɪɲ
fiù	fjuː
fiùghantach	fjuːənt̪əx
fiughar	fjuəɾ
fiùran	fjuːran
flaitheas	fl̪ˠaçəs̪
flath	flaː
fleadh	flɤɣ
fliche	fliçə
fliuch	flux
flòraidh	fl̪ˠɔːɾɪ
flùraichean	fl̪ˠuːɾəxʲən
flùr	fl̪ˠuːɾ
fodhad	foət
fodha	foə
fodhaibh	foəv
fodhainn	foɪɲ
fodham	foəm
fodhpa	foːpə
fòdhpa	fɔːpə
fo	fɔ
foghain	foɪɲ
fogharach	foəɾəx
foghar	fɤəɾ
foghar	foəɾ
foghlaim	fɤːl̪ˠəm
foghlam	fɤːl̪ˠəm
fòghnaidh	foːnɪ
foidhpe	fɤpə
fòidhpe	fɔːpə
foighidneach	fɤjɪtʲnəx
foileagan	fɔlakən
foileag	fɔlak
foillsich	fɤiʎʃɪç
foipe	fɔʰpə
foirfe	fɤɾʲfə
foirmle	fɤɾʲɤmlə
fois	foʃ
follaiseach	fɔl̪ˠɪʃəx
follais	fɔɫ̪ɪʃ
fòn	foːn
fon	fɔn̪ˠ
fonn	fɔun̪ˠ
fonnmhor	fɔn̪ˠəɾ
fonnmhor	fɔun̪ˠvəɾ
fòpa	fɔːʰpə
fopa	fɔʰpə
forca	fɔrˠxkə
forcan	fɔrˠxkən
forc	fɔrˠxk
fosfor	fɔsfɔɾ
fòs	fɔːs̪
fosgail	fɔskal
fosgladh	fɔskl̪ˠəɣ
fraidhig	fɾajɪc
fraidhigte	fɾajɪctʲə
fraing	frˠaŋʲkʲ
fraingis	fɾaiɲcɪʃ
frangach	fɾaŋkəx
frangag	fɾaŋkak
frangaich	fɾaŋkɪç
frangais	fɾaŋkɪʃ
frang	fɾaŋk
fraoch	fɾɯːx
freagair	fɾʲekɪɾʲ
freagarrachd	fɾʲekərˠəxk
freagarrach	fɾʲekərˠəx
freasdalachd	fɾʲes̪t̪əl̪ˠəxg
freasdalach	fɾʲes̪t̪əl̪ˠəx
freumh	fɾʲɪəv
frids	fɾʲitʲʃ
friseal	fɾʲiʃəl̪ˠ
fuar	fuəɾ
fuasgail	fuəs̪kal
fuil	ful
fuineadair	fuɲədɛrʲ
fuineall	fuɲəl̪ˠ
fuin	fuɲ
fuirce	fɯɾxʲkʲə
fuirc	fɯɾxʲkʲ
fuireach	fuɾʲəx
fuirich	fuɾʲɪç
fulangach	ful̪ˠəŋkəx
fulang	fuɫ̪əŋk
furachas	fuɾəxəs̪
furasta	fuɾəs̪t̪ə
gabhail	kahal
gabh	ka
gabh	kav
gabh	kɔ
gach	kax
gàd	gaːd
gadhar	kɤər
gad	kat̪
gafann	kafənˠ̪
gàidhealach	kɛːəl̪ˠəx
gàidheal	kɛːəɫ̪
gàidhealtachd	kɛːəl̪ˠtəxk
gàidhlig	kaːlɪkʲ
gainmheach	kɛnɛəx
gainmheach	kɛnɛvəx
gainmheach	kɛɾʲɛvəx
gàirdeachas	kaːrtʲəxəs
gàireachdainn	kaːɾʲəxkɪɲ
gairge	kɛɾʲɛcə
gàir	kaːɾʲ
gairme	kɤɾʲəmʲə
gairm	kɤɾʲəm
gaisgeach	kaʃcəx
galan	kal̪ˠan
galar	kal̪ˠəɾ
gal	kal̪ˠ
galla	kaɫ̪ə
gall	kaul̪ˠ
gaoid	kɯːtʲ
gaoil	kɯːʎ
gaoisid	gɯːʃidʒ
gaol	kɯːl̪ˠ
gaothach	kɯːəx
gaoth	kɯː
garaids	kaɾɪtʲʃ
garbh	kaɾav
garg	gaɾˠəg
garg	kaɾak
gàrradh	kaːrˠəɣ
gasta	kas̪t̪ə
gath	gah
gèadh	ciəɣ
geala	cal̪ˠə
geal	kʲaɫ̪
gealladh	kʲaɫ̪əɣ
geall	kʲaul̪ˠ
geama	cɛmə
geamannan	cɛmən̪ˠən
geamhradh	kʲɛuɾəɣ
geansaidh	kʲɛns̪ɪ
gearan	kʲɛɾan
gearastan	cɛɾəs̪t̪an
gèar	kʲiaɾ
gearmailtis	cɛɾɛmaltʲɪʃ
gearran	cɛrˠan
gearran	kʲaran
gearran	kʲarən
geàrr	kʲaːrˠ
geasachd	kʲɛsaxk
geas	kʲes
geata	kʲɛʰt̪ə
gèilleadh	kʲeːʎəɣ
gèill	kʲeːʎ
geodha	kʲɔə
geòidh	cɔːʝ
geug	ceːk
ghàidhealtachd	ɣɛːəl̪ˠtəxk
ghaoth	ɣɯː
gharbh	ɣaɾav
ghasta	ɣas̪t̪ə
gheall	jaul̪ˠ
ghearran	ʝɛrˠan
gheibheadh	jevəɣ
gheibheadh	joəɣ
gheibh	jɛv
gheibh	jo
ghiblean	ʝiplan
ghille	ʝiʎə
ghlac	ɣl̪ˠaxk
ghlais	ɣl̪ˠaʃ
ghlic	ʝliçc
ghob	ɣop
ghoid	ɣɤtʲ
ghoirid	ɣɤɾʲɪtʲ
ghràidh	ɣɾaːj
ghrannd	ɣɾãũn̪ˠt̪
ghualainn	ɣuəl̪ˠɪɲ
ghuth	ɣuh
giall	kʲiəl̪ˠ
giblean	ciplan
gile	kʲilə
gilleasbuig	kʲɪʎes̪pɪkʲ
gillebrìghde	kʲiʎəpɾʲiːtʲə
gille	kʲiʎə
gilliosa	kʲɪʎiəs̪ə
gimleid	kimilatʲ
gin	gʲin
ginideach	cinɪtʲəx
giomach	giməx
gionach	kʲinəx
giorra	ciɾˠə
giorsal	kʲirˠs̪əl̪ˠ
giotàr	kʲɪt̪ʰaːɾ
g	k
glacadh	kl̪ˠaxkəɣ
glac	kl̪ˠaxk
glaine	kl̪ˠaɲə
glainne	kl̪ˠaɲə
glais	kl̪ˠaʃ
glaodh	kl̪ˠɯː
glaschu	kl̪ˠas̪əxɔ
glaschu	kl̪ˠas̪əxu
glas	kl̪ˠas̪
glasraichear	kl̪ˠasˠɾɪçəɾ
gleann	klaun̪ˠ
gleansach	klɛnsəx
glè	kleː
gleoc	klɔxk
gleus	kleːs̪
glice	kliçkʲə
glic	kliçc
glòir	kɫ̪ɔːɾʲ
glòr	kl̪ˠɔːɾ
gnàg	kɾ̃ãːk
gnàthach	kɾãːəx
gnàth	kɾãː
gnè	krɛː
gnìomh	kɾʲĩə̃v
gnosd	kɾ̃ɔ̃s̪t̪
gnothach	grõəx
gnothach	grõɪç
gnothach	grɔ̃əx
gnothach	grɔ̃ɪç
gnùis	kɾuːʃ
gobha	koə
gobhar	koəɾ
gob	kop
goibhle	kəilə
goibhnean	kəinən
goid	kɤtʲ
goilf	kɔlf
goirid	kɤɾʲɪtʲ
goirt	kɔrtʃʲ
goistidh	gɔʃdʲɪ
gòrach	kɔːɾəx
gòraiche	kɔːɾɪçə
goraidh	kɔɾɪ
gòrdan	kɔːrˠt̪an
gorm	kɔrɔ̃m
gort	kɔrˠʃt̪
gràdhaich	kɾaːɪç
gràdh	kraːɣ
gràidh	kɾaːj
gràineag	kɾaːɲak
gram	gram
grànda	kɾãːn̪ˠtə
grannd	kɾãũn̪ˠt̪
greannach	kʲɾʲɛn̪ˠəx
greann	kɾʲaun̪ˠ
greas	kɾʲes̪
greim	kɾeim
greim	kɾɤim
greim	kɾʲeim
greim	kɾʲɤim
grèine	cɾʲeːɲə
grianach	cɾʲianəx
grian	cɾʲian
grìbhean	cɾiːvan
griogair	g̊ɾʲig̊ɪɾʲ
grod	kɾot
gruagach	kɾuəkəx
gruagaire	kɾuəkɪɾʲə
gruaidh	kɾuəj
gruamach	kɾuəməx
gualainn	kuəl̪ˠɪɲ
gualann	kuəl̪ˠən̪ˠ
gual	kuəl̪ˠ
guga	kukə
guib	kɤp
guidhe	kujə
guileag	kulak
guirmean	kɯɾʲɯman
gu	kə
gum	kəm
gun	kən̪ˠ
gun	kəɲ
gunna	kun̪ˠə
guth	kuh
hallo	haɫoː
halò	haloː
hama	hamə
hearach	hɛɾəx
hiort	hɪrˠʃt̪
iad	atʲ
iad	ət̪
iad	iə̯t̪
iadsan	aːs̪ən̪ˠ
iadsan	iə̯t̪s̪ən̪ˠ
iagan	iəkan
iain	iaɲ
iall	iəl̪ˠ
ialtag	iəl̪ˠt̪ək
iarann	iərˠɪɲ
iarla	iəɾɫ̪ə
iarraidh	iərˠɪ
iarr	iərˠ
iasgaich	iəskɪç
iasgair	iəs̪kɛɾʲ
iasg	iəsk
idir	itʲɪɾʲ
ifhreann	irʲən̪ˠ
ifhrinn	irʲɪɲ
ifreann	ifrʲən̪ˠ
ifrinn	ifrʲɪɲ
i	i
ì	iː
ìle	iːlə
imlich	imilɪç
inghean	inijan
innealta	ĩɲəl̪ˠt̪ə
innis	ĩːʃ
innseanach	ĩːʃənəx
innse	ĩːʃə
innte	ə̃ĩɲtʲə
innte	ĩːɲtʲə
inntinneach	ĩːɲtʲɪɲəx
ìobairt	iəpərˠʃtʲ
ìoc	iəxk
ioghnadh	iənəɣ
iolair	jul̪ˠɪɾʲ
iomadh	iməɣ
iomain	imɛɲ
iomall	iməl̪ˠ
iomchaidh	ɪməxi
ìomhar	iəvəɾ
iomradh	imiɾəɣ
ionga	iŋkə
iongantach	ĩə̃n̪ˠt̪əx
iongnadh	ĩə̃nəɣ
ionnsachadh	jũːn̪ˠs̪əxəɣ
ionnsaichibh	jũːn̪ˠsɪçɪv
ionnsaich	jũːn̪ˠsɪç
ionraic	jũnəɾɪc
ìota	iəht̪ˠə
iseabail	iʃəpal
ise	iʃə
is	ɪs̪
is	ɪʃ
ist	ɪʃtʲ
itheann	içən̪ˠ
ithe	içə
ith	iç
iubhar	juəɾ
iuchair	juxɪɾʲ
lachaidh	l̪ˠaxɪ
lachan	ɫ̪axan
ladhar	ɫ̪ɤəɾ
ladhran	ɫ̪ɤːɾan
laghach	l̪ˠɤəx
laghail	ɫ̪ɤɣal
lagh	ɫ̪ɤɣ
lag	l̪ˠak
làidir	l̪ˠaːtʲɪɾʲ
làimheadh	l̪ˠɛ̃ːəɣ
làimh	l̪ˠaiv
lainnir	ɫ̪aɲɪɾʲ
làireach	l̪ˠaːɾʲəx
làir	l̪ˠaːɾʲ
là	l̪ˠaː
làmhach	l̪ˠaːvəx
làn	l̪ˠaːn
lann	ɫ̪an̪ˠən
lann	ɫ̪aun̪ˠ
laoch	ɫ̪ɯːx
laoghan	l̪ˠɯːɣan
laogh	l̪ˠɯːɣ
làraidh	l̪ˠaːɾɪ
lasadain	l̪ˠas̪ətɛn
lasadan	l̪ˠas̪ətan
làthaireach	l̪ˠaːɪɾʲəx
làthair	ɫ̪aːɪɾʲ
latha	l̪ˠaa
leabaidh	ʎepɪ
leabharlannaiche	ʎoəɾl̪ˠan̪ˠɪçə
leabharlann	ʎoəɾl̪ˠən̪ˠ
leabhar	ʎoəɾ
leac	ʎɛxk
leagsaidh	ʎeks̪ɪ
leamh	l̠ʲɛv
leam	ləm
leam	lɛm
leam	lɔ̃ũm
leam	luːm
leanabh	ʎɛnəv
lean	ʎɛn
leannan	ʎɛn̪ˠan
leann	ʎaun̪ˠ
leasan	ʎɛs̪ən
leas	ʎes
leatas	ʎɛht̪əs
leatha	leːçə
leatha	lɛə
leatha	lɛɛ
leatha	lɛhə
leatha	lɛɔ
leatha	ʎɛhə
leathann	lɛhən̪ˠ
leathann	ʎɛhən̪ˠ
leat	laʰt̪
leat	lɛʰt̪
leatromach	ʎɛht̪ɾəməx
leibh	leːv
leibh	leiv
leibh	ləv
leibh	lɤiv
leibh	li
leibh	liːv
leibh	lɯib
lèigheadaireachd	ʎeːətɪɾʲəxk
leigheas	ʎeəs̪
lèigh	ʎeː
leig	ʎekʲ
lèine	ʎeːɲə
leinn	leiɲ
leinn	leɲː
leinn	lɤiɲ
lèir	ʎeːɾʲ
lèirsinneach	ʎeːɾʲʃɪɲəx
lèirsinn	ʎeːɾʲʃɪɲ
lèiruig	ʎɛːɾɪc
leisgeadair	ʎeʃkʲətɛɾʲ
leisgeul	ʎeʃkʲəl̪ˠ
leisg	ʎeʃkʲ
leis	lɛʃ
leithid	ʎeɪtʲ
leitir	ʎehtʲɪɾʲ
le	le
leòdhas	ʎɔːəs̪
leòmhann	ʎɔːən̪ˠ
leòsan	ɫ̪ʲɔːsan
leotha	lɛɔɔ
leotha	lɔ
leotha	lɔːxə
leotha	lɔə
leotha	ʎoə
leth	ʎe
leughadh	ʎeːvəɣ
leugh	ʎeːv
leumadair	ʎeːmət̪ɛɾʲ
leum	ʎeːm
liath	ʎiə
lice	ʎiʰkʰʲə
lilidh	ʎilɪ
linn	ʎiːɲ
liogh	ʎɤɣ
liomaid	ʎimɪtʲ
lìon	ʎiən
lionn	ʎuːn̪ˠ
lionntachd	ʎuːn̪ˠt̪ʰəxk
lios	ʎis̪
litir	ʎihtʲɪɾʲ
lobhadh	l̪ˠɔvəɣ
lobhte	l̪ˠɔvtə
lochan	ɫ̪ɔxan
lochlannach	l̪ˠɔxl̪ˠən̪ˠəx
loch	ɫ̪ɔx
lòdrach	lɔːdrəx
lofa	ɫ̪ɔfə
loidhne	l̪ˠɔinə
lòineag	l̪ˠɔːɲak
loisgean	lˠɔʃkʲan
loisgte	l̪ˠɔʃtʲə
lò	l̪ˠɔː
long	l̪ˠɔuŋk
lòn	l̪ˠɔːn
lon	ɫ̪ɔn
lorg	ɫ̪ɔrɔk
losgann	l̪ˠɔs̪kən̪ˠ
luach	l̪ˠuəx
luaidhe	l̪ˠuəjə
luaidh	l̪ˠuəj
luaithe	l̪ˠuəjə
luaithre	l̪ˠuəɾʲə
luath	l̪ˠuə
lùbach	l̪ˠuːpəx
luchag	ɫ̪uxak
luchd	ɫ̪uxk
luch	ɫ̪ux
lugha	l̪ˠɤɣə
lugha	l̪ˠuə
luibh	l̪ˠuj
luinneag	l̪ˠɯɲak
lùnastal	l̪ˠuːnəs̪t̪əl̪ˠ
lus	l̪ˠus̪
lùth	l̪ˠuː
macaoidh	maxkɤj
macaonghais	maxkɯ̃nɯ̃ɪʃ
macgriogair	maxg̊ɾʲig̊ɪɾʲ
mac	maʰk
macnèill	maxkɾɛːʎ
macnèill	maxkɾiːʎ
macrùslaig	maxkɾuːs̪l̪ˠɪkʲ
madadh	matəɣ
madainn	mat̪ɪɲ
madainn	mɛt̪ɪɲ
magadh	makəɣ
magaidh	makɪ
magairle	makərˠʎə
màg	maːk
maide	matʲə
maide	matʃə
maide	mɛtʲə
maide	mɛtʃə
maighdean	məitʲən
maighdeann	mɤitʲən
maighread	maiɾʲət̪
màili	maːlɪ
mairbh	maɾʲɪv
màiread	maːɾʲət̪
mairead	maiɾʲət̪
mairead	maɾʲət̪
màiri	maːɾʲɪ
mair	maɾʲ
mairtfheòil	marˠʃtʲɔl
maiseach	maʃʲax
maise	maʃə
màla	maːɫ̪ə
màldachd	maːl̪ˠdəxk
mall	maul̪ˠ
màmag	maːmak
mamaidh	mami
manach	manəx
manadh	manəɣ
manaidsear	manɪtʲʃəɾ
manainn	manɪɲ
mand	man̪ˠt̪
mànran	mãːɾan
mànus	maːnəs̪
maoidh	mɤj
maoilios	mɯːləs̪
maoin	mɯːnʲ
maoldòmhnaich	mɯl̪ˠt̪ɔ̃ːnɪç
maol	mɯːɫ̪
maor	mɯːɾ
maoth	mɯː
mapa	mahpə
marag	maɾak
marbh	maɾav
marcachd	maɾxkəxk
marcach	maɾxkəx
marcas	marˠxkas̪
marc	marxk
margadh	maɾˠakəɣ
mar	maɾ
marsaili	marˠs̪alɪ
màrtainn	maːrˠʃt̪ɪɲ
mart	marˠʃt̪
màrt	marˠʃt
mata	maʰtə
matamataigeach	mat̪ʰəmat̪ʰɪkʲax
matamataigear	mat̪ʰəmat̪ʰɪkʲəɾ
matamataig	mat̪ʰəmat̪ʰɪkʲ
màthair	maːhɪɾʲ
mathan	mahan
math	ma
math	mah
math	mɛ
meacan	mɛxkan
meadaigeach	medʲɪgʲəx
meadhanan	miaanən
meadhan	miaan
meallan	mjal̪ˠan
meall	mɛul̪ˠ
meall	mjaul̪ˠ
meal	mjal̪ˠ
meanbh	mɛnɛv
mean	mɛn
mearachd	mɛɾəxk
mearanach	mɛranax
measgaich	meskɪç
measgaichte	meskɪçtʲə
measg	mesk
meas	mes
meilc	melçkʲ
meileadh	meləɣ
meil	mel
meirg	meɾʲekʲ
mèirleach	mɛːrˠləx
mèirleach	mʲaːrˠləx
meòg	mjɔːk
meòir	mjɔːɾʲ
meud	miat
mhac	vaxk
mhadadh	vatəɣ
mhàiri	vaːɪri
mhair	vaɾʲ
mhanainn	vanɪɲ
mharc	varxk
mhart	varˠʃt̪
mhàrt	varˠʃt
mhàthair	vaːhəɾʲ
mhath	vaː
mhath	vah
mhealladh	vjaɫ̪əɣ
mheall	vjauɫ̪
mheas	ves
mhèirleach	vɛːrˠləx
mhìcheil	viːçɛlʲ
mhic	vihc
mhil	vjil
mhìosachan	viəsəxan
mhoire	vɔɾʲə
mholainn	vɔɫ̪ɪɲ
mhòrag	voːɾak
mhòr	voːɾ
mìcheal	miːçəl̪ˠ
mìcheil	miːçɛlʲ
mic	miʰkʲ
mìle	miːlə
milis	milɪʃ
milleadh	miʎəɣ
millean	miʎan
mill	miːʎ
mil	mil
mil	mʲil
mìltean	miːltʰʲən
mi	mi
mìn	miːn
min	mjin
mionaid	minətʲ
mion	min
mions	mins
mìorbhaileach	miəɾvələx
mìosachan	miəsəxan
mìosan	miəs̪ən
mìos	miːs̪
mìos	miəs̪
miotag	mihtak
mire	mʲiɾʲə
mise	miʃə
misg	miʃc
misneach	miʃnəx
m'	m
mocheirigh	mɔxərʲɪ
moch	mɔx
mochthrath	mɔxra
modhail	mɔɣal
modh	mɔɣ
mòd	mɔːt̪
mòine	mɔːɲə
moire	mɔɾʲə
molach	mɔɫ̪əx
mol	mol
molta	mɔɫ̪t̪ʰə
mòmaid	mɔːmɪtʲ
monadh	mɔnəɣ
mòrag	moːɾak
mòrail	mɔːral
mòra	moːɾə
mòr	moːɾ
motha	moə
mucan	muʰkən
muc	muxk
muga	mukə
muicfheòil	muçcɔl
muilchdinn	muluçkɪɲ
muilcheann	mulɪçən
muilchear	mulɪçɛɾ
muilchill	mulɪçɪʎ
muilchinn	mulɪçɪɲ
muileann	muʎən̪ˠ
muile	mulə
muille	muʎə
muime	muimə
muinichill	munuçɪʎ
muinntir	mɯiɲtʲɪɾʲ
muireall	mɯɾʲəl̪ˠ
muir	murʲ
mullach	mul̪ˠəx
mult	mul̪ˠt̪ˠ
mu	mə
muncaidh	muŋkɪ
mun	mən
mura	muɾə
murchadh	muɾuxəɣ
murchan	muɾuxan
murdag	muːrˠt̪ak
mùrn	muːɾn
mustais	musdaʃ
nàbaidh	n̪ˠaːpi
nach	n̪ˠax
nàdarrach	n̪ˠaːt̪ərˠəx
naidheachd	n̪ˠɛəxk
nàireach	n̪ˠaːɾʲəx
nàiseantach	n̪ˠaːʃən̪ˠt̪əx
nàmhaid	n̪ˠãːətʲ
nàmhaid	n̪ˠãːvətʲ
na	na
na	nə
naochad	n̪ˠɯːxət̪
naoghas	n̪ˠɯəs̪
naoinearan	n̪ˠɯːnəɾən
naoinear	n̪ˠɯːɲəɾ
naoineir	n̪ˠɯːnəɾʲ
naoi	nɯːɣ
naoi	nɯːi
naonar	n̪ˠɯːnəɾ
nàrach	n̪ˠaːɾəx
nar	naɾ
nas	nəs̪
nathair	n̪ˠahɪɾʲ
neacal	ɲɛxkəl̪ˠ
neach	ɲɛx
nead	ɲet̪
neart	ɲɛɾʃt̪
neasgaid	ɲes̪katʲ
neas	ɲes̪
neònach	ɲɔːnəx
neul	ɲiaɫ̪
niall	ɲiaɫ̪
nicaoidh	ɲixkɤj
nicaonghais	ɲixkɯ̃nɯ̃ɪʃ
nigheann	ɲiːan̪ˠ
nighean	ɲiːan
nighneag	ɲiːnak
nigh	ɲiː
nì	niː
nì	ɲiː
nirribhidh	ɲir̪ˠɪvi
niseag	ɲiʃag
nis	niʃ
nobhail	n̪ˠɔval
nochd	n̪ˠɔ̃xk
nodha	n̪ˠoə
nollaig	n̪ˠɔl̪ˠɪkʲ
no	nə
no	nɔ
noraidh	n̪ˠɔɾɪ
norrag	n̪ˠɔrˠak
not	n̪ˠɔht̪
nuair	n̪ˠuəɾʲ
nur	nuɾ
obair	opəɾʲ
òban	ən̪ˠt̪ʰɔːpan
obann	opən̪ˠ
obrachadh	obrəxəɣ
obraich	oprɪç
ochdad	ɔxkət̪
ochdamh	ɔxkəv
ochdnair	ɔxkəɾʲ
ochdnaran	ɔxkəɾən
ochdnar	ɔxkəɾ
ochd	ɔxk
odhar	oər
ògmhios	ɔːkvɪs
òg	ɔːk
oide	ɤtʲə
oidhche	ɤ̃ĩçə
oidhirp	ɤɪrʲp
oifigearan	ɔfɪgʲɛɾən
oifigear	ɔfɪgʲɛɾ
oifis	ɔfɪʃ
òige	ɔːkʲə
òigh	ɔːj
oighre	ɤiɾʲə
oighrig	ɤiɾʲɪkʲ
oillteil	ɤiʎt̪ʲal
oillt	əiʎʲtʰʲ
oilthigh	ɤlhɪ
òinseach	ɔːɲʃəx
oirbh	əɾʲəv
oirbh	ɔɾɪ
oirbh	ɔɾʲəv
oirbh	ɔɾu
oirbhse	ɔɾʲɪvʃə
oirnne	ɔrˠɲə
oirnn	ɔrˠn
oirnn	ɔrˠɲ
oirnn	ɔrɪɲ
òir	ɔːɾʲ
oir	ɔir
oirre	ɔrˠə
oirre	ɔrˠhə
oirre	ɔrˠɔ
oirrese	ɔɾəʃə
oirre	urˠə
oisinn	ɔʃɪɲ
oisir	ɤʃɪɾʲ
olann	ɔl̪ˠən̪ˠ
ola	ɔl̪ˠə
olc	ɔɫ̪xk
ollaimh	ɔl̪ˠɪv
ollamh	ɔl̪ˠəv
onair	ɔnɪɾʲ
onarach	ɔnaɾəx
o	ɔ
oraindsear	ɔɾɪɲtʲʃɛɾ
orainds	ɔrɪntʲʃ
orainsear	ɔɾɪɲʃɛɾ
òran	ɔːɾan
òrd	ɔːɾʃt̪
òrdugh	ɔːr̪ˠʃt̪əɣ
òrdugh	ɔːr̪ˠʃt̪u
orm	aɾam
orm	ɔɾɔm
ormsa	ɔɾams̪ə
òr	ɔːɾ
orra	ɔrˠə
orra	ɔrˠɔ
orra	ɔɾhə
orrasan	ɔɾəs̪ən
ort	ɔrˠs̪t̪
ort	ɔrˠʃtʲ
osna	ɔs̪n̪ˠə
os	ɔs
pacach	pʰaxg̊əx
pacraidhe	paxgrɪjə
pàdraig	pʰaːt̪ɾɪkʲ
pàidh	pʰaːj
pailt	paldʲ
pàipear	pʰɛːʰpʰəɾ
pàirc	pʰaːɾʲçkʲ
pàirtidh	pʰaːrˠʃtʲi
pàisde	paːʃtʲə
pana	pʰanə
pàraig	pʰaːɾɪkʲ
pàra	pʰaːɾa
peacach	pʰɛxkəx
peacadh	pʰɛxkəɣ
peadar	pʰet̪əɾ
peairt	pʰɛrˠʃtʲ
peall	pʰjaul̪ˠ
peann	pʰjaun̪ˠ
peansailean	pʰɛns̪alən
peansail	pʰɛns̪al
peantadh	pʰɛn̪ˠt̪əɣ
peantair	pʰɛn̪ˠt̪ɛɾʲ
peant	pʰɛn̪ˠt̪
peapag	pʰɛhpak
peasair	pʰɛs̪ɪɾʲ
peigi	pʰekʲɪ
peileag	pʰelag̊
peinnsean	pʰeiɲʃan
peitseagach	pʰiːt̪ʃakəx
peitseagan	pʰiːt̪ʃakan
peitseag	pʰiːt̪ʃak
peitseige	pʰiːt̪ʃɛkʲə
peur	pʰiəɾ
phàisde	faːʃtʰʲə
phàiste	faːʃtʰʲə
phana	fanə
pheadair	fetɪɾʲ
pheann	fjaun̪ˠ
pheantair	fɛn̪ˠt̪ɛɾʲ
pheapag	fɛhpak
pheasair	fɛs̪ɪɾʲ
pheata	fɛʰt̪ə
pheitseagan	fiːt̪ʃakan
pheitseag	fiːt̪ʃak
pheitseige	fiːt̪ʃɛkʲə
phinc	fiɲc
phiuthar	fjuəɾ
phoit	fɔhtʲ
phost	fɔs̪t̪
phrìosan	fɾʲiːs̪ən
phuist	fɯʃtʲ
phurpaidh	furpi
phut	fuht̪
pinc	pʰiŋʲkʲ
pinnt	pʰĩːɲtʲ
pìobaire	pʰiːpɛɾʲə
piobar	pʰipəɾ
pìosail	pʰiːsal
piseag	pʰiʃak
pitheid	pʰiɛtʲ
piuthar	pʰjuəɾ
plèanaichean	pʰlɛːnəxʲən
plèana	pʰlɛːnə
pleòiteag	pʰʎɔːhtʲak
poblachd	pʰɔpl̪ˠəxk
poca	pʰɔxkə
pòca	pɔːxkə
pòg	pʰɔːk
poit	pʰɔhtʲ
poll	pʰɔul̪ˠ
pòl	pʰɔːl̪ˠ
port	pʰɔrˠʃt̪
pòsadh	pʰɔːs̪əɣ
pòsaidh	pʰɔːs̪ɪ
pòs	pʰɔːs
pòsta	pʰɔːs̪t̪ə
post	pʰɔs̪t̪
p	pʰ
pràiseach	pʰɾaːʃəx
pràis	pʰɾaːʃ
preas	pʰɾʲes̪
priob	prʲib
prìomhaid	pʰɾiːɪtʲ
prionnsa	prʲũːn̪ˠsə
prìosan	pʰɾʲiːs̪ən
prògramair	pɾoːgɾamɛɾʲ
pròiseact	pʰɾɔːʃəkt̪
pròiseil	pʰɾɔːʃɛl
pròis	prɔːʃ
pronn	pʰɾɔun̪ˠ
puing	pʰɯiŋʲkʲ
puist	pʰɯʃtʲ
punnd	pũːn̪ˠt̪
purgadair	pʰuɾukətɛrʲ
purpaidh	pʰurpi
putadh	pʰuht̪əɣ
putan	pʰuht̪an
put	pʰuht̪
radan	ratən
radharc	rˠɤːəɾk
ràdh	rˠaː
raghnall	rˠãːəl̪ˠ
raghnall	rˠɤ̃ːəl̪ˠ
raibeart	rˠapəɾʂʈ
raineach	rˠaɲəx
ràith	rˠaːj
ràitinn	rˠaːhtʲɪɲ
ràmh	rˠaːv
rànaich	rˠaːnɪç
rann	rˠaun̪ˠ
ràn	rˠaːn
raonabogha	rˠɯːnəpo
raonaid	rˠɯːnɪtʲ
raon	rˠɯːn
rathad	rˠaːt̪
rathad	rˠaad
rathad	rˠahat̪
reachd	rˠɛxk
reamhar	rˠãũəɾ
reic	rˠeçkʲ
rèidh	rˠeːj
rèis	rˠeːʃ
rèiteachadh	rˠeːhtʲəxəɣ
rèiteach	rˠeːhtʲəx
rèitear	rˠeːhtʲəɾ
rèite	rˠeːʰtʲə
rèitich	rˠeːhtʲɪç
rèitire	rˠeːhtʲɪɾʲə
reòthadh	rˠɔːəɣ
reòth	rˠɔː
reul	rˠeːɫ̪
riabhach	rˠiəvəx
riadh	rˠiəɣ
riaghail	rˠiəal
riaghailt	rˠiəəltʲ
riamh	rˠiəv
ribe	rˠipə
rìbhinn	rˠiːvɪɲ
ridireach	rˠitʲɪɾʲəx
righinn	rˠiɪɲ
rìgh	rˠiː
rìgh	rˠɯi
rìgh	rˠʊi
rinn	rˠiːɲ
rinn	ɾʲiːɲ
rinn	ɾɯiɲ
rinn	ɾɯɲ
riochdaich	rˠixkɪç
rìoghachd	rˠiəəxk
rionnag	rʲuːnak
ri	ɾʲi
rìs	rˠiːʃ
rithe	ɾʲiə
rium	ɾəm
rium	ɾʲum
rium	ɾɔ̃ũm
rium	ɾum
riutha	ɾʲuə
riut	ɾət̪
riut	ɾʲuʰt̪
robach	rˠopəx
robhar	rˠoəɾ
robhas	rˠoəs̪
robh	ɾoː
rob	rˠɔp
ròb	rɔːb
roghnaich	rˠoːnɪç
roid	rˠɔtʲ
roile	rˠɔlə
roimhe	ɾɛ̃ə
roimhe	ɾɔ̃jə
roinne	rˠɤɲə
roinn	rˠɤiɲ
ròmanach	rˠɔːmənəx
romhad	ɾõət̪
romhad	ɾɔ̃ət̪
romhad	ɾɔɔt̪
romham	ɾõəm
romham	ɾɔ̃əm
romham	ɾɔɔm
ròn	rɔːn
ro	ɾɔ
ròsta	rˠɔːs̪t̪ə
rothair	rˠɔhɪɾʲ
ruadh	rˠuəɣ
ruairidh	rˠuəɾʲɪ
ruaraidh	rˠuəɾɪ
rud	rˠut̪
rugadh	ɾukəɣ
rug	rˠuk
rùisg	rˠuːʃc
rùisgte	rˠuːʃtʲə
ruith	rˠih
rùn	rˠuːn
rùraich	rˠuːɾɪç
rùsgadh	rˠuːs̪kəɣ
rùsg	ruːs̪k
rus	rˠus̪
sàbaid	s̪aːpatʲ
sàbaid	s̪aːpɪtʲ
sabaid	sapatʲ
sabaid	sapɪtʲ
sàbhail	saːval
sabhal	s̪aəl̪ˠ
sabhal	s̪ɔəl̪ˠ
sàbh	s̪aːv
sabhs	saus
sàboind	s̪aːpɪɲtʲ
sàboind	s̪aːpɔɲtʲ
sacraidh	saxkrɪ
sagart	s̪akərʃt
saighdearach	sɤitʲərəx
saighdear	sɤitʲəɾ
sailead	s̪alət̪
saill	saiʎ
sàil	s̪aːl
salach	saɫ̪əx
salainn	sal̪ˠəɲ
salann	s̪al̪ˠən̪ˠ
salm	sal̪ˠam
sàl	saːl̪ˠ
sàmhach	s̪aːəx
sàmhach	s̪aːvəx
sàmhach	s̪ɛːəx
samhainn	saũiɲ
samhain	saũiɲ
samhla	sãũl̪ˠə
samhradh	sauɾəɣ
samhradh	s̪auɾəɣ
sanntach	s̪ãũn̪ˠt̪ˠəx
sannt	s̪ãũn̪ˠt̪
saoghal	s̪ɯːəɫ̪
saoil	s̪ɯːl
saoire	s̪ɯːrʲə
saoirse	s̪ɯːrˠʃə
saorsa	s̪ɯːrˠs̪ə
saor	s̪ɯːɾ
sàraich	s̪aːɾɪç
sàr	s̪aːɾ
sasainn	sasəɲ
sasannach	s̪as̪ən̪ˠəx
sasgunnach	s̪as̪gən̪ˠəx
scoite	sˠkætʲə
seacaid	ʃɛxkatʲ
seachainn	ʃɛxɪɲ
seachain	ʃɛxɪn
seachdad	ʃɛxkət̪
seachdnair	ʃɛxkəɾʲ
seachdnaran	ʃɛxkəɾən
seachdnar	ʃɛxkəɾ
seachd	ʃɛxk
seach	ʃɛx
seadh	ʃɤɣ
seagh	ʃɤɣ
seàirdeant	s̪aɾtʲɛnt̪
sealg	ʃaɫ̪ak
sealladh	ʃal̪ˠəɣ
seall	ʃaul̪ˠ
sealtainn	ʃɛl̪ˠt̪ɪɲ
seanair	ʃɛnɪɾʲ
seanais	ʃɛnɪʃ
seanasan	ʃɛnəsan
seanas	ʃɛnəs
seanchais	ʃɛnəxəʃ
seanchas	ʃɛnəxəs̪
seang	ʃɛŋk
seanmhairean	ʃɛnəvɛɾʲən
seanmhair	ʃɛnəvɛɾʲ
seanmhar	ʃɛnəvəɾ
seann	ʃãũn̪ˠ
sean	ʃɛn
searbh	ʃɛɾˠɛv
searmon	ʃɛɾɛmɔn
searrach	ʃɛrˠəx
sear	ʃɛr
seasaidh	ʃes̪ɪ
seasamh	ʃes̪əv
seasgad	ʃeskət̪
seiceach	ʃeçkʲəx
seiche	ʃeçə
seicich	ʃeçkʲɪç
seilcheag	ʃeləçak
seileach	ʃeləx
seile	ʃelə
seillean	ʃeʎan
sèimheachadh	ʃɛːvəxəɣ
sèimh	ʃɛ̃ːv
seinneadair	ʃeɲət̪ɪɾʲ
seinn	ʃeiɲ
seirbheis	ʃeɾʲevɪʃ
seisear	ʃeʃəɾ
seocan	ʃɔxkan
seoc	ʃɔxk
seòladair	ʃɔːl̪ˠət̪ɛɾʲ
seòladh	ʃɔːɫ̪əɣ
seòl	ʃɔːɫ̪
seòmar	ʃɔːmər
seonachan	ʃɔnəxan
seonag	ʃɔnak
seonaidh	ʃɔnɪ
seònaid	ʃɔːnatʲ
seòras	ʃɔːɾˠəs
seòrsa	ʃɔːrˠs̪ə
seo	ʃɔ
sè	ʃɛː
seudan	ʃia̯t̪ən
seud	ʃia̯t̪
seumaidh	ʃeːmɪ
seumais	ʃeːmɪʃ
seumas	ʃeːməs̪
seun	ʃian
seunta	ʃiən̪ˠt̪ə
sgadan	s̪kat̪an
sgàire	s̪kaːɾʲə
sgairp	s̪kaɾʲp
sgap	sgahb
sgaradh	skaraɣ
sgarbh	skaɾav
sgàth	skaː
sgath	s̪kah
sgeilp	s̪kʲelp
sgeir	sgʲerʲ
sgéith	s̪ceː
sgèith	s̪ceː
sgeith	s̪ceh
sgèith	s̪cɛː
sgeulachd	skʲiəl̪ˠəxk
sgiamh	s̪cĩə̃v
sgian	s̪kʲian
sgiathach	skʲiəhəx
sgileil	skʲilal
sgillinn	skʲiʎɪɲ
sgimilearachd	skʲimiləɾəxk
sgimilear	skʲimiləɾʲ
sgiobair	skʲipɛɾʲ
sgiobalta	s̪cɪpəl̪ˠt̪ə
sgioblaich	skʲipl̪ˠɪç
sgiomalaireachd	skʲimiɫəɾʲəxk
sgiort	s̪cɤɾˠʃt̪
sgitheanach	s̪cianəx
sgìth	s̪kʲiː
sgoilear	s̪kɔlɛɾ
sgoinneil	s̪kɤɲal
sgonaichean	s̪kɔnɪçən
sgona	s̪kɔnə
sgòthach	s̪kɔːəx
sgòth	s̪kɔː
sgoth	s̪kɔh
sgrathail	skɾahal
sgreamhail	s̪kɾʲɛfal
sgreamhail	s̪kɾʲɛval
sgreuchail	s̪kɾʲiaxal
sgreuch	s̪krʲiax
sgrìobhadair	s̪kɾiːvətɛɾʲ
sgrìobhadh	s̪kɾʲiːɤɣ
sgrìobhadh	s̪kɾʲiːʊ
sgrìobhadh	s̪kɾʲiːvəɣ
sgrìobhadh	s̪kɾʲiɤʊk
sgrìobh	s̪kɾʲiːv
sgrìob	s̪kɾʲiːp
sgriosail	s̪kɾʲis̪al
sgrùdaich	s̪kɾuːt̪ɪç
sguab	skuəp
shàbhail	haːval
shalach	haɫ̪əx
sheanair	hɛnɪɾʲ
shean	hɛn
sheòladh	hjɔːɫ̪əɣ
sheumais	heːmɪʃ
sheumas	heːməs̪
sheunta	hiən̪ˠt̪ə
shìl	hiːl
shìos	hiəs̪
shiùcair	hjuːxkɪɾʲ
shnàmh	n̪ˠãːv
shoilleir	hɤʎɪɾʲ
shoirbheachail	hɤɾʲɤvəxal
shreap	hrɛhp
shuas	huəs̪
siabannach	ʃiəbənəx
siabann	ʃiəpən̪ˠ
sianaran	ʃianəɾən
sianar	ʃianəɾ
siar	ʃiər
sia	ʃia
sibhse	ʃivʃə
sibh	ʃiv
sibh	ʃu
sìde	ʃiːtʲə
sìleas	ʃiːləs̪
sìle	ʃiːlʲə
silidh	ʃilɪ
sìl	ʃiːl
sil	ʃil
simidh	ʃimɪ
sìm	ʃiːm
sìneag	ʃiːnʲak
sìne	ʃiːɲə
sine	ʃinə
sineubhar	ʃineːvəɾ
singilte	ʃiŋʲgʲɪldʲə
sinne	ʃiɲə
sinn	ʃiɲ
sin	ʃɛn
sin	ʃɪn
sionnachan	ʃũn̪ˠəxan
sionnach	ʃun̪ˠəx
siorc	ʃɪɾʃk
siorc	ʃɪʃk
sìorraidh	ʃiərɪ
siorram	ʃirˠəm
sìor	ʃiəɾ
sìos	ʃiəs̪
sitheann	ʃiən̪ˠ
sìth	ʃiː
siubhal	ʃuəɫ̪
siùcair	ʃuːxkɪɾʲ
siùcar	ʃuːxkər
siud	ʃit̪
siùrsachd	ʃuːrˠs̪əxk
siùrsach	ʃuːɾs̪əx
slàine	s̪l̪ˠaːɲə
slàinte	slaːntʃə
slaodach	s̪l̪ˠɯːt̪əx
slaodaiche	s̪l̪ˠɯːt̪ɪçə
slaod	sl̪ˠɯːd
slathag	s̪l̪ˠaak
slat	sˠl̪ˠaht
sleagh	ʃʎɤɣ
sleamhainn	ʃʎɛ̃ũ̯ɪɲ
sleamhainn	ʃʎɛ̃vɪɲ
sliabh	ʃʎiəv
slige	ʃlʲɪkʲə
sliseag	ʃliʃak
sloc	sɫ̪ɔxk
slòighre	s̪ɫ̪ɤiɾʲə
sloinneadh	s̪l̪ˠɤɲəɣ
sluagh	sɫ̪uəɣ
smaoinich	s̪mɯːɲɪç
smeòrach	s̪mjɔːɾəx
smid	smitʲ
smiogaid	s̪mikatʲ
smocte	s̪mɔxtʲə
snag	s̪n̪ˠak
snaidhm	s̪naim
snàmh	sn̪ˠãːv
snasail	snasal
snas	s̪n̪ˠas̪
snàthad	s̪naːhət̪
sneachd	ʃɲɛxk
snèap	ʃɲɛːhp
snog	sn̪ˠok
soidhneadh	sɤinəɣ
soidhn	sɤin
soilleir	sɤʎɪɾʲ
soillsean	sɤi̯ʎʃan
soillse	s̪ɤi̯ʎʃə
soineannta	s̪ɔɲən̪ˠt̪ə
soirbheachail	s̪ɤɾʲɤvəxal
soitheach	s̪ɛəx
soitheach	s̪ɤəx
solais	s̪ɔl̪ˠɪʃ
solasan	s̪ɔl̪ˠəs̪ən
solas	s̪ɔl̪ˠəs̪
somhairle	s̪oərˠlə
somhairle	s̪ohərˠlə
sònraichte	sɔ̃ːnɾɪçtʲə
sorcha	s̪ɔɾɔxə
sòr	sɔːr
so	s̪o
so	s̪ɔ
spadair	sbadɛrʲ
spad	sbad
spaideil	sbadʲal
spaidsear	sbadʲʃər
spàinntis	spaːɲtʲɪʃ
spairt	sˠpˠaɾˠtʲ
spairt	sparˠʃtʲ
spaistear	sbaʃdʲər
speal	spjal̪ˠ
speuclairean	s̪piaxkl̪ˠɪɾʲən
spìosrach	s̪piːs̪ɾəx
spìosraich	s̪piːs̪ɾɪç
spìos	s̪piːs̪
spìos	s̪piəs̪
sponsairich	sbɔnsɛrʲɪç
sponsair	sbɔnsɛrʲ
sporan	spɔran
spòrsail	spɔːrsal
spruilleach	spɾuʎəx
spùinneadair	spuːɲətɪɾʲ
sràc	s̪t̪ɾaːʰk
sràid	s̪ɾaːtʲ
sràid	s̪ɾaːtʃ
sràid	s̪t̪ɾaːtʲ
sràid	s̪t̪ɾaːtʃ
srathair	s̪t̪ɾahɪɾʲ
srath	s̪t̪ɾah
sreap	strɛhp
srian	s̪t̪ɾiən
sròn	s̪ɾɔːn
sròn	s̪t̪ɾɔːn
srùbag	s̪t̪ɾuːpak
sruighlea	s̪t̪ɾuilə
sruth	s̪t̪ɾuh
's	s̪
s	s̪
's	ʃ
staidhir	s̪t̪ajɪɾʲ
staidhre	s̪t̪aiɾʲə
staid	statʲ
stais	st̪aʃ
stamag	s̪t̪ʰamak
staoig	s̪tɤikʲ
stèidheadh	ʃtʲeːəɣ
stèidhich	ʃtʲeːɪç
stèidh	stʲeː
stèidh	ʃtʲeː
stèidhte	ʃtʲeːtʲə
steòrnabhagh	ʃtʲɔːrˠn̪ˠəvaɣ
stiallach	stʲiəl̪ˠəx
stiubha	ʃtʲuə
stocainn	s̪t̪ɔxkɪɲ
stoc	s̪t̪ɔxk
stoirmeil	s̪t̪ˠɤɾʲɤmal
stoirm	s̪t̪ɤɾʲɤm
stràc	s̪ɾaːxk
strìopachas	st̪ɾiːpʰəxəs̪
strìopach	st̪ɾiːpʰəx
strì	s̪t̪ɾiː
suaimhneach	s̪uəivɲəx
suas	s̪uəs̪
sùbh	s̪uː
sùgh	s̪uː
suidheachadh	suiəxəɣ
suidheachadh	sɯiəxəɣ
suidhe	s̪ɯiə
suidh	si
suidh	suj
suidh	sɯj
sùil	s̪uːl
suim	s̪ɯim
suirghe	s̪ɯɾʲɯjə
sunndach	s̪ũːn̪ˠt̪əx
sùnndach	s̪uːn̪ˠt̪ˠəx
tabhann	tʰahən̪ˠ
tablaid	tʰapl̪ˠɪtʲ
taca	tʰaxkə
tachair	tʰaːxɪɾʲ
tachd	taxg
tadhal	tʰɤəl̪ˠ
tagair	tʰakɪrʲ
tagairt	t̪ʰakəɾʲʃtʲ
taghairm	tʰɤɾʲɤm
taghan	tʰɤɣan
taghta	t̪ʰɤːʰt̪ə
taghta	t̪ʰɤɣt̪ə
tagh	t̪ʰɤː
tagh	t̪ʰɤɣ
taibhsean	t̪ʰaivʃən
taibhse	t̪ʰaivʃə
taigeis	tʰakʲɪʃ
taighean	t̪ʰɛhən
taighean	t̪ʰɤjən
taighe	tʰaiə
taighe	tʰɛhə
taigh	t̪ʰaj
taigh	t̪ʰe
taigh	t̪ʰɤj
tàileasg	tʰaːləs̪k
taingeil	tʰaiŋʲkʲal
taing	tʰaiɲc
tàinig	t̪aːnɪkʲ
tairbhe	t̪ʰɛɾʲɛvə
tàirneanach	tʰaːrˠɲənəx
taisg	t̪ʰaʃc
taisteal	t̪ʰaʃtʲəl̪ˠ
talamh	t̪ʰal̪ˠav
talla	tʰal̪ˠə
taobhaich	tʰɯːvɪç
taobh	t̪ʰɯːv
tapadh	t̪ʰahpəɣ
tapaidh	tʰahpɪ
tarmachan	t̪ʰaɾaməxan
tarraing	tʰarˠɪɲc
tartan	tʰarˠʃtan
tasdan	t̪ʰas̪t̪an
tasgadh	tasgəɣ
teachdaireachd	tʃʰɛxkɛrʲəxk
teachd	tʃʰɛxk
teadhair	tʲeɪrʲ
teagaisg	tʃʰekɪʃkʲ
teagasg	tʃʰekəsk
teaghlach	tʃʰɤːɫ̪əx
teampall	tʲʰɛ̃ũmpəl̪ˠ
teampall	tʃʰɛ̃ũmpəl̪ˠ
teanga	tʲʰɛɣə
teanga	tʲʰɛŋə
teanga	tʲʰɛŋi
teanga	tʃʰɛɣi
teanga	tʃʰɛkə
teanga	tʃʰɛŋgə
teanga	tʃʰɤɣi
teannta	tʃʰaun̪ˠt̪ə
teann	tʃʰaun̪ˠ
teàrlach	tʃʰaːrˠl̪ˠəx
tèarmannair	tʲiərmənɛrʲ
tèarmann	tʲʰiəɾmən̪ˠ
teàrnadh	tʃʰaːrˠn̪ˠəɣ
teas	tʃʰes̪
teatha	t̪ʰeə
teicneolas	tʃʰeçcɲɔl̪ˠəsˠ
teine	tʃʰenə
teòclaid	tʃʰɔːxkl̪ˠɪtʲ
teth	tʃʰeh
tha	ha
tha	haː
thaigh	hɤj
thàinig	haːnɪkʲ
thairbhe	hɛɾʲɛvə
thall	haul̪ˠ
thaobh	hɯːv
tharraing	harˠɪɲc
thatar	haʰt̪ər
thathar	haəɾ
thathas	haəs̪
theaghlach	hjɤːɫ̪əx
their	heɾʲ
theth	heh
thig	hikʲ
thilg	hilic
thill	həiʎ
thill	hiːʎ
thinn	hiːɲ
thiugh	hju
thogadh	hokəɣ
thoir	hɔɾʲ
thoirt	hɔrˠʃtʲ
thòn	hɔːn
thrang	hɾaŋk
throid	ɾɔtʲ
thuilleadh	hɯʎəɣ
thuirt	hurˠʃtʲ
thuirt	hurˠtʲ
thuit	huhtʲ
thusa	hus̪ə
thu	u
tìde	tʃʰiːtʲə
tighearna	tʃʰiərˠn̪ˠə
tig	tʲikʲ
tilgeil	tʃʰilical
tilg	tʃʰilikʲ
till	tʃʰiːʎ
tìm	tʃʰiːm
tinneas	tʃʰiɲəs̪
tinn	tʃʰĩːɲ
tiodhlac	tʃʰiəl̪ˠək
tiodhlaic	tʃʰiəl̪ˠɪc
tiops	tʃʰips
tìoraidh	tʲiːri
tioram	tʃʰiɾəm
tiriodh	tʃʰiɾʲəɣ
tì	t̪ʰiː
tì	tʃʰiː
tiugainn	tʃʰukɪɲ
tiugh	tʃʰu
tiùrr	tʰʲuːrˠ
tlàth	t̪ʰl̪ˠaː
tobar	t̪ʰopəɾ
togair	togɪrʲ
togalach	tʰokəl̪ˠəx
tog	tʰok
toilichte	tʰɔləçtʲə
toil	t̪ʰɔl
toinn	tʰɤiɲ
toirte	t̪ʰɔrˠʃtʲə
toir	t̪ʰɔɾʲ
toirt	t̪ʰɔrˠʃtʲ
toit	t̪ʰɔhtʲ
tolladh	tʰɔl̪ˠəɣ
tolltach	t̪ʰɔuɫ̪t̪ʰəx
toll	tʰɔul̪ˠ
tomaidh	t̪ʰomɪ
tòmas	tʰoːməs̪
tom	t̪ʰɔum
tonnan	tʰɔn̪ˠən
tonn	tʰɔun̪ˠ
tòn	tʰɔːn
torcall	t̪ʰɔɾxkəl̪ˠ
torman	tʰɔɾɔman
tormod	t̪ʰɔrɔmət̪
torrach	tʰɔrˠəx
tòrr	t̪ʰɔːrˠ
tràigh	tʰɾaːj
tràille	t̪ʰɾai̯ʎə
tràill	t̪ʰɾai̯ʎ
traisg	t̪ʰɾaʃkʲ
trang	tʰɾaŋk
trasg	t̪ʰɾas̪k
tràth	t̪ʰɾaː
trèan	t̪ʰɾɛːn
treasamh	tʰɾesəv
trèig	t̪ʰɾeːc
treun	t̪ʰɾʲeːn
trianaid	t̪ʰɾiənɪt̪ʲ
trian	tʰɾiən
tric	t̪ɾiçkʲ
trìthead	tʰɾiçət̪
trì	tʲʰɾʲiː
triubhas	tʰɾuəs̪
triùir	t̪ʰɾuːɾʲ
tròcair	tʰɾɔːxkɪɾʲ
troich	trɔç
troid	tʰɾɔtʲ
troigh	trɔç
trom	t̪ʰɾɔum
truagh	t̪ʰɾuəɣ
truime	t̪ʰɾɯmə
t	t̪ʰ
t'	t̪ʰ
t	t̪ʰiː
t'	tʲʰ
tuagh	t̪ʰuəɣ
tuarastail	t̪ʰuəɾəs̪t̪əl
tuarastail	t̪uəɾˠəsˠt̪əlʲ
tuarastal	t̪ʰuəɾəs̪t̪əl̪
tuathail	t̪ʰuəhəl
tuathal	tʰuəhəl̪ˠ
tuathanachail	tuəhanəxal
tuathanach	tuəhənəx
tuathanas	tʰuəhənəs̪
tuath	t̪ʰuə
tubaist	tʰupɪʃtʲ
tùdair	tʰuːtɛrʲ
tuigsinn	t̪ʰɯcʃɪɲ
tuig	t̪ʰɯc
tuilleadh	t̪ʰɯʎəɣ
tuil	tul
tuiteam	tʰuhtʲəm
tuit	t̪ʰuʰtʰʲ
tumadh	t̪ʰuməɣ
tunnag	tʰun̪ˠak
turadh	tʰɯɾəɣ
turas	t̪ʰuɾəs̪
tùsanach	tuːsanəx
tusa	t̪ʰus̪ə
tu	t̪ʰu
uabhasach	uəvəs̪əx
uachdaran	uəxkərən
uaibhreach	uəivɾʲəx
uaigneach	uəkʲɲəx
uaine	uəɲə
uainfheòil	uəɲɔl
uaireannan	uəɾʲən̪ˠən
uan	uan
uathachas	uəhəxəs
uath	uəh
ubhal	uəɫ̪
ud	ət̪
ugan	ukan
ugh	u
uibhist	ɯɪʃtʲ
uicipeid	uçkʲɪpetʲ
uidheam	ujəm
ùidh	uːj
uidh	uj
uileag	ulək
uileann	ulən̪ˠ
uilebheist	uləveʃtʲ
uile	ulə
uilleam	ɯʎam
uilleim	ɯʎɪm
uill	wəl
uill	wɛl
uill	wil
uime	imə
uime	imɔ
uimesan	iməs̪ən̪ˠ
uimpe	impʰɔ
uimpese	ɯi̯mpʰəʃə
uimpe	ɯi̯mpʰə
ùine	uːɲə
uinnean	ɯɲan
uiread	uɾʲət̪
ùire	uːɾʲə
ùir	uːɾʲ
ùisdean	uːʃtʲan
uiseag	ɪʃʲak
uiseag	ɯʃak
uisge	ɯʃkʲə
umadsa	umət̪s̪ə
umad	ũət̪
umad	umət̪
umaibhse	uməvʃə
umaibh	uməv
umainne	uməɲə
umainn	uməɲ
umamsa	uməms̪ə
umam	uməm
umha	ũə
umpasan	umpʰəs̪ən̪ˠ
umpa	uːmpʰə
umpa	uːmpʰɔ
umpa	umpʰə
ùna	uːnə
uncail	uŋkal
ungairis	uŋkɪɾʲɪʃ
ungair	uŋkɪɾʲ
ùraisg	uːɾɪʃkʲ
ùra	uːɾˠə
ùrnaigh	uːrˠn̪ˠɪ
urram	urˠəm
urras	urˠəs̪
