a	a
abadala	abadala
abadesi	abadesi
abadeso	abadeso
abadeyala	abadejala
abadeyi	abadeji
abadeyo	abadejo
abadi	abadi
abadini	abadini
abadino	abadino
abado	abado
abaduli	abaduli
abadulo	abadulo
abaki	abaki
abako	abako
abandonabez	abandonabɛs
abandonabez	abandonabɛz
abandonabis	abandonabis
abandonabos	abandonabɔs
abandonabus	abandonabus
abandonanta	abandonanta
abandonante	abandonante
abandonanti	abandonanti
abandonanto	abandonanto
abandonar	abandonar
abandonas	abandonas
abandonata	abandonata
abandonate	abandonate
abandonati	abandonati
abandonato	abandonato
abandonez	abandonɛs
abandonez	abandonɛz
abandoninta	abandoninta
abandoninte	abandoninte
abandoninti	abandoninti
abandoninto	abandoninto
abandonir	abandonir
abandonis	abandonis
abandonita	abandonita
abandonite	abandonite
abandoniti	abandoniti
abandonito	abandonito
abandononta	abandononta
abandononte	abandononte
abandononti	abandononti
abandononto	abandononto
abandonor	abandonɔr
abandonos	abandonɔs
abandonota	abandonota
abandonote	abandonote
abandonoti	abandonoti
abandonoto	abandonoto
abandonus	abandonus
abasar	abasar
abase	abase
abasez	abasɛs
abasez	abasɛz
abasis	abasis
abasos	abasɔs
abasus	abasus
abatajari	abatadʒari
abatajari	abataʒari
abatajaro	abataʒarɔ
abatanta	abatanta
abatante	abatante
abatanti	abatanti
abatanto	abatanto
abatar	abatar
abatas	abatas
abatata	abatata
abatate	abatate
abatati	abatati
abatato	abatato
abatez	abatɛs
abatez	abatɛz
abatinta	abatinta
abatinte	abatinte
abatinti	abatinti
abatinto	abatinto
abatir	abatir
abatis	abatis
abatisi	abatisi
abatiso	abatiso
abatita	abatita
abatite	abatite
abatiti	abatiti
abatito	abatito
abatonta	abatonta
abatonte	abatonte
abatonti	abatonti
abatonto	abatonto
abator	abatɔr
abatos	abatɔs
abatota	abatota
abatote	abatote
abatoti	abatoti
abatoto	abatoto
abatus	abatus
abceseskar	abtseseskar
abcesi	abtsesi
abceso	abtseso
abdikar	abdikar
abdikas	abdikas
abdikez	abdikɛs
abdikez	abdikɛz
abdikis	abdikis
abdikos	abdikɔs
abdikus	abdikus
abdomini	abdomini
abdomino	abdomino
abduktar	abduktar
abeli	abeli
abelo	abelo
abeluyo	abelujo
abieti	abi̯eti
abieto	abi̯eto
abjekta	abdʒekta
abjekta	abʒekta
ablativi	ablativi
ablativo	ablativo
abnegar	abnegar
abolisanto	abolisanto
abolisar	abolisaɾ
abolisati	abolisati
abolisesi	abolisesi
aboliseso	aboliseso
aboliso	aboliso
abono	abono
abordar	abɔrdar
abortar	abortar
abortigar	abortigar
abortigar	abɔrtigar
abortos	abortɔs
abortus	abortus
aboyar	abojar
abrejar	abredʒar
abrejar	abreʒar
abrejas	abredʒas
abrejas	abreʒas
abreviar	abrevi̯ar
abrevias	abrevi̯as
abreviez	abrevi̯ɛs
abreviez	abrevi̯ɛz
abrevio	abrevi̯o
abrikoti	abrikoti
abrikoto	abrikoto
abrikoto	abrikɔtɔ
abrupta	abrupta
absenteso	absenteso
absinto	absinto
absoluta	absoluta
absolute	absolute
abstrakta	abstrakta
abstrakte	abstrakte
abundanta	abundanta
abundanto	abundanto
abundar	abundar
abundas	abundas
abundegar	abundegar
abundis	abundis
abundos	abundɔs
abundus	abundus
acendar	atsɛndar
acendilo	atsendilo
acensar	atsensar
acento	atsento
aceptanta	atseptanta
aceptante	atseptante
aceptanti	atseptanti
aceptanto	atseptanto
aceptar	atseptar
aceptas	atseptas
aceptata	atseptata
aceptate	atseptate
aceptati	atseptati
aceptato	atseptato
aceptez	atseptɛs
aceptez	atseptɛz
aceptinta	atseptinta
aceptinte	atseptinte
aceptinti	atseptinti
aceptinto	atseptinto
aceptir	atseptir
aceptis	atseptis
aceptita	atseptita
aceptite	atseptite
aceptiti	atseptiti
aceptito	atseptito
aceptonta	atseptonta
aceptonte	atseptonte
aceptonti	atseptonti
aceptonto	atseptonto
aceptor	atseptɔr
aceptos	atseptɔs
aceptota	atseptota
aceptote	atseptote
aceptoti	atseptoti
aceptoto	atseptoto
aceptus	atseptus
acerba	atserba
acida	atsida
acidi	atsidi
acido	atsido
acioni	atsjoni
acioniero	atsjonjeɾo
aciono	atsjono
ad	ad
adavane	adavane
aden	aden
adepto	adepto
adfluar	adflu̯ar
adherar	adherar
adianta	adi̯anta
adiante	adi̯ante
adianti	adi̯anti
adianto	adi̯anto
adiar	adi̯ar
adias	adi̯as
adiate	adi̯ate
adibe	adibe
adicionar	aditsi̯onar
adicionas	aditsi̯onas
adicionez	aditsi̯onɛs
adicionez	aditsi̯onɛz
adicionir	aditsi̯onir
adicionis	aditsi̯onis
adicionor	aditsi̯onɔr
adicionos	aditsi̯onɔs
adicionus	aditsi̯onus
adio	adio
adio	adiɔ
adios	adi̯ɔs
adjacanta	addʒatsanta
adjacanta	adʒatsanta
adjektiva	addʒektiva
adjektiva	adʒektiva
adjektivi	addʒektivi
adjektivi	adʒektivi
adjektivo	addʒektivo
adjektivo	adʒektivo
adjuntar	adʒuntar
adminime	adminime
administranto	administranto
admirar	admirar
admiras	admiras
admiris	admiris
admiros	admirɔs
admirus	admirus
admisar	admisar
adolecanto	adoletsanto
adoptanta	adoptanta
adoptante	adoptante
adoptanti	adoptanti
adoptanto	adoptanto
adoptar	adoptar
adoptas	adoptas
adoptata	adoptata
adoptate	adoptate
adoptati	adoptati
adoptato	adoptato
adoptez	adoptɛs
adoptez	adoptɛz
adoptinta	adoptinta
adoptinte	adoptinte
adoptinti	adoptinti
adoptinto	adoptinto
adoptir	adoptir
adoptis	adoptis
adoptita	adoptita
adoptite	adoptite
adoptiti	adoptiti
adoptito	adoptito
adopto	adopto
adoptonta	adoptonta
adoptonte	adoptonte
adoptonti	adoptonti
adoptonto	adoptonto
adoptor	adoptɔr
adoptos	adoptɔs
adoptota	adoptota
adoptote	adoptote
adoptoti	adoptoti
adoptoto	adoptoto
adoptus	adoptus
adoranta	adoranta
adorante	adorante
adoranti	adoranti
adoranto	adoranto
adorar	adorar
adoras	adoras
adorata	adorata
adorate	adorate
adorati	adorati
adorato	adorato
adorez	adorɛs
adorez	adorɛz
adorinta	adorinta
adorinte	adorinte
adorinti	adorinti
adorinto	adorinto
adorir	adorir
adoris	adoris
adorita	adorita
adorite	adorite
adoriti	adoriti
adorito	adorito
adoronta	adoronta
adoronte	adoronte
adoronti	adoronti
adoronto	adoronto
adoror	adorɔr
adoros	adorɔs
adorota	adorota
adorote	adorote
adoroti	adoroti
adoroto	adoroto
adorus	adorus
adpozar	adpozar
adpozez	adpozɛs
adpozez	adpozɛz
adresi	adresi
adresizar	adresizar
adreso	adreso
adsub	adsub
adsur	adsur
adulto	adulto
adurolo	adurolo
adventi	adventi
advento	advento
advere	advere
adverso	adverso
advokati	advokati
advokato	advokato
aeri	aeri
aero	aero
aeroliti	aeroliti
aerolito	aerolito
aeronavi	aeronavi
aeronavo	aeronavo
aeroplani	aeroplani
aeroplano	aeroplano
aeroportui	aeroportui
aeroportuo	aeroportuo
aerosolo	aerosolo
aerostati	aerostati
aerostato	aerostato
afabla	afabla
afecionar	afetsionar
afero	afero
afliktar	afliktar
aflikto	aflikto
agadi	agadi
aganti	aganti
agar	agar
agato	agato
agavo	agavo
agema	agema
agi	agi
aginti	aginti
agitar	agitar
agitesar	agitesar
agnelo	agnelo
agnoskanta	agnoskanta
agnoskante	agnoskante
agnoskanti	agnoskanti
agnoskanto	agnoskanto
agnoskar	agnoskar
agnoskas	agnoskas
agnoskata	agnoskata
agnoskate	agnoskate
agnoskati	agnoskati
agnoskato	agnoskato
agnoskez	agnoskɛs
agnoskez	agnoskɛz
agnoskinta	agnoskinta
agnoskinte	agnoskinte
agnoskinti	agnoskinti
agnoskinto	agnoskinto
agnoskir	agnoskir
agnoskis	agnoskis
agnoskita	agnoskita
agnoskite	agnoskite
agnoskiti	agnoskiti
agnoskito	agnoskito
agnoskonta	agnoskonta
agnoskonte	agnoskonte
agnoskonti	agnoskonti
agnoskonto	agnoskonto
agnoskor	agnoskɔr
agnoskos	agnoskɔs
agnoskota	agnoskota
agnoskote	agnoskote
agnoskoti	agnoskoti
agnoskoto	agnoskoto
agnoskus	agnoskus
ago	ago
agonti	agonti
agrafo	agrafo
agro	agro
agrokultivi	agrokultivi
agrokultivisti	agrokultivisti
agrokultivisto	agrokultivisto
agrokultivo	agrokultivo
agulo	agulo
ajila	aʒila
ajornar	adʒornar
ajornar	aʒornar
ajornas	adʒornas
ajornas	aʒornas
ajornez	adʒornɛs
ajornez	aʒornɛz
ajornir	adʒornir
ajornir	aʒornir
ajornis	adʒornis
ajornis	aʒornis
ajornor	adʒornɔr
ajornor	aʒornɔr
ajornos	adʒornɔs
ajornos	aʒornɔs
ajornus	adʒornus
ajornus	aʒornus
ajustar	adʒustar
ajustar	aʒustar
ajustez	adʒustɛs
ajustez	aʒustɛz
akademiani	akademi̯ani
akademiano	akademi̯ano
akademio	akademio
akademio	akademjo
aklamanto	aklamanto
aklimatar	aklimatar
akompananta	akompananta
akompanante	akompanante
akompananti	akompananti
akompananto	akompananto
akompanar	akompanar
akompanas	akompanas
akompanata	akompanata
akompanate	akompanate
akompanati	akompanati
akompanato	akompanato
akompanez	akompanɛs
akompanez	akompanɛz
akompaninta	akompaninta
akompaninte	akompaninte
akompaninti	akompaninti
akompaninto	akompaninto
akompanir	akompanir
akompanis	akompanis
akompanita	akompanita
akompanite	akompanite
akompaniti	akompaniti
akompanito	akompanito
akompano	akompano
akompanonta	akompanonta
akompanonte	akompanonte
akompanonti	akompanonti
akompanonto	akompanonto
akompanor	akompanɔr
akompanos	akompanɔs
akompanota	akompanota
akompanote	akompanote
akompanoti	akompanoti
akompanoto	akompanoto
akompanus	akompanus
akonito	akonito
akordo	akordo
aktiva	aktiva
aktori	aktori
aktorino	aktorino
aktorino	aktɔɾinɔ
aktoro	aktoro
aktoro	aktɔɾɔ
aktorulo	aktorulo
aktorulo	aktɔɾulɔ
aktuala	aktuala
aktualigar	aktuwaligar
aktualigar	aktuwaligaɾ
akumular	akumular
akushar	akuʃar
akustiko	akustiko
akuta	akuta
akutigar	akutigar
akuzanta	akuzanta
akuzante	akuzante
akuzanti	akuzanti
akuzanto	akuzanto
akuzar	akuzar
akuzas	akuzas
akuzata	akuzata
akuzate	akuzate
akuzati	akuzati
akuzato	akuzato
akuzez	akuzɛs
akuzez	akuzɛz
akuzinta	akuzinta
akuzinte	akuzinte
akuzinti	akuzinti
akuzinto	akuzinto
akuzis	akuzis
akuzita	akuzita
akuzite	akuzite
akuziti	akuziti
akuzito	akuzito
akuzonta	akuzonta
akuzonte	akuzonte
akuzonti	akuzonti
akuzonto	akuzonto
akuzos	akuzɔs
akuzota	akuzota
akuzote	akuzote
akuzoti	akuzoti
akuzoto	akuzoto
akuzus	akuzus
al	al
alarmos	alarmɔs
albergestro	albɛrgɛstro
albergo	albɛrgo
albumeni	albumeni
albumenizar	albumenizar
albumeno	albumeno
alejar	aledʒar
alejar	aleʒar
alejas	aledʒas
alejas	aleʒas
alejez	aledʒɛs
alejez	aleʒɛz
alejir	aledʒir
alejir	aleʒir
alejis	aledʒis
alejis	aleʒis
alejor	aledʒɔr
alejor	aleʒɔr
alejos	aledʒɔs
alejos	aleʒɔs
alejus	aledʒus
alejus	aleʒus
alelo	alelo
alfabeti	alfabeti
alfabeto	alfabeto
algebrala	algebrala
algebro	algebro
algoritmi	algoritmi
alii	alii
alimentala	alimentala
alimentanta	alimentanta
alimentar	alimɛntar
alimentas	alimentas
alimentez	alimentɛs
alimentez	alimentɛz
alimentis	alimentis
alimento	alimento
alimentos	alimentɔs
alkeni	alkeni
alkeno	alkeno
alkoholo	alkoholo
almonar	almonar
almono	almono
alo	alo
altagrade	altagrade
altaji	altadʒi
altaji	altaʒi
altajo	altadʒo
altajo	altaʒo
altanivela	altanivela
altega	altega
alterar	alterar
altra	altra
altru	altru
alumeto	alumeto
amasigar	amasigar
amaso	amaso
amebala	amebala
amebi	amebi
amebo	amebo
ameliorar	ameli̯orar
ami	ami
amiki	amiki
amiko	amiko
amo	amo
amorala	amorala
amoranti	amoranti
amorar	amorar
amorati	amorati
amoratino	amoratino
amorato	amorato
amoratulo	amoratulo
amorinti	amorinti
amoriti	amoriti
amoro	amoro
amoronti	amoronti
amoroti	amoroti
amortisar	amɔrtisar
amperi	amperi
ampero	ampero
ampla	ampla
amuzar	amuzar
an	an
anado	anado
anagramo	anagramo
analoga	analoga
ananasi	ananasi
ananaso	ananaso
ancestrala	antsestrala
ancestri	antsestri
ancestro	antsestro
anciena	antsijena
anciena	antsijɛna
anciena	antsjena
anciena	antsjɛna
anekdoto	anekdoto
anelido	anelido
anemono	anemono
angliana	aŋgliana
anguli	anguli
angulo	angulo
anhelanta	anhelanta
anhelante	anhelante
anhelanti	anhelanti
anhelanto	anhelanto
anhelar	anhelar
anhelas	anhelas
anhelegar	anhelegar
anhelez	anhelɛs
anhelez	anhelɛz
anheligar	anheligar
anheligez	anheligɛs
anheligez	anheligɛz
anhelinta	anhelinta
anhelinte	anhelinte
anhelinti	anhelinti
anhelinto	anhelinto
anhelir	anhelir
anhelis	anhelis
anhelonta	anhelonta
anhelonte	anhelonte
anhelonti	anhelonti
anhelonto	anhelonto
anhelor	anhelɔr
anhelos	anhelɔs
anhelus	anhelus
animala	animala
animalo	animalo
animar	animar
animas	animas
animir	animir
animor	animɔr
aniono	ani̯ono
anjeli	andʒeli
anjeli	anʒeli
anjelo	andʒelo
anjelo	anʒelo
anke	anke
ankore	ankore
ankro	ankro
anmala	anmala
anmo	anmo
anso	anso
antarktika	antarktika
ante	ante
antea	antea
antee	antee
antibiotiko	antibi̯otiko
anticipante	antitsipante
anticipanti	antitsipanti
anticipanto	antitsipanto
anticipar	antitsipar
anticipas	antitsipas
anticipata	antitsipata
anticipate	antitsipate
anticipati	antitsipati
anticipato	antitsipato
anticipez	antitsipɛs
anticipez	antitsipɛz
anticipinti	antitsipinti
anticipis	antitsipis
anticipita	antitsipita
anticipiti	antitsipiti
anticiponti	antitsiponti
anticipor	antitsipɔr
anticipos	antitsipɔs
anticipoti	antitsipoti
anticipus	antitsipus
antiheroo	antiheroo
antiqua	antikwa
antologii	antologii
antologio	antologi̯o
anuncar	anuntsar
aorti	aorti
aortitala	aortitala
aortito	aortito
aorto	aorto
aparar	aparar
aparas	aparas
aparati	aparati
aparato	aparato
aparez	aparɛs
aparez	aparɛz
aparir	aparir
aparor	aparɔr
aparos	aparɔs
apartamenti	apartamenti
apartamento	apartamento
apartenar	apartenar
apelante	apelante
apelar	apelar
apelas	apelas
apelez	apelɛs
apelez	apelɛz
apelinte	apelinte
apelir	apelir
apelis	apelis
apelonte	apelonte
apelor	apelɔr
apelos	apelɔs
apelus	apelus
apen	apen
apene	apene
apertante	apertante
apertanti	apertanti
apertanto	apertanto
apertar	apertar
apertas	apertas
apertata	apertata
apertate	apertate
apertati	apertati
apertato	apertato
apertez	apertɛs
apertez	apertɛz
apertis	apertis
apertita	apertita
aperto	aperto
apertor	apertɔr
apertos	apertɔs
apertus	apertus
aplikanti	aplikanti
aplikar	aplikar
aplikas	aplikas
aplikati	aplikati
aplikez	aplikɛs
aplikez	aplikɛz
apliki	apliki
aplikinti	aplikinti
aplikir	aplikir
aplikis	aplikis
aplikiti	aplikiti
apliko	apliko
aplikonti	aplikonti
aplikor	aplikɔr
aplikos	aplikɔs
aplikoti	aplikoti
aplikus	aplikus
apogar	apogar
apogas	apogas
apogili	apogili
apogilo	apogilo
apogis	apogis
apogos	apogɔs
apogus	apogus
apologiar	apologjar
apreciar	apretsi̯ar
apta	apta
aptesar	aptesar
apud	apud
aqua	aku̯a
aqua	akva
aquirajo	aku̯iraʒo
aquirajo	akviradʒo
aquirar	akvirar
aquirar	akwirar
aquirez	akvirɛs
aquirez	akwirɛz
aquiros	akvirɔs
aquiros	akwirɔs
aquo	akwo
aquofalo	akwofalo
aquovortici	aku̯ovortitsi
aquovortici	akvovortitsi
aquovortico	aku̯ovortitso
aquovortico	akvovortitso
aquoza	akwoza
arachar	aratʃar
arakido	arakido
aranjar	arandʒar
aranjar	aranʒar
aranjas	arandʒas
aranjas	aranʒas
aranjez	arandʒɛs
aranjez	aranʒɛz
aranjir	arandʒir
aranjir	aranʒir
aranjis	arandʒis
aranjis	aranʒis
aranjor	arandʒɔr
aranjor	aranʒɔr
aranjos	arandʒɔs
aranjos	aranʒɔs
aranjus	arandʒus
aranjus	aranʒus
arbalesti	arbalesti
arbalesto	arbalesto
arbustaro	arbustaro
arbustaro	arbustarɔ
arbusto	arbusto
archo	artʃo
argumentanta	argumentanta
argumentante	argumentante
argumentanti	argumentanti
argumentanto	argumentanto
argumentar	argumentar
argumentas	argumentas
argumentata	argumentata
argumentate	argumentate
argumentati	argumentati
argumentato	argumentato
argumentez	argumentɛs
argumentez	argumentɛz
argumenti	argumenti
argumentinta	argumentinta
argumentinte	argumentinte
argumentinti	argumentinti
argumentinto	argumentinto
argumentir	argumentir
argumentis	argumentis
argumentita	argumentita
argumentite	argumentite
argumentiti	argumentiti
argumentito	argumentito
argumento	argumento
argumentonta	argumentonta
argumentonte	argumentonte
argumentonti	argumentonti
argumentonto	argumentonto
argumentor	argumentɔr
argumentos	argumentɔs
argumentota	argumentota
argumentote	argumentote
argumentoti	argumentoti
argumentoto	argumentoto
argumentus	argumentus
aristokrati	aristokrati
aristokrato	aristokrato
arjenta	ardʒenta
arjenta	arʒenta
arjentea	ardʒentea
arjentea	arʒentea
arjenti	ardʒenti
arjenti	arʒenti
arjentinia	arʒentinia
arjento	ardʒento
arjento	arʒento
arjentomoneto	ardʒentomoneto
arjentomoneto	arʒentomoneto
arjentoza	ardʒentoza
arjentoza	arʒentoza
arkeologio	arkeologi̯o
arki	arki
arkianjelo	arki̯andʒelo
arkianjelo	arki̯anʒelo
arkiduko	arkiduko
arkiepiskopo	arki̯episkopo
arkipelago	arkipelago
arkitekti	arkitekti
arkitekto	arkitɛkto
arkitekturi	arkitekturi
arkitekturo	arkitɛkturo
arkivisto	arkivisto
arko	arko
armarkeri	armarkeri
armarkero	armarkero
armarki	armarki
armarkisti	armarkisti
armarkisto	armarkisto
armarko	armarko
armei	armei
armeo	armeo
armo	armo
armoro	armoro
armoro	aɾmɔɾɔ
arogar	arogar
arogema	arogema
aromata	aromata
arti	arti
artificala	artifitsala
artificale	artifitsale
artisto	artisto
artisto	aɾtistɔ
arto	arto
arto	aɾtɔ
artokarpo	artokarpo
artokarpofrukto	artokarpofrukto
artoverko	artoverko
asasinar	asasinar
asfalto	asfalto
asidua	asiduwa
asidue	asiduwe
askoltar	askɔltar
asno	asno
asortar	asortar
aspektar	aspektar
aspirar	aspirar
astmo	astmo
astrofiziko	astrofiziko
astrolabo	astrolabo
astronomo	astronomo
atachar	atatʃar
atachita	atatʃita
atachuri	atatʃuri
atachuro	atatʃuro
atakir	atakir
atakor	atakɔr
atakos	atakɔs
atencar	atentsar
atencoze	atentsoze
atentanta	atentanta
atentante	atentante
atentanti	atentanti
atentanto	atentanto
atentar	atentar
atentas	atentas
atentata	atentata
atentate	atentate
atentati	atentati
atentato	atentato
atentez	atentɛs
atentez	atentɛz
atenti	atenti
atentinta	atentinta
atentinte	atentinte
atentinti	atentinti
atentinto	atentinto
atentir	atentir
atentis	atentis
atentita	atentita
atentite	atentite
atentiti	atentiti
atentito	atentito
atentonta	atentonta
atentonte	atentonte
atentonti	atentonti
atentonto	atentonto
atentor	atentɔr
atentos	atentɔs
atentota	atentota
atentote	atentote
atentoti	atentoti
atentoto	atentoto
atentus	atentus
atinganta	atinganta
atingante	atingante
atinganti	atinganti
atinganto	atinganto
atingar	atingar
atingas	atingas
atingata	atingata
atingate	atingate
atingati	atingati
atingato	atingato
atingez	atingɛs
atingez	atingɛz
atingi	atingi
atinginta	atinginta
atinginte	atinginte
atinginti	atinginti
atinginto	atinginto
atingir	atingir
atingis	atingis
atingita	atingita
atingite	atingite
atingiti	atingiti
atingito	atingito
atingo	atingo
atingonta	atingonta
atingonte	atingonte
atingonti	atingonti
atingonto	atingonto
atingor	atingɔr
atingos	atingɔs
atingota	atingota
atingote	atingote
atingoti	atingoti
atingoto	atingoto
atingus	atingus
atolo	atolo
atomi	atomi
atomo	atomo
audaceskez	au̯datseskɛs
audaceskez	au̯datseskɛz
audacez	au̯datsɛs
audacez	au̯datsɛz
audaco	au̯datso
augmentar	au̯gmentar
augmentar	au̯gmɛntaɾ
augmentas	au̯gmentas
augmentez	au̯gmentɛs
augmentez	au̯gmentɛz
augmentir	au̯gmentir
augmentis	au̯gmentis
augmentor	au̯gmentɔr
augmentos	au̯gmentɔs
augmentus	au̯gmentus
augurar	au̯gurar
auguras	au̯guras
auguris	au̯guris
auskultar	au̯skultar
auskultilo	au̯skultilo
autarkeso	au̯tarkeso
automobili	au̯tomobili
automobilo	au̯tomobilo
automobilo	au̯tɔmɔbilɔ
autori	au̯tori
autoro	au̯toro
autoryuri	au̯torjuri
autoryuro	au̯torjuro
autuno	au̯tuno
autuno	au̯tunɔ
avalanchar	avalantʃar
avalanchar	avalantʃaɾ
avalancho	avalantʃo
avalancho	avalantʃɔ
avan	avan
avana	avana
avancar	avantsar
avancigar	avantsigar
avane	avane
avantaji	avantadʒi
avantaji	avantaʒi
avantajo	avantadʒo
avantajo	avantaʒo
avelano	avelano
avelano	avelanɔ
averto	averto
aviacar	aviatsar
aviaco	aviatso
avida	avida
aviono	avi̯ono
avo	avo
avokado	avokado
axi	agzi
axi	aksi
axiomala	agzi̯omala
axiomala	aksi̯omala
axiomi	agzi̯omi
axiomi	aksi̯omi
axiomo	agzi̯omo
axiomo	aksi̯omo
axo	akso
axoloto	agzoloto
axoloto	aksoloto
axoloto	akzoloto
b	b
b	be
babilachabez	babilatʃabɛs
babilachabez	babilatʃabɛz
babilachar	babilatʃar
babilachez	babilatʃɛs
babilachez	babilatʃɛz
babiladar	babiladar
babiladas	babiladas
babiladez	babiladɛs
babiladez	babiladɛz
babiladi	babiladi
babiladis	babiladis
babilados	babiladɔs
babiladus	babiladus
babilanta	babilanta
babilar	babilar
babilas	babilas
babilema	babilema
babilez	babilɛs
babilez	babilɛz
babili	babili
babilis	babilis
babilos	babilɔs
babilus	babilus
bagajo	bagadʒo
bagajo	bagaʒo
bakanta	bakanta
bakante	bakante
bakanti	bakanti
bakanto	bakanto
bakar	bakar
bakata	bakata
bakate	bakate
bakati	bakati
bakato	bakato
bakinta	bakinta
bakinti	bakinti
bakinto	bakinto
bakita	bakita
bakiti	bakiti
bakito	bakito
bakonta	bakonta
bakonti	bakonti
bakonto	bakonto
bakota	bakota
bakoti	bakoti
bakoto	bakoto
bakterii	bakterii
bakterio	bakterio
bakterio	bakterjo
balasto	balasto
balbutar	balbutar
balda	balda
balistiko	balistiko
balnar	balnar
balono	balono
balustrado	balustrado
balzamino	balzamino
balzamo	balzamo
banano	banano
banano	bananɔ
bandaji	bandadʒi
bandaji	bandaʒi
bandajizabez	bandadʒizabɛs
bandajizabez	bandaʒizabɛz
bandajizanta	bandadʒizanta
bandajizanta	bandaʒizanta
bandajizante	bandadʒizante
bandajizante	bandaʒizante
bandajizanti	bandadʒizanti
bandajizanti	bandaʒizanti
bandajizanto	bandadʒizanto
bandajizanto	bandaʒizanto
bandajizata	bandadʒizata
bandajizata	bandaʒizata
bandajizate	bandadʒizate
bandajizate	bandaʒizate
bandajizati	bandadʒizati
bandajizati	bandaʒizati
bandajizato	bandadʒizato
bandajizato	bandaʒizato
bandajizez	bandadʒizɛs
bandajizez	bandaʒizɛz
bandajizinta	bandadʒizinta
bandajizinta	bandaʒizinta
bandajizinte	bandadʒizinte
bandajizinte	bandaʒizinte
bandajizinti	bandadʒizinti
bandajizinti	bandaʒizinti
bandajizinto	bandadʒizinto
bandajizinto	bandaʒizinto
bandajizita	bandadʒizita
bandajizita	bandaʒizita
bandajizite	bandadʒizite
bandajizite	bandaʒizite
bandajiziti	bandadʒiziti
bandajiziti	bandaʒiziti
bandajizito	bandadʒizito
bandajizito	bandaʒizito
bandajizonta	bandadʒizonta
bandajizonta	bandaʒizonta
bandajizonte	bandadʒizonte
bandajizonte	bandaʒizonte
bandajizonti	bandadʒizonti
bandajizonti	bandaʒizonti
bandajizonto	bandadʒizonto
bandajizonto	bandaʒizonto
bandajizota	bandadʒizota
bandajizota	bandaʒizota
bandajizote	bandadʒizote
bandajizote	bandaʒizote
bandajizoti	bandadʒizoti
bandajizoti	bandaʒizoti
bandajizoto	bandadʒizoto
bandajizoto	bandaʒizoto
bandajo	bandadʒo
bandajo	bandaʒo
bankisto	bankisto
banko	banko
bankroti	bankroti
bankrotinto	bankrotinto
bankroto	bankroto
barbuliar	barbuli̯ar
barelo	barelo
bari	bari
baricentri	baritsentri
baricentro	baritsentro
barilo	barilo
baro	baro
baroka	baroka
barometri	barometri
barometro	barɔmɛtrɔ
baroskopo	baroskopo
basa	basa
basamenti	basamenti
basamento	basamento
baseni	baseni
baseno	baseno
basigar	basigar
baso	basɔ
bastonagar	bastonagar
bastonagas	bastonagas
bastonagez	bastonagɛs
bastonagez	bastonagɛz
bastonagir	bastonagir
bastonagis	bastonagis
bastonagor	bastonagɔr
bastonagos	bastonagɔs
bastonagus	bastonagus
bastoneto	bastoneto
bastono	bastono
batar	batar
batas	batas
bati	bati
bato	bato
bavuri	bavuri
bavuro	bavuro
bazolinei	bazolinei
bazolineo	bazolineo
be	be
be	bɛ
bebeo	bebeo
beja	beʒa
beko	beko
bela	bela
belgia	belgia
belgia	belgja
beligar	beligar
benedikar	benedikar
benigna	benigna
benki	benki
benko	benko
berberiso	berberiso
berenjeni	berendʒeni
berenjeni	berenʒeni
berenjeno	berendʒeno
berenjeno	berenʒeno
bergamoto	bergamoto
bersar	bersar
bersilo	bersilo
bestio	bestio
bestio	bestjo
bezonas	bezonas
bezonis	bezonis
bezonos	bezonɔs
bezonus	bezonus
biblala	biblala
bibli	bibli
biblioteko	biblioteko
biblioteko	bibljoteko
biblo	biblo
bici	bitsi
biciklagar	bitsiklagar
bicikli	bitsikli
biciklo	bitsiklo
bico	bitso
bicoko	bitsoko
bideti	bideti
bideto	bideto
bielorusia	bi̯elorusi̯a
bigama	bigama
bigamesi	bigamesi
bigameso	bigameso
bigami	bigami
bigamo	bigamo
bigota	bigota
bikonvexa	bikonvegza
bikonvexa	bikonveksa
biliardo	bili̯ardo
bilingua	bilingu̯a
bilingua	bilingva
bilinguesi	bilingu̯esi
bilinguesi	bilingvesi
bilingueso	bilingu̯eso
bilingueso	bilingveso
bimanua	bimanua
bindar	bindar
bineti	bineti
bineto	bineto
binoklo	binoklo
binuklea	binuklea
biokemii	bi̯okemii
biokemio	biokemio
biomaso	biomaso
biomekaniko	biomekaniko
biomekanismo	biomekanismo
bioritmi	bi̯oritmi
bioritmo	bi̯oritmo
bioteknologio	bioteknologio
bipeda	bipeda
biplano	biplano
biro	biro
bisextila	bisɛgztila
bisextila	bisɛkstila
bisquiti	bisku̯iti
bisquiti	biskviti
bisquito	bisku̯ito
bisquito	biskvito
bisulfidi	bisulfidi
bisulfido	bisulfido
biti	biti
bito	bito
bitra	bitra
bitresi	bitresi
bitreso	bitreso
bitrigar	bitrigar
blamar	blamar
blanka	blanka
blankatra	blankatra
blankigar	blankigar
blazono	blazono
blezar	blezar
blonda	blonda
blua	blua
bluzo	bluzo
boki	boki
boko	boko
bokotuki	bokotuki
bokotuko	bokotuko
boliar	boli̯ar
bolias	boli̯as
bolietar	boli̯etar
boliez	boli̯ɛs
boliez	boli̯ɛz
boliigar	boliigar
boliigas	boliigas
boliigez	boliigɛs
boliigez	boliigɛz
boliigir	boliigir
boliigis	boliigis
boliigor	boliigɔr
boliigos	boliigɔs
boliigus	boliigus
boliir	boliir
boliis	boliis
bolior	boli̯ɔr
bolios	boli̯ɔs
bolius	boli̯us
bolo	bolo
bombi	bombi
bona	bona
bonbono	bɔnbono
bone	bone
bonfacar	bɔnfatsar
bonfaci	bonfatsi
bonfaco	bonfatso
bonvenar	bonvenar
bonveni	bonveni
bonvenigar	bonvenigar
bonveno	bonveno
bonvolo	bonvolo
borar	borar
borato	borato
bordi	bordi
bordizar	bordizar
bordo	bordo
bordumo	bordumo
borgezi	borgezi
borgezo	borgezo
botanizanta	botanizanta
botanizante	botanizante
botanizanti	botanizanti
botanizanto	botanizanto
botanizar	bɔtanizar
botanizata	botanizata
botanizate	botanizate
botanizati	botanizati
botanizato	botanizato
botanizinta	botanizinta
botanizinte	botanizinte
botanizinti	botanizinti
botanizinto	botanizinto
botanizita	botanizita
botanizite	botanizite
botaniziti	botaniziti
botanizito	botanizito
botanizonta	botanizonta
botanizonte	botanizonte
botanizonti	botanizonti
botanizonto	botanizonto
botanizota	botanizota
botanizote	botanizote
botanizoti	botanizoti
botanizoto	botanizoto
bovo	bovo
bovulo	bovulo
boxanta	bogzanta
boxanta	boksanta
boxante	bogzante
boxante	boksante
boxanti	bogzanti
boxanti	boksanti
boxanto	bogzanto
boxanto	boksanto
boxar	bogzar
boxar	boksar
boxas	bogzas
boxas	boksas
boxata	bogzata
boxata	boksata
boxate	bogzate
boxate	boksate
boxati	bogzati
boxati	boksati
boxato	bogzato
boxato	boksato
boxez	bogzɛs
boxez	boksɛz
boxinta	bogzinta
boxinta	boksinta
boxinte	bogzinte
boxinte	boksinte
boxinti	bogzinti
boxinti	boksinti
boxinto	bogzinto
boxinto	boksinto
boxir	bogzir
boxir	boksir
boxis	bogzis
boxis	boksis
boxita	bogzita
boxita	boksita
boxite	bogzite
boxite	boksite
boxiti	bogziti
boxiti	boksiti
boxito	bogzito
boxito	boksito
boxo	bogzo
boxo	bokso
boxonta	bogzonta
boxonta	boksonta
boxonte	bogzonte
boxonte	boksonte
boxonti	bogzonti
boxonti	boksonti
boxonto	bogzonto
boxonto	boksonto
boxor	bogzɔr
boxor	boksɔr
boxos	bogzɔs
boxos	boksɔs
boxota	bogzota
boxota	boksota
boxote	bogzote
boxote	boksote
boxoti	bogzoti
boxoti	boksoti
boxoto	bogzoto
boxoto	boksoto
boxus	bogzus
boxus	boksus
braceleto	bratseleto
bradipo	bradipo
brakio	brakio
brakio	brakjo
brakiumo	brakiumo
brakiumo	brakiumɔ
brakiumo	brakjumo
brakiumo	brakjumɔ
bramar	bramar
bramas	bramas
bramez	bramɛs
bramez	bramɛz
bramis	bramis
bramo	bramo
bramos	bramɔs
bramus	bramus
brazilia	brazili̯a
brechi	bretʃi
brechizabez	bretʃizabɛs
brechizabez	bretʃizabɛz
brechizanta	bretʃizanta
brechizante	bretʃizante
brechizanti	bretʃizanti
brechizanto	bretʃizanto
brechizar	bretʃizar
brechizas	bretʃizas
brechizati	bretʃizati
brechizez	bretʃizɛs
brechizez	bretʃizɛz
brechizinta	bretʃizinta
brechizinte	bretʃizinte
brechizinti	bretʃizinti
brechizinto	bretʃizinto
brechizir	bretʃizir
brechizis	bretʃizis
brechiziti	bretʃiziti
brechizonta	bretʃizonta
brechizonte	bretʃizonte
brechizonti	bretʃizonti
brechizonto	bretʃizonto
brechizor	bretʃizɔr
brechizos	bretʃizɔs
brechizoti	bretʃizoti
brechizus	bretʃizus
brecho	bretʃo
breteli	breteli
bretelo	bretelo
brido	brido
briko	briko
brino	brino
brino	bɾinɔ
briocho	briotʃo
briocho	bɾiɔtʃɔ
brizoza	brizoza
brodar	brodar
brodas	brodas
brodis	brodis
brodos	brodɔs
brodus	brodus
brokati	brokati
brokato	brokato
bronzo	bronzo
broshuro	broʃuro
bruiso	brui̯so
brular	brular
brulas	brulas
bruli	bruli
brulis	brulis
brulos	brulɔs
brulus	brulus
brutala	brutala
bruto	bruto
bubacho	bubatʃo
bubi	bubi
bubino	bubino
bubo	bubo
bubono	bubono
bubuli	bubuli
bubulo	bubulo
buchar	butʃar
bucheyo	butʃejo
bujii	budʒii
bujii	buʒii
bujio	budʒi̯o
bujio	buʒi̯o
buklo	buklo
buletini	buletini
buletino	buletino
bulgaria	bulgari̯a
bulo	bulo
bulteni	bulteni
bulteno	bulteno
bumerango	bumerango
burjoni	burdʒoni
burjoni	burʒoni
burjonifar	burʒonifar
burjono	burdʒono
burjono	burʒono
burleska	burleska
burso	burso
busoli	busoli
busolo	busolo
busto	busto
butiko	butiko
butro	butro
buxo	bugzo
buxo	bukso
c	ts
c	tse
ca	tsa
cadie	tsadie
canokte	tsanokte
caro	tsaro
cavespere	tsavespere
ce	tse
ce	tsɛ
cedanti	tsedanti
cedar	tsedar
cedas	tsedas
cedati	tsedati
cedema	tsedema
cedez	tsedɛs
cedez	tsedɛz
cedinti	tsedinti
cedir	tsedir
cedis	tsedis
cediti	tsediti
cedonti	tsedonti
cedor	tsedɔr
cedos	tsedɔs
cedoti	tsedoti
cedrati	tsedrati
cedrato	tsedrato
cedri	tsedri
cedus	tsedus
celar	tselar
celerio	tseleri̯o
celiba	tseliba
celibino	tselibino
celulo	tselulo
cembro	tsembro
ceno	tseno
censo	tsenso
censuranta	tsensuranta
censurante	tsensurante
censuranti	tsensuranti
censuranto	tsensuranto
censurar	tsensurar
censuras	tsensuras
censurata	tsensurata
censurate	tsensurate
censurati	tsensurati
censurato	tsensurato
censurez	tsensurɛs
censurez	tsensurɛz
censuri	tsensuri
censurinta	tsensurinta
censurinte	tsensurinte
censurinti	tsensurinti
censurinto	tsensurinto
censurir	tsensurir
censuris	tsensuris
censurita	tsensurita
censurite	tsensurite
censuriti	tsensuriti
censurito	tsensurito
censuro	tsensuro
censuronta	tsensuronta
censuronte	tsensuronte
censuronti	tsensuronti
censuronto	tsensuronto
censuror	tsensurɔr
censuros	tsensurɔs
censurota	tsensurota
censurote	tsensurote
censuroti	tsensuroti
censuroto	tsensuroto
censurus	tsensurus
cent	sent
cent	tsent
cent	tsɛnt
centauro	tsentau̯ro
centimetri	tsentimetri
centimetro	tsentimetro
centri	tsentri
centriolo	tsentri̯olo
centro	tsentro
ceramikala	tseramikala
cerizo	tserizo
cernar	tsernar
certa	tserta
certe	tserte
certena	tsertena
cerumeni	tserumeni
cerumeno	tserumeno
cervo	tservo
cesar	tsesar
cesiganti	tsesiganti
cesigati	tsesigati
cesiginti	tsesiginti
cesigiti	tsesigiti
cesigonti	tsesigonti
cesigoti	tsesigoti
chagrenar	tʃagrenar
chagrenas	tʃagrenas
chagrenez	tʃagrenɛs
chagrenez	tʃagrenɛz
chagrenis	tʃagrenis
chagreno	tʃagreno
chagrenos	tʃagrenɔs
chagrenus	tʃagrenus
chambro	tʃambro
championesi	tʃampi̯onesi
championeso	tʃampi̯oneso
championo	tʃampiono
championo	tʃampjono
championokonkursi	tʃampi̯onokonkursi
championokonkurso	tʃampi̯onokonkurso
chanco	tʃantso
chanjabez	tʃandʒabɛs
chanjabez	tʃanʒabɛz
chanjanti	tʃandʒanti
chanjanti	tʃanʒanti
chanjar	tʃandʒar
chanjar	tʃanʒar
chanjas	tʃandʒas
chanjas	tʃanʒas
chanjati	tʃandʒati
chanjati	tʃanʒati
chanjez	tʃandʒɛs
chanjez	tʃanʒɛz
chanjinti	tʃandʒinti
chanjinti	tʃanʒinti
chanjir	tʃandʒir
chanjir	tʃanʒir
chanjis	tʃandʒis
chanjis	tʃanʒis
chanjiti	tʃandʒiti
chanjiti	tʃanʒiti
chanjonti	tʃandʒonti
chanjonti	tʃanʒonti
chanjor	tʃandʒɔr
chanjor	tʃanʒɔr
chanjos	tʃandʒɔs
chanjos	tʃanʒɔs
chanjoti	tʃandʒoti
chanjoti	tʃanʒoti
chanjus	tʃandʒus
chanjus	tʃanʒus
chao	tʃao
chapelo	tʃapelo
charioto	tʃarioto
charioto	tʃaɾiɔtɔ
charjar	tʃarʒar
charmante	tʃarmante
charmanti	tʃarmanti
charmanto	tʃarmanto
charmar	tʃarmar
charminti	tʃarminti
charminto	tʃarminto
charmonti	tʃarmonti
charmonto	tʃarmonto
charniragar	tʃarniragar
charniri	tʃarniri
charnirizar	tʃarnirizar
charniro	tʃarniro
chasar	tʃasar
chasar	tʃasaɾ
chaso	tʃaso
chaso	tʃasɔ
chasohundo	tʃasohundo
che	tʃe
che	tʃɛ
chekia	tʃeki̯a
chelati	tʃelati
chelato	tʃelato
chera	tʃera
chereskar	tʃereskar
chereskez	tʃereskɛs
chereskez	tʃereskɛz
cherpar	tʃerpar
cherpar	tʃɛɾpaɾ
chipa	tʃipa
chipro	tʃipro
ci	tsi
cibernetiko	tsibernetiko
cielala	tsi̯elala
cielarko	tsi̯elarko
ciencala	tsientsala
cienci	tsi̯entsi
ciencisto	tsientsisto
ciencisto	tsiɛntsistɔ
cienco	tsientso
cienco	tsiɛntsɔ
cilindro	tsilindrɔ
cilio	tsili̯o
cimbalo	tsimbalo
cindro	tsindro
cinematografilo	tsinematografilo
cinematografilo	tsinɛmatɔgɾafilɔ
cinemo	tsinemo
cintilo	tsintilo
cirkondar	tsirkondar
cirkum	tsirkum
cirkumaji	tsirkumadʒi
cirkumaji	tsirkumaʒi
cirkumajo	tsirkumaʒo
cirkumiranti	tsirkumiranti
cirkumirati	tsirkumirati
cirkumirinti	tsirkumirinti
cirkumiriti	tsirkumiriti
cirkumironti	tsirkumironti
cirkumiroti	tsirkumiroti
cirkumklozar	tsirkumklozar
cirkumklozez	tsirkumklozɛs
cirkumklozez	tsirkumklozɛz
cirkumskribar	tsirkumskribar
cirkumskribir	tsirkumskribir
cirkumskribor	tsirkumskribɔr
cis	tsis
cise	tsise
citanta	tsitanta
citante	tsitante
citanti	tsitanti
citanto	tsitanto
citar	tsitar
citas	tsitas
citata	tsitata
citate	tsitate
citati	tsitati
citato	tsitato
citez	tsitɛs
citez	tsitɛz
citinta	tsitinta
citinte	tsitinte
citinti	tsitinti
citinto	tsitinto
citir	tsitir
citis	tsitis
citita	tsitita
citite	tsitite
cititi	tsititi
citito	tsitito
citologio	tsitologi̯o
citonta	tsitonta
citonte	tsitonte
citonti	tsitonti
citonto	tsitonto
citor	tsitɔr
citos	tsitɔs
citota	tsitota
citote	tsitote
citoti	tsitoti
citoto	tsitoto
citrono	tsitrono
citrusfrukto	tsitrusfrukto
citruso	tsitruso
citus	tsitus
civila	tsivila
civitani	tsivitani
civitano	tsivitano
civito	tsivito
cizo	tsizo
co	tso
coexistir	tsoegzistir
coexistir	tsoeksistir
d	d
d	de
dami	dami
damnar	damnar
damnas	damnas
damnez	damnɛs
damnez	damnɛz
damnir	damnir
damnis	damnis
damnor	damnɔr
damnos	damnɔs
damnus	damnus
damo	damo
damo	damɔ
damzelo	damzelo
danjeroza	dandʒeroza
danjeroza	danʒeroza
danko	danko
dansar	dansar
darfar	darfar
darfas	darfas
datumari	datumari
datumaro	datumaro
datumi	datumi
datumo	datumo
de	de
de	dɛ
debati	debati
debato	debato
debilinterago	debilinterago
decar	detsar
decembri	detsembri
decembro	detsembro
decendanto	detsendanto
decendar	detsendar
decensar	detsensar
deceptar	detseptar
decidanta	detsidanta
decidante	detsidante
decidanti	detsidanti
decidanto	detsidanto
decidar	detsidar
decidas	detsidas
decidata	detsidata
decidate	detsidate
decidati	detsidati
decidato	detsidato
decidema	detsidema
decidez	detsidɛs
decidez	detsidɛz
decidigar	detsidigar
decidinta	detsidinta
decidinte	detsidinte
decidinti	detsidinti
decidinto	detsidinto
decidir	detsidir
decidis	detsidis
decidita	detsidita
decidite	detsidite
deciditi	detsiditi
decidito	detsidito
decido	detsido
decidonta	detsidonta
decidonte	detsidonte
decidonti	detsidonti
decidonto	detsidonto
decidos	detsidɔs
decidota	detsidota
decidote	detsidote
decidoti	detsidoti
decidoto	detsidoto
decidus	detsidus
decimala	detsimala
decimali	detsimali
decimalo	detsimalo
decimetri	detsimetri
decimetro	detsimetro
dedikir	dedikir
defensante	defensante
defensanti	defensanti
defensanto	defensanto
defensar	defensar
defensar	dɛfɛnsaɾ
defensata	defensata
defensate	defensate
defensati	defensati
defensato	defensato
defensez	defensɛs
defensez	defensɛz
degenerar	degenerar
dekani	dekani
dekano	dekano
delegiti	delegiti
delegito	delegito
delicio	delitsio
delicio	dɛlitsiɔ
delikata	delikata
demagogo	demagogo
demandar	demandar
dementa	dementa
dementerio	dementerio
demono	demono
demonstrante	demonstrante
demonstranti	demonstranti
demonstranto	demonstranto
demonstrar	demonstrar
demonstras	demonstras
demonstrata	demonstrata
demonstrate	demonstrate
demonstrati	demonstrati
demonstrato	demonstrato
demonstrez	demonstrɛs
demonstrez	demonstrɛz
demonstri	demonstri
demonstris	demonstris
demonstro	demonstro
demonstror	demonstrɔr
demonstros	demonstrɔs
demonstrus	demonstrus
densa	densa
denti	denti
dentifrici	dentifritsi
dentifrico	dentifritso
dentisto	dentisto
dento	dento
deo	deo
deplorinda	deplorinda
depos	depos
depos	dɛpɔs
depose	depose
depose	dɛpɔsɛ
depozanto	depozanto
depozar	depozar
depozario	depozari̯o
depozas	depozas
depozato	depozato
depozinto	depozinto
depozir	depozir
depozito	depozito
depozonto	depozonto
depozor	depozɔr
depozoto	depozoto
deputanti	deputanti
deputar	deputar
deputas	deputas
deputati	deputati
deputez	deputɛs
deputez	deputɛz
deputinti	deputinti
deputir	deputir
deputis	deputis
deputiti	deputiti
deputonti	deputonti
deputor	deputɔr
deputos	deputɔs
deputoti	deputoti
deputus	deputus
derivaji	derivadʒi
derivaji	derivaʒi
derivajo	derivaʒo
derivar	derivar
desaranjar	desarandʒar
desaranjar	desaranʒar
descharjar	destʃarʒar
desfacilaji	desfatsiladʒi
desfacilaji	desfatsilaʒi
desfacilajo	desfatsiladʒo
desfacilajo	desfatsilaʒo
desfacileskar	desfatsileskar
desfaciligar	desfatsiligar
desfeliceso	desfelitseso
desfidema	desfidema
desfidemeso	desfidemeso
desfreshigar	desfreʃigar
deshardeskar	deshardeskar
deshardigar	deshardigar
deshonesta	dɛshonɛsta
deshonoro	deshonoro
desklozar	desklozar
desklozez	desklozɛs
desklozez	desklozɛz
deskovrar	deskovrar
deskovresar	deskovresar
desmonetigar	desmonetigar
desorganizanta	desorganizanta
desorganizante	desorganizante
desorganizanti	desorganizanti
desorganizanto	desorganizanto
desorganizar	desorganizar
desorganizas	desorganizas
desorganizata	desorganizata
desorganizate	desorganizate
desorganizati	desorganizati
desorganizato	desorganizato
desorganizeso	desorganizeso
desorganizez	desorganizɛs
desorganizez	desorganizɛz
desorganizi	desorganizi
desorganizinta	desorganizinta
desorganizinte	desorganizinte
desorganizinti	desorganizinti
desorganizinto	desorganizinto
desorganizir	desorganizir
desorganizis	desorganizis
desorganizita	desorganizita
desorganizite	desorganizite
desorganiziti	desorganiziti
desorganizito	desorganizito
desorganizo	desorganizo
desorganizonta	desorganizonta
desorganizonte	desorganizonte
desorganizonti	desorganizonti
desorganizonto	desorganizonto
desorganizor	desorganizɔr
desorganizos	desorganizɔs
desorganizota	desorganizota
desorganizote	desorganizote
desorganizoti	desorganizoti
desorganizoto	desorganizoto
desorganizus	desorganizus
desplasizar	desplasizar
desplezuro	desplezuro
desplumizar	desplumizar
desrespektar	desrespektar
desskrubagar	dɛsskrubagar
desvisar	dɛsvisar
detale	detale
detali	detali
detalo	detalo
detaloza	detaloza
detektivo	detektivo
detonar	detonar
detonas	detonas
devancar	devantsar
developanta	developanta
developante	developante
developanti	developanti
developanto	developanto
developar	developar
developata	developata
developate	developate
developati	developati
developato	developato
developinta	developinta
developinte	developinte
developinti	developinti
developinto	developinto
developir	developir
developita	developita
developite	developite
developiti	developiti
developito	developito
developonta	developonta
developonte	developonte
developonti	developonti
developonto	developonto
developor	developɔr
developota	developota
developote	developote
developoti	developoti
developoto	developoto
devorar	devorar
devota	devota
dezinenco	dezinentso
dezirar	dezirar
deziregar	deziregar
dezirinda	dezirinda
diafana	di̯afana
dialogizar	di̯alogizar
dicante	ditsante
dicanti	ditsanti
dicanto	ditsanto
dicar	ditsar
dicar	ditsaɾ
dicas	ditsas
dicata	ditsata
dicate	ditsate
dicati	ditsati
dicato	ditsato
dicez	ditsɛs
dicez	ditsɛz
dicionario	ditsi̯onari̯o
dicir	ditsir
dicis	ditsis
dicite	ditsite
dicito	ditsito
dicor	ditsɔr
dicos	ditsɔs
dicus	ditsus
dieto	di̯eto
diferar	diferar
diferenciar	diferentsiar
difrakti	difrakti
difrakto	difrakto
diftongo	diftongo
difuzar	difuzar
digestar	digestar
digesto	digesto
digi	digi
digna	digna
digo	digo
dika	dika
diligenta	diligenta
dimezo	dimezo
diminutar	diminutar
diminutar	diminutaɾ
diminutas	diminutas
diminutos	diminutɔs
dina	dina
dinamitagar	dinamitagar
dinamito	dinamito
dinamo	dinamo
dinear	dinɛar
dinosaurio	dinosawrio
dinosauro	dinosawro
dio	dio
dio	diɔ
diocezi	di̯otsezi
diocezo	di̯otsezo
diplasar	diplasar
direktadi	direktadi
direktado	direktado
direktar	direktar
direktiva	direktiva
disciplinanti	distsiplinanti
disciplinar	distsiplinar
disciplinas	distsiplinas
disciplinati	distsiplinati
disciplinez	distsiplinɛs
disciplinez	distsiplinɛz
disciplininti	distsiplininti
disciplinir	distsiplinir
disciplinis	distsiplinis
discipliniti	distsipliniti
disciplinonti	distsiplinonti
disciplinor	distsiplinɔr
disciplinos	distsiplinɔs
disciplinoti	distsiplinoti
disciplinus	distsiplinus
disho	diʃo
disimular	disimular
disimulas	disimulas
disimulez	disimulɛs
disimulez	disimulɛz
disimulir	disimulir
disimulis	disimulis
disimulor	disimulɔr
disimulos	disimulɔs
disimulus	disimulus
disipar	disipar
diskursi	diskursi
diskurso	diskurso
diskutado	diskutado
diskuto	diskuto
dispozar	dispozar
dispozeso	dispozeso
dispozez	dispozɛs
dispozez	dispozɛz
dissolvar	dissolvar
dissolvas	dissolvas
dissolvi	dissolvi
dissolvo	dissolvo
dissolvo	dissolvɔ
distingar	distingar
distingo	distingo
distrikto	distrikto
divenar	divenar
diversa	diversa
dividar	dividar
dividas	dividas
dividis	dividis
dividos	dividɔs
divinar	divinar
divorcar	divortsar
divorcigar	divortsigar
divorco	divortso
dizastri	dizastri
dizastro	dizastro
docar	dotsar
docar	dɔtsaɾ
dogmato	dogmato
doktrino	doktrino
dolca	dɔltsa
dolorar	dolorar
dolori	dolori
dolorigar	dolorigar
doloro	doloro
domajar	domadʒar
domajar	domaʒar
domaji	domadʒi
domaji	domaʒi
domajo	domadʒo
domajo	domaʒo
domeni	domeni
domeno	domeno
domestika	domestika
dometi	dometi
dometo	dometo
domi	domi
dominacar	dɔminatsar
domo	domo
domo	dɔmɔ
donacar	donatsar
donacario	donatsario
donaji	donadʒi
donaji	donaʒi
donajo	donadʒo
donajo	donaʒo
donar	donar
dop	dop
dop	dɔp
dope	dope
dormar	dormar
dormetanti	dormetanti
dormetinti	dormetinti
dormetonti	dormetonti
dormez	dormɛs
dormez	dormɛz
dorsi	dorsi
dorso	dorso
dorsosako	dɔrsosako
dozo	dozo
draki	draki
drako	drako
dramato	dramato
drinkajo	drinkadʒo
drinkajo	drinkaʒo
drinkanta	drinkanta
drinkante	drinkante
drinkanto	drinkanto
drinkar	drinkar
drinkas	drinkas
drinkata	drinkata
drinkate	drinkate
drinkato	drinkato
drinkebla	drinkebla
drinkerio	drinkeri̯o
drinkeyo	drinkejo
drinkez	drinkɛs
drinkez	drinkɛz
drinkinta	drinkinta
drinkinte	drinkinte
drinkinto	drinkinto
drinkir	drinkir
drinkis	drinkis
drinkita	drinkita
drinkite	drinkite
drinkito	drinkito
drinkonta	drinkonta
drinkonte	drinkonte
drinkonto	drinkonto
drinkor	drinkɔr
drinkos	drinkɔs
drinkota	drinkota
drinkote	drinkote
drinkoto	drinkoto
drinkus	drinkus
dronar	dronar
dubar	dubar
dubitar	dubitar
dubitar	dubitaɾ
dubitema	dubitema
due	du̯e
duimi	duimi
duimo	duimo
duktar	duktar
dum	dum
dungo	dungo
duopligar	duopligar
dupi	dupi
dupiganti	dupiganti
dupiganto	dupiganto
dupigar	dupigar
dupigeri	dupigeri
dupigero	dupigero
dupo	dupo
durameni	durameni
durameno	durameno
duriti	duriti
durstar	durstar
dursto	dursto
dusencesi	dusentsesi
dusenceso	dusentseso
e	e
ebonito	ebonito
ecelar	etselar
eceptar	etseptar
ecepte	etsepte
ed	ɛd
edifici	edifitsi
edifico	edifitso
edro	edro
efacar	ɛfatsar
efikar	efikar
egala	egala
ego	ego
egorjar	ɛgorʒar
ek	ɛk
ekirar	ekirar
eklezio	eklezi̯o
eklipsi	eklipsi
ekliptiki	ekliptiki
ekliptiko	ekliptiko
ekologio	ekologi̯o
ekosistemi	ekosistemi
ekosistemo	ekosistemo
ekswichar	ekswitʃar
el	el
el	ɛl
elaboranta	elaboranta
elaborante	elaborante
elaboranti	elaboranti
elaboranto	elaboranto
elaborar	elaborar
elaborar	ɛlabɔɾaɾ
elaboras	elaboras
elaborata	elaborata
elaborate	elaborate
elaborati	elaborati
elaborato	elaborato
elaborez	elaborɛs
elaborez	elaborɛz
elaborinta	elaborinta
elaborinte	elaborinte
elaborinti	elaborinti
elaborinto	elaborinto
elaborir	elaborir
elaboris	elaboris
elaborita	elaborita
elaborite	elaborite
elaboriti	elaboriti
elaborito	elaborito
elaboronta	elaboronta
elaboronte	elaboronte
elaboronti	elaboronti
elaboronto	elaboronto
elaboror	elaborɔr
elaboros	elaborɔs
elaborota	elaborota
elaborote	elaborote
elaboroti	elaboroti
elaboroto	elaboroto
elaborus	elaborus
elefanti	elefanti
elefantini	elefantini
elefanto	elefanto
elefantuli	elefantuli
elektar	elektar
elektro	elektro
elu	elu
elua	elua
elua	elwa
embracar	embratsar
emersar	emersar
emfazar	emfazar
emiri	emiri
emiro	emiro
employar	emplojar
employas	emplojas
employez	emplojɛs
employez	emplojɛz
employis	emplojis
employos	emplojɔs
employus	emplojus
en	en
endokarpo	endokarpo
enduktar	enduktar
enemika	enemika
enemiko	enemiko
energiala	energi̯ala
energio	energi̯o
energioza	energi̯oza
engajar	engadʒar
engajar	engaʒar
enigmato	enigmato
enirar	enirar
enkorpiganta	enkorpiganta
enkorpigante	enkorpigante
enkorpiganti	enkorpiganti
enkorpiganto	enkorpiganto
enkorpigar	enkorpigar
enkorpigas	enkorpigas
enkorpigata	enkorpigata
enkorpigate	enkorpigate
enkorpigati	enkorpigati
enkorpigato	enkorpigato
enkorpigez	enkorpigɛs
enkorpigez	enkorpigɛz
enkorpiginta	enkorpiginta
enkorpiginte	enkorpiginte
enkorpiginti	enkorpiginti
enkorpiginto	enkorpiginto
enkorpigir	enkorpigir
enkorpigis	enkorpigis
enkorpigita	enkorpigita
enkorpigite	enkorpigite
enkorpigiti	enkorpigiti
enkorpigito	enkorpigito
enkorpigonta	enkorpigonta
enkorpigonte	enkorpigonte
enkorpigonti	enkorpigonti
enkorpigonto	enkorpigonto
enkorpigor	enkorpigɔr
enkorpigos	enkorpigɔs
enkorpigota	enkorpigota
enkorpigote	enkorpigote
enkorpigoti	enkorpigoti
enkorpigus	enkorpigus
enlanjigar	enlandʒigar
enlanjigar	enlanʒigar
enmurigar	enmurigar
enoyar	enojar
enswichar	enswitʃar
enterigar	enterigar
enterigeyo	enterigejo
entraprezi	entraprezi
entraprezo	entraprezo
entratenar	entratennar
entratenar	ɛntratɛnnar
entuziasmigar	entuzijasmigar
envolvar	envolvar
envolvas	envolvas
envolvez	envolvɛs
envolvez	envolvɛz
envolvir	envolvir
envolvis	envolvis
envolvor	envolvɔr
envolvos	envolvɔs
envolvus	envolvus
enzimo	enzimo
epicentri	epitsentri
epicentro	epitsentro
episkopo	episkopo
epoko	epoko
equaciono	eku̯atsi̯ono
equaciono	ekvatsi̯ono
equilibranta	eku̯ilibranta
equilibranta	ekvilibranta
equilibrante	eku̯ilibrante
equilibrante	ekvilibrante
equilibranti	eku̯ilibranti
equilibranti	ekvilibranti
equilibranto	eku̯ilibranto
equilibranto	ekvilibranto
equilibrar	eku̯ilibrar
equilibrar	ekvilibrar
equilibras	eku̯ilibras
equilibras	ekvilibras
equilibrata	eku̯ilibrata
equilibrata	ekvilibrata
equilibrate	eku̯ilibrate
equilibrate	ekvilibrate
equilibrati	eku̯ilibrati
equilibrati	ekvilibrati
equilibrato	eku̯ilibrato
equilibrato	ekvilibrato
equilibrez	eku̯ilibrɛz
equilibrez	ekvilibrɛs
equilibrinta	eku̯ilibrinta
equilibrinta	ekvilibrinta
equilibrinte	eku̯ilibrinte
equilibrinte	ekvilibrinte
equilibrinti	eku̯ilibrinti
equilibrinti	ekvilibrinti
equilibrinto	eku̯ilibrinto
equilibrinto	ekvilibrinto
equilibrir	eku̯ilibrir
equilibrir	ekvilibrir
equilibris	eku̯ilibris
equilibris	ekvilibris
equilibrita	eku̯ilibrita
equilibrita	ekvilibrita
equilibrite	eku̯ilibrite
equilibrite	ekvilibrite
equilibriti	eku̯ilibriti
equilibriti	ekvilibriti
equilibrito	eku̯ilibrito
equilibrito	ekvilibrito
equilibro	eku̯ilibro
equilibro	ekvilibro
equilibronta	eku̯ilibronta
equilibronta	ekvilibronta
equilibronte	eku̯ilibronte
equilibronte	ekvilibronte
equilibronti	eku̯ilibronti
equilibronti	ekvilibronti
equilibronto	eku̯ilibronto
equilibronto	ekvilibronto
equilibror	eku̯ilibrɔr
equilibror	ekvilibrɔr
equilibros	eku̯ilibrɔs
equilibros	ekvilibrɔs
equilibrota	eku̯ilibrota
equilibrota	ekvilibrota
equilibrote	eku̯ilibrote
equilibrote	ekvilibrote
equilibroti	eku̯ilibroti
equilibroti	ekvilibroti
equilibroto	eku̯ilibroto
equilibroto	ekvilibroto
equilibrus	eku̯ilibrus
equilibrus	ekvilibrus
equivalar	ekwivalar
erci	ertsi
erco	ɛrtso
erektar	erektar
eriko	eriko
ermito	ermito
eroranta	eroranta
erorante	erorante
erorar	erorar
eroras	eroras
erorez	erorɛs
erorez	erorɛz
erorir	erorir
eroris	eroris
eroro	eroro
eroro	ɛɾɔɾɔ
eroror	erorɔr
eroros	erorɔs
erorus	erorus
erste	ɛɾste
es	ɛs
esamifar	esamifar
esamo	esamo
esanta	esanta
esante	esante
esanti	esanti
esanto	esanto
esar	esar
esencala	esentsala
esenci	esentsi
esenco	esentso
esforcar	ɛsfɔrtsar
eshafodo	eʃafodo
esinta	esinta
esinte	esinte
esinti	esinti
esinto	esinto
eskadro	eskadro
eskadrono	eskadrono
eskapar	eskapar
esonta	esonta
esonte	esonte
esonti	esonti
esonto	esonto
espado	espado
espelar	espelar
espelar	ɛspɛlaɾ
esperanto	esperanto
esperar	esperar
esperas	esperas
esperez	esperɛs
esperez	esperɛz
esperonto	esperonto
espista	ɛspista
espisto	ɛspisto
espo	espo
esquado	eskwado
esto	esto
esvanar	ɛsvanar
eterna	eterna
eternigar	eternigar
etero	etero
etikala	etikala
etiketo	ɛtikɛtɔ
etiko	etiko
etiqueto	etikveto
etiqueto	etikweto
etnologi	etnologi
etnologii	etnologii
etnologio	etnologi̯o
etnologo	etnologo
etuyo	etujo
euro	ɛu̯ro
europa	ewropa
europa	ɛwɾɔpa
europana	eu̯ropana
evaluar	evaluar
evaluar	ɛvaluaɾ
evaluate	evaluate
evar	evar
evidente	evidente
evieri	evi̯eri
eviero	evi̯ero
evita	evita
eviti	eviti
evito	evito
evo	evo
evolucionar	evolutsi̯onar
evolucionas	evolutsi̯onas
evolucionez	evolutsi̯onɛs
evolucionez	evolutsi̯onɛz
evolucionigar	evolutsi̯onigar
evolucionir	evolutsi̯onir
evolucionis	evolutsi̯onis
evolucionor	evolutsi̯onɔr
evolucionos	evolutsi̯onɔs
evolucionus	evolutsi̯onus
exajeranti	egzadʒeranti
exajeranti	eksaʒeranti
exajeranto	egzadʒeranto
exajeranto	eksaʒeranto
examenar	egzamenar
examenar	eksamenar
examenato	egzamenato
examenato	eksamenato
exameni	egzameni
exameni	eksameni
exameno	egzameno
exameno	eksameno
exasperanta	egzasperanta
exasperanta	eksasperanta
exasperante	egzasperante
exasperante	eksasperante
exasperanti	egzasperanti
exasperanti	eksasperanti
exasperanto	egzasperanto
exasperanto	eksasperanto
exasperar	egzasperar
exasperar	eksasperar
exasperas	egzasperas
exasperas	eksasperas
exasperata	egzasperata
exasperata	eksasperata
exasperate	egzasperate
exasperate	eksasperate
exasperati	egzasperati
exasperati	eksasperati
exasperato	egzasperato
exasperato	eksasperato
exasperez	egzasperɛs
exasperez	eksasperɛz
exasperinta	egzasperinta
exasperinta	eksasperinta
exasperinte	egzasperinte
exasperinte	eksasperinte
exasperinti	egzasperinti
exasperinti	eksasperinti
exasperinto	egzasperinto
exasperinto	eksasperinto
exasperir	egzasperir
exasperir	eksasperir
exasperis	egzasperis
exasperis	eksasperis
exasperita	egzasperita
exasperita	eksasperita
exasperite	egzasperite
exasperite	eksasperite
exasperiti	egzasperiti
exasperiti	eksasperiti
exasperito	egzasperito
exasperito	eksasperito
exasperonta	egzasperonta
exasperonta	eksasperonta
exasperonte	egzasperonte
exasperonte	eksasperonte
exasperonti	egzasperonti
exasperonti	eksasperonti
exasperonto	egzasperonto
exasperonto	eksasperonto
exasperor	egzasperɔr
exasperor	eksasperɔr
exasperos	egzasperɔs
exasperos	eksasperɔs
exasperota	egzasperota
exasperota	eksasperota
exasperote	egzasperote
exasperote	eksasperote
exasperoti	egzasperoti
exasperoti	eksasperoti
exasperoto	egzasperoto
exasperoto	eksasperoto
exasperus	egzasperus
exasperus	eksasperus
exekutar	egzekutar
exekutar	eksekutar
exekutebla	egzekutebla
exekutebla	eksekutebla
exekuti	egzekuti
exekuti	eksekuti
exekuto	egzekuto
exekuto	eksekuto
exhortar	egzhortar
exhortar	ekshortar
exkavar	ɛgzkavar
exkavar	ɛkskavar
exkluzar	egzkluzar
exkluzar	ekskluzar
exkuzar	ekskuzar
exkuzo	ekskuzo
exkuzo	ɛkskuzɔ
expektar	egzpektar
expektar	ekspektar
experimento	eksperimento
explikar	egzplikar
explikar	eksplikar
explikas	egzplikas
explikas	eksplikas
explikez	egzplikɛs
explikez	eksplikɛz
explikir	egzplikir
explikir	eksplikir
explikis	egzplikis
explikis	eksplikis
explikor	egzplikɔr
explikor	eksplikɔr
explikos	egzplikɔs
explikos	eksplikɔs
explikus	egzplikus
explikus	eksplikus
expresar	ekspresar
expresema	egzpresema
expresema	ekspresema
extensar	ɛgztɛnsar
extensar	ɛkstɛnsar
extensas	egztensas
extensas	ekstensas
extensos	egztensɔs
extensos	ekstensɔs
extera	ekstera
exteraji	egzteradʒi
exteraji	eksteraʒi
exterajo	egzteradʒo
exterajo	eksteraʒo
extere	ekstere
extingar	egztingar
extingar	ekstingar
extirpar	egztirpar
extirpar	ekstirpar
extra	egztra
extra	ekstra
extraordinara	ekstraordinarijo
extrema	egztrema
extrema	ekstrema
exuduri	egzuduri
exuduri	eksuduri
exuduro	egzuduro
exuduro	eksuduro
exulcero	egzultsero
exulcero	eksultsero
exutorio	egzutori̯o
exutorio	eksutori̯o
ezoko	ezoko
f	f
f	fe
fabli	fabli
fablo	fablo
fabo	fabo
fabrikar	fabrikar
fabrikerio	fabrikerio
fabriki	fabriki
fabrikir	fabrikir
fabrikis	fabrikis
fabriko	fabriko
fabrikor	fabrikɔr
fabrikos	fabrikɔs
facar	fatsar
facila	fatsila
facile	fatsile
facileskar	fatsileskar
faciligar	fatsiligar
fagonuco	fagonutso
fairo	fairo
fairo	faiɾɔ
fakte	fakte
fakti	fakti
fakto	fakto
fakturo	fakturo
falar	falar
faliar	fali̯ar
faligar	faligar
falo	falo
familio	famili̯o
famoza	famoza
fanatika	fanatika
fanatikeso	fanatikeso
fanfaronadi	fanfaronadi
fanfaronado	fanfaronado
fanfaronar	fanfaronar
fango	fango
fantaziar	fantaziar
fantazias	fantazi̯as
fantaziez	fantazi̯ɛs
fantaziez	fantazi̯ɛz
fantaziir	fantaziir
fantaziis	fantaziis
fantazior	fantazi̯ɔr
fantazios	fantazi̯ɔs
fantazius	fantazi̯us
fantomi	fantomi
fantomo	fantomo
faraono	faraono
farbi	farbi
farbo	farbo
faro	faro
fasado	fasado
fastar	fastar
fatala	fatala
fatigar	fatigar
fato	fato
favoranta	favoranta
favorante	favorante
favoranti	favoranti
favoranto	favoranto
favorar	favorar
favoras	favoras
favorata	favorata
favorate	favorate
favorati	favorati
favorato	favorato
favorez	favorɛs
favorez	favorɛz
favorinta	favorinta
favorinte	favorinte
favorinti	favorinti
favorinto	favorinto
favorir	favorir
favoris	favoris
favorita	favorita
favorite	favorite
favoriti	favoriti
favorito	favorito
favoronta	favoronta
favoronte	favoronte
favoronti	favoronti
favoronto	favoronto
favoror	favorɔr
favoros	favorɔs
favorota	favorota
favorote	favorote
favoroti	favoroti
favoroto	favoroto
favorus	favorus
faxar	fagzar
faxar	faksar
fe	fe
fe	fɛ
febla	febla
febrala	febrala
febrar	febrar
febratra	febratra
febroza	febroza
februari	februari
februaro	februaro
feko	feko
feldo	fɛldo
felica	felitsa
feliceso	felitseso
femuro	femuro
fendar	fendar
fenestro	fenestro
ferma	fɛrma
fero	fero
fervoroza	fervoroza
fervoyala	fervojala
fervoyi	fervoji
fervoyo	fervojo
festinanta	festinanta
festinante	festinante
festinanti	festinanti
festinanto	festinanto
festinar	festinar
festinas	festinas
festinez	festinɛs
festinez	festinɛz
festininta	festininta
festininte	festininte
festininti	festininti
festininto	festininto
festinir	festinir
festinis	festinis
festinonta	festinonta
festinonte	festinonte
festinonti	festinonti
festinonto	festinonto
festinor	festinɔr
festinos	festinɔs
festinus	festinus
fetida	fetida
feto	feto
fiancar	fiantsaɾ
fiancitino	fiantsitino
fiancitino	fiantsitinɔ
fiancito	fiantsito
fiancito	fiantsitɔ
fiancitulo	fiantsitulo
fiancitulo	fiantsitulɔ
fiasko	fiasko
fidar	fidar
fiera	fi̯era
figi	figi
figo	figo
figuri	figuri
figuro	figuro
figuro	figuɾɔ
filmo	filmo
filozofiar	filozofiar
filozofio	filozofjo
filtranta	filtranta
filtrante	filtrante
filtranti	filtranti
filtranto	filtranto
filtrar	filtrar
filtras	filtras
filtrata	filtrata
filtrate	filtrate
filtrati	filtrati
filtrato	filtrato
filtrez	filtrɛs
filtrez	filtrɛz
filtrinta	filtrinta
filtrinte	filtrinte
filtrinti	filtrinti
filtrinto	filtrinto
filtrir	filtrir
filtris	filtris
filtrita	filtrita
filtrite	filtrite
filtriti	filtriti
filtrito	filtrito
filtronta	filtronta
filtronte	filtronte
filtronti	filtronti
filtronto	filtronto
filtror	filtrɔr
filtros	filtrɔs
filtrota	filtrota
filtrote	filtrote
filtroti	filtroti
filtroto	filtroto
filtrus	filtrus
finanta	finanta
finante	finante
finanto	finanto
finar	finar
finas	finas
finata	finata
finate	finate
finato	finato
fine	fine
finez	finɛs
finez	finɛz
fingri	fingri
fingro	fingro
fini	fini
fininta	fininta
fininte	fininte
fininto	fininto
finir	finir
finis	finis
finita	finita
finite	finite
finiti	finiti
finito	finito
finlandana	finlandana
finlando	finlando
fino	fino
finonta	finonta
finonte	finonte
finonto	finonto
finor	finɔr
finos	finɔs
finota	finota
finote	finote
finoto	finoto
finus	finus
fixigesar	fiksigesar
fiziko	fiziko
flajoleti	fladʒoleti
flajoleti	flaʒoleti
flajoleto	fladʒoleto
flajoleto	flaʒoleto
flamo	flamo
flarar	flarar
flatuema	flatuema
flatulenta	flatulenta
flechi	fletʃi
flecho	fletʃo
flegar	flegar
flegas	flegas
flegez	flegɛs
flegez	flegɛz
flegir	flegir
flegis	flegis
flegor	flegɔr
flegos	flegɔs
flegus	flegus
floko	floko
florkaulo	florkau̯lo
floro	floro
floso	floso
floso	flɔsɔ
flotacar	flotatsar
fluar	flu̯ar
fluas	fluas
flugi	flugi
flugo	flugo
flui	flui
fluir	fluir
fluis	fluis
fluktuar	fluktuar
fluo	fluo
fluos	fluɔs
fluus	fluus
fodar	fodar
fola	fola
foliaro	foli̯aro
folii	folii
folio	foli̯o
fondar	fondar
fondesar	fondesar
fonteni	fonteni
fonteno	fonteno
fontenoplumi	fontenoplumi
fontenoplumo	fontenoplumo
fonto	fonto
fontolingui	fɔntolingu̯i
fontolinguo	fɔntolingu̯o
for	fɔr
foresti	foresti
foresto	foresto
forjar	fordʒar
forjar	forʒar
forjas	fordʒas
forjas	forʒas
forjetar	forʒetar
formacar	fɔrmatsar
formala	fɔrmala
formiko	formiko
formiko	fɔrmikɔ
formikumar	fɔrmikumar
formikumo	fɔrmikumo
formo	formo
forprenar	forprenar
forta	forta
forteso	forteso
fortiganta	fortiganta
fortigante	fortigante
fortiganti	fortiganti
fortiganto	fortiganto
fortigar	fortigar
fortigas	fortigas
fortigata	fortigata
fortigate	fortigate
fortigati	fortigati
fortigato	fortigato
fortigez	fortigɛs
fortigez	fortigɛz
fortiginta	fortiginta
fortiginte	fortiginte
fortiginti	fortiginti
fortiginto	fortiginto
fortigir	fortigir
fortigis	fortigis
fortigita	fortigita
fortigite	fortigite
fortigiti	fortigiti
fortigito	fortigito
fortigonta	fortigonta
fortigonte	fortigonte
fortigonti	fortigonti
fortigonto	fortigonto
fortigor	fortigɔr
fortigos	fortigɔs
fortigota	fortigota
fortigote	fortigote
fortigoti	fortigoti
fortigoto	fortigoto
fortigus	fortigus
fortuno	fɔrtuno
fosati	fosati
fosato	fosato
foseti	foseti
foseto	foso
fosfati	fosfati
fosfato	fosfato
foso	foso
fotografanta	fotografanta
fotografante	fotografante
fotografanti	fotografanti
fotografanto	fotografanto
fotografar	fotografar
fotografas	fotografas
fotografata	fotografata
fotografate	fotografate
fotografati	fotografati
fotografato	fotografato
fotografez	fotografɛs
fotografez	fotografɛz
fotografinta	fotografinta
fotografinte	fotografinte
fotografinti	fotografinti
fotografinto	fotografinto
fotografir	fotografir
fotografis	fotografis
fotografita	fotografita
fotografite	fotografite
fotografiti	fotografiti
fotografito	fotografito
fotografonta	fotografonta
fotografonte	fotografonte
fotografonti	fotografonti
fotografonto	fotografonto
fotografor	fotografɔr
fotografos	fotografɔs
fotografota	fotografota
fotografote	fotografote
fotografoti	fotografoti
fotografoto	fotografoto
fotografuri	fotografuri
fotografuro	fotografuro
fotografus	fotografus
foyo	fojo
fraciono	fratsiono
fraciono	fratsjono
fragi	fragi
fragmenti	fragmenti
fragmento	fragmento
frago	frago
frajila	fradʒila
frajila	fraʒila
frakasar	frakasar
frambo	frambo
frapanta	frapanta
frapante	frapante
frapanto	frapanto
frapar	frapar
frapas	frapas
frapata	frapata
frapate	frapate
frapato	frapato
frapez	frapɛs
frapez	frapɛz
frapi	frapi
frapinta	frapinta
frapinte	frapinte
frapinto	frapinto
frapir	frapir
frapis	frapis
frapita	frapita
frapite	frapite
frapito	frapito
frapo	frapo
fraponta	fraponta
fraponte	fraponte
fraponto	fraponto
frapor	frapɔr
frapos	frapɔs
frapota	frapota
frapote	frapote
frapoto	frapoto
frapus	frapus
fratala	fratala
fratatra	fratatra
frati	frati
fratini	fratini
fratino	fratino
frato	frato
fratuli	fratuli
fratulo	fratulo
frazo	frazo
fregati	fregati
fregato	fregato
freni	freni
freno	freno
fresha	freʃa
fresheskar	freʃeskar
fricionar	fritsjonar
fricionar	fɾitsjɔnaɾ
frigorizili	frigorizili
frigorizilo	frigorizilo
frigoro	frigoro
fristi	fristi
fristo	fristo
frivoleso	frivoleso
frivoli	frivoli
frivolo	frivolo
fromaja	fromadʒa
fromaja	fromaʒa
fromajala	fromadʒala
fromajala	fromaʒala
fromajatra	fromadʒatra
fromajatra	fromaʒatra
fromajifar	fromadʒifar
fromajifar	fromaʒifar
fromajiferii	fromadʒiferii
fromajiferii	fromaʒiferii
fromajiferio	fromadʒiferi̯o
fromajiferio	fromaʒiferi̯o
fromajo	fromadʒo
fromajo	fromaʒo
fromajoza	fromadʒoza
fromajoza	fromaʒoza
frontieri	fronti̯eri
frontiero	fronti̯ero
frosto	frosto
frotor	frotɔr
frotos	frotɔs
frukto	frukto
frumento	frumento
fumar	fumar
funcionar	funtsi̯onar
funciono	funtsi̯ono
fundamenti	fundamenti
fundamentisti	fundamentisti
fundamentisto	fundamentisto
fundamento	fundamento
funeli	funeli
funerala	funerala
funero	funero
furiero	furi̯ero
furio	furi̯o
furtar	furtar
furtos	furtɔs
fushar	fuʃar
fusilo	fusilo
fusilo	fusilɔ
fusteno	fusteno
futbalo	futbalo
futbalo	futbalɔ
futurala	futurala
futuro	futuro
fuzeo	fuzeo
g	g
g	ge
gameti	gameti
gameto	gameto
ganas	ganas
ganso	ganso
ganto	ganto
garantii	garantii
garantio	garantijo
gardeni	gardeni
gardeno	gardeno
garnizono	garnizono
gasagar	gasagar
gaso	gaso
gastiganto	gastiganto
gastigar	gastigar
gastiginto	gastiginto
gaya	gaja
gazono	gazono
ge	ge
ge	gɛ
generala	generala
generale	generale
generalo	generalo
genero	genero
genevi	genevi
geni	geni
genio	geni̯o
genitiva	genitiva
genitivi	genitivi
genitivo	genitivo
genitoro	genitoro
genitoro	gɛnitɔɾɔ
geno	geno
genomi	genomi
genro	genro
gento	gɛnto
genui	genui
genuo	genuo
genuo	genwo
geologi	geologi
geologio	geologio
geologio	geologjo
geologo	geologo
geotropa	geotropa
germania	germani̯a
giganta	giganta
giganti	giganti
giganto	giganto
gildo	gildo
gimnazio	gimnazio
glacar	glatsar
glaciera	glatsi̯era
glacierala	glatsi̯erala
glacieri	glatsi̯eri
glaciero	glatsi̯ero
glacieskar	glatsjeskar
glacieskar	glatsjɛskaɾ
glacio	glatsio
glacio	glatsjo
gladiatori	gladi̯atori
gladiatoro	gladi̯atoro
glano	glano
glaso	glaso
glata	glata
glatiganti	glatiganti
glatigar	glatigar
glatigati	glatigati
glatigez	glatigɛs
glatigez	glatigɛz
glatiginti	glatiginti
glatigir	glatigir
glatigiti	glatigiti
glatigonti	glatigonti
glatigor	glatigɔr
glatigoti	glatigoti
glavi	glavi
glavo	glavo
glebo	gleba
glezar	glezar
glikogeni	glikogeni
glikogeno	glikogeno
glikoso	glikoso
glitveturi	glitveturi
glitveturo	glitveturo
globalismi	globalismi
globalismo	globalismo
globeto	globeto
gluagar	gluagar
gluo	gluo
gluteni	gluteni
gluteno	gluteno
glutinar	glutinar
glutus	glutus
gnomi	gnomi
gnomo	gnomo
gondi	gondi
gondo	gondo
gondolo	gondolo
goniometri	goni̯ometri
goniometro	goni̯ometro
gorilo	gorilo
gorilo	gɔrilɔ
gracio	gratsi̯o
gracio	gratsjo
gracioza	gratsioza
gracioza	gratsjoza
grado	grado
grafika	grafika
grafiko	grafiko
gramatikala	gramatikala
gramatiki	gramatiki
gramatiko	gramatiko
grami	grami
gramo	gramo
granario	granarjɔ
granda	granda
grandeskar	grandeskar
grandioza	grandi̯oza
granivora	granivora
granizar	granizar
granizas	granizas
granizez	granizɛs
granizez	granizɛz
granizir	granizir
granizis	granizis
granizor	granizɔr
granizos	granizɔs
granizus	granizus
grano	grano
gratar	gratar
gratez	gratɛs
gratez	gratɛz
gratigar	gratigar
gratitudar	gratitudar
gratitudo	gratitudo
gratitudoza	gratitudoza
gravida	gravida
gravitado	gravitado
gravitanta	gravitanta
gravitante	gravitante
gravitanti	gravitanti
gravitanto	gravitanto
gravitar	gravitar
gravitas	gravitas
gravitez	gravitɛs
gravitez	gravitɛz
graviti	graviti
gravitinta	gravitinta
gravitinte	gravitinte
gravitinti	gravitinti
gravitinto	gravitinto
gravitir	gravitir
gravitis	gravitis
gravito	gravito
gravitonta	gravitonta
gravitonte	gravitonte
gravitonti	gravitonti
gravitonto	gravitonto
gravitor	gravitɔr
gravitos	gravitɔs
gravitus	gravitus
grelar	grelar
greletar	greletar
grelo	grelo
grenado	grenado
greso	greso
grilar	grilar
griza	griza
groteska	groteska
grozelo	grozelo
grucho	grutʃo
guidar	gu̯idar
guidar	gvidar
guidas	gu̯idas
guidas	gvidas
guidez	gu̯idɛz
guidez	gvidɛs
guidis	gu̯idis
guidis	gvidis
guidos	gu̯idɔs
guidos	gvidɔs
guidus	gu̯idus
guidus	gvidus
guindo	gwindo
gulfi	gulfi
gulfo	gulfo
guvernantaro	guvernantaro
guvernar	guvernar
guvernerii	guvernerii
guvernerio	guvernerio
guvernerio	guvernerjo
guyavo	gujavo
h	h
h	he
habila	habila
hachar	hatʃar
hakilo	hakilo
halogeni	halogeni
halogeno	halogeno
haltar	haltar
haltez	haltɛs
haltez	haltɛz
hangaro	hangaro
hano	hano
harda	harda
hardesi	hardesi
hardeskar	hardeskar
hardeso	hardeso
hardigar	hardigar
haringo	haringo
haro	haro
harpuno	harpuno
hauo	hau̯o
havar	havar
hazardi	hazardi
hazardo	hazardo
he	he
he	hɛ
hedero	hedero
hefo	hefo
hefo	hɛfɔ
hegi	hegi
hegizar	hegizar
hego	hego
hektowati	hektowati
hektowato	hektowato
hela	hela
helici	helitsi
helico	helitso
heliko	heliko
heliostati	heli̯ostati
heliostato	heli̯ostato
heliotropo	heli̯otropo
helminti	helminti
helpanta	helpanta
helpante	helpante
helpanti	helpanti
helpanto	helpanto
helpar	helpar
helpar	hɛlpar
helpas	helpas
helpata	helpata
helpate	helpate
helpati	helpati
helpato	helpato
helpema	helpema
helpez	helpɛs
helpez	helpɛz
helpinta	helpinta
helpinte	helpinte
helpinti	helpinti
helpinto	helpinto
helpir	helpir
helpis	helpis
helpita	helpita
helpite	helpite
helpiti	helpiti
helpito	helpito
helpolinguo	hɛlpolinguwo
helponta	helponta
helponte	helponte
helponti	helponti
helponto	helponto
helpor	helpɔr
helpos	helpɔs
helpota	helpota
helpote	helpote
helpoti	helpoti
helpoto	helpoto
helpus	helpus
heme	heme
hepato	hepato
herbi	herbi
herbo	herbo
herbo	hɛrbɔ
herdo	herdo
herdo	hɛɾdɔ
heredar	heredar
hermetika	hermetika
heroeni	heroeni
heroeno	heroeno
heroeso	heroeso
heroo	heroo
hezitar	hezitar
hezitema	hezitema
hezito	hezito
hido	hido
hidrati	hidrati
hidrato	hidrato
hidrogeni	hidrogeni
hidrogeno	hidrogeno
hidrologi	hidrologi
hidrologo	hidrologo
hiere	hiere
hike	hikɛ
hipar	hipar
hiperligar	hiperligar
hiperligilo	hiperligilɔ
hipo	hipo
hipokondrio	hipokondri̯o
hirundi	hirundi
hirundo	hirundo
hisopo	hisopo
hispania	hispania
hodie	hodie
hodie	hodi̯e
hola	hola
homarala	homarala
homardi	homardi
homardo	homardo
homaro	homaro
homeosexuala	homeoseksuala
homeosexualo	homeoseksualo
homo	homo
honesta	honesta
honori	honori
honorumala	honorumala
horizonto	horizonto
horlojeto	horlodʒeto
horlojeto	horloʒeto
horlojo	horlodʒo
horlojo	horloʒo
hueto	hueto
hufofero	hufofero
humida	humida
humuro	humuro
hundala	hundala
hundini	hundini
hundino	hundino
hundo	hundo
hungrar	hungrar
hungro	hungro
huo	huo
i	i
ibe	ibe
ibe	ibɛ
ica	itsa
ici	itsi
ico	itso
ideala	ideala
idealo	ideala
idioti	idi̯oti
idiotismo	idiotismo
idiotismoza	idiotismoza
idioto	idioto
idisto	idisto
ido	ido
idoli	idoli
idolo	idolo
iesu	i̯esu
il	il
ilo	ilo
ilu	ilu
ilua	ilua
ilua	ilwa
ilustrar	ilustrar
iluziono	iluziono
iluziono	iluzjono
imaginanta	imaginanta
imaginante	imaginante
imaginanti	imaginanti
imaginanto	imaginanto
imaginar	imaginar
imaginas	imaginas
imaginata	imaginata
imaginate	imaginate
imaginati	imaginati
imaginato	imaginato
imaginez	imaginɛs
imaginez	imaginɛz
imagininta	imagininta
imagininte	imagininte
imagininti	imagininti
imagininto	imagininto
imaginir	imaginir
imaginis	imaginis
imaginita	imaginita
imaginite	imaginite
imaginiti	imaginiti
imaginito	imaginito
imaginonta	imaginonta
imaginonte	imaginonte
imaginonti	imaginonti
imaginonto	imaginonto
imaginor	imaginɔr
imaginos	imaginɔs
imaginota	imaginota
imaginote	imaginote
imaginoti	imaginoti
imaginoto	imaginoto
imaginus	imaginus
imbecila	imbetsila
imperanta	imperanta
imperante	imperante
imperanti	imperanti
imperanto	imperanto
imperar	imperar
imperas	imperas
imperata	imperata
imperate	imperate
imperati	imperati
imperato	imperato
imperez	imperɛs
imperez	imperɛz
imperiestri	imperi̯estri
imperiestro	imperiestro
imperinta	imperinta
imperinte	imperinte
imperinti	imperinti
imperinto	imperinto
imperir	imperir
imperis	imperis
imperita	imperita
imperite	imperite
imperiti	imperiti
imperito	imperito
imperonta	imperonta
imperonte	imperonte
imperonti	imperonti
imperonto	imperonto
imperor	imperɔr
imperos	imperɔs
imperota	imperota
imperote	imperote
imperoti	imperoti
imperoto	imperoto
imperus	imperus
importanta	importanta
importanto	importanto
imposti	imposti
imposto	imposto
imprimala	imprimala
impulsiva	impulsiva
imputar	imputar
incendiante	intsendi̯ante
incendiar	intsendi̯ar
incendias	intsendi̯as
incendiata	intsendi̯ata
incendiate	intsendi̯ate
incendiati	intsendi̯ati
incendiato	intsendi̯ato
incendiez	intsendi̯ɛs
incendiez	intsendi̯ɛz
incendiir	intsendiir
incendiis	intsendiis
incendiopumpili	intsendi̯opumpili
incendiopumpilo	intsendi̯opumpilo
incendior	intsendi̯ɔr
incendios	intsendi̯ɔs
incendius	intsendi̯us
indiferenta	indiferenta
indijar	indidʒar
indijar	indiʒar
indikativo	indikativo
indikesar	indikesar
indikili	indikili
indikilo	indikilo
induktar	induktar
indukto	indukto
indulgema	indulgema
industriale	industri̯ale
industriizez	industriizɛs
industriizez	industriizɛz
industrio	industri̯o
indutar	indutar
inerta	inerta
infama	infama
infanto	infanto
infektar	infektar
infektas	infektas
infektez	infektɛs
infektez	infektɛz
infekti	infekti
infektis	infektis
infekto	infekto
infektos	infektɔs
infektus	infektus
infinitivo	infinitivo
inflamar	inflamar
inflameso	inflameso
inflami	inflami
inflamo	inflamo
inflamuri	inflamuri
inflamuro	inflamuro
informar	informar
informas	informas
informez	informɛs
informez	informɛz
informis	informis
informus	informus
infuzi	infuzi
infuzuri	infuzuri
infuzuro	infuzuro
ingrediento	ingredi̯ɛnto
inicio	initsi̯o
injektadi	indʒektadi
injektadi	inʒektadi
injektado	indʒektado
injektado	inʒektado
injektaji	indʒektadʒi
injektaji	inʒektaʒi
injektajo	indʒektadʒo
injektajo	inʒektaʒo
injektar	indʒektar
injektar	inʒektar
injektas	indʒektas
injektas	inʒektas
injekti	indʒekti
injekti	inʒekti
injektis	indʒektis
injektis	inʒektis
injektizar	indʒektizar
injektizar	inʒektizar
injektizas	indʒektizas
injektizas	inʒektizas
injektizez	indʒektizɛs
injektizez	inʒektizɛz
injektizis	indʒektizis
injektizis	inʒektizis
injektizo	indʒektizo
injektizo	inʒektizo
injektizos	indʒektizɔs
injektizos	inʒektizɔs
injektizus	indʒektizus
injektizus	inʒektizus
injekto	indʒekto
injekto	inʒekto
injektos	indʒektɔs
injektos	inʒektɔs
injektus	indʒektus
injektus	inʒektus
inko	inko
insekti	insekti
insekto	insekto
insertar	insertar
insertas	insertas
insertez	insertɛs
insertez	insertɛz
insertir	insertir
insertis	insertis
insertor	insertɔr
insertos	insertɔs
insertus	insertus
insigno	insigno
instanti	instanti
instanto	instanto
instruktar	instruktar
instrukto	instrukto
instrumenti	instrumenti
instrumento	instrumento
insulano	insulano
insularo	insularo
insultanta	insultanta
insultante	insultante
insultanti	insultanti
insultanto	insultanto
insultar	insultar
insultas	insultas
insultata	insultata
insultate	insultate
insultati	insultati
insultato	insultato
insultez	insultɛs
insultez	insultɛz
insultinta	insultinta
insultinte	insultinte
insultinti	insultinti
insultinto	insultinto
insultir	insultir
insultis	insultis
insultita	insultita
insultite	insultite
insultiti	insultiti
insultito	insultito
insultonta	insultonta
insultonte	insultonte
insultonti	insultonti
insultonto	insultonto
insultor	insultɔr
insultos	insultɔs
insultota	insultota
insultote	insultote
insultoti	insultoti
insultoto	insultoto
insultus	insultus
intelekto	intelekto
intencar	intentsar
inter	inter
inter	intɛɾ
interagi	interagi
interago	interago
interlukti	interlukti
interlukto	interlukto
intermixi	intermigzi
intermixi	intermiksi
intermixo	intermikso
internaciona	internatsiona
internaciona	internatsjona
internacione	internatsione
internacione	internatsjone
internacioneso	internatsijoneso
interreto	intɛrreto
interruptar	interuptar
interspaco	interspatso
interveni	interveni
interveno	interveno
intervido	intɛrvido
interviuvar	intervjuvar
interviuvar	intɛɾvjuvaɾ
interviuvo	intervjuvo
interviuvo	intɛɾvjuvɔ
intrigar	intrigar
introduktar	introduktar
inundar	inundar
invadas	invadas
invadir	invadir
invadis	invadis
inversigi	inversigi
inversigo	inversigo
invitar	invitar
ioni	i̯oni
ionizante	i̯onizante
ionizar	i̯onizar
ionizas	i̯onizas
ionizez	i̯onizɛs
ionizez	i̯onizɛz
ionizis	i̯onizis
ionizos	i̯onizɔs
ionizus	i̯onizus
iono	i̯ono
ipsa	ipsa
iracar	iratsar
iracas	iratsas
iracego	iratsego
iracez	iratsɛs
iracez	iratsɛz
iracigar	iratsigar
iracir	iratsir
iracis	iratsis
iraco	iɾatso
iracor	iratsɔr
iracos	iratsɔs
iracus	iratsus
iranta	iranta
irante	irante
iranti	iranti
iranto	iranto
irar	irar
iras	iras
irez	irɛs
irez	irɛz
irga	irga
irgo	irgo
irgu	irgu
irinta	irinta
irinte	irinte
irinti	irinti
irinto	irinto
irir	irir
iris	iris
iritar	iritar
irlando	irlando
ironta	ironta
ironte	ironte
ironti	ironti
ironto	ironto
iror	irɔr
iros	irɔs
irus	irus
islando	islando
ita	ita
iterar	iterar
itere	itero
iti	iti
ito	ito
ito	itɔ
ivoro	ivoro
izobari	izobari
izobaro	izobaro
izomeri	izomeri
izomero	izomero
izraelido	izraelido
izraelido	izɾaɛlidɔ
j	ʒ
j	ʒe
ja	dʒa
ja	ʒa
jacanta	dʒatsanta
jacanta	ʒatsanta
jacar	dʒatsar
jacar	ʒatsar
jaguaro	dʒagvaro
jaguaro	ʒagwaro
jaketo	dʒaketo
jaketo	ʒaketo
jako	dʒako
jako	ʒako
jaluza	dʒaluza
jaluza	ʒaluza
jamaika	dʒamaika
jamaika	ʒamaika
januaro	dʒanuaro
januaro	ʒanuaro
japonia	dʒaponi̯a
japonia	ʒaponi̯a
japoniano	dʒaponi̯ano
japoniano	ʒaponi̯ano
japono	dʒapono
japono	ʒapono
jari	dʒari
jari	ʒari
jaro	dʒaro
jaro	ʒaro
jaspo	dʒaspo
jaspo	ʒaspo
je	ʒe
je	ʒɛ
jemeli	dʒemeli
jemeli	ʒemeli
jemelo	dʒemelo
jemelo	ʒemelo
jenar	dʒenar
jenar	ʒenar
jeneroza	dʒeneroza
jeneroza	ʒeneroza
jenerozesi	dʒenerozesi
jenerozesi	ʒenerozesi
jenerozeso	dʒenerozeso
jenerozeso	ʒenerozeso
jenjivo	dʒendʒivo
jenjivo	ʒenʒivo
jentila	dʒentila
jentila	ʒentila
jeristi	dʒeristi
jeristi	ʒeristi
jeristo	dʒeristo
jeristo	ʒeristo
jermifar	dʒermifar
jermifar	ʒermifar
jetanto	dʒetanto
jetanto	ʒetanto
jetar	dʒetar
jetar	ʒetar
jetato	dʒetato
jetato	ʒetato
jetinto	dʒetinto
jetinto	ʒetinto
jetito	dʒetito
jetito	ʒetito
jetonto	dʒetonto
jetonto	ʒetonto
jetoto	dʒetoto
jetoto	ʒetoto
jirafi	dʒirafi
jirafi	ʒirafi
jirafo	dʒirafo
jirafo	ʒirafo
jokar	dʒokar
jokar	ʒokar
joko	dʒoko
joko	ʒoko
jonki	dʒonki
jonki	ʒonki
jonko	dʒonko
jonko	ʒonko
jornar	dʒornar
jornar	ʒornar
jorneskar	dʒorneskar
jorneskar	ʒorneskar
jorni	dʒorni
jorni	ʒorni
jorno	dʒorno
jorno	ʒorno
jornomezi	dʒornomezi
jornomezi	ʒornomezi
jornomezo	dʒornomezo
jornomezo	ʒornomezo
jovdii	dʒovdii
jovdii	ʒovdii
jovdio	ʒovdio
jovdio	ʒɔvdiɔ
joyala	dʒojala
joyala	ʒojala
joyanta	dʒojanta
joyanta	ʒojanta
joyar	dʒojar
joyar	ʒojar
joyema	dʒojema
joyema	ʒojema
joyigar	dʒojigar
joyigar	ʒojigar
joyo	dʒojo
joyo	ʒojo
joyoza	dʒojoza
joyoza	ʒojoza
juar	dʒuar
juar	ʒuar
judiciar	dʒuditsi̯ar
judiciar	ʒuditsi̯ar
judikanto	dʒudikanto
judikanto	ʒudikanto
judikar	dʒudikar
judikar	ʒudikar
judikati	dʒudikati
judikati	ʒudikati
judikato	dʒudikato
judikato	ʒudikato
judikeri	dʒudikeri
judikeri	ʒudikeri
judikero	dʒudikero
judikero	ʒudikero
judiki	dʒudiki
judiki	ʒudiki
judikinti	dʒudikinti
judikinti	ʒudikinti
judikinto	dʒudikinto
judikinto	ʒudikinto
judikiti	dʒudikiti
judikiti	ʒudikiti
judikito	dʒudikito
judikito	ʒudikito
judiko	dʒudiko
judiko	ʒudiko
judikonti	dʒudikonti
judikonti	ʒudikonti
judikonto	dʒudikonto
judikonto	ʒudikonto
judikoti	dʒudikoti
judikoti	ʒudikoti
judikoto	dʒudikoto
judikoto	ʒudikoto
juez	dʒuɛs
juez	ʒuɛz
julio	dʒuli̯o
julio	ʒuli̯o
junio	dʒuni̯o
junio	ʒuni̯o
juntar	dʒuntar
juntar	ʒuntar
juntas	dʒuntas
juntas	ʒuntas
juntata	dʒuntata
juntata	ʒuntata
juntita	dʒuntita
juntita	ʒuntita
juntos	dʒuntɔs
juntos	ʒuntɔs
jupeti	dʒupeti
jupeti	ʒupeti
jupeto	dʒupeto
jupeto	ʒupeto
jupitero	dʒupitero
jupitero	ʒupitero
jupizar	dʒupizar
jupizar	ʒupizar
jupo	dʒupo
jupo	ʒupo
jurnali	dʒurnali
jurnali	ʒurnali
jurnalo	dʒurnalo
jurnalo	ʒurnalo
jus	ʒus
justa	dʒusta
justa	ʒusta
juveli	dʒuveli
juveli	ʒuveli
juvelisto	dʒuvelisto
juvelisto	ʒuvelisto
juvelo	ʒuvelo
k	k
k	ke
ka	ka
kabaneto	kabaneto
kabano	kabano
kabano	kabanɔ
kabareto	kabareto
kabineto	kabineto
kabineto	kabinɛtɔ
kabino	kabino
kabino	kabinɔ
kad	kad
kadro	kadro
kafeerio	kafeerio
kafeo	kafeo
kakao	kakao
kakar	kakar
kakar	kakaɾ
kaktuso	kaktuso
kalamitati	kalamitati
kalamitato	kalamitato
kalemburo	kalemburo
kalico	kalitso
kalkulanta	kalkulanta
kalkulante	kalkulante
kalkulanti	kalkulanti
kalkulanto	kalkulanto
kalkular	kalkular
kalkulas	kalkulas
kalkulata	kalkulata
kalkulate	kalkulate
kalkulati	kalkulati
kalkulato	kalkulato
kalkulez	kalkulɛs
kalkulez	kalkulɛz
kalkulinta	kalkulinta
kalkulinte	kalkulinte
kalkulinti	kalkulinti
kalkulinto	kalkulinto
kalkulir	kalkulir
kalkulis	kalkulis
kalkulita	kalkulita
kalkulite	kalkulite
kalkuliti	kalkuliti
kalkulito	kalkulito
kalkulonta	kalkulonta
kalkulonte	kalkulonte
kalkulonti	kalkulonti
kalkulonto	kalkulonto
kalkulor	kalkulɔr
kalkulos	kalkulɔs
kalkulota	kalkulota
kalkulote	kalkulote
kalkuloti	kalkuloti
kalkuloto	kalkuloto
kalkulus	kalkulus
kalma	kalma
kaloro	kaloro
kalsoneto	kalsoneto
kalsono	kalsono
kalumnianto	kalumni̯anto
kalva	kalva
kalzo	kalzo
kalzumo	kalzumo
kalzumo	kalzumɔ
kam	kam
kamaradi	kamaradi
kamarado	kamarado
kambiar	kambiar
kambiar	kambjar
kambio	kambio
kambio	kambjo
kamero	kamero
kamiono	kamiono
kamiono	kamiɔnɔ
kamizo	kamizo
kamizo	kamizɔ
kamizolo	kamizolo
kanabo	kanabo
kanapeo	kanapeo
kancelereyo	kantselerejo
kand	kand
kande	kande
kande	kandɛ
kandeli	kandeli
kandelieri	kandeli̯eri
kandeliero	kandeli̯ero
kandelo	kandelo
kandio	kandi̯o
kansono	kansono
kantanta	kantanta
kantante	kantante
kantanti	kantanti
kantanto	kantanto
kantar	kantar
kantas	kantas
kantata	kantata
kantate	kantate
kantati	kantati
kantato	kantato
kantero	kantero
kantez	kantɛs
kantez	kantɛz
kanti	kanti
kantinta	kantinta
kantinte	kantinte
kantinti	kantinti
kantinto	kantinto
kantir	kantir
kantis	kantis
kantisti	kantisti
kantisto	kantisto
kantita	kantita
kantite	kantite
kantiti	kantiti
kantito	kantito
kantonta	kantonta
kantonte	kantonte
kantonti	kantonti
kantor	kantɔr
kantos	kantɔs
kantota	kantota
kantote	kantote
kantoti	kantoti
kantoto	kantoto
kantus	kantus
kaoso	kaoso
kapabla	kapabla
kapitali	kapitali
kapitalo	kapitalo
kapreolo	kapreolo
kapri	kapri
kapricema	kapritsema
kapro	kapro
kaptar	kaptar
kara	kara
kardinala	kardinala
karear	karear
karikaturo	karikaturo
karno	karno
karpo	karpo
karto	karto
kartocho	kartotʃo
kartochuyo	kartotʃujo
kartoludo	kartoludo
kartono	kartono
kartonobindar	kartonobindar
kaseri	kaseri
kasero	kasero
kasiso	kasiso
kaso	kaso
kasrolo	kasrolo
kastano	kastano
kastelo	kastelo
katedri	katedri
katedro	katedro
kateno	kateno
kateto	kateto
kati	kati
kationo	kati̯ono
kato	kato
kaucioni	kau̯tsi̯oni
kaucionizar	kau̯tsi̯onizar
kauciono	kau̯tsi̯ono
kaudala	kau̯dala
kaulo	kau̯lo
kauzala	kau̯zala
kauzi	kau̯zi
kauziganta	kau̯ziganta
kauzigante	kau̯zigante
kauziganti	kau̯ziganti
kauziganto	kau̯ziganto
kauzigar	kau̯zigar
kauzigas	kau̯zigas
kauzigata	kau̯zigata
kauzigate	kau̯zigate
kauzigati	kau̯zigati
kauzigato	kau̯zigato
kauzigez	kau̯zigɛs
kauzigez	kau̯zigɛz
kauziginta	kau̯ziginta
kauziginte	kau̯ziginte
kauziginti	kau̯ziginti
kauziginto	kau̯ziginto
kauzigir	kau̯zigir
kauzigis	kau̯zigis
kauzigita	kau̯zigita
kauzigite	kau̯zigite
kauzigiti	kau̯zigiti
kauzigito	kau̯zigito
kauzigonta	kau̯zigonta
kauzigonte	kau̯zigonte
kauzigonti	kau̯zigonti
kauzigonto	kau̯zigonto
kauzigor	kau̯zigɔr
kauzigos	kau̯zigɔs
kauzigota	kau̯zigota
kauzigote	kau̯zigote
kauzigoti	kau̯zigoti
kauzigoto	kau̯zigoto
kauzigus	kau̯zigus
kauzo	kau̯zo
kavalo	kavalo
kavalrio	kavalri̯o
kaverno	kaverno
kayero	kajero
kazo	kazo
ke	ke
ke	kɛ
kelka	kelka
kelkafoye	kelkafoje
kelo	kelo
kerlo	kɛrlo
kesto	kesto
kilogramo	kilogramo
kilometro	kilometro
kindi	kindi
kindo	kindo
kirko	kirko
kiroptero	kiroptero
klado	klado
klara	klara
klarigar	klarigar
klauno	klau̯no
kleriki	kleriki
kleriko	kleriko
klimar	klimar
klimato	klimato
kloko	kloko
kloko	klɔkɔ
klorido	klorido
klozar	klozar
klozez	klozɛs
klozez	klozɛz
klukar	klukar
koaktar	kɔaktar
kobri	kobri
kobro	kobro
kodexo	kodegzo
kodexo	kodekso
koherar	koherar
koincidi	kointsidi
kokoso	kokoso
kolda	kolda
koldeskar	koldeskar
koldeskar	kɔldɛskar
koldeso	koldeso
kolektar	kolektar
kolektas	kolektas
kolektez	kolektɛs
kolektez	kolektɛz
kolektis	kolektis
kolektos	kolektɔs
kolektus	kolektus
koliar	koliar
koliar	koljar
kolibrio	kolibri̯o
kolino	kolino
kolizioni	kolizi̯oni
koliziono	koloziono
kolokar	kolokar
kolokez	kolokɛs
kolokez	kolokɛz
koloniano	koloniano
koloniano	kɔlɔnianɔ
kolonii	kolonii
kolonio	kolonio
kolonio	kolonjo
koloro	koloro
koloro	kɔlɔɾɔ
koloroza	koloroza
kolumo	kolumo
kolumo	kɔlumɔ
koluzionar	koluzi̯onar
koluziono	koluzi̯ono
kom	kom
komandar	komandar
kombatala	kombatala
kombati	kombati
kombato	kombato
kombinanta	kombinanta
kombinante	kombinante
kombinanti	kombinanti
kombinanto	kombinanto
kombinar	kombinar
kombinas	kombinas
kombinata	kombinata
kombinate	kombinate
kombinati	kombinati
kombinato	kombinato
kombinez	kombinɛs
kombinez	kombinɛz
kombininta	kombininta
kombininte	kombininte
kombininti	kombininti
kombininto	kombininto
kombinir	kombinir
kombinis	kombinis
kombinita	kombinita
kombinite	kombinite
kombiniti	kombiniti
kombinito	kombinito
kombinonta	kombinonta
kombinonte	kombinonte
kombinonti	kombinonti
kombinonto	kombinonto
kombinor	kombinɔr
kombinos	kombinɔs
kombinota	kombinota
kombinote	kombinote
kombinoti	kombinoti
kombinoto	kombinoto
kombinus	kombinus
kombustar	kombustar
komencar	komentsar
komendar	komɛndar
komitati	komitati
komitato	komitato
komo	komo
kompatinda	kompatinda
kompetenta	kompetenta
komplezajo	komplezaʒo
komplezema	komplezema
komplikar	komplikar
komplikas	komplikas
komplikez	komplikɛs
komplikez	komplikɛz
komplikis	komplikis
komplikos	komplikɔs
komplikus	komplikus
kompozar	kɔmpozar
komprar	komprar
komprar	kɔmprar
komprenar	komprenar
komprenebla	komprenebla
kompreneble	kompreneble
komprenende	komprenende
komprenesar	komprenesar
komputar	komputar
komputas	komputas
komputero	komputero
komputez	komputɛs
komputez	komputɛz
komputir	komputir
komputis	komputis
komputor	komputɔr
komputos	komputɔs
komputus	komputus
komti	komti
komto	komto
komunitato	komunitato
konceptar	kontseptar
koncepto	kontsepto
koncerne	kontserne
koncesar	kontsesar
koncesi	kontsesi
konceso	kontseso
kondutar	kondutar
konektanta	konektanta
konektante	konektante
konektanto	konektanto
konektar	konektar
konektas	konektas
konektata	konektata
konektate	konektate
konektato	konektato
konektinta	konektinta
konektinte	konektinte
konektinto	konektinto
konektir	konektir
konektis	konektis
konektita	konektita
konektite	konektite
konektito	konektito
konektonta	konektonta
konektonte	konektonte
konektonto	konektonto
konektor	konektɔr
konektos	konektɔs
konektota	konektota
konektote	konektote
konektoto	konektoto
konektus	konektus
konfesar	kɔnfesar
konfundar	kɔnfundar
konglomerateso	konglomerateso
konglomerati	konglomerati
konglomerato	konglomerato
konjedar	kondʒedar
konjedar	konʒedar
konjelar	konʒelar
konjelar	kɔnʒɛlaɾ
konkluziva	konkluziva
konkordar	konkordar
konocar	konotsar
konocar	kɔnɔtsar
konocata	konotsata
konsakrar	konsakrar
konsentar	konsentar
konsequar	konsekvar
konsequar	konsekwar
konseque	konseku̯e
konseque	konsekve
konsequo	konseku̯o
konsequo	konsekvo
konsiderar	konsiderar
konsideresar	konsideresar
konsilar	konsilar
konsoli	konsoli
konsolo	konsolo
konstruktar	kɔnstruktar
konstrukturi	konstrukturi
konstrukturo	kɔnstrukturo
konsultar	konsultar
kontado	kontado
kontanta	kontanta
kontante	kontante
kontanti	kontanti
kontanto	kontanto
kontar	kontar
kontas	kontas
kontata	kontata
kontate	kontate
kontati	kontati
kontato	kontato
kontenajo	kɔntenadʒo
kontenajo	kɔntenaʒo
kontenar	kɔntenar
konteni	konteni
konteno	konteno
kontez	kontɛs
kontez	kontɛz
kontinta	kontinta
kontinte	kontinte
kontinti	kontinti
kontinto	kontinto
kontir	kontir
kontis	kontis
kontita	kontita
kontite	kontite
kontiti	kontiti
kontito	kontito
konto	konto
kontonta	kontonta
kontonte	kontonte
kontonti	kontonti
kontonto	kontonto
kontor	kontɔr
kontos	kontɔs
kontota	kontota
kontote	kontote
kontoti	kontoti
kontoto	kontoto
kontrafaktar	kontrafaktar
kontrakti	kontrakti
kontrakto	kontrakto
kontredicar	kontreditsar
kontredicar	kɔntrɛditsaɾ
kontredici	kontreditsi
kontredico	kontreditso
kontributaji	kontributadʒi
kontributaji	kontributaʒi
kontributajo	kontributadʒo
kontributajo	kontributaʒo
kontributar	kontributar
kontus	kontus
konvexa	konvegza
konvexa	konveksa
koquanta	kokvanta
koquanta	kokwanta
koquante	kokvante
koquante	kokwante
koquanti	kokvanti
koquanti	kokwanti
koquanto	kokvanto
koquanto	kokwanto
koquar	kokvar
koquar	kokwar
koquas	koku̯as
koquas	kokvas
koquata	kokvata
koquata	kokwata
koquate	kokvate
koquate	kokwate
koquati	kokvati
koquati	kokwati
koquato	kokvato
koquato	kokwato
koqueri	kokveri
koqueri	kokweri
koquero	kokvero
koquero	kokwero
koqueyi	kokveji
koqueyi	kokweji
koqueyo	kokwejo
koquez	koku̯ɛz
koquez	kokvɛs
koquinta	kokvinta
koquinta	kokwinta
koquinte	kokvinte
koquinte	kokwinte
koquinti	kokvinti
koquinti	kokwinti
koquinto	kokvinto
koquinto	kokwinto
koquir	kokvir
koquir	kokwir
koquis	koku̯is
koquis	kokvis
koquita	kokvita
koquita	kokwita
koquite	kokvite
koquite	kokwite
koquiti	kokviti
koquiti	kokwiti
koquito	kokvito
koquito	kokwito
koquonta	kokvonta
koquonta	kokwonta
koquonte	kokvonte
koquonte	kokwonte
koquonti	kokvonti
koquonti	kokwonti
koquonto	kokvonto
koquonto	kokwonto
koquor	kokvɔr
koquor	kokwɔr
koquos	koku̯ɔs
koquos	kokvɔs
koquota	kokvota
koquota	kokwota
koquote	kokvote
koquote	kokwote
koquoti	kokvoti
koquoti	kokwoti
koquoto	kokvoto
koquoto	kokwoto
koquus	koku̯us
koquus	kokvus
koram	koram
kordio	kordio
kordio	kɔɾdiɔ
kordo	kordo
kordono	kordono
korekta	korekta
korespondo	korespondo
korno	korno
korodar	korodar
korpi	korpi
korpo	korpo
korseto	korseto
kortico	kortitso
kortico	kɔɾtitsɔ
kosmo	kosmo
kovrar	kovrar
krabo	krabo
kravati	kravati
kravato	kravato
krear	krear
krear	krɛar
kredebla	kredebla
kreinti	kreinti
kreinto	kreinto
kreitaro	kreitaro
kremo	kremo
kremo	krɛmɔ
krepo	krepo
kreskar	kreskar
kreskar	krɛskar
kreskigar	kreskigar
kreskigar	krɛskigar
krespo	krespo
kreuri	kreu̯ri
kreuro	kreu̯ro
kriar	kriar
kriegas	kri̯egas
kriegez	kri̯egɛs
kriegez	kri̯egɛz
kriegis	kri̯egis
kriegos	kri̯egɔs
kriegus	kri̯egus
krimini	krimini
krimino	krimino
kristnasko	kristnasko
kromatika	kromatika
kromosomo	kromosomo
krono	krono
krucho	krutʃo
krucumanta	krutsumanta
krucumante	krutsumante
krucumanti	krutsumanti
krucumanto	krutsumanto
krucumar	krutsumar
krucumas	krutsumas
krucumata	krutsumata
krucumate	krutsumate
krucumati	krutsumati
krucumato	krutsumato
krucumez	krutsumɛs
krucumez	krutsumɛz
krucuminta	krutsuminta
krucuminte	krutsuminte
krucuminti	krutsuminti
krucuminto	krutsuminto
krucumir	krutsumir
krucumis	krutsumis
krucumita	krutsumita
krucumite	krutsumite
krucumiti	krutsumiti
krucumito	krutsumito
krucumonta	krutsumonta
krucumonte	krutsumonte
krucumonti	krutsumonti
krucumonto	krutsumonto
krucumor	krutsumɔr
krucumos	krutsumɔs
krucumota	krutsumota
krucumote	krutsumote
krucumoti	krutsumoti
krucumoto	krutsumoto
krucumus	krutsumus
kruda	kruda
kruela	kruela
kruelaji	krueladʒi
kruelaji	kruelaʒi
kruelajo	krueladʒo
kruelajo	kruelaʒo
krugo	krugo
kruri	kruri
kruro	kruro
krusto	krusto
kuglo	kuglo
kuki	kuki
kuko	kuko
kuliero	kuli̯ero
kultelo	kultelo
kultelo	kultɛlɔ
kultivar	kultivar
kultivisti	kultivisti
kultivisto	kultivisto
kulturi	kulturi
kulturlinguo	kulturlinguwo
kulturo	kulturo
kunfuzar	kunfuzar
kuniklo	kuniklo
kunlaboranta	kunlaboranta
kunlaborante	kunlaborante
kunlaboranti	kunlaboranti
kunlaboranto	kunlaboranto
kunlaborar	kunlaborar
kunlaborar	kunlabɔɾaɾ
kunlaboras	kunlaboras
kunlaborez	kunlaborɛs
kunlaborez	kunlaborɛz
kunlabori	kunlabori
kunlaborinta	kunlaborinta
kunlaborinte	kunlaborinte
kunlaborinti	kunlaborinti
kunlaborinto	kunlaborinto
kunlaborir	kunlaborir
kunlaboris	kunlaboris
kunlaboro	kunlaboro
kunlaboronta	kunlaboronta
kunlaboronte	kunlaboronte
kunlaboronti	kunlaboronti
kunlaboronto	kunlaboronto
kunlaboror	kunlaborɔr
kunlaboros	kunlaborɔs
kunlaborus	kunlaborus
kuntara	kuntara
kuntexto	kuntegzto
kuntexto	kunteksto
kunveni	kunveni
kunveno	kunveno
kunvivebla	kunvivebla
kupo	kupo
kupolo	kupolo
kupro	kupro
kurajo	kuradʒo
kurajo	kuraʒo
kurar	kurar
kuras	kuras
kuratar	kuratar
kurati	kurati
kurato	kurato
kuregar	kuregar
kuregas	kuregas
kuregez	kuregɛs
kuregez	kuregɛz
kuregis	kuregis
kuregos	kuregɔs
kuregus	kuregus
kuriero	kuriero
kuris	kuris
kuros	kurɔs
kurso	kurso
kurta	kurta
kurteno	kurteno
kurus	kurus
kuseno	kuseno
kustar	kustar
kustumo	kustumo
kuto	kuto
l	l
l	le
la	la
labiobarbi	labi̯obarbi
labiobarbo	labi̯obarbo
laborar	laborar
laboratorio	laboratorio
laboratorio	laboratorjo
laboristala	laboristala
laboristaro	laboristaro
laboristo	laboristo
laboruri	laboruri
laboruro	laboruro
lacerar	latserar
lacerita	latserita
lacero	latsero
lacerto	latserto
laceruri	latseruri
laceruro	latseruro
lageti	lageti
lageto	lageto
lagi	lagi
lago	lago
lakrimifar	lakrimifar
lakrimo	lakrimo
lakto	lakto
lakto	laktɔ
laktumo	laktumo
lamentanta	lamentanta
lamentante	lamentante
lamentanti	lamentanti
lamentanto	lamentanto
lamentar	lamentar
lamentas	lamentas
lamentez	lamentɛs
lamentez	lamentɛz
lamenti	lamenti
lamentinta	lamentinta
lamentinte	lamentinte
lamentinti	lamentinti
lamentinto	lamentinto
lamentir	lamentir
lamentis	lamentis
lamento	lamento
lamentonta	lamentonta
lamentonte	lamentonte
lamentonti	lamentonti
lamentonto	lamentonto
lamentor	lamentɔr
lamentus	lamentus
lana	lana
lanceti	lantseti
lanceto	lantseto
lanci	lantsi
lancieri	lantsi̯eri
lanciero	lantsi̯ero
lanco	lantso
landala	landala
landi	landi
lando	lando
langeto	langeto
lango	lango
lanjo	landʒo
lanjo	lanʒo
lano	lano
lansar	lansar
lardi	lardi
latero	latero
latrino	latrino
latvia	latvi̯a
laudanti	lau̯danti
laudar	lau̯dar
laudas	lau̯das
laudati	lau̯dati
laudinti	lau̯dinti
laudir	lau̯dir
laudis	lau̯dis
lauditi	lau̯diti
laudonti	lau̯donti
laudor	lau̯dɔr
laudos	lau̯dɔs
laudoti	lau̯doti
laudus	lau̯dus
lauso	lau̯so
lauta	lau̯ta
laute	lau̯te
lavendo	lavendo
laveyo	lavejo
laxa	lagza
laxa	laksa
laxigar	lagzigar
laxigar	laksigar
laxigas	lagzigas
laxigas	laksigas
laxigez	lagzigɛs
laxigez	laksigɛz
laxigir	lagzigir
laxigir	laksigir
laxigis	lagzigis
laxigis	laksigis
laxigor	lagzigɔr
laxigor	laksigɔr
laxigos	lagzigɔs
laxigos	laksigɔs
laxigus	lagzigus
laxigus	laksigus
le	le
le	lɛ
lecioni	letsi̯oni
leciono	letsi̯ono
leda	leda
ledro	ledro
legacar	legatsar
legacario	legatsari̯o
legacez	legatsɛs
legacez	legatsɛz
legala	legala
legendo	legendo
legi	legi
legifado	legifado
legifar	legifar
legiono	legiono
legiono	legjono
lego	lego
legumi	legumi
legumo	legumo
lejera	leʒera
lektanto	lektanto
lektar	lektar
lektebla	lektebla
lemi	lemi
lemo	lemo
leonini	leonini
leonino	leonino
leopardi	leopardi
leopardo	leopardo
lernar	lernar
lernar	lɛɾnaɾ
lernolibro	lernolibro
letro	letro
lexiko	legziko
lexiko	leksiko
lezar	lezar
libera	libera
liberpensisto	liberpensisto
libreti	libreti
libreto	libreto
libri	libri
libro	libro
licencar	litsentsar
licenco	litsentso
liechtenstein	liktɛnstai̯n
liechtenstein	liktɛnʃtai̯n
liganti	liganti
ligar	ligar
ligati	ligati
liginti	liginti
ligiti	ligiti
ligonti	ligonti
ligoti	ligoti
likanta	likanta
likante	likante
likanti	likanti
likanto	likanto
likar	likar
likas	likas
likata	likata
likate	likate
likati	likati
likato	likato
likez	likɛs
likez	likɛz
liki	liki
likinta	likinta
likinte	likinte
likinti	likinti
likinto	likinto
likir	likir
likis	likis
likita	likita
likite	likite
likiti	likiti
likito	likito
likonta	likonta
likonte	likonte
likonti	likonti
likonto	likonto
likor	likɔr
likos	likɔs
likota	likota
likote	likote
likoti	likoti
likoto	likoto
likus	likus
linealo	linealo
linei	linei
lineo	lineo
lingoti	lingoti
lingoto	lingoto
linguala	linguala
linguala	lingwala
linguisti	lingu̯isti
linguisti	lingvisti
linguistikala	linguwistikala
linguistiko	linguwistiko
linguisto	linguisto
linguisto	lingwisto
linguo	lingu̯o
linguo	lingvo
lipogramo	lipogramo
liquida	liku̯ida
liro	liro
listi	listi
literaturaji	literaturadʒi
literaturaji	literaturaʒi
literaturajo	literaturadʒo
literaturajo	literaturaʒo
literaturala	literaturala
literaturo	literaturo
literi	literi
litero	litero
liti	liti
litiganta	litiganta
litigante	litigante
litiganti	litiganti
litiganto	litiganto
litigar	litigar
litigas	litigas
litigata	litigata
litigate	litigate
litigati	litigati
litigato	litigato
litigez	litigɛs
litigez	litigɛz
litiginta	litiginta
litiginte	litiginte
litiginti	litiginti
litiginto	litiginto
litigita	litigita
litigite	litigite
litigiti	litigiti
litigito	litigito
litigonta	litigonta
litigonte	litigonte
litigonti	litigonti
litigonto	litigonto
litigor	litigɔr
litigota	litigota
litigote	litigote
litigoti	litigoti
litigoto	litigoto
lito	lito
litri	litri
litro	litro
lituania	lituani̯a
livar	livar
livresar	livresar
lo	lo
lo	lɔ
logikala	logikala
logiko	logiko
lojar	loʒar
lokacar	lokatsar
lokacas	lokatsas
lokacez	lokatsɛs
lokacez	lokatsɛz
lokacir	lokatsir
lokacis	lokatsis
lokacor	lokatsɔr
lokacos	lokatsɔs
lokacus	lokatsus
loklo	loklo
loko	loko
lokomoco	lokomotso
lonchi	lontʃi
loncho	lontʃo
longigar	longigar
longitudo	longitudo
lor	lor
lor	lɔɾ
lore	lore
lore	lɔɾɛ
lorneti	lorneti
lorneto	lorneto
loyale	lojale
lu	lu
lua	lua
ludar	ludar
ludi	ludi
ludo	ludo
lugar	lugar
luktar	luktar
lukto	lukto
lumar	lumar
lumi	lumi
lumo	lumo
lundio	lundio
lundio	lundiɔ
luno	luno
lupo	lupɔ
m	m
m	me
ma	ma
macedonia	matsedoni̯a
maestrala	maestrala
magazino	magazino
magiisto	magiisto
magio	magijo
magnetala	magnetala
magnezio	magnezi̯o
magra	magra
makuleto	makuleto
makulizar	makulizar
makulo	makulo
malakiti	malakiti
malakito	malakito
malediki	malediki
malediko	malediko
maligna	maligna
malta	malta
mama	mama
mamifero	mamifero
mamo	mamo
mamuto	mamuto
mancho	mantʃo
mandolini	mandolini
mandolino	mandolino
mani	mani
manipulado	manipulado
manipular	manipular
manipulas	manipulas
manipulo	manipulo
manjaji	mandʒadʒi
manjaji	manʒaʒi
manjajo	mandʒadʒo
manjajo	manʒaʒo
manjar	mandʒaɾ
manjar	manʒaɾ
manjebla	manʒebla
manjesar	manʒesar
mankar	mankar
manko	manko
mano	mano
marasmo	marasmo
maratono	maratono
marchas	martʃas
marchez	martʃɛs
marchez	martʃɛz
mardio	mardi̯o
mariajar	mari̯adʒar
mariajar	mari̯aʒar
maristo	maristo
maro	maro
marshi	marʃi
marso	marso
martelo	martelo
marto	marto
mashino	maʃino
maso	maso
materialismo	materi̯alismo
materio	materio
materio	matɛɾiɔ
mati	mati
matino	matinɔ
mato	mato
matri	matri
matrico	matritso
matro	matro
max	maks
maxim	magzim
maxim	maksim
me	me
me	mɛ
mea	mea
mediano	medi̯ano
medikala	medikala
medikala	mɛdikala
mediko	mediko
mediko	mɛdikɔ
meditar	meditar
mekaniko	mekaniko
mekanismo	mekanismo
melanino	melanino
melanomo	melanomo
melkar	melkar
melodio	melodi̯o
meloni	meloni
melono	melono
mem	mem
membrani	membrani
membrano	membrano
memoranta	memoranta
memorante	memorante
memoranti	memoranti
memoranto	memoranto
memorar	memorar
memoras	memoras
memorata	memorata
memorate	memorate
memorati	memorati
memorato	memorato
memorez	memorɛs
memorez	memorɛz
memorinta	memorinta
memorinte	memorinte
memorinti	memorinti
memorinto	memorinto
memorir	memorir
memoris	memoris
memorita	memorita
memorite	memorite
memoriti	memoriti
memorito	memorito
memoro	memoro
memoronta	memoronta
memoronte	memoronte
memoronti	memoronti
memoronto	memoronto
memoror	memorɔr
memoros	memorɔs
memorota	memorota
memorote	memorote
memoroti	memoroti
memoroto	memoroto
memorus	memorus
menajerio	menaʒerio
menaji	menadʒi
menaji	menaʒi
menajo	menadʒo
menajo	menaʒo
mencionanta	mentsi̯onanta
mencionante	mentsi̯onante
mencionanti	mentsi̯onanti
mencionanto	mentsi̯onanto
mencionar	mentsi̯onar
mencionas	mentsi̯onas
mencionata	mentsi̯onata
mencionate	mentsi̯onate
mencionati	mentsi̯onati
mencionato	mentsi̯onato
mencionez	mentsi̯onɛs
mencionez	mentsi̯onɛz
mencioninda	mentsioninda
mencioninda	mentsjoninda
mencioninta	mentsi̯oninta
mencioninte	mentsi̯oninte
mencioninti	mentsi̯oninti
mencioninto	mentsi̯oninto
mencionir	mentsi̯onir
mencionis	mentsi̯onis
mencionita	mentsi̯onita
mencionite	mentsi̯onite
mencioniti	mentsi̯oniti
mencionito	mentsi̯onito
menciono	mentsi̯ono
menciononta	mentsi̯ononta
menciononte	mentsi̯ononte
menciononti	mentsi̯ononti
menciononto	mentsi̯ononto
mencionor	mentsi̯onɔr
mencionos	mentsi̯onɔs
mencionota	mentsi̯onota
mencionote	mentsi̯onote
mencionoti	mentsi̯onoti
mencionoto	mentsi̯onoto
mencionus	mentsi̯onus
mentala	mentala
mentiar	mentiar
mentiar	mentjar
mentio	menti̯o
mentioza	mentioza
mentioza	mentjoza
mento	mento
mentono	mentono
mentonumo	mɛntonumo
meristemo	meristemo
meritoza	meritoza
merkati	merkati
merkato	merkato
merkurdio	merkurdio
merkurdio	mɛɾkuɾdiɔ
merkurio	meɾkuɾio
merkuro	merkuro
mesaji	mesadʒi
mesaji	mesaʒi
mesajo	mesadʒo
mesajo	mesaʒo
mestieristi	mesti̯eristi
mestieristo	mestieristo
mestieristo	mestjeristo
mestiero	mestiero
mestiero	mestjero
metadono	metadono
metala	metala
metalizar	metalizar
metalizas	metalizas
metalizez	metalizɛs
metalizez	metalizɛz
metalizir	metalizir
metalizis	metalizis
metalizor	metalizɔr
metalizos	metalizɔs
metalizus	metalizus
metalo	metalo
metar	metar
metas	metas
meteoro	meteoro
metri	metri
metro	metro
meza	meza
mezepokala	mezepokala
mezepoko	mezepoko
mielaquo	mi̯elaku̯o
mielkuko	mi̯ɛlkuko
mielo	mi̯elo
mieltempo	mi̯ɛltɛmpo
migreni	migreni
migrenigar	migrenigar
migreno	migreno
mikologio	mikologi̯o
mikra	mikra
mikrigar	mikrigar
mikrobi	mikrobi
mikrobo	mikrobo
mikrofono	mikrofono
mikroskopo	mikroskopo
mil	mil
miligrami	miligrami
miligramo	miligramo
milimetri	milimetri
milimetro	milimetro
milio	miljo
milio	miljɔ
milito	milito
min	min
minacar	minatsar
minaco	minatso
mineralo	mineralo
mineralogio	mineralogi̯o
minim	minim
ministi	ministi
ministo	ministo
minuti	minuti
minuto	minuto
mirakla	mirakla
miraklatra	miraklatra
mirakli	mirakli
miraklo	miraklo
mitologio	mitologi̯o
mitralioso	mitralioso
mitralioso	mitɾaliɔsɔ
mitro	mitro
mizerikordio	mizerikordijo
mizero	mizero
moblo	moblo
moblo	mɔblɔ
modemo	modemo
moderna	moderna
moderna	mɔdɛɾna
modi	modi
modo	modo
modo	mɔdɔ
mokadi	mokadi
mokado	mokado
moldova	moldova
molekulo	molekulo
molestar	molestar
molusko	molusko
momenti	momenti
momento	momento
monakeyi	monakeji
monakeyo	monakejo
monako	monako
monarkio	monarki̯o
monato	monato
mondo	mondo
mondolinguala	mondolinguala
mondolinguala	mondolingwala
mondolingui	mondolingu̯i
mondolingui	mondolingvi
mondolinguo	mondolinguo
mondolinguo	mondolingwo
mondumala	mondumala
mondumala	mɔndumala
mondumo	mondumo
mondumo	mɔndumɔ
monetigar	monetigar
moneto	moneto
monetuyo	monetujo
monodroma	monodroma
monomero	monomero
monopolo	monopolo
monstri	monstri
monstro	monstro
montenegro	montenegro
monteto	monteto
monto	monto
montoza	montoza
monumenti	monumenti
monumento	monumento
mordar	mordar
morfemi	morfemi
morfemo	morfemo
morfino	morfino
morfogena	morfogena
morfogenezi	morfogenezi
morfogenezo	morfogenezo
morfogeni	morfogeni
morfogeno	morfogeno
mori	mori
mortar	mɔrtar
mortigar	mɔrtigar
morto	mɔrto
morui	morui
moruo	moruo
moskeo	moskeo
moskito	moskito
mosko	mosko
motivi	motivi
motivizar	motivizar
motivo	motivo
motori	motori
motoro	motoro
movar	movar
movas	movas
moyeni	mojeni
moyeno	mojeno
mujar	muʒar
multa	multa
multiplikar	multiplikar
mungar	mungar
mungar	muŋgar
muono	muono
musho	muʃo
musketo	musketo
muso	muso
mustar	mustar
mustardi	mustardi
mustardo	mustardo
mutono	mutono
muzeo	muzeo
muzikar	muzikar
muziki	muziki
muziko	muziko
muziko	muzikɔ
myelo	mjelo
myelo	mjɛlɔ
n	n
n	ne
nacionala	natsionala
nacionala	natsjonala
naciono	natsiono
naciono	natsjono
napalmo	napalmo
napo	napo
naskar	naskar
nasko	nasko
natar	natar
naturala	naturala
naturale	naturale
naturalismo	naturalismo
naturi	naturi
naturo	naturo
naufrajar	nau̯fradʒar
naufrajar	nau̯fraʒar
naufraji	nau̯fradʒi
naufraji	nau̯fraʒi
naufrajo	nau̯fradʒo
naufrajo	nau̯fraʒo
navigado	navigado
navigar	navigar
nazego	nazego
nazi	nazi
nazo	nazo
ne	ne
ne	nɛ
nebulo	nebulo
nebulozo	nebulozo
necesa	netsesa
necesajo	netsesadʒo
necesajo	netsesaʒo
nedecidema	nedetsidema
nederlandana	nederlandana
nederlando	nederlando
nedrinkebla	nedrinkebla
neglijar	neglidʒar
neglijar	negliʒar
negociar	negotsi̯ar
nek	nɛk
nekapabla	nekapabla
nekapabligar	nekapabligar
nekonocata	nekonotsata
nekrologo	nekrologo
nekropolo	nekropolo
nektari	nektari
nektarini	nektarini
nektarino	nektarino
nektaro	nektaro
nelogikala	nelogikala
nematodi	nematodi
nematodo	nematodo
nemediata	nemedi̯ata
nemediate	nemedi̯ate
neopreni	neopreni
neopreno	neopreno
neorganika	neorganika
nepopulara	nepopulara
neposibla	neposibla
nepotismo	nepotismo
neptuno	neptuno
neracionala	neratsi̯onala
nervi	nervi
nervika	nervika
nervo	nervo
nesekura	nesekura
nesto	nesto
netransitiva	netɾansitiva
neuroni	neu̯roni
neurono	neu̯rono
neutra	neu̯tra
neutroni	neu̯troni
neutrono	neu̯trono
nevi	nevi
nevini	nevini
nevino	nevino
nevo	nevo
nexta	negzta
nexta	neksta
nicho	nitʃo
nihiligar	nihiligar
nikotino	nikotino
nitrati	nitrati
nitrato	nitrato
nitrido	nitrido
nivar	nivar
niveli	niveli
nivelo	nivelo
nivo	nivo
no	no
nobla	nobla
nocar	notsar
nociva	notsiva
noco	notso
nodo	nodo
noktar	noktar
nokteskar	nokteskar
nokteskar	nɔktɛskar
nokti	nokti
nokto	nokto
noktobujii	noktobudʒii
noktobujii	noktobuʒii
noktobujio	noktobudʒi̯o
noktobujio	noktobuʒi̯o
noktomezi	noktomezi
noktomezo	noktomezo
nomado	nomado
nomar	nomar
nomar	nɔmaɾ
nomenklaturo	nomenklaturo
nomi	nomi
nomo	nomo
nomo	nɔmɔ
nordo	nordo
normala	normala
normale	normale
normo	normo
notar	notar
nova	nova
nova	nɔva
novembri	novembri
novembro	novembro
nuanco	nuantso
nubeto	nubeto
nubi	nubi
nubo	nubo
nuco	nutso
nucoruptilo	nutsoruptilo
nuda	nuda
nudismo	nudismo
nudisti	nudisti
nudisto	nudisto
nuklea	nuklea
nukleala	nukleala
nukleo	nukleo
nukleoli	nukleoli
nukleolo	nukleolo
nuko	nuko
nukumo	nukumo
nukumo	nukumɔ
nulo	nulo
nulube	nulube
numeralo	numeralo
nun	nun
nur	nur
nura	nura
nutrar	nutrar
nutrivi	nutrivi
nutrivo	nutrivo
nutro	nutro
nuva	nuva
o	o
obeliski	obeliski
obelisko	obelisko
objecionar	obʒetsjonar
objecionar	ɔbʒɛtsjɔnaɾ
objekti	obdʒekti
objekti	obʒekti
objekto	obdʒekto
objekto	obʒekto
obliviar	oblivi̯ar
observatorii	observatorii
observatorio	observatori̯o
obsidiani	obsidi̯ani
obsidiano	obsidi̯ano
obskura	obskura
obskureso	obskureso
obsoleta	obsoleta
obstakli	obstakli
obstaklo	obstaklo
obstini	obstini
obstino	obstino
obtuza	obtuza
oceani	otseani
oceano	otseano
ociar	otsi̯ar
ocidar	otsidar
ocido	otsido
ocido	ɔtsidɔ
ocio	otsi̯o
ocitar	otsitar
ocitar	ɔtsitaɾ
od	ɔd
odiante	odi̯ante
odianti	odi̯anti
odianto	odi̯anto
odiar	odi̯ar
odiata	odi̯ata
odiate	odi̯ate
odiati	odi̯ati
odiato	odi̯ato
odo	odo
odorar	odorar
odoro	odoro
ofensanta	ofensanta
ofensante	ofensante
ofensar	ofensar
ofensas	ofensas
ofensata	ofensata
ofensate	ofensate
ofensez	ofensɛs
ofensez	ofensɛz
ofensinta	ofensinta
ofensinte	ofensinte
ofensir	ofensir
ofensis	ofensis
ofensita	ofensita
ofensite	ofensite
ofensonta	ofensonta
ofensonte	ofensonte
ofensor	ofensɔr
ofensos	ofensɔs
ofensota	ofensota
ofensote	ofensote
ofensus	ofensus
oficala	ofitsala
ofici	ofitsi
oficianta	ofitsi̯anta
oficiante	ofitsi̯ante
oficianti	ofitsi̯anti
oficianto	ofitsi̯anto
oficiar	ofitsi̯ar
oficias	ofitsi̯as
oficiez	ofitsi̯ɛs
oficiez	ofitsi̯ɛz
oficiinta	ofitsiinta
oficiinte	ofitsiinte
oficiinti	ofitsiinti
oficiinto	ofitsiinto
oficiir	ofitsiir
oficiis	ofitsiis
oficionta	ofitsi̯onta
oficionte	ofitsi̯onte
oficionti	ofitsi̯onti
oficionto	ofitsi̯onto
oficior	ofitsi̯ɔr
oficios	ofitsi̯ɔs
oficiri	ofitsiri
oficiro	ofitsiro
oficius	ofitsi̯us
ofico	ofitso
ofte	ofte
okarini	okarini
okarino	okarino
okazioni	okazi̯oni
okaziono	okazi̯ono
oktani	oktani
oktano	oktano
oktanto	oktanto
oktobri	oktobri
oktobro	oktobro
okuli	okuli
okulo	okulo
ol	ol
ol	ɔl
olda	olda
olim	olim
olima	olima
olivo	olivo
olua	olua
olua	olwa
ombro	ombro
omnibuso	omnibuso
omnibuso	ɔmnibusɔ
on	on
on	ɔn
ondego	ondego
ondi	ondi
ondifar	ondifar
ondo	ondo
onklini	onklini
onklino	onklino
onklo	onklo
onu	onu
onua	onua
onua	onwa
operacar	operatsar
operaco	operatso
operi	operi
opero	opero
oportar	oportar
optimisti	optimisti
optimisto	optimisto
or	ɔr
oraklo	oraklo
oranjo	orandʒo
oranjo	oranʒo
ordinara	ordinara
ordini	ordini
ordino	ordino
oreli	oreli
orelo	orelo
orelumo	orelumo
orfani	orfani
orfano	orfano
organa	organa
organeto	organeto
organeto	oɾganɛtɔ
organi	organi
organika	organika
organismi	organismi
organismo	organismo
organizanta	organizanta
organizante	organizante
organizanti	organizanti
organizanto	organizanto
organizar	organizar
organizar	oɾganizaɾ
organizas	organizas
organizata	organizata
organizate	organizate
organizati	organizati
organizato	organizato
organizeso	organizeso
organizez	organizɛs
organizez	organizɛz
organizi	organizi
organizinta	organizinta
organizinte	organizinte
organizinti	organizinti
organizinto	organizinto
organizir	organizir
organizis	organizis
organizita	organizita
organizite	organizite
organiziti	organiziti
organizito	organizito
organizo	organizo
organizonta	organizonta
organizonte	organizonte
organizonti	organizonti
organizonto	organizonto
organizor	organizɔr
organizos	organizɔs
organizota	organizota
organizote	organizote
organizoti	organizoti
organizoto	organizoto
organizus	organizus
organo	organo
orgenisti	orgenisti
orgenisto	orgenisto
origani	origani
origano	origano
originala	originala
origini	origini
origino	origino
orkestrala	orkestrala
orkestrala	ɔrkɛstrala
orkestro	orkestro
orkestro	ɔrkɛstrɔ
ornitorinko	ornitorinko
osto	osto
ovi	ovi
ovo	ovo
ozono	ozono
p	p
p	pe
p	pee
pacala	patsala
pacema	patsema
pacienta	patsi̯enta
pacienti	patsi̯enti
paciento	patsi̯ento
paco	patso
pacoza	patsoza
padelo	padelo
pagor	pagɔr
paki	paki
pako	pako
paladino	paladino
paliativa	pali̯ativa
palio	pali̯o
palisi	palisi
paliso	paliso
palpebragar	palpebragar
palpebro	palpebro
pamfleti	pamfleti
pamfleto	pamfleto
panoramo	panoramo
pantoflo	pantoflo
papa	papa
papala	papala
papaveri	papaveri
papavero	papavero
paperachi	paperatʃi
paperacho	paperatʃo
paperi	paperi
papero	papero
papi	papi
papilioni	papili̯oni
papiliono	papiliono
papiliono	papiljono
papo	papo
papriko	papriko
parafalo	parafalo
parafalo	parafalɔ
parapluvi	parapluvi
parapluvo	parapluvo
parashuto	paraʃuto
parasuni	parasuni
parasuno	parasuno
pardonar	pardonar
pardono	pardono
parei	parei
parenta	parenta
parento	parento
parko	parko
parkurar	parkurar
paro	paro
paroki	paroki
paroko	paroko
parolanti	parolanti
parolanto	parolanto
parolar	parolar
parolar	parɔlar
paronimi	paronimi
paronimo	paronimo
participi	partitsipi
participo	partitsipo
partikulara	partikulara
partikulo	partikulo
partio	parti̯o
partisi	partisi
partiso	partiso
parto	parto
partoprenar	partoprenar
parturar	parturar
pasajar	pasadʒar
pasajar	pasaʒar
pasajeri	pasadʒeri
pasajeri	pasaʒeri
pasajero	pasadʒero
pasajero	pasaʒero
pasajo	pasadʒo
pasajo	pasaʒo
pasinta	pasinta
pasinto	pasinto
pasiva	pasiva
pasteto	pasteto
pasteto	pastɛtɔ
pasti	pasti
pastinako	pastinako
pasto	pasto
patologio	patologi̯o
patrini	patrini
patro	patro
patruli	patruli
patrulo	patrulo
pavilioni	pavili̯oni
paviliono	paviliono
paviliono	paviljono
pavono	pavono
pavono	pavɔnɔ
pavonumar	pavonumar
pavonumar	pavɔnumar
pavonumo	pavonumo
pavonumo	pavɔnumɔ
pazar	pazar
pazo	pazo
pe	pe
pe	pɛ
pedfingro	pedfingro
pedo	pedo
peizajo	peizaʒo
peizajo	pei̯zaʒo
pektorala	pektorala
pektoro	pektoro
pekunioza	pekunioza
pekunioza	pekunjoza
pendar	pendar
pendar	pɛndaɾ
peninsulala	peninsulala
peninsulale	peninsulale
peninsulalesi	peninsulalesi
peninsulaleso	peninsulaleso
peninsulatra	peninsulatra
peninsulatre	peninsulatre
peninsulesi	peninsulesi
peninsuleso	peninsuleso
peninsuli	peninsuli
peninsuligar	peninsuligar
peninsulo	peninsulo
peniso	peniso
pensanti	pensanti
pensas	pensas
pensati	pensati
pensez	pensɛs
pensez	pensɛz
pensi	pensi
pensinti	pensinti
pensionar	pensi̯onar
pensir	pensir
pensis	pensis
pensiti	pensiti
pensonti	pensonti
pensor	pensɔr
pensos	pensɔs
pensoti	pensoti
pensus	pensus
pentagoni	pentagoni
pentagono	pentagono
pentagramo	pentagramo
per	per
per	pɛɾ
perfida	perfida
periodo	periodo
perisar	perisar
perkutar	perkutar
perkutas	perkutas
perkutis	perkutis
perkutos	perkutɔs
perkutus	perkutus
perli	perli
perlo	perlo
permisar	permisar
permisas	permisas
permisez	permisɛs
permisez	permisɛz
permisir	permisir
permisis	permisis
permisor	permisɔr
permisos	permisɔs
permisus	permisus
permutar	permutar
permutas	permutas
permuto	permuto
perpetua	perpetua
perplexa	perplegza
perplexa	perpleksa
persekutar	persekutar
persequar	pɛrsɛkwar
persiko	persiko
personala	personala
personalizar	personalizar
persono	persono
perspektivi	perspektivi
perspektivo	perspektivo
persuadar	persuadar
persuadir	persuadir
perturbante	perturbante
perturbanti	perturbanti
perturbanto	perturbanto
perturbar	perturbar
perturbas	perturbas
perturbata	perturbata
perturbate	perturbate
perturbati	perturbati
perturbato	perturbato
perturbez	perturbɛs
perturbez	perturbɛz
perturbis	perturbis
perturbor	perturbɔr
perturbos	perturbɔs
perturbus	perturbus
perucho	perutʃo
peruko	peruko
pesimisti	pesimisti
pesimisto	pesimisto
peskar	pɛskar
petiolo	peti̯olo
petrolo	petrolo
pezi	pezi
pijamo	pidʒamo
pijamo	piʒamo
pikniko	pikniko
piktar	piktar
piktas	piktas
piktez	piktɛs
piktez	piktɛz
piktir	piktir
piktis	piktis
piktor	piktɔr
piktos	piktɔs
pikturo	pikturo
piktus	piktus
pilo	pilo
pinguino	pingvino
pinguino	pingwino
pioniri	pi̯oniri
pioniro	pi̯oniro
piono	piono
pipo	pipo
piro	piro
pistolo	pistolo
pitagoro	pitagoro
placi	platsi
placo	platso
plafono	plafono
plafono	plafɔnɔ
plajo	pladʒo
plajo	plaʒo
plako	plako
planaji	planadʒi
planaji	planaʒi
planajo	planadʒo
planajo	planaʒo
planetari	planetari
planetaro	planetaro
plani	plani
planko	plaŋko
planko	plaŋkɔ
plano	plano
plantacar	plantatsar
plantacerio	plantatserio
planto	planto
plaso	plaso
plastiko	plastiko
plear	plear
plezar	plezar
plezure	plɛzuɾɛ
plezuri	plezuri
plezuro	plezuro
ploranti	ploranti
plu	plu
plualtigar	plualtigar
plualtigas	plualtigas
plualtigez	plualtigɛs
plualtigez	plualtigɛz
plualtigir	plualtigir
plualtigis	plualtigis
plualtigor	plualtigɔr
plualtigos	plualtigɔs
plualtigus	plualtigus
plubeligar	plubeligar
plubonigar	plubonigar
plucherigar	plutʃerigar
pludensigar	pludɛnsigar
pludolcigar	pludɔltsigar
plufermigar	plufɛrmigar
plufortigar	plufɔrtigar
plufreshigar	plufreʃigar
plumaligar	plumaligar
plumaro	plumaro
plumatra	plumatra
plumi	plumi
plumieri	plumi̯eri
plumiero	plumi̯ero
plumizar	plumizar
plumo	plumo
plumo	plumɔ
plumolito	plumolito
plumostroki	plumostroki
plumostroko	plumostroko
plura	plura
plurala	plurala
pluralo	pluralo
pluralo	pluɾalɔ
pluri	pluri
pluvar	pluvar
pluvar	pluvaɾ
pluvarko	pluvarko
pluvas	pluvas
pluvo	pluvo
pluvo	pluvɔ
po	po
podkasto	podkasto
poemi	poemi
poemo	poemo
poka	poka
poke	poke
polala	polala
polara	polara
polemikar	polemikar
polemikas	polemikas
polemiki	polemiki
polemikis	polemikis
polemiko	polemiko
polemikos	polemikɔs
polemikus	polemikus
poleni	poleni
poleno	poleno
policestro	politsestro
polico	politso
poligama	poligama
polimero	polimero
polinuklea	polinuklea
politikala	politikala
politiko	politiko
polo	polo
polpo	polpo
poltrona	poltrona
poltrono	poltrono
polvo	polvo
pomi	pomi
pomo	pomo
pomo	pɔmɔ
poniardagar	poni̯ardagar
poniardo	poni̯ardo
ponto	ponto
ponto	pɔntɔ
poplo	poplo
popo	popo
populara	populara
populi	populi
populo	populo
pordisto	pordisto
poroza	poroza
porozesi	porozesi
porozeso	porozeso
porteo	pɔrteo
portugal	portugal
portuo	portwo
portuo	pɔɾtwɔ
pos	pos
pos	pɔs
posdimezo	posdimezo
posdineo	pɔsdinɛo
posedanti	posedanti
posedanto	posedanto
posmilita	posmilita
posto	posto
postular	postular
potati	potati
potato	potato
potencialo	potentsi̯alo
pozar	pozar
pozeso	pozeso
pozez	pozɛs
pozez	pozɛz
pozor	pozɔr
praktikala	praktikala
praktikar	praktikar
praktikas	praktikas
praktikesar	praktikesar
praktikez	praktikɛs
praktikez	praktikɛz
praktikir	praktikir
praktikis	praktikis
praktiko	praktiko
praktikor	praktikɔr
praktikos	praktikɔs
praktikus	praktikus
pramo	pramo
precipitar	pretsipitar
precipua	pretsipua
precipue	pretsipue
precize	pretsize
preco	pretso
preco	pɾɛtsɔ
predicante	preditsante
predicar	preditsar
predicas	preditsas
predicata	preditsata
predicate	preditsate
predicati	preditsati
predicato	preditsato
predicir	preditsir
predicite	preditsite
predikar	predikar
predikar	pɾɛdikaɾ
pregar	pregar
pregeyi	pregeji
pregeyo	pregejo
pregi	pregi
prejudiki	predʒudiki
prejudiki	preʒudiki
prejudiko	predʒudiko
prejudiko	preʒudiko
prematura	prematura
prenar	prenar
presar	presar
presegar	presegar
presi	presi
preso	preso
preter	pretɛr
preterirar	preterirar
preurbi	preurbi
preurbo	preurbo
prezenta	prezenta
prezenta	pɾɛzɛnta
prezenti	prezenti
prezento	prezento
prezidanta	prezidanta
prezidante	prezidante
prezidanti	prezidanti
prezidanto	prezidanto
prezidar	prezidar
prezidas	prezidas
prezideri	prezideri
prezidero	prezidero
prezidez	prezidɛs
prezidez	prezidɛz
prezidinta	prezidinta
prezidinte	prezidinte
prezidinti	prezidinti
prezidinto	prezidinto
prezidir	prezidir
prezidis	prezidis
prezidonta	prezidonta
prezidonte	prezidonte
prezidonti	prezidonti
prezidonto	prezidonto
prezidor	prezidɔr
prezidos	prezidɔs
prezidus	prezidus
pri	pri
primara	primara
princo	printso
printempe	printempe
printempo	printempo
printempo	pɾintɛmpɔ
prismati	prismati
prismato	prismato
privacar	privatsar
prizar	prizar
probabla	probabla
probar	probar
probas	probas
probez	probɛs
probez	probɛz
probis	probis
problemo	problemo
probos	probɔs
probus	probus
procedi	protsedi
procedo	protsedo
procenti	protsenti
procento	protsento
procesema	protsesema
produktar	produktar
produktar	pɾɔduktaɾ
profetala	profetala
profetala	prɔfɛtala
profeto	profeto
profeto	prɔfɛtɔ
programo	programo
progresi	progresi
progreso	progreso
projetanta	prodʒetanta
projetanta	proʒetanta
projetante	prodʒetante
projetante	proʒetante
projetanti	prodʒetanti
projetanti	proʒetanti
projetanto	prodʒetanto
projetanto	proʒetanto
projetar	prodʒetar
projetar	proʒetar
projetas	prodʒetas
projetas	proʒetas
projetata	prodʒetata
projetata	proʒetata
projetate	prodʒetate
projetate	proʒetate
projetati	prodʒetati
projetati	proʒetati
projetato	prodʒetato
projetato	proʒetato
projetez	prodʒetɛs
projetez	proʒetɛz
projetinta	prodʒetinta
projetinta	proʒetinta
projetinte	prodʒetinte
projetinte	proʒetinte
projetinti	prodʒetinti
projetinti	proʒetinti
projetinto	prodʒetinto
projetinto	proʒetinto
projetir	prodʒetir
projetir	proʒetir
projetis	prodʒetis
projetis	proʒetis
projetite	prodʒetite
projetite	proʒetite
projetiti	prodʒetiti
projetiti	proʒetiti
projetito	prodʒetito
projetito	proʒetito
projeto	prodʒeto
projeto	proʒeto
projetonta	prodʒetonta
projetonta	proʒetonta
projetonte	prodʒetonte
projetonte	proʒetonte
projetonti	prodʒetonti
projetonti	proʒetonti
projetonto	prodʒetonto
projetonto	proʒetonto
projetor	prodʒetɔr
projetor	proʒetɔr
projetos	prodʒetɔs
projetos	proʒetɔs
projetota	prodʒetota
projetota	proʒetota
projetote	prodʒetote
projetote	proʒetote
projetoti	prodʒetoti
projetoti	proʒetoti
projetoto	prodʒetoto
projetoto	proʒetoto
projetus	prodʒetus
projetus	proʒetus
proletarii	proletarii
proletario	proletario
proletario	proletarjo
promenar	promenar
promenite	promenite
promulgar	promulgar
promulgas	promulgas
promulgate	promulgate
promulgez	promulgɛs
promulgez	promulgɛz
promulgis	promulgis
promulgos	promulgɔs
promulgus	promulgus
pronomo	pronomo
pronta	prɔnta
pronuncar	pronuntsar
pronuncebla	pronuntsebla
propagadi	propagadi
propagado	propagado
propulsar	propulsar
prosternar	prosternar
prosternas	prosternas
prosternez	prosternɛs
prosternez	prosternɛz
prosternir	prosternir
prosternis	prosternis
prosternor	prosternɔr
prosternos	prosternɔs
prosternus	prosternus
prostracar	prostratsar
prostraco	prostratso
protektar	protektar
protektar	pɾɔtɛktaɾ
protekti	protekti
protekto	protekto
protisto	protisto
protoplasto	protoplasto
proxim	progzim
proxim	proksim
proximeskar	proksimeskar
proximesko	proksimesko
pruno	pruno
pruritar	pruritar
pruritar	pɾuɾitaɾ
prurito	prurito
prurito	pɾuɾitɔ
pruvar	pruvar
pseudonimo	pseu̯donimo
psiko	psiko
psikopato	psikopato
puerala	puerala
puerala	pwerala
puero	pu̯ero
pulsanto	pulsanto
pulsari	pulsari
pulsaro	pulsaro
pulsas	pulsas
punto	punto
punto	puntɔ
pupei	pupei
pupeo	pupeo
pupi	pupi
pupo	pupo
puritani	puritani
puritano	puritano
purpura	purpura
purpurea	purpurea
purpuro	purpuro
puteo	puteo
putrar	putrar
putrinta	putrinta
q	kw
q	kwe
qua	kwa
quadrato	ku̯adrato
quadrato	kvadrato
quakero	ku̯akero
quala	kwala
quale	kwale
quale	kwalɛ
qualesala	kwalesala
qualeso	kwaleso
quankam	ku̯ankam
quankam	kvankam
quanta	kwanta
quante	kwante
quante	kwantɛ
quantesala	kwantesala
quantesi	ku̯antesi
quantesi	kvantesi
quantesma	ku̯antɛsma
quanteso	kwanteso
quanto	kwanto
quar	kwar
quartermastro	ku̯artermastro
quartermastro	kvartermastro
que	kwe
que	kwɛ
querar	kwerar
questioni	ku̯esti̯oni
questioni	kvesti̯oni
questiono	ku̯esti̯ono
questiono	kvesti̯ono
qui	kwi
quieta	ku̯i̯eta
quieta	kvi̯eta
quik	kwik
quinino	ku̯inino
quinino	kvinino
quitigar	kwitigar
quo	kwo
quo	kwɔ
quoniam	ku̯oni̯am
quoniam	kvoni̯am
r	ɾ
r	ɾe
racionala	ratsi̯onala
radiar	radiar
radii	radii
radio	radio
radioaktiveso	radi̯oaktiveso
radios	radi̯ɔs
rafto	rafto
rafto	ɾaftɔ
rakar	rakar
rakez	rakɛs
rakez	rakɛz
rakonto	rakonto
rakos	rakɔs
rakus	rakus
rani	rani
rankoro	rankoro
rano	rano
raptar	raptar
raptar	ɾaptaɾ
rare	rare
raspanta	raspanta
raspante	raspante
raspanti	raspanti
raspanto	raspanto
raspar	raspar
raspas	raspas
raspata	raspata
raspate	raspate
raspati	raspati
raspato	raspato
raspez	raspɛs
raspez	raspɛz
raspinta	raspinta
raspinte	raspinte
raspinti	raspinti
raspinto	raspinto
raspir	raspir
raspis	raspis
raspita	raspita
raspite	raspite
raspiti	raspiti
raspito	raspito
rasponta	rasponta
rasponte	rasponte
rasponti	rasponti
rasponto	rasponto
raspor	raspɔr
raspos	raspɔs
raspota	raspota
raspote	raspote
raspoti	raspoti
raspoto	raspoto
raspus	raspus
rato	rato
ratono	ratono
raupi	rau̯pi
raupo	rau̯po
re	re
re	ɾɛ
reala	reala
reale	reale
recensar	retsɛnsar
recenso	retsɛnso
recepcionar	retseptsi̯onar
recepcionas	retseptsi̯onas
recepcionez	retseptsi̯onɛs
recepcionez	retseptsi̯onɛz
recepcionir	retseptsi̯onir
recepcionis	retseptsi̯onis
recepciono	retseptsi̯ono
recepcionor	retseptsi̯onɔr
recepcionos	retseptsi̯onɔs
recepcionus	retseptsi̯onus
recevar	retsevar
reciproka	retsiproka
reda	reda
redaktar	rɛdaktar
redakteri	redakteri
redaktero	redaktero
redemti	redemti
redemto	redemto
refraktanta	refraktanta
refraktar	refraktar
refraktas	refraktas
refraktez	refraktɛs
refraktez	refraktɛz
refraktir	refraktir
refraktis	refraktis
refraktor	refraktɔr
refraktos	refraktɔs
refraktus	refraktus
refreni	refreni
refreno	refreno
refutar	refutar
regenerante	regenerante
regeneranti	regeneranti
regeneranto	regeneranto
regenerar	regenerar
regeneras	regeneras
regenerata	regenerata
regenerate	regenerate
regenerati	regenerati
regenerato	regenerato
regenerez	regenerɛs
regenerez	regenerɛz
regenerinti	regenerinti
regenerir	regenerir
regeneriti	regeneriti
regeneronti	regeneronti
regeneror	regenerɔr
regeneroti	regeneroti
regnante	regnante
regnanti	regnanti
regnar	regnar
regnas	regnas
regnez	regnɛs
regnez	regnɛz
regnis	regnis
regnos	regnɔs
regnus	regnus
regresar	regresar
regresas	regresas
regresez	regresɛs
regresez	regresɛz
regresir	regresir
regresis	regresis
regresor	regresɔr
regresos	regresɔs
regresus	regresus
regretar	regretar
reguli	reguli
regulo	regulo
rejo	redʒo
rejo	reʒo
reklamacar	reklamatsar
reklamo	reklamo
rekortar	rekortar
religiala	religiala
religiala	religjala
religio	religi̯o
religioza	religioza
religioza	religjoza
remarkar	remarkar
remarkar	ɾɛmaɾkaɾ
remediachi	remedi̯atʃi
remediacho	remediatʃo
remediacho	remedjatʃo
remedio	remedio
remedio	remedjo
remonstrar	rɛmɔnstrar
renkontrar	renkontrar
reparar	reparar
repasto	repasto
repentar	repentar
repliko	repliko
repozar	repozar
repozar	ɾɛpɔzaɾ
repteri	repteri
reptero	reptero
repudiar	repudi̯ar
repudias	repudi̯as
repudiez	repudi̯ɛs
repudiez	repudi̯ɛz
repudiir	repudiir
repudiis	repudiis
repudior	repudi̯ɔr
repudios	repudi̯ɔs
repudius	repudi̯us
repugnar	repuŋgar
reputeso	reputeso
resonanta	resonanta
resonante	resonante
resonanti	resonanti
resonanto	resonanto
resonar	resonar
resonas	resonas
resonez	resonɛs
resonez	resonɛz
resoninta	resoninta
resoninte	resoninte
resoninti	resoninti
resoninto	resoninto
resonir	resonir
resonis	resonis
resononta	resononta
resononte	resononte
resononti	resononti
resononto	resononto
resonor	resonɔr
resonos	resonɔs
resonus	resonus
respektar	respektar
respiras	respiras
respirez	respirɛs
respirez	respirɛz
responsanta	responsanta
responsiva	responsiva
restaji	restadʒi
restaji	restaʒi
restajo	restadʒo
restajo	restaʒo
restas	restas
restaurante	restau̯rante
restauranti	restau̯ranti
restauranto	restau̯ranto
restauras	restau̯ras
restaurata	restau̯rata
restaurate	restau̯rate
restaurati	restau̯rati
restaurato	restau̯rato
restaurez	restau̯rɛs
restaurez	restau̯rɛz
restauris	restau̯ris
restauror	restau̯rɔr
resti	resti
resto	resto
reto	reto
retoloki	retoloki
retoloko	retoloko
retopagini	retopagini
retopagino	retopagino
retroirar	retroirar
retrotirar	retrotirar
retushar	retutʃar
revo	revo
revoko	revoko
revolucionema	revolutsionema
revolucionema	revolutsjonema
revolucioni	revolutsi̯oni
revoluciono	revolutsiono
revoluciono	revolutsjono
revuar	revu̯ar
revuo	revu̯o
rezistema	rezistema
rezistiva	rezistiva
rezumanta	rezumanta
rezumante	rezumante
rezumar	rezumar
rezumas	rezumas
rezumata	rezumata
rezumate	rezumate
rezume	rezume
rezumez	rezumɛs
rezumez	rezumɛz
rezuminta	rezuminta
rezuminte	rezuminte
rezumir	rezumir
rezumis	rezumis
rezumita	rezumita
rezumite	rezumite
rezumonta	rezumonta
rezumonte	rezumonte
rezumor	rezumɔr
rezumos	rezumɔs
rezumota	rezumota
rezumote	rezumote
rezumus	rezumus
ricevar	ritsevar
richajo	ritʃadʒo
richajo	ritʃaʒo
richeskar	ritʃeskar
ridetar	ridetar
ridetar	ridɛtaɾ
rideti	rideti
rideto	rideto
rideto	ridɛtɔ
ridinda	ridinda
rikomencar	rikomentsar
rinsar	rinsar
ritmi	ritmi
rivereti	rivereti
rivereto	rivereto
rivo	rivo
rizomo	rizomo
robi	robi
robo	robo
roboto	roboto
rodar	rodar
rodez	rodɛs
rodez	rodɛz
roki	roki
roko	roko
rokoza	rokoza
romanala	romanala
rospo	ɾospo
rostro	rostro
rostro	ɾɔstɾɔ
roto	roto
rozea	rozea
rozea	ɾɔzɛa
rozeto	rozeto
rozieri	rozi̯eri
roziero	rozi̯ero
rumania	rumani̯a
ruptilo	ruptilo
rurala	rurala
rurani	rurani
rurano	rurano
ruro	ruro
rusia	rusi̯a
s	s
s	se
sa	sa
sabla	sabla
sablo	sablo
sacerdoti	satserdoti
sacerdoto	satserdoto
saciar	satsi̯ar
sacias	satsi̯as
sacios	satsi̯ɔs
saja	sadʒa
saja	saʒa
sajesi	sadʒesi
sajesi	saʒesi
sajeso	sadʒeso
sajeso	saʒeso
sako	sako
sako	sakɔ
saliko	saliko
saloni	saloni
salono	salono
saltar	saltar
saluti	saluti
saluto	saluto
salvar	salvar
salvo	salvo
sama	sama
sambuko	sambuko
samideani	samideani
samideano	samideano
samlandani	samlandani
samlandano	samlandano
samtempe	samtempe
sana	sana
sandalo	sandalo
sanesar	sanesar
sangifar	sangifar
sanigar	sanigar
sanigas	sanigas
sanigez	sanigɛs
sanigez	sanigɛz
santa	santa
santeso	santeso
saponino	saponino
sarko	sarko
sat	sat
sata	sata
satiro	satiro
satisfacar	satisfatsar
saturanta	saturanta
saturante	saturante
saturanti	saturanti
saturanto	saturanto
saturar	saturar
saturas	saturas
saturata	saturata
saturate	saturate
saturati	saturati
saturdio	saturdi̯o
saturez	saturɛs
saturez	saturɛz
saturinta	saturinta
saturinte	saturinte
saturinti	saturinti
saturinto	saturinto
saturir	saturir
saturis	saturis
saturita	saturita
saturite	saturite
saturiti	saturiti
saturito	saturito
saturno	saturno
saturonta	saturonta
saturonte	saturonte
saturonti	saturonti
saturonto	saturonto
saturor	saturɔr
saturos	saturɔs
saturota	saturota
saturote	saturote
saturoti	saturoti
saturoto	saturoto
saturus	saturus
sauco	sau̯tso
saveskar	saveskar
savi	savi
savis	savis
savurar	savurar
se	se
se	sɛ
secioni	setsi̯oni
seciono	setsiono
seciono	setsjono
sed	sed
segli	segli
seglo	seglo
segmenti	segmenti
segun	segun
sejornar	seʒornar
sekar	sekar
sekundara	sekundara
selektar	selektar
selektar	sɛlɛktaɾ
selo	selo
semano	semano
semano	sɛmanɔ
sen	sen
sencesa	sentsesa
senci	sentsi
senco	sentso
sendar	sendar
senhara	senhara
senkapigar	senkapigar
senmezura	senmezura
sentir	sentir
separar	separar
separas	separas
separez	separɛs
separez	separɛz
separir	separir
separis	separis
separor	separɔr
separos	separɔs
sepultar	sepultar
sequanta	sekvanta
sequanta	sekwanta
sequar	seku̯ar
sequar	sekvar
serbia	serbi̯a
serchar	sɛrtʃar
serpenti	serpenti
serpento	serpento
seruristi	seruristi
seruristo	seruristo
servar	servar
servar	sɛɾvaɾ
sfero	sfero
shakar	ʃakar
shakfiguro	ʃakfiguro
shako	ʃako
shamiganta	ʃamiganta
shamigar	ʃamigar
shamigas	ʃamigas
shamigez	ʃamigɛs
shamigez	ʃamigɛz
shamiginta	ʃamiginta
shamigir	ʃamigir
shamigis	ʃamigis
shamigita	ʃamigita
shamigonta	ʃamigonta
shamigor	ʃamigɔr
shamigos	ʃamigɔs
shamigus	ʃamigus
shaminda	ʃaminda
shamo	ʃamo
shikani	ʃikani
shikano	ʃikano
shildi	ʃildi
shildo	ʃildo
shovinismi	ʃovinismi
shovinismo	ʃovinismo
si	si
sidar	sidar
sidar	sidaɾ
sidilo	sidilo
sidilo	sidilɔ
siejar	sjɛʒar
sieji	si̯edʒi
sieji	si̯eʒi
siejo	si̯edʒo
siejo	si̯eʒo
siesti	si̯esti
siesto	siesta
sigareti	sigareti
sigareto	sigareto
sigaro	sigaro
sigaruyo	sigarujo
signi	signi
signifikar	signifikar
signifikar	signifikaɾ
signifiki	signifiki
signifiko	signifiko
signo	signo
sika	sika
sikeskar	sikeskar
sikijar	sikiʒar
silenco	silɛntso
sileni	sileni
sileno	sileno
silka	silka
silkatra	silkatra
silko	silko
siluri	siluri
simbolo	simbolo
simetreso	simetreso
simii	simii
similesar	similesar
simio	simio
simio	simjo
sinapismi	sinapismi
sinapismo	sinapismo
sindikati	sindikati
sindikato	sindikato
singla	singla
singlu	singlu
sinioro	sini̯oro
sinkar	siŋkar
sinkar	siŋkaɾ
sinkas	sinkas
sinkata	sinkata
sinkez	sinkɛs
sinkez	sinkɛz
sinkis	sinkis
sinkos	sinkɔs
sinkus	sinkus
sinonima	sinonima
sinonimi	sinonimi
sinonimo	sinonimo
sinso	sinso
sintezi	sintezi
sintezo	sintezo
siori	si̯ori
siorini	si̯orini
siorino	si̯orino
sioro	si̯oro
sioruli	si̯oruli
siorulo	si̯orulo
sireni	sireni
sireno	sireno
sisanta	sisanta
sisante	sisante
sisanti	sisanti
sisanto	sisanto
sisar	sisar
sisas	sisas
sisata	sisata
sisate	sisate
sisati	sisati
sisato	sisato
sisez	sisɛs
sisez	sisɛz
sisinta	sisinta
sisinte	sisinte
sisinti	sisinti
sisinto	sisinto
sisir	sisir
sisis	sisis
sisita	sisita
sisite	sisite
sisiti	sisiti
sisito	sisito
sisonta	sisonta
sisonte	sisonte
sisonti	sisonti
sisonto	sisonto
sisor	sisɔr
sisos	sisɔs
sisota	sisota
sisote	sisote
sisoti	sisoti
sisoto	sisoto
sistemala	sistemala
sistemo	sistemo
sisus	sisus
sitelo	sitelo
situesi	situesi
situeso	situeso
sive	sive
sizar	sizar
skalo	skalo
skandinavia	skandinavi̯a
skarabeo	skarabeo
skarsa	skarsa
skeleti	skeleti
skeleto	skeleto
sketeyo	sketejo
skiglitar	skiglitar
skikuranta	skikuranta
skikurante	skikurante
skikuranti	skikuranti
skikuranto	skikuranto
skikurar	skikurar
skikuras	skikuras
skikurez	skikurɛs
skikurez	skikurɛz
skikurinta	skikurinta
skikurinte	skikurinte
skikurinti	skikurinti
skikurinto	skikurinto
skikurir	skikurir
skikuris	skikuris
skikuronta	skikuronta
skikuronte	skikuronte
skikuronti	skikuronti
skikuronto	skikuronto
skikuror	skikurɔr
skikuros	skikurɔs
skikurus	skikurus
skio	skio
skisar	skisar
sklavi	sklavi
sklavo	sklavo
skolo	skolo
skopo	skɔpɔ
skrachar	skratʃar
skreni	skreni
skreno	skreno
skribanta	skribanta
skribante	skribante
skribanti	skribanti
skribanto	skribanto
skribar	skribar
skribas	skribas
skribata	skribata
skribate	skribate
skribati	skribati
skribato	skribato
skribez	skribɛs
skribez	skribɛz
skribinta	skribinta
skribinte	skribinte
skribinti	skribinti
skribinto	skribinto
skribir	skribir
skribis	skribis
skribita	skribita
skribite	skribite
skribiti	skribiti
skribito	skribito
skribonta	skribonta
skribonte	skribonte
skribonti	skribonti
skribonto	skribonto
skribor	skribɔr
skribos	skribɔs
skribota	skribota
skribote	skribote
skriboti	skriboti
skriboto	skriboto
skriburi	skriburi
skriburo	skriburo
skribus	skribus
skriptar	skriptar
skrubagar	skrubagar
skrubo	skrubo
skrubturnili	skrubturnili
skrubturnilo	skrubturnilo
skultar	skultar
skulturi	skulturi
skulturo	skulturo
skurelo	skurelo
slovakia	slovaki̯a
slovenia	sloveni̯a
socialismo	sotsi̯alismo
sociologio	sotsi̯ologi̯o
sociologo	sotsi̯ologo
sociso	sotsiso
sofismi	sofismi
sofismo	sofismo
sokursar	sokursar
sokurso	sokurso
sola	sola
soldati	soldati
soldato	soldato
solei	solei
solena	solena
solene	solene
solstico	solstitso
solvar	solvar
solvuri	solvuri
solvuro	solvuro
somero	somero
somero	sɔmɛɾɔ
sonanto	sonanto
sondar	sɔndar
sonji	sondʒi
sonji	sonʒi
sonjo	sondʒo
sonjo	sonʒo
sorganta	sorganta
sorgante	sorgante
sorganti	sorganti
sorganto	sorganto
sorgar	sɔrgar
sorgas	sorgas
sorgata	sorgata
sorgate	sorgate
sorgati	sorgati
sorgato	sorgato
sorgez	sorgɛs
sorgez	sorgɛz
sorginta	sorginta
sorginte	sorginte
sorginti	sorginti
sorginto	sorginto
sorgir	sorgir
sorgis	sorgis
sorgita	sorgita
sorgite	sorgite
sorgiti	sorgiti
sorgito	sorgito
sorgonta	sorgonta
sorgonte	sorgonte
sorgonti	sorgonti
sorgonto	sorgonto
sorgor	sorgɔr
sorgos	sorgɔs
sorgota	sorgota
sorgote	sorgote
sorgoti	sorgoti
sorgoto	sorgoto
sorgus	sorgus
sorto	sorto
sostantivi	sostantivi
sovaja	sovadʒa
sovaja	sovaʒa
spaco	spatso
spaconavi	spatsonavi
spaconavo	spatsonavo
spanieleti	spani̯eleti
spanieli	spani̯eli
spanielo	spani̯elo
spano	spano
sparar	sparar
sparesar	sparesar
spatulo	spatulo
specala	spetsala
specaligar	spetsaligar
specigar	spetsigar
speco	spetso
spektar	spektar
spektar	spɛktaɾ
spico	spitso
spiki	spiki
spiko	spiko
spinati	spinati
spinato	spinato
spiritala	spiritala
spiritalismo	spiritalismo
spirito	spirito
spleno	spleno
spliti	spliti
splito	splito
sponjo	sponʒo
spontana	spontana
spontane	spontane
spontaneso	spontaneso
spozo	spozo
spricar	spritsar
spumifar	spumifar
spumifor	spumifɔr
stacar	statsar
staciono	statsi̯ono
staco	statso
stadio	stadio
stadio	stadiɔ
standar	standar
standardo	standardo
standi	standi
stando	stando
startar	startar
stati	stati
statistiko	statistiko
stativo	stativo
stato	stato
statuto	statuto
stelaro	stelaro
sterko	sterko
sternutar	sternutar
stetoskopo	stetoskopo
stifa	stifa
stimular	stimular
stonagar	stonagar
stoterar	stoterar
strado	strado
strado	stɾadɔ
strandar	strandar
strandar	stɾandaɾ
strandi	strandi
strando	strando
strati	strati
strato	strato
streta	streta
striizar	striizar
striizas	striizas
striizez	striizɛs
striizez	striizɛz
striizis	striizis
striizos	striizɔs
striizus	striizus
strikas	strikas
striki	striki
strikis	strikis
striko	striko
strikos	strikɔs
strikus	strikus
strokar	strokar
strokar	strɔkar
stroki	stroki
stroko	stroko
stroko	strɔkɔ
strucho	strutʃo
studios	studi̯ɔs
stufajo	stufadʒo
stufajo	stufaʒo
stufanta	stufanta
stufante	stufante
stufanti	stufanti
stufanto	stufanto
stufar	stufar
stufata	stufata
stufate	stufate
stufati	stufati
stufato	stufato
stufinta	stufinta
stufinte	stufinte
stufinti	stufinti
stufinto	stufinto
stufita	stufita
stufite	stufite
stufiti	stufiti
stufito	stufito
stufonta	stufonta
stufonte	stufonte
stufonti	stufonti
stufonto	stufonto
stufota	stufota
stufote	stufote
stufoti	stufoti
stufoto	stufoto
stulo	stulo
stuvagar	stuvagar
stuvo	stuvo
su	su
sua	sua
subisar	subisar
sublima	sublima
sublimante	sublimante
sublimanti	sublimanti
sublimanto	sublimanto
sublimar	sublimar
sublimas	sublimas
sublimata	sublimata
sublimate	sublimate
sublimati	sublimati
sublimato	sublimato
sublimez	sublimɛs
sublimez	sublimɛz
sublimis	sublimis
sublimor	sublimɔr
sublimos	sublimɔs
sublimus	sublimus
submisar	submisar
submisar	submisaɾ
subordinita	subordinita
subpeninsuli	subpeninsuli
subpeninsulo	subpeninsulo
substanci	substantsi
substanco	substantso
substantivi	substantivi
substantivo	substantivo
substitucar	substitutsar
substitucar	substitutsaɾ
subsumir	subsumir
subtera	subtera
subtila	subtila
subtilaji	subtiladʒi
subtilaji	subtilaʒi
subtilajo	subtiladʒo
subtilajo	subtilaʒo
subtileso	subtileso
suburbo	suburbo
sucesar	sutsesar
suciar	sutsiar
suciar	sutsjar
suciema	sutsi̯ema
sudo	sudo
sudorifar	sudorifar
sudorifas	sudorifas
sudorifez	sudorifɛs
sudorifez	sudorifɛz
sudorifir	sudorifir
sudorifis	sudorifis
sudorifor	sudorifɔr
sudorifos	sudorifɔs
sudorifus	sudorifus
sudoro	sudoro
suedia	swedja
suedia	swɛdja
suficar	sufitsar
suflar	suflar
sugar	sugar
sugato	sugato
sui	sui
suko	suko
sukombar	sukombar
sukoza	sukoza
sukri	sukri
sukro	sukro
sulfidi	sulfidi
sulfido	sulfido
sulfito	sulfito
sulfo	sulfo
sundio	sundio
sunlumo	sunlumo
suno	suno
sunolumo	sunolumo
superba	superba
superbeso	superbeso
superesar	superesar
supernatura	supernatura
supernatura	supɛrnatura
supo	supo
suportar	suportar
suporti	suporti
suporto	suporto
supresar	supɾesaɾ
sur	sur
surda	surda
surdigar	surdigar
surdigas	surdigas
surdigez	surdigɛs
surdigez	surdigɛz
surdigis	surdigis
surdigos	surdigɔs
surdigus	surdigus
surfacala	surfatsala
surpozar	surpozar
surpozez	surpozɛs
surpozez	surpozɛz
susteni	susteni
susteno	susteno
susurar	susurar
sutar	sutar
sutar	sutaɾ
suverena	suverena
swabragar	swabragar
swabro	swabro
swichar	switʃar
t	t
t	te
ta	ta
tableti	tableti
tablo	tablo
tabulo	tabulo
takti	takti
taktiko	taktiko
takto	takto
tala	tala
tale	tale
talono	talono
talono	talɔnɔ
tam	tam
tamtamo	tamtamo
tandem	tandɛm
tapisi	tapisi
tapisisti	tapisisti
tapisisto	tapisisto
tapisizar	tapisizar
tapiso	tapiso
tarda	tarda
tardeskar	tardeskar
tardigar	tardigar
tarto	tarto
tarto	taɾtɔ
taso	taso
tauro	tawro
taxio	tagzi̯o
taxio	taksi̯o
te	te
te	tɛ
tedar	tedar
tegar	tegar
teknikala	teknikala
tekto	tɛkto
telefonar	telefonar
telefonas	telefonas
telefonez	telefonɛs
telefonez	telefonɛz
telefoni	telefoni
telefonis	telefonis
telefono	telefono
telefonos	telefonɔs
telefonus	telefonus
telegramo	telegramo
televiziono	televiziono
temerara	temerara
temo	temo
tempesto	tempesto
tempi	tempi
tempo	tempo
temporalo	tɛmporalo
temporo	tɛmporo
tenanto	tenanto
tendo	tendo
tenebroza	tenebroza
tenera	tenera
tensar	tensar
tensita	tensita
tentanta	tentanta
tentante	tentante
tentanti	tentanti
tentanto	tentanto
tentar	tentar
tentas	tentas
tentata	tentata
tentate	tentate
tentati	tentati
tentato	tentato
tentez	tentɛs
tentez	tentɛz
tentinta	tentinta
tentinte	tentinte
tentinti	tentinti
tentinto	tentinto
tentir	tentir
tentis	tentis
tentita	tentita
tentite	tentite
tentiti	tentiti
tentito	tentito
tentonta	tentonta
tentonte	tentonte
tentonti	tentonti
tentonto	tentonto
tentor	tentɔr
tentos	tentɔs
tentota	tentota
tentote	tentote
tentoti	tentoti
tentoto	tentoto
tentus	tentus
teo	teo
teologio	teologi̯o
teorbi	teorbi
teorbo	teorbo
teorio	teori̯o
teplico	tɛplitso
teraso	teraso
terciara	tertsi̯ara
teritorio	teritori̯o
terminari	terminari
terminaro	terminaro
termini	termini
termino	termino
termo	termo
termo	tɛɾmɔ
tero	tero
terpomo	terpomo
tertremi	tertremi
tertremo	tertremo
texajo	tegzadʒo
texajo	teksaʒo
texto	tegzto
texto	teksto
ti	ti
til	til
timida	timida
tiranatra	tiranatra
tirante	tirante
tirar	tirar
tiras	tiras
tirez	tirɛs
tirez	tirɛz
tirita	tirita
tirkesti	tirkesti
tirkesto	tirkɛsto
tisui	tisui
tisuo	tisu̯o
titulo	titulo
tomati	tomati
tomato	tomato
tombeyo	tombeyo
tombo	tombo
tondrar	tɔndrar
tondro	tɔndro
torako	torako
tormentante	tormentante
tormentar	tormentar
tormentar	tɔɾmɛntaɾ
tormentas	tormentas
tormentata	tormentata
tormentate	tormentate
tormentati	tormentati
tormentato	tormentato
tormentez	tormentɛs
tormentez	tormentɛz
tormentis	tormentis
tormentor	tormentɔr
tormentos	tormentɔs
tormentus	tormentus
toro	toro
torono	torono
torono	tɔɾɔnɔ
torto	torto
torto	tɔɾtɔ
tostar	tostar
tosto	tosto
tota	tota
tote	tote
totmonda	totmonda
toxika	togzika
toxika	toksika
toxiki	togziki
toxiki	toksiki
toxiko	togziko
toxiko	toksiko
tradukala	tradukala
tradukar	tradukar
tradukenda	tradukenda
tradukesar	tradukesar
traduki	traduki
traduko	traduko
trahizanta	trahizanta
trahizante	trahizante
trahizanti	trahizanti
trahizanto	trahizanto
trahizar	trahizar
trahizas	trahizas
trahizata	trahizata
trahizate	trahizate
trahizez	trahizɛs
trahizez	trahizɛz
trahizinta	trahizinta
trahizinte	trahizinte
trahizinti	trahizinti
trahizinto	trahizinto
trahizir	trahizir
trahizis	trahizis
trahizita	trahizita
trahizite	trahizite
trahizonta	trahizonta
trahizonte	trahizonte
trahizonti	trahizonti
trahizonto	trahizonto
trahizor	trahizɔr
trahizos	trahizɔs
trahizota	trahizota
trahizote	trahizote
trahizus	trahizus
traktar	traktar
tranchar	trantʃar
tranchar	tɾantʃaɾ
tranco	trantso
tranquila	tranku̯ila
tranquila	trankvila
transfigurar	transfigurar
transfinita	transfinita
transformar	transformar
transirar	transiɾaɾ
transiro	transiro
transitar	tɾansitaɾ
transitiva	transitiva
transito	tɾansito
transpeninsula	transpeninsula
transpozar	transpozar
transpozez	transpozɛs
transpozez	transpozɛz
trapasar	trapasar
traurar	trau̯rar
trauro	trau̯ro
tre	tre
trefo	trefo
trempita	trempita
treni	treni
trezori	trezori
trezoro	trezoro
trianguli	tri̯anguli
triangulo	tri̯angulo
tribui	tribui
tribuo	tribuwo
tridento	tridento
triedro	triedro
trinuklea	trinuklea
trista	trista
triumfar	triumfar
triumfo	triumfo
tro	tro
trombociti	trombotsiti
trombocito	trombotsito
trompar	trompar
troni	troni
tropiko	tropiko
troto	troto
trotuaro	trotuaro
trotuaro	trotwaro
trovebla	trovebla
trueti	trueti
trueto	trueto
truo	truo
tu	tu
tua	tua
tuberkloso	tuberkloso
tuerta	tuerta
tuni	tuni
tuno	tuno
turbano	turbano
turdi	turdi
turdo	turdo
turismo	turismo
turisto	turisto
turkia	turki̯a
turmo	turmo
turmo	tuɾmɔ
turnar	turnar
turnas	turnas
turnez	turnɛs
turnez	turnɛz
turnir	turnir
turnis	turnis
turnor	turnɔr
turnos	turnɔs
turnus	turnus
turo	turo
u	u
ube	ube
ube	ubɛ
uceli	utseli
ucelo	utselo
ula	ula
ultra	ultra
ulular	ulular
umbiliko	umbiliko
un	un
unajo	unadʒo
unajo	unaʒo
uneso	uneso
unika	unika
unikeso	unikeso
unikorno	unikorno
unionar	unionar
unionesar	unijonesar
unionita	uni̯onita
uniono	uniono
uniono	unjono
universala	universala
universitati	universitati
universitato	universitato
universo	universo
universo	univɛɾsɔ
uno	uno
upupo	upupo
urano	urano
urbestro	urbestro
urbi	urbi
urbo	urbo
urjar	urdʒar
urjar	urʒar
urso	urso
usa	usa
usana	usana
utensilo	utensilo
utensilo	utɛnsilɔ
uzabez	uzabɛs
uzabez	uzabɛz
uzar	uzar
uzas	uzas
uzenda	uzenda
uzi	uzi
uzis	uzis
uzos	uzɔs
uzus	uzus
v	v
v	ve
vabo	vabo
vadanti	vadanti
vadar	vadar
vadas	vadas
vadati	vadati
vadez	vadɛs
vadez	vadɛz
vadinti	vadinti
vadir	vadir
vadis	vadis
vaditi	vaditi
vadonti	vadonti
vador	vadɔr
vados	vadɔs
vadoti	vadoti
vadus	vadus
vakua	vakua
vakueso	vakueso
vakuo	vakuo
vakuoli	vakuoli
vakuolo	vakuolo
valo	valo
vapornavi	vapornavi
vapornavo	vapornavo
vaporo	vaporo
varmega	varmega
varo	varo
varsar	varsar
vartas	vartas
vasalo	vasalo
vasta	vasta
vatikano	vatikano
ve	ve
ve	vɛ
vehar	vehar
vehilo	vehilo
vehilo	vɛhilo
veino	vɛi̯no
vejetar	vedʒetar
vejetar	veʒetar
vejetarar	vedʒetarar
vejetarar	veʒetarar
vel	vɛl
velo	velo
venenagar	venenagar
veneni	veneni
venenizar	venenizar
venenizas	venenizas
venenizez	venenizɛs
venenizez	venenizɛz
venenizis	venenizis
venenizos	venenizɔs
venenizus	venenizus
veneno	veneno
venenoza	venenoza
venerdio	venerdio
venerdio	vɛnɛɾdiɔ
venez	venɛs
venez	venɛz
venir	venir
venor	venɔr
venos	venɔs
ventar	ventar
ventas	ventas
ventez	ventɛs
ventez	ventɛz
venti	venti
ventir	ventir
ventis	ventis
ventor	ventɔr
ventos	ventɔs
ventri	ventri
ventro	ventro
ventus	ventus
venuso	venuso
vera	vera
vera	vɛra
verda	verda
verdaji	verdadʒi
verdaji	verdaʒi
verdajo	verdaʒo
vere	vere
vere	vɛrɛ
vereso	vereso
vereso	vɛrɛsɔ
verketo	verketo
verki	verki
verko	verko
vers	vɛrs
vertico	vertitso
vertuo	vertuo
vertuoza	vertuoza
vespereskanta	vespereskanta
vespereskante	vespereskante
vespereskanti	vespereskanti
vespereskanto	vespereskanto
vespereskar	vespereskar
vespereskinta	vespereskinta
vespereskinte	vespereskinte
vespereskinti	vespereskinti
vespereskinto	vespereskinto
vespereskonta	vespereskonta
vespereskonte	vespereskonte
vespereskonti	vespereskonti
vespereskonto	vespereskonto
vespereskor	vespereskɔr
vespereskos	vespereskɔs
vesperi	vesperi
vespero	vespero
vespo	vespo
vestaro	vestaro
vesti	vesti
vesto	vesto
vestoni	vestoni
vestono	vestono
vetero	vetero
veturi	veturi
veturo	veturo
vicar	vitsar
vice	vitse
vicerala	vitserala
vicerari	vitserari
viceraro	vitseraro
viceri	vitseri
vicero	vitsero
vicina	vitsina
vicino	vitsino
vicio	vitsi̯o
viciozeso	vitsi̯ozeso
vidar	vidar
vidar	vidaɾ
vidas	vidas
vidati	vidati
vidato	vidato
videbla	videbla
videbla	vidɛbla
videi	videi
video	videjo
video	vidɛjɔ
vidi	vidi
vidita	vidita
vilajano	vilaʒano
vilaji	viladʒi
vilaji	vilaʒi
vilajo	viladʒo
vilajo	vilaʒo
vildo	vildo
vilo	vilo
vinkar	vinkar
vino	vino
vintrala	vintrala
vintro	vintro
violacar	violatsar
violacar	viɔlatsaɾ
violenta	violenta
violentema	violentema
violento	violento
virala	virala
vireso	vireso
virgino	virgino
virgulo	virgulo
viro	viro
visar	visar
visilo	visilo
vito	vito
vitoberi	vitoberi
vitobero	vitobero
vitratra	vitratra
vitrigar	vitrigar
vitro	vitro
vivo	vivo
vivoza	vivoza
vivozigar	vivozigar
vizajo	vizadʒo
vizajo	vizaʒo
vizar	vizar
voco	votso
volar	volar
volas	volas
volfi	volfi
volfo	volfo
volkano	volkano
voluntar	voluntar
voluntar	vɔluntaɾ
voluntez	voluntɛs
voluntez	voluntɛz
volus	volus
volvar	vɔlvar
vomar	vomar
vortari	vortari
vortaro	vɔrtaro
vorticar	vortitsar
vortico	vortitso
vorto	vɔrto
vortolibri	vortolibri
vortolibro	vɔrtolibro
vortoludo	vortoludo
votar	votar
votas	votas
votez	votɛs
votez	votɛz
votis	votis
votos	votɔs
votus	votus
vovar	vovar
voyeti	vojeti
vu	vu
vua	vua
vulgara	vulgara
vulturo	vulturo
vundas	vundas
vundis	vundis
vundos	vundɔs
vundus	vundus
w	w
w	we
we	we
we	wɛ
weldar	weldar
weldez	weldɛs
weldez	weldɛz
weldos	weldɔs
westo	westo
wikipedio	wikipedi̯o
wikivortaro	wikivortaro
wiskio	wiski̯o
x	ks
x	kse
xe	kse
xe	ksɛ
y	j
y	je
ya	ja
yarala	jarala
yarale	jarale
yari	jari
yarmili	jarmili
yarmilo	jarmilo
yaro	jaro
ye	je
ye	jɛ
yen	jɛn
yes	jes
yogurto	jogurto
yuna	juna
yurizar	jurizar
yuro	juro
yusta	justa
z	z
z	ze
ze	ze
ze	zɛ
zefiri	zefiri
zefiro	zefiro
zeloza	zeloza
zero	zero
zezear	zezear
zigomati	zigomati
zigomato	zigomato
zinko	zinko
