bana	bana
boikanyego	boikxanɛɣo
boikarabelo	boikxarabɛlo
boikgogomosô	boikxoxomosô
boikokobetso	boikxokobɛtso
boitshepo	boitsʰɛpo
boitshwarelo	boitsʰʷarɛlo
boitumelo	boitumelo
dijo	didʒo
diphaphatha	dipʰapʰatʰa
kgomo	kxomo
leihlo	leihlo
letsatsi	lɛtsatsi
mariga	mariga
metsi	mɛtsi
mme	mːɛ
monna	mɔnːa
mosadi	mosadi
motho	motʰo
nakò	nakò
ngaka	ŋaka
ntlo	ntɬo
pula	pula
rre	rːɛ
seatla	sɛatɬa
sefate	sefate
thaba	tʰaba
