ក	kɑː
កក	kɑːʔ
កករ	kɑkɑː
កកាយ	kɑkaːj
កកិត	kɑkət
កកិល	kɑkəl
កកូរ	kɑkou
កកេរ	kɑkeː
កកេះ	kɑkeh
កក់	kɑʔ
កក្កដា	kaʔkəɗaː
កខុប	kɑkʰop
កខ្វក់	kɑʔʋɑʔ
កង	kɑːŋ
កង់	kɑŋ
កង់បេរ៉ា	kɑŋɓeːraː
កង់ស៊ែរ	kɑŋsɛː
កង់ហ្គូរូ	kɑŋguːruː
កង្កែប	kɑŋkaep
កង្ខា	kaŋkʰaː
កង្ខើញ	kɑŋkʰaəɲ
កង្វល់	kɑŋʋɑl
កង្វិន	kɑŋʋən
កង្វះ	kɑŋʋah
កង្ហារ	kɑŋhaː
កង្ហែន	kɑŋhaen
កញ្ចក់	kɑɲcɑʔ
កញ្ចប់	kɑɲcɑp
កញ្ចាស់	kɑɲcah
កញ្ចុះ	kɑɲcoh
កញ្ចែ	kɑɲcae
កញ្ឆា	kɑɲcʰaː
កញ្ឆែត	kɑɲcʰaet
កញ្ជួ	kɑɲcuə
កញ្ជើ	kɑɲcəː
កញ្ជះ	kɑɲcĕəh
កញ្ជ្រឹល	kɑɲcrɨl
កញ្ជ្រួច	kɑɲcruəc
កញ្ជ្រោង	kɑɲcroːŋ
កញ្ញា	kaɲɲaː
កដិពន្ធ	kaʔɗepŏən
កដ្ឋមណ្ឌូ	kɑːɗmɑːnɗuː
កណិការ	kɑːnekaː
កណ្ដក	kɑnɗɑʔ
កណ្ដាប់	kɑnɗap
កណ្ដាល	kɑnɗaːl
កណ្ដាស់	kɑnɗah
កណ្ដឹង	kɑnɗəŋ
កណ្ដុក	kɑnɗok
កណ្ដុរ	kɑnɗol
កណ្ដូប	kɑnɗoup
កណ្ដួយ	kɑnɗuəj
កណ្ដៀង	kɑnɗiəŋ
កណ្ដៀត	kɑnɗiət
កណ្ដៀរ	kɑnɗiə
កណ្ដៀវ	kɑnɗiəw
កណ្ដោល	kɑnɗaol
កណ្ឌ	kan
កតញ្ញុតា	kaʔtaɲɲutaː
កតវេទី	kaʔtaʔʋeitiː
កតិកា	kaʔtekaː
កត់	kɑt
កត្តា	kɑttaː
កត្តិក	katɗək
កថា	kaʔtʰaː
កថិន	kɑtʰən
កន	kɑːn
កនិដ្ឋ	kaʔnɨt
កនិដ្ឋា	kaʔnɨttʰaː
កន្តាំង	kɑntaŋ
កន្ត្រង	kɑntrɑːŋ
កន្ត្រៃ	kɑntraj
កន្ទក់	kɑntŭəʔ
កន្ទប	kɑntɔːp
កន្ទល់	kɑntŭəl
កន្ទុយ	kɑntuj
កន្ទួត	kɑntuət
កន្ទេល	kɑnteil
កន្ទោង	kɑntoːŋ
កន្ធរ	kɑntʰɔː
កន្យា	kanjaː
កន្លង	kɑnlɑːŋ
កន្លាត	kɑnlaːt
កន្លាស់	kɑnlah
កន្លុក	kɑnlok
កន្លេង	kɑnleːŋ
កន្លែង	kɑnlaeŋ
កន្លះ	kɑnlah
កន្សែង	kɑnsaeŋ
កន្សោម	kɑnsaom
កន្សោមពាក្យ	kɑnsaompiəʔ
កប	kɑːp
កប៉ាល់	kaʔpal
កប៉ៅ	kɑpaw
កប់	kɑp
កប៌ូរ	kaːɓou
កប្បាស	kɑpɓaːh
កម	kɑːm
កមល	kaʔmɑl
កម្ចី	kɑmcəj
កម្ជិល	kɑmcɨl
កម្ញី	kammɲəj
កម្ពស់	kɑmpŭəh
កម្ពុជ	kɑmpuc
កម្ពុជា	kampuciə
កម្ពោជិក	kɑmpoːcɨk
កម្ម	kam
កម្មករ	kamkɑː
កម្មដ្ឋាន	kammattʰaːn
កម្មន្ត	kammɑntaʔ
កម្មន្តសាល	kammɑnnɔsaːl
កម្មបទ	kamɓɑt
កម្មវិធី	kamʋitʰiː
កម្មាធិការ	kammaːtʰikaː
កម្រង	kɑmrɑːŋ
កម្រៃ	kɑmraj
កម្រោល	kɑmraol
កម្លាំង	kɑmlaŋ
កម្សាន្ត	kɑmsaːn
ករ	kɑː
ករណី	kaʔraʔnəj
ករណីយកិច្ច	kɑːrnəjkəc
ករុណា	kaʔrunaː
កល	kɑl
កលហ	kaʔlaʔhaʔ
កលាប	kaʔlaːp
កលិយុគ	kɑllijuk
កល់	kɑl
កល្យាណ	kɑljaːn
កវកាប្យ	kaʔʋĕəʔkaːp
កវី	kaʔʋəj
កសិកម្ម	kaʔsekam
កសិករ	kaʔsekɑː
កសិដ្ឋាន	kaʔsəttʰaːn
កសិណ	kaʔsən
កសិណសាក្សី	kaʔsənsaksəj
កស្បូន	kɑsɓoun
កាក	kaːʔ
កាកបាទ	kaʔkɑɓaːt
កាក់	kaʔ
កាង	kaːŋ
កាច	kaːc
កាចុង	kaːcoŋ
កាច់	kac
កាញ់	kaɲ
កាដូលីញ៉ូម	kaːɗouliːɲoum
កាណាដា	kaːnaːɗaː
កាណុង	kaːnoŋ
កាណូត	kaːnout
កាណ៌	kaː
កាត	kaːt
កាតា	kaːtaː
កាតាំង	kaːtaŋ
កាតឹប	kaːtəp
កាតូត	kaːtout
កាតូលិក	kaːtoulɨk
កាតែត	kaːtaet
កាត់	kat
កាត់ត	kattɑː
កាត់ម្យូម	katmjuːm
កាន់	kan
កាន់សាស់	kansah
កាប	kaːp
កាបូន	kaːɓoun
កាបូប	kaːɓoup
កាបូអ៊ីដ្រាត	kaːɓouʔiːɗraːt
កាប៊ុល	kaːɓul
កាប់	kap
កាប់វែរ	kapʋɛː
កាប៌ាស	kaːɓaːh
កាពិ	kaːpiʔ
កាព្យ	kaːp
កាម	kaːm
កាមគុណ	kaːmmĕəʔkun
កាមសុខ	kaːmĕəʔsok
កាមីញ៉ុង	kaːmiːɲoŋ
កាមេរូន	kaːmeiruːn
កាមេរ៉ា	kaːmeiraː
កាយ	kaːj
កាយវិការ	kaːjʋikaː
កាយ៉ាក់	kaːjaʔ
ការ	kaː
ការចរចា	kaːcɑːcaː
ការណដ្ឋាន	kaːraʔnaʔtʰaːn
ការណ៍	kaː
ការតុង	kaːtoŋ
ការន្ត	kaːrɑn
ការបោន	kaːɓaon
ការប្រកាស	kaːprɑːkaːh
ការអុក	kaːʔok
ការាត់	kaːrat
ការិនី	kaːrenəj
ការិយកម្ម	kaːrejaʔkam
ការិយកិច្ច	kaːrejaʔkəc
ការិយាធិបតេយ្យ	kaːrejaːtʰipaʔtaj
ការិយាល័យ	kaːrijaːlaj
ការី	kaːriː
ការី	kaːrəj
ការុង	kaːroŋ
ការ៉ុត	kaːrot
ការ៉ូ	kaːrou
ការ៉េ	kaːreː
ការ៉េម	kaːreːm
កាល	kaːl
កាលកិរិយា	kaːlkerejaː
កាលប្រវត្តិ	kaːlaʔprɑʋŏət
កាលីហ្វ័រញ៉ា	kaːliːhʋŏəɲaː
កាលៈទេសៈ	kaːlaʔteisaʔ
កាល់ស្យូម	kalsjoum
កាល្យូម	kaːljuːm
កាវ	kaːw
កាសិត	kaːsət
កាសែត	kaːsaet
កាស៊ីណូ	kaːsiːnou
កាហែ	kaːhae
កាហ្វេ	kaːfeː
កាហ្វេអ៊ីន	kaːfeːʔiːn
កាហ្សាក់ស្ថាន	kaːzakstʰaːn
កាឡាក់ស៊ី	kaːlaksiː
កាឡូរី	kaːlouriː
កាំ	kam
កាំង	kaŋ
កាំជ្រួច	kamcruəc
កាំបិត	kamɓət
កាំភ្លើង	kampləːŋ
កាំរស្មី	kamrĕəʔsməj
កិង	kəŋ
កិច្ច	kəc
កិច្ចការ	kəckaː
កិត្តិ	kətteʔ
កិត្តិគុណ	kəttekun
កិត្តិយស	kəttejɔːh
កិន	kən
កិប	kəp
កិរិយា	kerijaː
កិរិយាសព្ទ	kerijaːsap
កិរិយាស័ព្ទ	kerijaːsap
កិរ្តិ៍	keː
កិល	kəl
កិលេស	keleːh
កី	kəj
កីឡា	kəjlaː
កីឡាករ	kəjlaːkɑː
កីឡាដ្ឋាន	kəjlaːtʰaːn
កឹង	kəŋ
កឹម	kəm
កឹះ	kəh
កឺ	kəɨ
កុង	koŋ
កុងតាក់	koŋtaʔ
កុងទ័រ	koŋtŏə
កុងស៊ុល	koŋsul
កុងហ្គោ	koŋgoː
កុងអាន	koŋʔaːn
កុង្សីយ៍	koŋsəj
កុញ	koɲ
កុញ្ចែ	koɲcae
កុដធារិកា	kottʰiərikaː
កុដិ	kot
កុណ្ឌល	konɗŭəl
កុន	kon
កុបកម្ម	kopaʔkam
កុបករ	kopaʔkɑː
កុមារ	komaː
កុមារភាព	komaːpʰiəp
កុមារី	komaːrəj
កុម្ពណ្ឌ	kompŭən
កុម្ភការ	kompʰĕəʔkaː
កុម្ភការី	kompʰĕəʔkaːrəj
កុម្ភៈ	kompʰĕəʔ
កុម្មុយនិស្ត	kommujnɨh
កុម្ម៉ង់	kommɑŋ
កុរ	kol
កុលវគ្គ	kolaʔʋĕəʔ
កុលសម័្ពន្ធ	kolsampŏən
កុលាប	kolaːp
កុសល	kosɑl
កុហក	kohɑʔ
កុឡា	kolaː
កុំ	kom
កុំព្យូទ័រ	kompʰjuːtŏə
កូកាកូឡា	koukaːkoulaː
កូដកម្ម	kouɗaʔkam
កូត	kout
កូតង់សង់	koutɑŋsɑŋ
កូតឌីវ័រ	koutɗiːʋŏə
កូតា	koutaː
កូន	koun
កូប	koup
កូបាល	kouɓaːl
កូប៉ិនហាក	koupənhaːʔ
កូម័រ	koumŏə
កូយ	kouj
កូរ	kou
កូរ៉ាន	kouraːn
កូរ៉េ	koureː
កូលេស្តេរ៉ុល	kouleisteːrol
កូវ	kəw
កូវ៉ាឡង់	kouʋaːlɑŋ
កូសាំងស៊ីន	kousaŋsiːn
កូសូវ៉ូ	kousouʋou
កូសេកង់	kouseːkɑŋ
កូស៊ីនុស	kousiːnuh
កូស្តារីកា	koustaːriːkaː
កូឡា	koulaː
កូឡាឡាំពួរ	koulaːlampuə
កូឡុំ	koulom
កូឡុំបូ	koulomɓou
កូឡុំប៊ី	koulomɓiː
កូឡូរ៉ាដូ	koulouraːɗou
កូអង់ស៊ីម	kouʔɑŋsiːm
កួច	kuəc
កួត	kuət
កួរ	kuə
កើ	kaə
កើត	kaət
កើន	kaən
កៀង	kiəŋ
កៀច	kiəc
កៀប	kiəp
កៀស	kiəh
កៀហ្ស៊ីស៊ីស្ថាន	kiəziːsiːstʰaːn
កេង	keːŋ
កេតុ	keːtoʔ
កេនតាក់គី	keːntaʔkiː
កេនយ៉ា	keːnjaː
កេបិច	keːɓəc
កេរ៉ាទីន	keːraːtiːn
កេរ្តិ៍	keː
កេស	keːh
កេសនា	keːsaʔnaː
កេសរ	keːsɑː
កេះ	keh
កែ	kae
កែង	kaeŋ
កែប	kaep
កែភេទ	kaepʰeit
កែម	kaem
កែលវិន	kaelʋɨn
កែវ	kaew
កែស	kaeh
កែះ	kaeh
កៃ	kaj
កៃរ៉ូ	kajrou
កៃឡាត់	kajlat
កោង	kaoŋ
កោដិ	kaot
កោដ្ឋ	kaot
កោណ	kaon
កោណន្ត	kaonɑn
កោន	kaon
កោមល	kaomɑl
កោរ	kao
កោរីល	kaoriːl
កោស	kaoh
កោសិកា	kaosekaː
កោះ	kɑh
កៅទណ្ឌ	kawtŏən
កៅយក់	kawjŭəʔ
កៅស៊ូ	kawsuː
កៅឡា	kawlaː
កៅឡាក់	kawlaʔ
កៅអី	kawʔəj
កំចាត់	kɑmcat
កំជាប់	kɑmcŏəp
កំញម	kɑmɲɑːm
កំញាន	kɑmɲaːn
កំញើញ	kɑmɲaəɲ
កំដរ	kɑmɗɑː
កំដៅ	kɑmɗaw
កំណក	kɑmnɑːʔ
កំណត់	kɑmnɑt
កំណប់	kɑmnɑp
កំណាច	kɑmnaːc
កំណាញ់	kɑmnaɲ
កំណាត់	kɑmnat
កំណាន់	kɑmnan
កំណាព្យ	kɑmnaːp
កំណាយ	kɑmnaːj
កំណារ	kɑmnaː
កំណើត	kɑmnaət
កំណើន	kɑmnaən
កំណៀច	kɑmniəc
កំណែ	kɑmnae
កំណោង	kɑmnaoŋ
កំបត់	kɑmɓɑt
កំបាក់	kɑmɓaʔ
កំបាំង	kɑmɓaŋ
កំបោរ	kɑmɓao
កំប៉ង់	kɑmpoŋ
កំប៉ុង	kɑmpoŋ
កំប្រុក	kɑmprok
កំប្លែង	kɑmpʰlaeŋ
កំប្លោក	kɑmpʰlaok
កំផើម	kɑmpʰaəm
កំពង់	kɑmpŭəŋ
កំពត	kɑmpɔːt
កំពប់	kɑmpup
កំពស់	kɑmpŭəh
កំពីង	kɑmpiːŋ
កំពឹស	kɑmpɨh
កំពុក	kɑmpuk
កំពុង	kɑmpuŋ
កំពូល	kɑmpuːl
កំពែង	kɑmpɛːŋ
កំព្រា	kɑmpriə
កំព្រឹស	kɑmprɨh
កំភរ	kɑmpʰɔː
កំភូត	kɑmpʰuːt
កំភួន	kɑmpʰuən
កំភេម	kɑmpʰeim
កំភ្លាញ	kɑmpʰliəɲ
កំភ្លឹង	kɑmpʰlɨŋ
កំរ	kɑmrɑː
កំរង	kɑmrɑːŋ
កំរប	kɑmrɑːp
កំរាល	kɑmraːl
កំរាស់	kɑmrah
កំរិត	kɑmrɨt
កំរៀម	kɑmriəm
កំរេប	kɑmreːp
កំរោល	kɑmraol
កំលាំង	kɑmlaŋ
កំលោះ	kɑmlɑh
កំលៅ	kɑmlɨw
កំសាក	kɑmsaːʔ
កំសាន្ត	kɑmsaːn
កំសៀវ	kɑmsiəw
កំហាត់	kɑmhat
កំហិត	kɑmhət
កំហឹង	kɑmhəŋ
កំហុស	kɑmhoh
កំហែង	kɑmhaeŋ
កំអួត	kɑmʔuət
កំអែល	kɑmʔael
ក៏	kɑː
ក្ងាន	kŋaːn
ក្ងោក	kŋaok
ក្ដ	kɗɑː
ក្ដក់	kɗɑʔ
ក្ដាត	kɗaːt
ក្ដាប់	kɗap
ក្ដាម	kɗaːm
ក្ដារ	kɗaː
ក្ដាំងងា	kɗaŋŋiə
ក្ដិច	kɗəc
ក្ដិត	kɗət
ក្ដួច	kɗuəc
ក្ដោង	kɗaoŋ
ក្ដៅ	kɗaw
ក្តី	kɗəj
ក្តុក	kɗok
ក្ទម្ព	kʰtɔːm
ក្នាញ់	kʰnaɲ
ក្នាត់	kʰnat
ក្នុង	kʰnoŋ
ក្បត់	kɓɑt
ក្បាច់	kɓac
ក្បាល	kɓaːl
ក្បាំង	kɓaŋ
ក្បិត	kɓət
ក្បុង	kɓoŋ
ក្បូន	kɓoun
ក្បួន	kɓuən
ក្បឿង	kɓɨəŋ
ក្បៀស	kɓiəh
ក្បែរ	kɓae
ក្មួយ	kʰmuəj
ក្មេក	kʰmeːk
ក្មេង	kʰmeːŋ
ក្រ	krɑː
ក្រក	krɑːʔ
ក្រខ្វក់	krɑʔʋɑʔ
ក្រចក	krɑcɑːʔ
ក្រចាប់	krɑcap
ក្រចាស	krɑcaːh
ក្រចើល	krɑcaəl
ក្រចេះ	krɑceh
ក្រចៅ	krɑcaw
ក្រញរ	krɑɲɑː
ក្រញាញ់	krɑɲaɲ
ក្រញាំ	krɑɲam
ក្រញី	krɑɲiː
ក្រញូង	krɑɲuːŋ
ក្រញូស	krɑɲouh
ក្រដាស	krɑɗaːh
ក្រណាត់	krɑnat
ក្រប	krɑːp
ក្របី	krɑɓəj
ក្របូប	krɑɓoup
ក្រពុល	krɑpul
ក្រពើ	krɑpəː
ក្រពេញ	krɑpɨɲ
ក្រពះ	krɑpĕəh
ក្រម	krɑm
ក្រមរ	krɑmɑː
ក្រមា	krɑmaː
ក្រមារ	krɑmaː
ក្រមី	krɑməj
ក្រមុំ	krɑmum
ក្រមួន	krɑmuən
ក្រលៀន	krɑliən
ក្រវង់	krɑʋŭəŋ
ក្រវាត់	krɑʋat
ក្រវិល	krɑʋəl
ក្រសាន	krɑsaːn
ក្រសារ	krɑsaː
ក្រសាំង	krɑsaŋ
ក្រសាំងទាប	krɑːsaŋtiəp
ក្រសួង	krɑsuəŋ
ក្រស្នា	krɑsnaː
ក្រហម	krɑhɑːm
ក្រឡាន	krɑlaːn
ក្រឡាប់	krɑlap
ក្រឡាស់	krɑlah
ក្រឡុក	krɑlok
ក្រឡេច	krɑləc
ក្រអូប	krɑʔoup
ក្រាក់	kraʔ
ក្រាន	kraːn
ក្រាប	kraːp
ក្រាប់	krap
ក្រាម	kraːm
ក្រាមរមាស	kraːmrɔːmiəh
ក្រាល	kraːl
ក្រាវាត់	kraːʋat
ក្រាស	kraːh
ក្រាស់	krah
ក្រាហ្វ	kraːp
ក្រាំង	kraŋ
ក្រិក	krəc
ក្រិត	krət
ក្រឹម	krəm
ក្រឹស	krəh
ក្រុកៗ	krokkrok
ក្រុង	kroŋ
ក្រុត	krot
ក្រុម	krom
ក្រូច	krouc
ក្រូម	kroum
ក្រូម៉ាទីន	kroumaːtiːn
ក្រូម៉ូសូម	kroumousoum
ក្រូអាស៊ី	krouʔaːsiː
ក្រួច	kruəc
ក្រួស	kruəh
ក្រៀប	kriəp
ក្រៀម	kriəm
ក្រៀល	kriəl
ក្រេប	kreːp
ក្រេម	kreːm
ក្រែង	kraeŋ
ក្រែម	kraem
ក្រៃ	kraj
ក្រោក	kraok
ក្រោម	kraom
ក្រោយ	kraoj
ក្រោះ	krɑh
ក្រៅ	kraw
ក្រៅពី	krawpiː
ក្លង់	kʰlɑŋ
ក្លន	kʰlɑːn
ក្លរ	kʰlɑː
ក្លា	kʰlaː
ក្លាយ	kʰlaːj
ក្លាវ	kʰlaːw
ក្លាំពូ	kʰlampuː
ក្លិន	kʰlən
ក្លឹប	kʰləp
ក្លើ	kʰlaə
ក្លៀក	kʰliəʔ
ក្លែង	kʰlaeŋ
ក្លែម	kʰlaem
ក្វាតេម៉ាឡា	kʰʋaːteːmaːlaː
ក្សត្រ	kʰsat
ក្សត្រិយានី	kʰsatrejaːniː
ក្សត្រិយ៍	kʰsat
ក្សាន្ត	kʰsaːn
ក្សេត្រ	kʰseːt
ក្សេត្រវិទ	kʰseːtraʔʋɨt
ក្សេត្រវិទ្យា	kʰseːtraʔʋitʰjiə
ក្ស័ត្រ	kʰsat
ក្ស័យ	kʰsaj
ក្អក	kʔɑːʔ
ក្អម	kʔɑːm
ក្អាត់	kʔat
ក្អុក	kʔok
ក្អួត	kʔuət
ក្អេក	kʔeːk
ក្អែក	kʔaek
ក្អែប	kʔaep
ក្អែល	kʔael
ខ	kʰɑː
ខក	kʰɑːʔ
ខក់	kʰɑʔ
ខខិត	kʰɑkʰət
ខណៈ	kʰaʔnaʔ
ខណ្ឌ	kʰan
ខត្តិវង្ស	kʰatteʋŭəŋ
ខន	kʰɑːn
ខនិជ	kʰɑnɨc
ខន្តី	kʰɑntəj
ខន្ធ	kʰan
ខម	kʰɑːm
ខមាទោស	kʰɑːmiətoːh
ខាក	kʰaːʔ
ខាង	kʰaːŋ
ខាត	kʰaːt
ខាត់	kʰat
ខាត់ណា	kʰatnaː
ខាទុំ	kʰaːtum
ខាន	kʰaːn
ខាន់	kʰan
ខាន់ស្លាក់	kʰanslaʔ
ខាប់	kʰap
ខាយ	kʰaːj
ខារ	kʰaː
ខារ៉ាអូខេ	kʰaːraːʔoukʰeː
ខាល	kʰaːl
ខាំ	kʰam
ខិក	kʰək
ខិត	kʰət
ខិត្តវិទ្យា	kʰəttaʔʋɨtjiə
ខិម	kʰəm
ខឹង	kʰəŋ
ខុន	kʰon
ខុននិចធីខិត	kʰonnɨctʰiːkʰət
ខុស	kʰoh
ខូគី	kʰoukiː
ខូច	kʰouc
ខូវប៊	kʰəwɓɔː
ខួង	kʰuəŋ
ខួប	kʰuəp
ខួរ	kʰuə
ខៀន	kʰiən
ខៀវ	kʰiəw
ខេត្ត	kʰaet
ខេមរ	kʰeːmaʔraʔ
ខេមរៈ	kʰeːmaʔraʔ
ខែ	kʰae
ខែក	kʰaek
ខែង	kʰaeŋ
ខែល	kʰael
ខោ	kʰao
ខោល	kʰaol
ខោវប៊យ	kʰaowɓɔːj
ខំ	kʰɑm
ខះ	kʰah
ខ្ចប់	kʰcɑp
ខ្ចាត់	kʰcat
ខ្ចាយ	kʰcaːj
ខ្ចី	kʰcəj
ខ្ចោះ	kʰcɑh
ខ្ចៅ	kʰcaw
ខ្ជាក់	kʰcĕəʔ
ខ្ជាប់	kʰcŏəp
ខ្ជាយ	kʰciəj
ខ្ជិល	kʰcɨl
ខ្ញម	kɲɑːm
ខ្ញាំ	kɲam
ខ្ញី	kɲəj
ខ្ញុំ	kɲom
ខ្ញែរ	kɲae
ខ្ទង់	kʰtŭəŋ
ខ្ទប	kʰtɔːp
ខ្ទម	kʰtɔːm
ខ្ទិះ	kʰtih
ខ្ទឹង	kʰtɨŋ
ខ្ទឹម	kʰtɨm
ខ្ទឹមខ្យល់	kʰtɨmkjɑl
ខ្ទុតដី	kʰtutɗəj
ខ្ទុះ	kʰtuh
ខ្ទួយ	kʰtuəj
ខ្ទើយ	kʰtəːj
ខ្ទេច	kʰtɨc
ខ្ទះ	kʰtĕəh
ខ្នង	kʰnɑːŋ
ខ្នាត	kʰnaːt
ខ្នាយ	kʰnaːj
ខ្នារ	kʰnaː
ខ្នុរ	kʰnol
ខ្នួច	kʰnuəc
ខ្នើត	kʰnaət
ខ្នើយ	kʰnaəj
ខ្នែង	kʰnaeŋ
ខ្នោះ	kʰnɑh
ខ្ពង់	kpŭəŋ
ខ្ពស់	kpŭəh
ខ្ពុរ	kpuː
ខ្ពើម	kpəːm
ខ្មង	kʰmɑːŋ
ខ្មាស	kʰmaːh
ខ្មាំង	kʰmaŋ
ខ្មុល	kʰmol
ខ្មួញ	kʰmuəɲ
ខ្មួរ	kʰmuə
ខ្មេរ	kʰmeː
ខ្មេះ	kʰmeh
ខ្មែរ	kʰmae
ខ្មែរូបនីយកម្ម	kʰmaeruːpaʔniːjĕəʔkam
ខ្មោច	kʰmaoc
ខ្មៅ	kʰmaw
ខ្យង	kjɑːŋ
ខ្យល់	kjɑl
ខ្លា	kʰlaː
ខ្លាច	kʰlaːc
ខ្លាញ់	kʰlaɲ
ខ្លាំង	kʰlaŋ
ខ្លី	kʰləj
ខ្លឹម	kʰləm
ខ្លុយ	kʰloj
ខ្លូត	kʰlout
ខ្លួន	kʰluən
ខ្លែង	kʰlaeŋ
ខ្លៅ	kʰlaw
ខ្លះ	kʰlah
ខ្វង់	kʰʋɑŋ
ខ្វល់	kʰʋɑl
ខ្វាក់	kʰʋaʔ
ខ្វាន់	kʰʋan
ខ្វាម	kʰʋaːm
ខ្វិត	kʰʋət
ខ្វិន	kʰʋən
ខ្វៀរ	kʰʋiə
ខ្វែក	kʰʋaek
ខ្វែង	kʰʋaeŋ
ខ្វែវ	kʰʋaew
ខ្វះ	kʰʋah
ខ្សត់	kʰsɑt
ខ្សាច់	kʰsac
ខ្សឹប	kʰsəp
ខ្សុយ	kʰsoj
ខ្សៀ	kʰsiə
ខ្សៀវ	kʰsiəw
ខ្សែ	kʰsae
ខ្សែអាត់	kʰsaeʔat
ខ្សោយ	kʰsaoj
គ	kɔː
គក់	kŭəʔ
គគីរ	kɔkiː
គគ្រាត	kɔkriət
គង	kɔːŋ
គង់	kŭəŋ
គង្គ	kŭəŋkĕəʔ
គង្គា	kŭəŋkiə
គង្វាល	kŭəŋʋiəl
គជ	kĕəʔcĕəʔ
គជ់	kŭəc
គណ	kŭən
គណនា	kĕəʔnaʔniə
គណនី	kĕəʔnaʔniː
គណនីយដ្ឋាន	kĕəʔnaʔniːjattʰaːn
គណនេយ្យ	kŭənnaʔnɨj
គណនេយ្យករ	kŭənnaʔnɨjkɑː
គណន៍	kŭən
គណបក្ស	kĕəʔnaʔpaʔ
គណិត	kĕəʔnetaʔ
គណិតវិទ្យា	kĕəʔnetaʔʋɨtjiə
គណិតសាស្ត្រ	kĕəʔnetaʔsaːh
គណៈ	kĕəʔnaʔ
គណៈបេសកកម្ម	kĕəʔnaʔpeːsaʔkaʔkam
គណៈប្រតិភូ	kĕəʔnaʔprɑtepʰuː
គតិ	kĕəʔteʔ
គត់	kŭət
គន់	kŭən
គន្ថការ	kŭəntʰaʔkaː
គន្ធ	kŭən
គន្ធរស	kŏəntʰĕəʔrŭəh
គន្លង	kŭənlɔːŋ
គន្លាក់	kŭənlĕəʔ
គន្លឹះ	kŭənlɨh
គប់	kup
គភ៌	kŏə
គមនាគមន៍	kumməniəkum
គម្ដែង	kumɗaeŋ
គម្ពីរ	kumpiː
គម្យស្ថាន	kĕəʔmjĕəʔstʰaːn
គម្រាម	kumriəm
គម្រោង	kumroːŋ
គម្លាត	kumliət
គយ	kɔːj
គរ	kɔː
គរុ	kĕəʔruʔ
គល់	kŭəl
គល់រាំង	kŭəlrĕəŋ
គហណសាល	kĕəʔhaʔnaʔsaːl
គហបតី	kĕəʔhaʔpaʔɗəj
គាត់	kŏət
គាថា	kiətʰaː
គាប	kiəp
គាប់	kŏəp
គារវរូប	kiərĕəʔʋĕəʔruːp
គារវៈ	kiərĕəʔʋĕəʔ
គាវ	kiəw
គាវុត	kiəʋut
គាំ	kŏəm
គាំង	kĕəŋ
គិញ	kɨɲ
គិត	kɨt
គិម	kɨm
គិម្ហន្ត	kɨmhɑn
គិរី	kiriː
គិល	kɨl
គិលាន	kiliən
គិលានុបដ្ឋាក	kiliənupattʰaːʔ
គិលានុបដ្ឋាន	kiliənupattʰaːn
គិលានុបដ្ឋាយិកា	kiliənupattʰaːjikaː
គី	kiː
គីង្គក់	kiːŋkŭəʔ
គីតា	kiːtaː
គីតិកា	kiːtekaː
គីតូ	kiːtou
គីតេកា	kiːteːkaː
គីម	kiːm
គីមឈី	kiːmcʰiː
គីមបាប	kiːmɓaːp
គីមី	kiːmiː
គីម៉ូណូ	kiːmounou
គីស	kiːh
គីហ្កាលី	kiːgaːliː
គីឡូ	kiːlou
គីឡូក្រាម	kiːloukraːm
គីឡូម៉ែត្រ	kiːloumaet
គីឡូវ៉ាត់	kiːlouʋat
គឹម	kɨm
គឺ	kɨː
គុក	kuk
គុណ	kun
គុណធម៌	kunnaʔtʰŏə
គុណនាម	kunaʔniəm
គុណភាព	kunaʔpʰiəp
គុត	kut
គុន	kun
គុន្ធា	kuntʰiə
គុយ	kuj
គុយបា	kujɓaː
គុយវ៉ែត	kujʋaet
គុលិកា	kulikaː
គុហា	kuhiə
គុំ	kum
គូ	kuː
គូឆាយ	kuːcʰaːj
គូត	kuːt
គូថ	kuːt
គូទ	kuːt
គូធ	kuːt
គូប	kuːp
គូរ	kuː
គូលី	kuːliː
គូលែន	kuːlɛːn
គូស	kuːh
គូឡុំ	kuːlom
គួច	kuəc
គួរ	kuə
គៀវ	kiəw
គេ	kei
គេង	keiŋ
គេច	kɨc
គេហជន	keihaʔcŭən
គេហសាមិនី	keihaʔsaːminiː
គេហ៍	kei
គែ	kɛː
គែន	kɛːn
គែប	kɛːp
គែម	kɛːm
គែរ	kɛː
គៃ	kɨj
គោ	koː
គោក	koːk
គោឃាតក៍	koːkʰiət
គោឃាតដ្ឋាន	koːkʰiətattʰaːn
គោចរ	koːcɑː
គោតម	koːɗɑːm
គោត្រកូល	koːttraʔkoul
គោម	koːm
គោរព	koːrup
គោល	koːl
គោលិកា	koːlikaː
គោះ	kŭəh
គំនង់	kumnŭəŋ
គំនន់	kumnŭən
គំនរ	kumnɔː
គំនាប	kumniəp
គំនាប់	kumnŏəp
គំនិត	kumnɨt
គំនុំ	kumnum
គំនូរ	kumnuː
គំនូស	kumnuːh
គំរប	kumrɔːp
គំរប់	kumrup
គំរាម	kumriəm
គំរឹល	kumrɨl
គំរូ	kumruː
គំរោង	kumroːŋ
គំលាត	kumliət
គំលាន	kumliən
គំហាត់	kumhat
គំហើញ	kumhəːɲ
គ្នា	kʰniə
គ្មាន	kʰmiən
គ្រ	krɔː
គ្រង	krɔːŋ
គ្រញិច	krɔɲɨc
គ្រន្ថី	krŭəntʰəj
គ្រប	krɔːp
គ្រប់	krup
គ្រវែង	krɔʋɛːŋ
គ្រហស្ថ	krɔhŏəh
គ្រហុប	krɔhop
គ្រាន់	krŏən
គ្រាប់	krŏəp
គ្រាម	kriəm
គ្រាស	kriəh
គ្រាំ	krŏəm
គ្រិស្ត	krɨh
គ្រិស្ទាន	kristiən
គ្រី	kriː
គ្រីប	kriːp
គ្រីបតុង	kriːptoŋ
គ្រីមៀ	kriːmiə
គ្រឹប	krɨp
គ្រឹះ	krɨh
គ្រឹះស្ថាន	krɨhstʰaːn
គ្រុឌ	krut
គ្រុន	krun
គ្រូ	kruː
គ្រួសារ	kruəsaː
គ្រឿង	krɨəŋ
គ្រែ	krɛː
គ្រោង	kroːŋ
គ្រោះ	krŭəh
គ្រំ	krum
គ្លុយកូស	kʰlujkouh
គ្វាម	kʰʋiəm
ឃ	kʰɔː
ឃរ	kʰɔː
ឃរណី	kʰɔnəj
ឃាង	kʰiəŋ
ឃាត	kʰiət
ឃាត់	kʰŏət
ឃាន	kʰiən
ឃាំង	kʰĕəŋ
ឃិន	kʰɨn
ឃិនឆាយ	kʰɨncʰaːj
ឃីម	kʰiːm
ឃឹម	kʰɨm
ឃុន	kʰun
ឃុំ	kʰum
ឃើញ	kʰəːɲ
ឃោរ	kʰoː
ឃោរឃៅ	kʰoːkʰɨw
ឃោស	kʰoːsaʔ
ឃោសនា	kʰoːsaʔnaː
ឃោស្នា	kʰoːsnaː
ឃ្នាង	kʰniəŋ
ឃ្នាប	kʰniəp
ឃ្នូស	kʰnuːh
ឃ្មុំ	kʰmum
ឃ្លង់	kʰlŭəŋ
ឃ្លា	kʰliə
ឃ្លាត	kʰliət
ឃ្លាន	kʰliən
ឃ្លាំង	kʰlĕəŋ
ឃ្លី	kʰliː
ឃ្លេ	kʰlei
ឃ្លោក	kʰloːk
ឃ្លោង	kʰloːŋ
ង	ŋɔː
ងងឹត	ŋɔŋɨt
ងងុយ	ŋɔŋuj
ងប់	ŋup
ងាក	ŋiəʔ
ងាប់	ŋŏəp
ងាយ	ŋiəj
ងារ	ŋiə
ងាវ	ŋiəw
ងូត	ŋuːt
ងើត	ŋəːt
ងើប	ŋəːp
ងៀត	ŋiət
ង៉ា	ŋaː
ង៉ាវ	ŋaːw
ង៉ាវៗ	ŋaːwŋaːw
ង៉ែត	ŋaet
ច	cɑː
ចក្ខុ	caʔkʰoʔ
ចក្រ	caʔ
ចក្រពត្តិ	caʔkraʔpŏət
ចក្រភព	caʔkɑpʰup
ចក្រយាន	caʔkraʔjiən
ចក្រី	caʔkrəj
ចង	cɑːŋ
ចង់	cɑŋ
ចង្កា	cɑŋkaː
ចង្កឹះ	cɑŋkəh
ចង្កូត	cɑŋkout
ចង្កើះ	cɑŋkaəh
ចង្កៀង	cɑŋkiəŋ
ចង្កេះ	cɑŋkeh
ចង្កោយ	cɑŋkaoj
ចង្រិត	cɑŋrət
ចង្រៃ	cɑŋrɨj
ចង្វា	cɑŋʋaː
ចង្វាក់	cɑŋʋaʔ
ចង្វាត	cɑŋʋiət
ចង្វែក	cɑŋʋɛːk
ចង្ហាន់	cɑŋhan
ចង្ហុក	cɑŋhok
ចង្ហូរ	cɑŋhou
ចង្អុល	cɑŋʔol
ចង្អូរ	cɑŋʔou
ចង្អៀត	cɑŋʔiət
ចចក	cɑcɑːʔ
ចចា	cɑcaː
ចចាក់	cɑcaʔ
ចចឹក	cɑcək
ចត	cɑːt
ចតុកោណ	caʔtokaon
ចតុប្បច្ច័យ	caʔtoppaccaj
ចតុមុខ	caʔtommuk
ចត់	cɑt
ចត្រង្គ	caʔtrɑŋ
ចត្វ័ង្ស	cattʰʋaŋ
ចន្ថា	cɑntʰaː
ចន្ទ	can
ចន្ទគិរី	cankiriː
ចន្ទន៍	can
ចន្ទី	cantiː
ចន្លុះ	cɑnloh
ចន្លោះ	cɑnlɑh
ចប	cɑːp
ចប់	cɑp
ចម	cɑːm
ចម្ការ	cɑmkaː
ចម្ងាយ	cɑmŋaːj
ចម្បង	cɑmɓɑːŋ
ចម្ម	cam
ចម្រាញ់	cɑmraɲ
ចម្រុះ	cɑmroh
ចម្រើន	cɑmrəːn
ចម្រៀង	cɑmriəŋ
ចម្លង	cɑmlɑːŋ
ចម្លាក់	cɑmlaʔ
ចម្លើយ	cɑmləːj
ចម្លែក	cɑmlɛːk
ចម្អិន	cɑmʔən
ចរចា	cɑcaː
ចរណៃ	cɑːraʔnaj
ចរន្ត	caʔrɑn
ចរាចរ	cɑːraːcɑː
ចរាចរណ៍	cɑːraːcɑː
ចរិត	caʔrət
ចរិយា	caʔrejaː
ចលន	caʔlaʔnaʔ
ចលនវត្ថុ	caʔlaʔnaʔʋŏəttʰoʔ
ចលនា	caʔlaʔnaː
ចលាចល	caʔlaːcɑl
ចល័ត	caʔlat
ចាក	caːʔ
ចាការតា	caːkaːtaː
ចាក់	caʔ
ចាក់ចុល	caʔcol
ចាញ់	caɲ
ចាត់	cat
ចាន	caːn
ចាន់	can
ចាប	caːp
ចាប៉ី	caːpəj
ចាប់	cap
ចាព្លូ	caːpʰluː
ចាម	caːm
ចាម៉ៃកា	caːmajkaː
ចាយ	caːj
ចារ	caː
ចារបុរស	caːraʔɓorɑh
ចាស	caːh
ចាស់	cah
ចាហួយ	caːhuəj
ចាំ	cam
ចាំង	caŋ
ចាំបាច់	camɓac
ចា៎ះ	caːh
ចិក	cək
ចិញ្ចឹម	cəɲcəm
ចិញ្ចើម	cəɲcaəm
ចិញ្ចៀន	cəɲciən
ចិញ្ច្រាំ	cəɲcram
ចិត	cət
ចិត្ត	cət
ចិន	cən
ចិន្ដា	cənɗaː
ចិន្តបណ្ឌិត	centaʔɓɑnɗɨt
ចីពរ	cəjpɔː
ចីវរ	cəjʋɑː
ចីវរកាល	cəjʋaʔrĕəʔkaːl
ចឹក	cək
ចុក	cok
ចុង	coŋ
ចុងចោទ	coŋcaot
ចុងភៅ	coŋpʰɨw
ចុច	coc
ចុណ្ណភាព	connaʔpʰiəp
ចុតហ្មាយ	cotmaːj
ចុយ	coj
ចុះ	coh
ចូរ	cou
ចូល	coul
ចួង	cuəŋ
ចៀន	ciən
ចៀម	ciəm
ចៀស	ciəh
ចេក	ceːk
ចេង	ceːŋ
ចេញ	cəɲ
ចេតនា	ceːtaʔnaː
ចេតសិក	ceːtaʔsək
ចេតិយ	caetɗəj
ចេត្រ	caet
ចេន	ceːn
ចេរ	ceː
ចេស	ceːh
ចេស្ដា	ceːhsɗaː
ចេះ	ceh
ចែ	cae
ចែក	caek
ចែង	caeŋ
ចែវ	caew
ចៃ	caj
ចៃដន់	cajɗɑn
ចៃដន្យ	cajɗɑn
ចោទ	caot
ចោទកៈ	caotĕəʔkaʔ
ចោម	caom
ចោរ	cao
ចោល	caol
ចៅ	caw
ចំ	cɑm
ចំការ	cɑmkaː
ចំកោង	cɑmkaoŋ
ចំណង	cɑmnɑːŋ
ចំណង់	cɑmnɑŋ
ចំណត	cɑmnɑːt
ចំណរ	cɑmnɑː
ចំណាក	cɑmnaːʔ
ចំណាក់	cɑmnaʔ
ចំណាត់	cɑmnat
ចំណាប់	cɑmnap
ចំណាយ	cɑmnaːj
ចំណារ	cɑmnaː
ចំណាស់	cɑmnah
ចំណាំ	cɑmnam
ចំណឹក	cɑmnək
ចំណុច	cɑmnoc
ចំណុះ	cɑmnoh
ចំណូល	cɑmnoul
ចំណៀស	cɑmniəh
ចំណេញ	cɑmnəɲ
ចំណេះ	cɑmneh
ចំណែក	cɑmnaek
ចំណោទ	cɑmnaot
ចំណោម	cɑmnaom
ចំនួន	cɑmnuən
ចំនួប	cɑmnuəp
ចំបាប់	cɑmɓap
ចំបាំង	cɑmɓaŋ
ចំបើង	cɑmɓaəŋ
ចំប៉ា	cɑmpaː
ចំពាក់	cɑmpĕəʔ
ចំពុះ	cɑmpuh
ចំពូក	cɑmpuːk
ចំពួយ	cɑmpuəj
ចំពោះ	cɑmpŭəh
ចំរើន	cɑmraən
ចំរៀង	cɑmriəŋ
ចំហាយ	cɑmhaːj
ចំហុយ	cɑmhoj
ចំហៀង	cɑmhiəŋ
ចំឡង	cɑmlɑːŋ
ចំឡាក់	cɑmlaʔ
ចំឡើយ	cɑmlaəj
ចំឡែក	cɑmlaek
ចំអក	cɑmʔɑːʔ
ចំអាប	cɑmʔaːp
ចំអាម	cɑmʔaːm
ចំអិន	cɑmʔən
ច៎ា	caː
ច័ន	can
ច័ន្ទ	can
ច័ន្ធូ	cantʰuː
ច្នៃ	cʰnaj
ច្នៃប្រឌិត	cʰnajprɑːɗɨt
ច្បង	cɓɑːŋ
ច្បា	cɓaː
ច្បាប់	cɓap
ច្បាម	cɓaːm
ច្បារ	cɓaː
ច្បារមន	cɓaːmɔːn
ច្បាស់	cɓah
ច្បាំង	cɓaŋ
ច្រក	crɑːʔ
ច្រកែង	crɑkaeŋ
ច្រក់	crɑʔ
ច្រត់	crɑt
ច្របល់	crɑɓɑl
ច្របាច់	crɑɓac
ច្រមុះ	crɑmoh
ច្រវា	crɑʋaː
ច្រវាក់	crɑʋĕəʔ
ច្រឡៃ	crɑlaj
ច្រអូស	crɑʔouh
ច្រាច់	crac
ច្រាន	craːn
ច្រាម	craːm
ច្រាវ	craːw
ច្រាស	craːh
ច្រាំង	craŋ
ច្រាំងភ្នំ	craŋpʰnum
ច្រុះ	croh
ច្រូត	crout
ច្រួច	cruəc
ច្រើន	craən
ច្រៀង	criəŋ
ច្រេស	creːh
ច្រែះ	craeh
ឆ	cʰɑː
ឆកោណ	cʰɑkaon
ឆក់	cʰɑʔ
ឆត្រ	cʰat
ឆន	cʰɑːn
ឆន្ទៈ	cʰɑntĕəʔ
ឆប	cʰɑːp
ឆមាស	cʰɑmiəh
ឆវ	cʰaʔʋĕəʔ
ឆវគ្រឹះ	cʰaʔʋĕəkrɨh
ឆា	cʰaː
ឆាក	cʰaːʔ
ឆាខ្វៃ	cʰaːkʰʋaj
ឆាដ	cʰaːt
ឆាន់	cʰan
ឆាប	cʰaːp
ឆាប់	cʰap
ឆាយ	cʰaːj
ឆាស៊ីវ	cʰaːsiːw
ឆាំង	cʰaŋ
ឆា៎	cʰa
ឆី	cʰəj
ឆុង	cʰoŋ
ឆូក	cʰouk
ឆូត	cʰout
ឆេះ	cʰeh
ឆែ	cʰae
ឆែក	cʰaek
ឆែកកូស្លូវ៉ាគី	cʰaekkouslouʋaːkiː
ឆែវ	cʰaew
ឆៃថាវ	cʰajtʰaːw
ឆោត	cʰaot
ឆោម	cʰaom
ឆៅ	cʰaw
ឆ័ត្រ	cʰat
ឆ្កាង	cʰkaːŋ
ឆ្កឹះ	cʰkəh
ឆ្កួត	cʰkuət
ឆ្កែ	cʰkae
ឆ្ងល់	cʰŋɑl
ឆ្ងាញ់	cʰŋaɲ
ឆ្ងាយ	cʰŋaːj
ឆ្នាំ	cʰnam
ឆ្នាំង	cʰnaŋ
ឆ្នុក	cʰnok
ឆ្នុច	cʰnoc
ឆ្នូត	cʰnout
ឆ្នួន	cʰnuən
ឆ្នួរ	cʰnuə
ឆ្នើម	cʰnaəm
ឆ្នៀង	cʰniəŋ
ឆ្នេរ	cʰneː
ឆ្នោត	cʰnaot
ឆ្ពោះ	cpŭəh
ឆ្មក់	cʰmɑʔ
ឆ្មប	cʰmɑːp
ឆ្មា	cʰmaː
ឆ្មាំ	cʰmam
ឆ្លង	cʰlɑːŋ
ឆ្លាក់	cʰlaʔ
ឆ្លាត	cʰlaːt
ឆ្លាម	cʰlaːm
ឆ្លាស់	cʰlah
ឆ្លាំង	cʰlaŋ
ឆ្លុះ	cʰloh
ឆ្លូវ	cʰləw
ឆ្លើយ	cʰlaəj
ឆ្វេង	cʰʋeːŋ
ឆ្អាប	cʰʔaːp
ឆ្អិន	cʰʔən
ឆ្អឹង	cʰʔəŋ
ឆ្អើរ	cʰʔaə
ឆ្អែត	cʰʔaet
ជ	cɔː
ជក់	cŭəʔ
ជគត	cĕəʔkŭət
ជង្គង់	cŭəŋkŭəŋ
ជង្រុក	cŭəŋruk
ជជួរ	cɔcuə
ជជែក	cɔcɛːk
ជញ្ជក់	cŭəɲcŭəʔ
ជញ្ជាំង	cŭəɲcĕəŋ
ជញ្ជីង	cŭəɲciːŋ
ជញ្ជូន	cŭəɲcuːn
ជណ្ដើរ	cŭənɗaə
ជន	cŭən
ជន	cɔːn
ជនក	cĕəʔnĕəʔkaʔ
ជនឃាត	cĕəʔnĕəʔkʰiət
ជនបទ	cŭənnĕəʔɓat
ជនី	cĕəʔniː
ជន់	cŭən
ជន្ម	cŭənmĕəʔ
ជន្មា	cŭənmiə
ជន្ល	cŭənlɔː
ជន្លូស	cŭənluːh
ជប៉ុន	cĕəʔpon
ជប់	cup
ជម្ងឺ	cumŋɨː
ជម្នះ	cumnĕəh
ជម្ពូ	cumpuː
ជម្រាប	cumriəp
ជម្រុះ	cumruh
ជម្រើស	cumrəːh
ជម្រះ	cumrĕəh
ជម្លោះ	cumlŭəh
ជយោ	cĕəʔjoː
ជរា	cĕəʔriə
ជលធរ	cŭəllĕəʔtʰɔː
ជល់	cŭəl
ជា	ciə
ជាក់	cĕəʔ
ជាង	ciəŋ
ជាញ	ciəɲ
ជាតក	ciəɗɑʔ
ជាតា	ciətaː
ជាតិ	ciət
ជាតិលិង្គ	ciətelɨŋ
ជាតូបនីយកម្ម	ciətoupaʔniːjĕəʔkam
ជានុ	ciənuʔ
ជាន់	cŏən
ជាប់	cŏəp
ជាម	ciəm
ជាល	ciəl
ជាលិកា	ciəlikaː
ជាំ	cŏəm
ជិត	cɨt
ជិន	cɨn
ជិប	cɨp
ជិះ	cih
ជី	ciː
ជីក	ciːk
ជីប៊ូទី	ciːɓuːtiː
ជីព	ciːp
ជីពចរ	ciːpcɑː
ជីរ	ciː
ជីរណា	ciːrĕəʔnaː
ជីវ	ciːw
ជីវជាតិ	ciːʋĕəʔciət
ជីវភាព	ciːʋĕəʔpʰiəp
ជីវា	ciːʋaː
ជីវាណូ	ciːʋaːnou
ជីវិត	ciːʋɨt
ជីវៈ	ciːʋĕəʔ
ជីវ័ន	ciːʋŏən
ជីស៊ីណូ	ciːsiːnou
ជឹម	cɨm
ជុក	cuk
ជុល	cul
ជុំ	cum
ជុះ	cuh
ជុះអាច់	cuhʔac
ជូត	cuːt
ជូតការក៍	cuːtaʔkaː
ជូន	cuːn
ជូបហ្សាណា	cuːpzaːnaː
ជូបា	cuːɓaː
ជូរ	cuː
ជួង	cuəŋ
ជួញ	cuəɲ
ជួន	cuən
ជួប	cuəp
ជួយ	cuəj
ជួរ	cuə
ជួល	cuəl
ជួស	cuəh
ជើង	cəːŋ
ជឿ	cɨə
ជៀន	ciən
ជៀនជួន	ciəncuən
ជៀស	ciəh
ជេដ្ឋា	ceittʰaː
ជេរ	cei
ជេស្ឋ	ceih
ជែង	cɛːŋ
ជោគ	coːk
ជោះ	cŭəh
ជំងឺ	cumŋɨː
ជំនន់	cumnŭən
ជំនាញ	cumniəɲ
ជំនាន់	cumnŏən
ជំនិត	cumnɨt
ជំនិះ	cumnih
ជំនីរ	cumniː
ជំនុំ	cumnum
ជំនូន	cumnuːn
ជំនួញ	cumnuəɲ
ជំនួប	cumnuəp
ជំនួយ	cumnuəj
ជំនួរ	cumnuə
ជំនួល	cumnuəl
ជំនួស	cumnuəh
ជំនឿ	cumnɨə
ជំនែង	cumnɛːŋ
ជំនោរ	cumnoː
ជំនះ	cumnĕəh
ជំពាក់	cumpĕəʔ
ជំរក	cumrɔːʔ
ជំរាប	cumriəp
ជំរុញ	cumruɲ
ជំរើស	cumrəːh
ជំរៅ	cumrɨw
ជំរំ	cumrum
ជំរះ	cumrĕəh
ជំលើយ	cumləːj
ជំលោះ	cumlŭəh
ជំហប់	cumhup
ជំហាន	cumhiən
ជំហឺ	cumhɨː
ជះ	cĕəh
ជ័យ	cɨj
ជ័រ	cŏə
ជ្រក	crɔːʔ
ជ្រក់	crŭəʔ
ជ្រង់	crŭəŋ
ជ្រញ់	crŭəɲ
ជ្រលក់	crɔlŭəʔ
ជ្រលង	crɔlɔːŋ
ជ្រាប	criəp
ជ្រាល	criəl
ជ្រាវ	criəw
ជ្រាំ	crŏəm
ជ្រឹង	crɨŋ
ជ្រុង	cruŋ
ជ្រុះ	cruh
ជ្រូក	cruːk
ជ្រើស	crəːh
ជ្រៀង	criəŋ
ជ្រែ	crɛː
ជ្រែក	crɛːk
ជ្រៃ	crɨj
ជ្រោះ	crŭəh
ជ្រៅ	crɨw
ជ្រំ	crum
ជ្រះ	crĕəh
ជ្វា	cʰʋiə
ជ្វីស	cʰʋiːh
ជ្វីហ្វ	cʰʋiːf
ឈ	cʰɔː
ឈប់	cʰup
ឈម	cʰɔːm
ឈរ	cʰɔː
ឈាន	cʰiən
ឈាម	cʰiəm
ឈិង	cʰɨŋ
ឈិត	cʰɨt
ឈិន	cʰɨn
ឈីប	cʰiːp
ឈឹង	cʰɨŋ
ឈឹម	cʰɨm
ឈឺ	cʰɨː
ឈុត	cʰut
ឈូក	cʰuːk
ឈូង	cʰuːŋ
ឈួន	cʰuən
ឈើ	cʰəː
ឈោង	cʰoːŋ
ឈ្ងប់	cʰŋup
ឈ្ងុយ	cʰŋuj
ឈ្នាន់	cʰnŏən
ឈ្នាប់	cʰnŏəp
ឈ្នួល	cʰnuəl
ឈ្នះ	cʰnĕəh
ឈ្មួញ	cʰmuəɲ
ឈ្មោល	cʰmoːl
ឈ្មោះ	cʰmŭəh
ឈ្លក់	cʰlŭəʔ
ឈ្លប	cʰlɔːp
ឈ្លាក	cʰliəʔ
ឈ្លាន	cʰliən
ឈ្លើង	cʰləːŋ
ឈ្លើយ	cʰləːj
ឈ្លោះ	cʰlŭəh
ញ	ɲɔː
ញញឹម	ɲɔɲɨm
ញញួរ	ɲɔɲuə
ញាក់	ɲĕəʔ
ញាណ	ɲiən
ញាតិ	ɲiət
ញាត់	ɲŏət
ញាប់	ɲŏəp
ញាស់	ɲŏəh
ញាំ	ɲŏəm
ញាំង	ɲĕəŋ
ញី	ɲiː
ញឹក	ɲɨk
ញុះ	ɲuh
ញូតុន	ɲuːton
ញូប្រុនវិក	ɲuːprunʋɨk
ញូវជឺស៊ី	ɲɨwcɨːsiː
ញូវម៉ិកស៊ីកូ	ɲɨwməksiːkou
ញូវហាំសៀ	ɲɨwhamsiə
ញើស	ɲəːh
ញៀន	ɲiən
ញេច	ɲɨc
ញោម	ɲoːm
ញ៉ម	ɲɑːm
ញ៉ាំ	ɲam
ញ៉ុម	ɲom
ញ៉ូប្យូម	ɲoupʰjoum
ញ័រ	ɲŏə
ដ	ɗɑː
ដក	ɗɑːʔ
ដក់	ɗɑʔ
ដង	ɗɑːŋ
ដងក្ដារ	ɗɑŋkɗaː
ដងរែក	ɗɑŋrɛːk
ដង្កាត់	ɗɑŋkat
ដង្កូវ	ɗɑŋkəw
ដង្កែ	ɗɑŋkae
ដង្ហិត	ɗɑŋhət
ដង្ហើម	ɗɑŋhaəm
ដង្ហែ	ɗɑŋhae
ដដុស	ɗɑɗoh
ដដែល	ɗɑɗael
ដណ្ដាំ	ɗɑnɗam
ដណ្ដឹង	ɗɑnɗəŋ
ដទៃ	ɗɑtɨj
ដប	ɗɑːp
ដប់	ɗɑp
ដរាប	ɗɑraːp
ដល់	ɗɑl
ដា	ɗaː
ដាកា	ɗaːkaː
ដាក់	ɗaʔ
ដាច់	ɗac
ដាណឺម៉ាក	ɗaːnəɨmaːʔ
ដាន	ɗaːn
ដាប់	ɗap
ដាម	ɗaːm
ដាម៉ាស	ɗaːmaːh
ដារ	ɗaː
ដាល	ɗaːl
ដាល់	ɗal
ដាវ	ɗaːw
ដាស់	ɗah
ដាំ	ɗam
ដាំងដុង	ɗaŋɗoŋ
ដិត	ɗət
ដី	ɗəj
ដីកា	ɗəjkaː
ដឹក	ɗək
ដឹង	ɗəŋ
ដឺ	ɗəɨ
ដឺក្រេ	ɗəɨkreː
ដុត	ɗot
ដុល្លារ	ɗollaː
ដុស	ɗoh
ដុំ	ɗom
ដុះ	ɗoh
ដូង	ɗouŋ
ដូច	ɗouc
ដូច្នឹង	ɗoucʰnəŋ
ដូច្នេះ	ɗoucʰneh
ដូច្នោះ	ɗoucʰnɑh
ដូន	ɗoun
ដូនកែវ	ɗounkaew
ដូនជី	ɗounciː
ដូរ	ɗou
ដូហា	ɗouhaː
ដួង	ɗuəŋ
ដួន	ɗuən
ដួល	ɗuəl
ដើម	ɗaəm
ដើមចោទ	ɗaəmcaot
ដើម្បី	ɗaəmɓəj
ដើរ	ɗaə
ដៀប	ɗiəp
ដៀល	ɗiəl
ដៀវ	ɗiəw
ដេក	ɗeːk
ដេញ	ɗəɲ
ដេរ	ɗeː
ដេរីវេ	ɗeːriːʋei
ដេឡាវែរ	ɗeːlaːʋɛː
ដែក	ɗaek
ដែន	ɗaen
ដែនដី	ɗaenɗəj
ដែរ	ɗae
ដែល	ɗael
ដៃ	ɗaj
ដោត	ɗaot
ដោយ	ɗaoj
ដោះ	ɗɑh
ដៅ	ɗaw
ដំ	ɗɑm
ដំណក	ɗɑmnɑːʔ
ដំណក់	ɗɑmnɑʔ
ដំណល់	ɗɑmnɑl
ដំណាក់	ɗɑmnaʔ
ដំណាប់	ɗɑmnap
ដំណាល	ɗɑmnaːl
ដំណាល់	ɗɑmnal
ដំណាស់	ɗɑmnah
ដំណាំ	ɗɑmnam
ដំណឹង	ɗɑmnəŋ
ដំណុស	ɗɑmnoh
ដំណុះ	ɗɑmnoh
ដំណួច	ɗɑmnuəc
ដំណួល	ɗɑmnuəl
ដំណើប	ɗɑmnaəp
ដំណើរ	ɗɑmnaə
ដំណៀល	ɗɑmniəl
ដំណេក	ɗɑmneːk
ដំណេរ	ɗɑmneː
ដំណែង	ɗɑmnaeŋ
ដំណែល	ɗɑmnael
ដំណោះ	ɗɑmnɑh
ដំបង	ɗɑmɓɑːŋ
ដំបូង	ɗɑmɓouŋ
ដំបូល	ɗɑmɓoul
ដំបេ	ɗɑmɓaw
ដំបែ	ɗɑmɓae
ដំបៅ	ɗɑmɓaw
ដំរី	ɗɑmrəj
ដំឡូង	ɗɑmlouŋ
ដំឡើង	ɗɑmlaəŋ
ដ៏	ɗɑː
ដ្ឋាន	tʰaːn
ដ្បិត	ɗɓət
ដ្រូន	ɗroun
ឋ	tʰɑː
ឋាន	tʰaːn
ឋានវតី	tʰaːnʋɔtəj
ឋានៈ	tʰaːnaʔ
ឋិត	tʰət
ឋិតិ	tʰeteʔ
ឌ	ɗɔː
ឌាកា	ɗiəkaː
ឌាក៌នី	ɗiəkeniː
ឌាឌិម	ɗiəɗɨm
ឌិត	ɗɨt
ឌិន	ɗɨn
ឌិម្ភា	ɗɨmpʰiə
ឌី	ɗiː
ឌីជីថល	ɗiːciːtʰɑːl
ឌីណូស័រ	ɗiːnousŏə
ឌីប្លូម	ɗiːploum
ឌីប្លូម៉ាត	ɗiːploumaːt
ឌីសប្រូស្យូម	ɗiːhprousjoum
ឌុដាន់	ɗuɗan
ឌុយប្លាំង	ɗujpʰlaŋ
ឌុល	ɗul
ឌូយ	ɗuːj
ឌូស្ហាន់បេ	ɗuːsanɓeː
ឌួង	ɗuəŋ
ឍ	tʰɔː
ណ	nɑː
ណា	naː
ណាគ្រី	naːkriː
ណាតូ	naːtou
ណាមីប៊ី	naːmiːɓiː
ណារី	naːriː
ណាសារ៉ែត	naːsaːraet
ណាស៊ី	naːsiː
ណាស៊ីនិយម	naːsiːnijum
ណាស់	nah
ណាំង	naŋ
ណឺត្រុង	nəɨtroŋ
ណឺរ៉ូន	nəɨroun
ណូរី	nouriː
ណូអែល	nouʔael
ណួកសុត	nuəksot
ណេដឺរឡន់ថ៍	neːɗəɨlɑn
ណេប៊ុយឡា	neːɓujlaː
ណេប្រាស្កា	neːpraːskaː
ណេវ៉ាដា	neːʋaːɗaː
ណេះ	neh
ណែ	nae
ណែន	naen
ណែម	naem
ណោះ	nɑh
ណ្វៃយ៉ូ	nʋɨjjou
ត	tɑː
តក់	tɑʔ
តក្ក	taʔkaʔ
តក្កកម្ម	taʔkaʔkam
តង់	tɑŋ
តង់ត្ណិ	tɑŋ
តង់សង់	tɑŋsɑŋ
តង់ស្យុង	tɑŋsjoŋ
តង់ហ្សានី	tɑŋzaːniː
តង្ករ	tɑŋkɑː
តង្កៀប	tɑŋkiəp
តង្វាយ	tɑŋʋiəj
តជ្ជារី	tɑːcciəriː
តនយា	taʔnaʔjaː
តន់	tɑn
តន័យ	taʔnaj
តន្តិភាសា	ɗɑntepʰiəsaː
តន្តី	ɗɑntəj
តន្ត្រី	ɗɑntrəj
តប	tɑːp
តប់	tɑp
តម្កាត់	tɑmkat
តម្បាញ	tɑmɓaːɲ
តម្បៀត	tɑmɓiət
តម្ពែក	tɑmpɛːk
តម្រង	tɑmrɑːŋ
តម្រង់	tɑmrɑŋ
តម្រា	tɑmraː
តម្រុយ	tɑmroj
តម្រូវ	tɑmrɨw
តម្រួត	tɑmruət
តម្រៀប	tɑmriəp
តម្រេក	tɑmreik
តម្លា	tɑmlaː
តម្លឹង	tɑmlɨŋ
តម្លៃ	tɑmlaj
តម្លោះ	tɑmlɑh
តលភូមិ	taʔlaʔpʰuːm
តស់	tɑh
តស្ករ	taʔskɑː
តា	taː
តាកូម៉ា	taːkoumaː
តាកែវ	taːkaew
តាក់	taʔ
តាក់ស៊ី	taksiː
តាខ្មៅ	taːkʰmaw
តាង	taːŋ
តាជីគីស្ថាន	taːciːkiːstʰaːn
តាត	taːt
តានា	taːnaː
តាប	taːp
តាម	taːm
តាយ	taːj
តាយស៊ីវ	taːjsiːw
តារា	taːraː
តារាង	taːraːŋ
តារាវលី	taːraːʋĕəʔliː
តារាសាស្ត្រ	taːraːsaːh
តាល	taːlaʔ
តាលព្រឹក្ស	taːlaʔprɨk
តាលិន	taːlɨn
តាសក់	tasɑʔ
តាស្កិន	taːskən
តាហ៊រ	taːhɔː
តាំង	taŋ
តាំងម៉ែ	taŋmae
តិកនិក	təknɨk
តិច	təc
តិចនេចូម	təcneicoum
តិចសាស	təcsaːh
តិណជាតិ	tenaʔciət
តិណពេទ្យ	tenaʔpɛːt
តិណភូមិ	tenaʔpʰuːm
តិរច្ឆាន	teraccʰaːn
តិះ	teh
តីរវិថី	təjrĕəʔʋitʰəj
តឹក	tək
តឹកកែ	təkkae
តឹង	təŋ
តឹងរ៉ឹង	təŋrəŋ
តុ	tok
តុកកែ	tokkae
តុកតុក	toktok
តុក្កតា	tokkaʔtaː
តុកៗ	toktok
តុង	toŋ
តុច្ចភាព	toccaʔpʰiəp
តុរិយាង្គ	torijaːŋ
តុល	ɗol
តុលា	tolaː
តុលាការ	tolaːkaː
តុល្យ	toljĕəʔ
តុស្តី	tohsɗəj
តុះ	toh
តូក្យូ	toukjou
តូច	touc
តូន	toun
តូរ៉ា	touraː
តូរ៉ុនតូ	tourontou
តូហ្គោ	tougoː
តួ	tuə
តួកគី	tuəʔkiː
តួប៊ីន	tuəɓiːn
តួយ៉ាង	tuəjaːŋ
តួរមិនីស្ថាន	tuəminiːstʰaːn
តើ	taə
តើក	taək
តើន	taən
តើយ	taəj
តឿ	tɨə
តៀជីវ	tiəciːw
តៀប	tiəp
តៀម	tiəm
តេណេសស៊ី	teːneːhsiː
តេតាណូស	teːtaːnouh
តេស្ត	teːh
តេស្តូស្តេរ៉ូន	teːstousteːroun
តេហេរ៉ង់	teːheːrɑŋ
តេឡេ	teːleː
តេឡេក្រាម	teːleːkraːm
តេឡេហ្វូន	teːleːfoun
តែ	tae
តែង	taeŋ
តែនតិ៍	taen
តែនត្ណិ	taen
តែម	taem
តែមប្រិ៍	taem
តែលួ	taeluə
តៃប៉ិ	tajpeʔ
តៃវ៉ាន់	tajʋan
តោ	tao
តោក	taok
តោង	taoŋ
តោន	taon
តៅ	taw
តៅហ៊ូ	tawhuː
តំណ	tɑmnɑː
តំណក់	tɑmnɑʔ
តំណាង	tɑmnaːŋ
តំណាប់	tɑmnap
តំណាល	tɑmnaːl
តំណិះ	tɑmneh
តំណូច	tɑmnouc
តំណែង	tɑmnaeŋ
តំបន់	tɑmɓɑn
តំបាញ	tɑmɓaːɲ
តំពក់	tɑmpŭəʔ
តំរង់	tɑmrɑŋ
តំរិះ	tɑmreh
តំរៀប	tɑmriəp
តំឡឹង	tɑmləŋ
តះ	tah
ត្នោត	tʰnaot
ត្បាញ	tɓaːɲ
ត្បាល់	tɓal
ត្បូង	tɓouŋ
ត្បៀត	tɓiət
ត្មាត	tʰmaːt
ត្មោង	tʰmaoŋ
ត្រ	trɑː
ត្រកាល	trɑkaːl
ត្រកូល	trɑkoul
ត្រកួត	trɑkuət
ត្រកួន	trɑkuən
ត្រង	trɑːŋ
ត្រងាល	trɑŋaːl
ត្រង់	trɑŋ
ត្រង់ស្វមម៉ាទ័រ	trɑŋsʋɑːmmaːtŏə
ត្រចៀក	trɑciəʔ
ត្រជាក់	trɑcĕəʔ
ត្រដុស	trɑɗoh
ត្រដោះ	trɑɗɑh
ត្រណាប់	trɑnap
ត្រថុក	trɑtʰok
ត្របក	trɑɓɑːʔ
ត្របែក	trɑɓaek
ត្របែង	trɑɓaeŋ
ត្រប៉ែ	trɑpae
ត្រប់	trɑp
ត្រពាំង	trɑpĕəŋ
ត្រពោក	trɑpoːk
ត្រយូង	trɑjouŋ
ត្រល់	trɑl
ត្រសក់	trɑsɑʔ
ត្រសាល់	trɑsal
ត្រសេះ	trɑseh
ត្រឡប់	trɑlɑp
ត្រឡាច	trɑlaːc
ត្រា	traː
ត្រាក់ទ័រ	traʔtŏə
ត្រាច	traːc
ត្រាជូ	traːcuː
ត្រាញ់	traɲ
ត្រាប់	trap
ត្រាវ	traːw
ត្រាស់	trah
ត្រាំវ៉ៃ	tramʋaj
ត្រិះ	treh
ត្រី	trəj
ត្រីកោណ	trəjkaon
ត្រីចក្រយាន	trəjcaʔkrɑjiən
ត្រីបុរី	triːporiː
ត្រីមាស	trəjmiəh
ត្រីសព្ទ	trəjsap
ត្រឹម	trəm
ត្រុយ	troj
ត្រុំ	trom
ត្រូវ	trəw
ត្រួត	truət
ត្រួយ	truəj
ត្រើយ	traəj
ត្រៀប	triəp
ត្រៀម	triəm
ត្រេក	treːk
ត្រែ	trae
ត្រៃចីវរ	trajcəjʋɔː
ត្រៃបិដក	trajɓeɗɑːʔ
ត្លុក	tʰlok
ត្វា	tʰʋaː
ត្សារ	tsaː
ត្អូ	tʔou
ត្អូញ	tʔouɲ
ត្អើក	tʔaək
ថ	tʰɑː
ថង់	tʰɑŋ
ថង់យាម	tʰɑŋjiəm
ថត	tʰɑːt
ថន	tʰɑːn
ថនៈ	tʰaʔnaʔ
ថយ	tʰɑːj
ថលជលិក	tʰaʔlaʔcĕəʔlɨk
ថវិកា	tʰaʔʋikaː
ថា	tʰaː
ថាន	tʰaːn
ថាមពល	tʰaːmaʔpŭəl
ថាលគមន៍	tʰaːlĕəʔkum
ថាលសព្ទ	tʰaːlĕəʔsap
ថាស	tʰaːh
ថាំង	tʰaŋ
ថា៖	tʰaː
ថី	tʰəj
ថូ	tʰou
ថើប	tʰaəp
ថេរ	tʰeː
ថេរវាទ	tʰeːraʔʋiət
ថែ	tʰae
ថែម	tʰaem
ថៃ	tʰaj
ថៃឡង់	tʰajlɑŋ
ថៃឡង់ដ៍	tʰajlɑŋ
ថោក	tʰaok
ថោះ	tʰɑh
ថ្ករ	tʰkɑː
ថ្កាត់	tʰkat
ថ្កុល	tʰkol
ថ្កើង	tʰkaəŋ
ថ្កៀប	tʰkiəp
ថ្គាម	tʰkiəm
ថ្ងាស	tʰŋaːh
ថ្ងៃ	tʰŋaj
ថ្នល់	tʰnɑl
ថ្នាក់	tʰnaʔ
ថ្នាល	tʰnaːl
ថ្នាំ	tʰnam
ថ្នាំង	tʰnaŋ
ថ្នូរ	tʰnou
ថ្ពក់	tpŭəʔ
ថ្ពាល់	tpŏəl
ថ្ពែក	tpɛːk
ថ្ម	tʰmɑː
ថ្មី	tʰməj
ថ្មើរ	tʰmaə
ថ្លង់	tʰlɑŋ
ថ្លា	tʰlaː
ថ្លាន់	tʰlan
ថ្លឹង	tʰləŋ
ថ្លុក	tʰlok
ថ្លើម	tʰlaəm
ថ្លែង	tʰlaeŋ
ថ្លៃ	tʰlaj
ថ្វាយ	tʰʋaːj
ថ្វី	tʰʋəj
ទ	tɔː
ទក្សិណ	tĕəksən
ទង	tɔːŋ
ទង់	tŭəŋ
ទង្គិច	tŭəŋkɨc
ទង្វើ	tŭəŋʋəː
ទណ្ឌ	tŏən
ទណ្ឌឃាដ	tŏənɗĕəʔkʰiət
ទណ្ឌវាទ	tŏənɗĕəʔʋiət
ទទឹក	tɔtɨk
ទទឹម	tɔtɨm
ទទូច	tɔtuːc
ទទួល	tɔtuəl
ទទេ	tɔtei
ទន់	tŭən
ទន្ត	tŏən
ទន្ទឹម	tŭəntɨm
ទន្ទេញ	tŭəntɨɲ
ទន្ទ្រាន	tŭəntriən
ទន្លាប់	tŭənlŏəp
ទន្លេ	tŭənlei
ទន្សាយ	tŭənsaːj
ទប់	tup
ទម្ងន់	tumŋŭən
ទម្រ	tumrɔː
ទម្រង់	tumrŭəŋ
ទម្លាក់	tumlĕəʔ
ទម្លាប់	tumlŏəp
ទល់	tŭəl
ទស	tŭəh
ទសវត្សរ៍	tĕəʔsaʔʋŏət
ទស្សន	tŭəhsaʔnaʔ
ទស្សនកិច្ច	tŭəhsanaʔkəc
ទស្សនា	tŭəhsaʔnaː
ទស្សនាទាន	tŭəhsaʔnaːtiən
ទស្សនាវដ្ដី	tŭəhsaʔnaːʋɑtɗəj
ទស្សនីយភាព	tŭəhsaʔniːjĕəʔpʰiəp
ទស្សន៍	tŭəh
ទឡ្ហភាព	tŏəlhaʔpʰiəp
ទឡ្ហីករណៈ	tŏəlhəjkaʔraʔnaʔ
ទឡ្ហៈ	tŏəlhaʔ
ទា	tiə
ទាក់	tĕəʔ
ទាញ	tiəɲ
ទាឋា	tiətʰaː
ទាត់	tŏət
ទាន	tiən
ទាន់	tŏən
ទាប	tiəp
ទាម	tiəm
ទាយ	tiəj
ទាយាទ	tiəjiət
ទារ	tiə
ទារក	tiərŭəʔ
ទារិកា	tiərikaː
ទារុណ	tiərun
ទារុណកម្ម	tiərunkam
ទាល	tiəl
ទាល់	tŏəl
ទាវ	tiəw
ទាហាន	tiəhiən
ទាំង	tĕəŋ
ទិញ	tɨɲ
ទិដ្ឋន័យ	tɨttʰɑːnɨj
ទិដ្ឋភាព	tɨttʰaʔpʰiəp
ទិដ្ឋាការ	tɨttʰaːkaː
ទិន្នន័យ	tɨnnĕəʔnɨj
ទិន្នផល	tɨnnĕəʔpʰɑl
ទិព្យ	tɨp
ទិព្វ	tɨp
ទិវង្គត	tiʋŭəŋkŭət
ទិវា	tiʋiə
ទិស	tɨh
ទិសមានាការ	tisaʔmaːnaːkaː
ទី	tiː
ទីឃាយុភាព	tiːkʰiəjupʰiəp
ទីឃៈ	tiːkʰĕəʔ
ទីងមោង	tiːŋmoːŋ
ទីតាន	tiːtaːn
ទីទៃ	tiːtɨj
ទីន័ង	tiːnĕəŋ
ទីបេ	tiːɓeː
ទីរ៉ាណា	tiːraːnaː
ទីហ្វុង	tiːfoŋ
ទឹក	tɨk
ទុក	tuk
ទុក្ខ	tuk
ទុង	tuŋ
ទុច្ចរិត	tuccaʔrət
ទុតិយតា	tutejaʔtaː
ទុន	tun
ទុយណេស៊ី	tujneːsiː
ទុយនីស	tujniːh
ទុយយោ	tujjoː
ទុយល្យូម	tujljuːm
ទុយោ	tujoː
ទុយ៌ស	turəjŭəh
ទុរេន	turein
ទុរ្ភិក្ស	turəpʰɨk
ទុំ	tum
ទូ	tuː
ទូក	tuːk
ទូត	tuːt
ទូរ	tuː
ទូរទស្សន៍	tuːrĕəʔtŭəh
ទូរលិខ	tuːrĕəʔlɨk
ទូរលេខ	tuːrĕəʔleːk
ទូរសព្ទ	tuːrĕəʔsap
ទូរស័ព្ទ	tuːrĕəʔsap
ទូលាយ	tuːliəj
ទួរគី	tuəkiː
ទួរណឺវិស	tuənəʋɨh
ទួល	tuəl
ទើប	təːp
ទើរ	təː
ទៀ	tiə
ទៀង	tiəŋ
ទៀត	tiət
ទៀន	tiən
ទៀប	tiəp
ទេ	tei
ទេញ	tɨɲ
ទេត្យ	tɛːt
ទេព	teːp
ទេពតា	teːpɗaː
ទេពារក្ស	teipiərĕəʔ
ទេពី	teipiː
ទេព្តា	teipɗaː
ទេវ	teiʋĕəʔ
ទេវតា	teiʋĕəʔtaː
ទេវទត្ត	teiʋĕəʔtŏət
ទេវទូត	teiʋĕəʔtuːt
ទេវនាគរី	teiwniəkĕəʔriː
ទេវី	teiʋiː
ទេស	teːh
ទេសចរ	teihsaʔcɑː
ទេសចរណ៍	teihsaʔcɑː
ទេសនា	teisaʔnaː
ទេសពណ៌នា	teːhpŏənaʔniə
ទេសភាព	teisaʔpʰiəp
ទេសាភិបាល	teisaːpʰiɓaːl
ទេស្នា	teisaʔnaː
ទែន	tɛːn
ទែប្យូម	tɛːpʰjoum
ទោច	toːc
ទោចក្រយាន	toːcaʔkrɑjiən
ទោស	toːh
ទោះ	tŭəh
ទៅ	tɨw
ទំ	tum
ទំងន់	tumŋŭən
ទំនង	tumnɔːŋ
ទំនប់	tumnup
ទំនាក់	tumnĕəʔ
ទំនាញ	tumniəɲ
ទំនាល់	tumnŏəl
ទំនិញ	tumnɨɲ
ទំនុក	tumnuk
ទំនើប	tumnəːp
ទំនៀម	tumniəm
ទំនេរ	tumnei
ទំនោរ	tumnoː
ទំពក់	tumpŭəʔ
ទំពា	tumpiə
ទំពាំង	tumpĕəŋ
ទំព័រ	tumpŏə
ទំរ	tumrɔː
ទំរង់	tumrŭəŋ
ទំរេត	tumreit
ទំលាក់	tumlĕəʔ
ទំលាប់	tumlŏəp
ទំហំ	tumhum
ទះ	tĕəh
ទ័ព	tŏəp
ទ័យ	tɨj
ទ្រ	trɔː
ទ្រង់	trŭəŋ
ទ្រទ្រង់	trŭətrŭəŋ
ទ្រនាប់	trɔnŏəp
ទ្រនំ	trɔnum
ទ្រព្យ	trŏəp
ទ្រវែង	trɔʋɛːŋ
ទ្រាំ	trŏəm
ទ្រាំង	trĕəŋ
ទ្រី	triː
ទ្រឹស្ដី	trɨhsɗəj
ទ្រឹស្ដីបទ	trɨhsɗəjɓɑt
ទ្រុង	truŋ
ទ្រុម	trum
ទ្រូង	truːŋ
ទ្រេត	treit
ទ្វយវាទ	tʰʋĕəʔjĕəʔʋiət
ទ្វារ	tʰʋiə
ទ្វីប	tʰʋiːp
ទ្វេ	tʰʋei
ទ្វេធា	tʰʋeitʰiə
ទ្វេរភេទ	tʰʋeipʰeit
ធ	tʰɔː
ធន	tʰŭən
ធនក្ស័យ	tʰĕəʔnĕəʔkʰsaj
ធនាគារ	tʰĕəʔniəkiə
ធនិន	tʰĕəʔnɨn
ធនុ	tʰĕəʔnuʔ
ធមនី	tʰĕəʔmĕəʔniː
ធម៌	tʰŏə
ធម្ម	tʰŏəm
ធម្មជាតិ	tʰŏəmmĕəʔciət
ធម្មតា	tʰŏəmmĕəʔɗaː
ធម្មនុញ្ញ	tʰŏəmmĕəʔnuɲ
ធម្មារម្មណ៍	tʰŏəmmiərŏəm
ធរណី	tʰɔːrĕəʔnəj
ធរណីទ្វារ	tʰɔːrĕəʔnəjtʋiə
ធាក់	tʰĕəʔ
ធាង	tʰiəŋ
ធាតុ	tʰiət
ធាត់	tʰŏət
ធាត្រី	tʰiətrəj
ធាន	tʰiən
ធានា	tʰiəniə
ធានី	tʰiəniː
ធារ	tʰiə
ធី	tʰiː
ធីតា	tʰiːɗaː
ធីមភូ	tʰiːmpʰuː
ធឺ	tʰɨː
ធុង	tʰuŋ
ធុញ	tʰuɲ
ធុត្តជន	tʰuttaʔcŭən
ធុន	tʰun
ធុមី	tʰumiː
ធុរៈ	tʰurĕəʔ
ធុំ	tʰum
ធូណា	tʰuːnaː
ធូប	tʰuːp
ធូរ	tʰuː
ធូលី	tʰuːliː
ធៀប	tʰiəp
ធេង	tʰeiŋ
ធោវនដ្ឋាន	tʰoːʋĕəʔnattʰaːn
ធំ	tʰom
ធ្ងន់	tʰŋŭən
ធ្នល់	tʰnŭəl
ធ្នាក់	tʰnĕəʔ
ធ្នាប់	tʰnŏəp
ធ្នឹម	tʰnɨm
ធ្នូ	tʰnuː
ធ្នើរ	tʰnəː
ធ្មប់	tʰmup
ធ្មាយ	tʰmiəj
ធ្មេញ	tʰmɨɲ
ធ្យាន	tʰjiən
ធ្យូង	tʰjuːŋ
ធ្លាក់	tʰlĕəʔ
ធ្លាប់	tʰlŏəp
ធ្លាយ	tʰliəj
ធ្លុះ	tʰluh
ធ្វើ	tʰʋəː
ធ្វើគ្នា	tʰʋəːkʰniə
ន	nɔː
នក្ខត្ត	nĕəʔkʰat
នក្ខត្តយោគ	nĕəʔkʰattajoːk
នក្សត្រ	nĕəksat
នខា	nĕəʔkʰaː
នគរ	nɔkɔː
នគរូបនីយកម្ម	nɔkɔːruːpaʔniːjĕəʔkam
នគរោបនីយកម្ម	nɔkɔːroːpaʔniːjĕəʔkam
នង្គ័ល	nĕəŋkŏəl
នព្វរ័តន៍	nuppĕəʔrŏət
នភា	nĕəʔpʰiə
នភាល័យ	nĕəʔpʰiəlɨj
នយស្តិ	nĕəʔjŭəh
នយោបាយ	nĕəʔjoːɓaːj
នរ	nɔː
នរក	nɔrŭəʔ
នរកកុណ្ឌ	nĕəʔrĕəʔkaʔkon
នលាដ	nĕəʔliət
នហារុ	nĕəʔhaːruʔ
នាក់	nĕəʔ
នាគ	niəʔ
នាង	niəŋ
នាងស្រី	niəŋsrəj
នាដ	niət
នាដកថា	niəɗaʔkaʔtʰaː
នាថ	niət
នាទី	niətiː
នានត្ត	niənat
នានា	niəniə
នាភី	niəpʰiː
នាម	niəm
នាមប័ណ្ណ	niəmĕəʔɓan
នាយ	niəj
នាយក	niəjŭəʔ
នាយកដ្ឋាន	niəjŭəʔkattʰaːn
នាយករដ្ឋមន្ត្រី	niəjŭəʔrŏətmŭəntrəj
នាយទុន	niəjtun
នារ	niə
នារី	niəriː
នាលិ	niəl
នាវា	niəʋiə
នាវាចរ	niəʋiəcɑː
នាវិក	niəʋɨk
នាសា	niəsaː
នាសិក	niəsək
នាឡិកា	niəlekaː
នាំ	nŏəm
និកម្មភាព	nikammaʔpʰiəp
និករ	nikɑː
និកាយ	nikaːj
និក្ខមនំ	nɨkkʰamanaŋ
និក្ខេប	nɨkkʰeːp
និក្ខេបបទ	nɨkkʰeːpaʔɓɑt
និគម	nikum
និគ្គហិត	nɨkkĕəʔhət
និង	nɨŋ
និច្ច	nɨc
និច្ឆ័យ	nɨccʰaj
និជ្ជជនភាព	nɨccĕəʔcŭənpʰiəp
និទស្សន្ត	nitŭəhsɑn
និទាន	nitiən
និទ្ទោសកម្ម	nittoːsaʔkam
និបាត	niɓaːt
និបាតសព្ទ	niɓaːtaʔsap
និពន្ធ	nipŭən
និព្វាន	nɨppiən
និមល	nimɔːl
និមិត្ត	nimɨt
និម្មាបនកម្ម	nɨmmiəpaʔnaʔkam
និម្មាបនិក	nɨmmiəpaʔnɨk
និម្មិត	nɨmmɨt
និយម	nijum
និយាយ	nijiəj
និយុវដ្ឋាន	nijuʋĕəʔtʰaːn
និយោជក	nijoːcŭəʔ
និយោជិត	nijoːcɨt
និយោជិតា	nijoːcitaː
និរតី	nirəɗəj
និរទេស	niteih
និរន្តរាយ	nirɑntaʔraːj
និរុត្តិ	nirut
និរុត្តិសាស្ត្រ	niruttesaːh
និរៃ	nirɨj
និវត្តន៍	niʋŏət
និវាសដ្ឋាន	niʋiəsattʰaːn
និវេទនប័ណ្ណ	niʋeitĕəʔnĕəʔɓan
និសីទន	nisəjtĕəʔnĕəʔ
និស្សិត	nɨhsət
និស្ស័យ	nihsaj
នី	niː
នីការ៉ាហ្គ័រ	niːkaːraːgŏə
នីកែល	niːkael
នីតិ	niːteʔ
នីតិបញ្ញត្តិ	niːteɓaɲɲat
នីតិប្បញ្ញត្តិ	niːteɓaɲɲat
នីតិវិធី	niːteʋitʰiː
នីល	niːl
នីវ៉ុ	niːʋoʔ
នីហរ័ណ	niːhaʔran
នីហ្សេ	niːzeː
នីហ្សេរីយ៉ា	niːzeːriːjaː
នីឡុង	niːloŋ
នឹក	nɨk
នឹង	nɨŋ
នឹងន	nɨŋ
នុយ	nuj
នុយក្លេអូទីត	nujkʰleːʔoutiːt
នុយក្លេអ៊ែរ	nujkʰleːʔɛː
នុរស៊ុលតង់	nusultɑŋ
នូណាវូត	nuːnaːʋuːt
នូវ	nɨw
នឿយ	nɨəj
នេត្ត	neit
នេត្រ	neit
នេត្រា	neitriə
នេន	nein
នេប៉ាល់	neipal
នេសាទ	neːsaːt
នេអុង	neiʔoŋ
នេអូឌឹម	neiʔouɗɨm
នេះ	nih
នែប	nɛːp
នៃ	nɨj
នោប	noːp
នោម	noːm
នោះ	nuh
នៅ	nɨw
នំ	num
នំប៉ុង	numpoŋ
ន័យ	nɨj
ន័រវែស	nŏəʋɛːh
ប	ɓɑː
បក	ɓɑːʔ
បក់	ɓɑʔ
បក្ស	paʔ
បក្សី	ɓaksəj
បង	ɓɑːŋ
បង់	ɓɑŋ
បង់ក្លាដែស	ɓɑŋkʰlaːɗaeh
បង្ក	ɓɑŋkɑː
បង្កក	ɓɑŋkɑːʔ
បង្កង	ɓɑŋkɑːŋ
បង្កប់	ɓɑŋkɑp
បង្កាច់	ɓɑŋkac
បង្កាត់	ɓɑŋkat
បង្កាន់	ɓɑŋkan
បង្ការ	ɓɑŋkaː
បង្កើត	ɓɑŋkaət
បង្កើន	ɓɑŋkaən
បង្កោង	ɓɑŋkaoŋ
បង្ក្រាប	ɓɑŋkraːp
បង្ខន	ɓɑŋkʰɑːn
បង្ខាំ	ɓɑŋkʰam
បង្ខូច	ɓɑŋkʰouc
បង្ខំ	ɓɑŋkʰɑm
បង្គង	ɓɑŋkɔːŋ
បង្គន់	ɓɑŋkŭən
បង្គា	ɓɑŋkiə
បង្គាប់	ɓɑŋkŏəp
បង្គី	ɓɑŋkiː
បង្គោល	ɓɑŋkoːl
បង្រួម	ɓɑŋruəm
បង្រៀន	ɓɑŋriən
បង្វិល	ɓɑŋʋɨl
បង្វឹក	ɓɑŋʋək
បង្វេច	ɓɑŋʋɨc
បង្វែង	ɓɑŋʋaeŋ
បង្សុកូល	ɓaŋsokoul
បង្ហាញ	ɓɑŋhaːɲ
បង្ហាត់	ɓɑŋhat
បង្ហូរ	ɓɑŋhou
បង្ហួស	ɓɑŋhuəh
បង្ហើប	ɓɑŋhaəp
បង្ហើរ	ɓɑŋhaə
បង្ហៀរ	ɓɑŋhiə
បង្ហែ	ɓɑŋhae
បង្ហោច	ɓɑŋhaoc
បង្ហោះ	ɓɑŋhɑh
បង្អង់	ɓɑŋʔɑŋ
បង្អត់	ɓɑŋʔɑt
បង្អរ	ɓɑŋʔɑː
បង្អស់	ɓɑŋʔɑh
បង្អាច	ɓɑŋʔaːc
បង្អាប់	ɓɑŋʔap
បង្អូស	ɓɑŋʔouh
បង្អួច	ɓɑŋʔuəc
បង្អួត	ɓɑŋʔuət
បង្អៀង	ɓɑŋʔiəŋ
បង្អៀន	ɓɑŋʔiən
បង្អែម	ɓɑŋʔaem
បច្ចុគ្គមន៍	paccokkum
បច្ចុប្បន្ន	paccoɓɑn
បច្ចូស	paccouh
បច្ចេកទេស	pacceːkaʔteih
បច្ចេកវិទ្យា	pacceːkaʔʋitʰjiə
បច្ច័យ	paccaj
បច្ឆាញាតិ	paccʰaːɲiət
បច្ឆិម	paccʰemaʔ
បញ	ɓɑːɲ
បញ្ចកោណ	paɲcaʔkaon
បញ្ចក្ខន្ធ	paɲcaʔkʰan
បញ្ចប់	ɓɑɲcɑp
បញ្ចាល	ɓɑɲcaːl
បញ្ចាំ	ɓɑɲcam
បញ្ចាំង	ɓɑɲcaŋ
បញ្ចុក	ɓɑɲcok
បញ្ចុះ	ɓɑɲcoh
បញ្ចូល	ɓɑɲcoul
បញ្ចៀស	ɓɑɲciəh
បញ្ចេញ	ɓɑɲcəɲ
បញ្ឆោត	ɓɑɲcʰaot
បញ្ជល់	ɓɑɲcŭəl
បញ្ជា	ɓɑɲciə
បញ្ជាក់	ɓɑɲcĕəʔ
បញ្ជី	ɓɑɲciː
បញ្ជូន	ɓɑɲcuːn
បញ្ជោះ	ɓɑɲcŭəh
បញ្ឈប់	ɓɑɲcʰup
បញ្ឈឺ	ɓɑɲcʰɨː
បញ្ញត្តិ	ɓaɲɲat
បញ្ញា	paɲɲaː
បញ្ញើ	ɓaɲɲaə
បញ្ហា	ɓaɲhaː
បដិច្ចសមុប្បាទ	ɓɑːɗəccɑːhmupɓaːt
បដិទិន	paʔɗetɨn
បដិបត្តិ	paʔɗeɓat
បដិបទា	paʔɗepaʔtiə
បដិលាភ	paʔɗeliəp
បដិវត្តន៍	paʔɗeʋŏət
បដិសន្ធិ	paʔɗesɑntʰiʔ
បដិសម្បហារ	paʔɗesɑmpaʔhaː
បដិសរណដ្ឋាន	paʔɗesaʔrĕəʔnattʰaːn
បដិសេធ	paʔɗesaet
បដ្ដិកា	patɗekaː
បឋម	paʔtʰɑm
បឋមសិលា	paʔtʰɑmsəjlaː
បណ	ɓɑːn
បណីតាហារ	paʔnəjtaːhaː
បណ្ដា	ɓɑnɗaː
បណ្ដាញ	ɓɑnɗaːɲ
បណ្ដាល	ɓɑnɗaːl
បណ្ដាំ	ɓɑnɗam
បណ្ដឹង	ɓɑnɗəŋ
បណ្ដុះ	ɓɑnɗoh
បណ្ដើរ	ɓɑnɗaə
បណ្ដែត	ɓɑnɗaet
បណ្ដោយ	ɓɑnɗaoj
បណ្ដោះ	ɓɑnɗɑh
បណ្ដៅ	ɓɑnɗaw
បណ្ឌិកា	panɗikaː
បណ្ឌិត	ɓɑnɗɨt
បណ្ឌិតសភា	ɓɑnɗɨtsaʔpʰiə
បណ្ឌិត្យ	ɓɑnɗɨt
បណ្ណង្គជាតិ	pannaŋkĕəʔciət
បណ្ណាគារ	pannaːkiə
បណ្ណាធិការ	pannaːtʰikaː
បណ្ណារក្ស	pannaːraʔ
បណ្ណាល័យ	pannaːlaj
បណ្ណែ	ɓɑnnae
បត់	ɓɑt
បថ	ɓɑt
បទ	ɓɑt
បទានុក្រម	paʔtiənukrɑm
បទុម	paʔtum
បទុមរាគ	paʔtumĕəʔriəʔ
បទេស	paʔteih
បន	ɓɑːn
បន្ត	ɓɑntɑː
បន្តក់	ɓɑntɑʔ
បន្តិច	ɓɑntəc
បន្តឹង	ɓɑntəŋ
បន្តូច	ɓɑntouc
បន្ថយ	ɓɑntʰɑːj
បន្ថែ	ɓɑntʰae
បន្ថែម	ɓɑntʰaem
បន្ថោក	ɓɑntʰaok
បន្ទប់	ɓɑntup
បន្ទាត់	ɓɑntŏət
បន្ទាប់	ɓɑntŏəp
បន្ទាយ	ɓɑntiəj
បន្ទាល់	ɓɑntŏəl
បន្ទុក	ɓɑntuk
បន្ទុះ	ɓɑntuh
បន្ទូល	ɓɑntuːl
បន្ទោរ	ɓɑntoː
បន្ទោស	ɓɑntoːh
បន្ទំ	ɓɑntum
បន្ទះ	ɓɑntĕəh
បន្ធូរ	ɓɑntʰuː
បន្លា	ɓɑnlaː
បន្លាស់	ɓɑnlah
បន្លឺ	ɓɑnlɨː
បន្លួញ	ɓɑnluəɲ
បន្លែ	ɓɑnlae
បន្លែង	ɓɑnlaeŋ
បន្លោះ	ɓɑnlɑh
បន្លំ	ɓɑnlum
បន្សើម	ɓɑnsaəm
បន្សោះ	ɓɑnsɑh
បបរ	ɓɑɓɑː
បបូរ	ɓɑɓou
បបែល	ɓɑɓael
បបោស	ɓɑɓaoh
បពិត្រ	ɓɑpɨt
បម្រាម	ɓɑmraːm
បម្រើ	ɓɑmraə
បរ	ɓɑː
បរទេស	ɓɑːrĕəʔteih
បរម	ɓɑrom
បរមសុខ	paʔraʔmaʔsok
បរមាណូ	paʔraʔmaːnou
បរាជ័យ	paʔraːcɨj
បរាធីន	paʔraːtʰiːn
បរាមាត្រ	paːraːmiət
បរាសិត	paʔraːsət
បរិកម្ម	ɓɑːrekam
បរិច្ចាគ	ɓɑːrəccaːʔ
បរិច្ឆេទ	ɓɑːrəccʰaet
បរិញ្ញា	paʔrɨɲɲaː
បរិញ្ញាបត្រ	paʔrəɲɲaːɓat
បរិនិព្វាន	ɓaʔrinɨppiən
បរិបាល	ɓɑːreɓaːl
បរិបូរ	ɓɑːreɓou
បរិភោគ	ɓɑːrepʰoːk
បរិមាណ	paʔremaːn
បរិយាការ	paʔrejaːkaː
បរិយាកាស	paʔrejaːkaːh
បរិយោសាន	paʔrejaosaːn
បរិលាភ	paʔreliəp
បរិវេណ	ɓɑːreʋein
បរិសិដ្ឋរោគ	paʔresəttʰaʔroːk
បរិសុទ្ធ	ɓɑːresot
បរិស័ទ	ɓɑːresat
បរិស្ថាន	ɓɑːrestʰaːn
បរីក្សា	paʔrekʰsaː
បល្លង្ក	pallaŋ
បល្ល័ង្ក	pallaŋ
បវត្តិ	paʔʋŏət
បវេណី	paʔʋeiniː
បស្ចិម	ɓahcəm
បស្សាវៈ	pahsaːʋaʔ
បាកដាដ	ɓaːʔɗaːt
បាក់	ɓaʔ
បាក់តេរី	ɓaʔteːriː
បាក់យ៉ុង	ɓaʔjoŋ
បាង	ɓaːŋ
បាច	ɓaːc
បាច់	ɓac
បាញ់	ɓaɲ
បាញ់កាញ់	ɓaɲkaɲ
បាញ់ហយ	ɓaɲhɑːj
បាដិហារិយ៍	paːɗehaː
បាដិហារ្យ	paːɗehaː
បាត	ɓaːt
បាតរាស	paːtaʔraːh
បាតុកម្ម	paːtokam
បាតុករ	paːtokɑː
បាតុភូត	paːtopʰuːt
បាត់	ɓat
បាត់ដំបង	ɓatɗɑmɓɑːŋ
បាត្រ	ɓaːt
បាទ	ɓaːt
បាន	ɓaːn
បានលុង	ɓaːnluŋ
បាន់	ɓan
បាប	ɓaːp
បាបចិត្ត	ɓaːpaʔcət
បាបាដុស	ɓaːɓaːɗoh
បាប៊ីឡូន	ɓaːɓiːloun
បាមោជ្ជ	paːmaoccĕəʔ
បាយ	ɓaːj
បាយាស	ɓaːjaːh
បារ	ɓaː
បារត	ɓaːrɑːt
បារមី	ɓaːrĕəʔməj
បារម្ភ	ɓaːrɑm
បារាយណ៍	ɓaːraːj
បារាំង	ɓaːraŋ
បារី	ɓaːrəj
បារ៉ែន	ɓaːraen
បារ៉្យូម	ɓaːrjuːm
បាល	ɓaːl
បាលី	ɓaːləj
បាល់	ɓal
បាល័ដ្ឋ	ɓaːlat
បាល័ត	ɓaːlat
បាវ	ɓaːw
បាវចនា	paːʋaʔcaʔnaː
បាវចនៈ	paːʋaʔcaʔnaʔ
បាស	ɓaːh
បាហាម៉ា	ɓaːhaːmaː
បាឡាត់	ɓaːlat
បាឡុង	ɓaːloŋ
បាំង	ɓaŋ
បិណ្ឌ	ɓən
បិណ្ឌបាត	ɓənɓaːt
បិត	ɓət
បិតា	ɓəjɗaː
បិតុច្ឆា	petoccʰaː
បិទ	ɓət
បិសាច	ɓəjsaːc
បី	ɓəj
បីតិ	pəjteʔ
បឹង	ɓəŋ
បឺត	ɓəɨt
បឺរ	ɓəɨ
បុក	ɓok
បុគ្គល	ɓokkŭəl
បុគ្គលិក	ɓokkĕəʔlɨk
បុង	ɓoŋ
បុណ្យ	ɓon
បុណ្យរ៉យ៉ា	ɓonrɑːjaː
បុតស្វាណា	ɓotsʋaːnaː
បុត្ត	ɓot
បុត្រ	ɓot
បុត្រី	ɓotrəj
បុប្ផា	ɓoppʰaː
បុព្វកថា	ɓoppĕəʔkaʔtʰaː
បុព្វបទ	ɓoppĕəʔɓɑt
បុព្វេ	ɓoppei
បុព្វោ	ɓoppoː
បុរស	ɓorɑh
បុរាណ	ɓoraːn
បុរី	ɓorəj
បុរេប្រវត្តិ	poreːprɑʋŏət
បុល	ɓol
បុស្បា	ɓohsɓaː
បុស្ស	ɓoh
បុស្សរាគ	ɓohriəʔ
បូ	ɓou
បូក	ɓouk
បូជា	ɓouciə
បូប៊ីន	ɓouɓiːn
បូព៌ា	ɓoupiə
បូរី	ɓorəj
បូលីវី	ɓouliːʋiː
បូស៊្នី	ɓousniː
បូស្តុន	ɓouston
បូស្នៀ	ɓousniə
បួគីណាហ្វាសូ	ɓuəkiːnaːfaːsou
បួង	ɓuəŋ
បួន	ɓuən
បួស	ɓuəh
បើ	ɓaə
បើក	ɓaək
បើសិនជា	ɓaəsənciə
បៀ	ɓiə
បៀត	ɓiət
បៀតបៀន	ɓiətɓiən
បៀរ	ɓiə
បេ	paw
បេក្ខជន	peːkkʰaʔcŭən
បេង	ɓeːŋ
បេណាំង	ɓeːnaŋ
បេតុង	ɓeːtoŋ
បេថ្លេហិម	ɓeːtʰleːhəm
បេយ្យាលៈ	pajjaːlaʔ
បេរីល្យូម	ɓeːriːljuːm
បេរូត	ɓeːruːt
បេលី	ɓeːliː
បេសកកម្ម	peːsaʔkaʔkam
បេសកជន	peːsaʔkaʔcŭən
បេស្បល	ɓeːsɓɑːl
បេឡា	peːlaː
បេឡារុស	ɓeːlaːruh
បេះដូង	ɓehɗouŋ
បែក	ɓaek
បែង	ɓaeŋ
បែប	ɓaep
បែរ	ɓae
បែលក្រាដ	ɓaelkraːt
បែលហ្ស៊ិក	ɓaelzɨk
បៃ	ɓaj
បៃតង	ɓajtɑːŋ
បោក	ɓaok
បោង	ɓaoŋ
បោច	ɓaoc
បោប	ɓaop
បោយ	ɓaoj
បោរ	ɓao
បោស	ɓaoh
បោះ	ɓɑh
បំ	ɓɑm
បំណង	ɓɑmnɑːŋ
បំណាក់	ɓɑmnaʔ
បំណុល	ɓɑmnol
បំណើក	ɓɑmnaək
បំណែក	ɓɑmnaek
បំបាក់	ɓɑmɓaʔ
បំបាត់	ɓɑmɓat
បំបាំង	ɓɑmɓaŋ
បំបៀត	ɓɑmɓiət
បំបែក	ɓɑmɓaek
បំបះ	ɓɑmɓah
បំប្រៃ	ɓɑmpraj
បំប្លែង	ɓɑmpʰlaeŋ
បំផាយ	ɓɑmpʰaːj
បំផឹក	ɓɑmpʰək
បំផុត	ɓɑmpʰot
បំផើម	ɓɑmpʰaəm
បំផ្លាញ	ɓɑmpʰlaːɲ
បំផ្លើស	ɓɑmpʰlaəh
បំពង	ɓɑmpɔːŋ
បំពង់	ɓɑmpŭəŋ
បំពាក់	ɓɑmpĕəʔ
បំពាន	ɓɑmpiən
បំពារ	ɓɑmpiə
បំពាំង	ɓɑmpĕəŋ
បំពុល	ɓɑmpul
បំពួន	ɓɑmpuən
បំពេញ	ɓɑmpɨɲ
បំពោត	ɓɑmpoːt
បំព្រាង	ɓɑmpriəŋ
បំភូត	ɓɑmpʰuːt
បំភ័យ	ɓɑmpʰɨj
បំភ្លឺ	ɓɑmplɨː
បំភ្លៃ	ɓɑmplɨj
បំរាម	ɓɑmraːm
បំរើ	ɓɑmraə
បំរែ	ɓɑmrae
បះ	ɓah
ប៉ង	pɑːŋ
ប៉ង់សឺម៉ង់	pɑŋsəɨmɑŋ
ប៉ប្រិច	pɑprəc
ប៉ប្លោត	pɑploːt
ប៉ម	pɑːm
ប៉ា	paː
ប៉ាកកា	paːʔkaː
ប៉ាក់	paʔ
ប៉ាគីស្ថាន	paːkiːstʰaːn
ប៉ាឆា	paːcʰaː
ប៉ាណាម៉ា	paːnaːmaː
ប៉ាតេ	paːteː
ប៉ាន	paːn
ប៉ាន់	pan
ប៉ារទី	paːtiː
ប៉ារីស	paːriːh
ប៉ារ៉ាបូល	paːraːɓoul
ប៉ារ៉ាម៉ែត្រ	paːraːmaet
ប៉ារ៉ាហ្គាយ	paːraːgiəj
ប៉ាវ	paːw
ប៉ាសស្ព័រ	paːhspŏə
ប៉ាស៊ីហ្វិក	paːsiːfək
ប៉ាហាំង	paːhaŋ
ប៉ាឡាដ្យូម	paːlaːtjuːm
ប៉ាឡេស្ទីន	paːleːstiːn
ប៉ិកួៈ	pekuəʔ
ប៉ិបទីត	pəptiːt
ប៉ី	pəj
ប៉ឹង	pəŋ
ប៉ុណ្ណឹង	ponnəŋ
ប៉ុណ្ណោះ	ponnɑh
ប៉ុន	pon
ប៉ុនណា	ponnaː
ប៉ុន្តែ	pontae
ប៉ុន្មាន	ponmaːn
ប៉ុម	pom
ប៉ុស្តិ៍	poh
ប៉ុស្តិ៍ត្រួតពិនិត្យ	pohtruətpinɨt
ប៉ូដហ្គោរីកា	poutgoːriːkaː
ប៉ូតាស្យូម	poutaːsjoum
ប៉ូល	poul
ប៉ូលិស	poulih
ប៉ូវ	pəw
ប៉ូឡូញ	poulouɲ
ប៉េកាំង	peːkaŋ
ប៉េតុង	peːtoŋ
ប៉េនីស៊ីលីន	peːnisiːliːn
ប៉េរូ	peːruː
ប៉េស្ត	peːh
ប៉ែក	paek
ប៉ែល	pael
ប៉ៃលិន	pajlɨn
ប៉ោង	paoŋ
ប៉ោម	paom
ប៉ោយប៉ែត	paojpaet
ប៉ៅ	paw
ប៉ះ	pah
ប៉័ងតោ	paŋtao
ប៉្យាណូ	pʰjaːnou
ប៊ិក	ɓɨk
ប៊ិច	ɓɨc
ប៊ីចេង	ɓiːceːŋ
ប៊ីដុង	ɓiːɗoŋ
ប៊ីយេរ	ɓiːjɛː
ប៊ីយែរ	ɓiːjɛː
ប៊ីសកេក	ɓiːskeːk
ប៊ីស៊ីក្លេត	ɓiːsiːkʰleːt
ប៊ីស្កេក	ɓiːskeːk
ប៊ុយការ៉េស	ɓujkaːreːh
ប៊ុយដាប៉ែស	ɓujɗaːpaeh
ប៊ុយណូស៊ែ	ɓujnousɛː
ប៊ុយណូស៊ែរ	ɓujnousɛː
ប៊ុយតាន	ɓujtaːn
ប៊ុលហ្គារី	ɓulgiəriː
ប៊ុល្លឺតាំង	ɓulləɨtaŋ
ប៊ូតង់	ɓuːtɑŋ
ប៊ូតុង	ɓuːtoŋ
ប៊ូយ៉ាំប៊ូរ៉ា	ɓuːjamɓuːraː
ប៊ូរុនឌី	ɓuːrunɗiː
ប៊ែន	ɓɛːn
ប៊ែរលីន	ɓɛːliːn
ប៊័រ	ɓəː
ប៊្រីតថេន	priːttʰeːn
ប័ណ្ណ	ɓan
ប័ណ្ណសារ	ɓannaʔsaː
ប័ត្រ	ɓat
ប្ដី	pɗəj
ប្ដឹង	pɗəŋ
ប្ដូរ	pɗou
ប្តេជ្ញា	pɗacɲaː
ប្រកប	prɑkɑːp
ប្រកាន់	prɑkan
ប្រកាប់	prɑkap
ប្រកាស	prɑkaːh
ប្រកួត	prɑkuət
ប្រក្រតី	praʔkrɑɗəj
ប្រគល់	prɑkŭəl
ប្រង់កា	prɑŋkaː
ប្រចណ្ឌ	prɑcan
ប្រចាំ	prɑcam
ប្រចឹក	prɑcək
ប្រចួប	prɑcuəp
ប្រចៀវ	prɑciəw
ប្រច័ណ្ឌ	prɑcan
ប្រឆាំង	prɑcʰaŋ
ប្រជា	prɑciə
ប្រជាធិបតេយ្យ	prɑciətʰɨppaʔtaj
ប្រជាមានិត	prɑːciəmiənɨt
ប្រជុំ	prɑcum
ប្រជួប	prɑcuəp
ប្រជែង	prɑcɛːŋ
ប្រឈម	prɑcʰɔːm
ប្រឈួន	prɑcʰuən
ប្រញប្ត	prɑɲap
ប្រញាប់	prɑɲap
ប្រដា	prɑɗaː
ប្រដាប់	prɑɗap
ប្រដាល់	prɑɗal
ប្រឌិត	prɑɗɨt
ប្រណាំង	prɑnaŋ
ប្រណិធាន	prɑnetʰiən
ប្រណីត	prɑnəjt
ប្រតិកម្ម	praʔtekam
ប្រតិករ	praʔtekɑː
ប្រតិទិន	prɑtetɨn
ប្រតិនិន្នាទ	prɑtenɨnniət
ប្រតិបត្តិ	prɑteɓat
ប្រតិបត្តិការ	prɑteɓattekaː
ប្រតិពល	prɑtepŭəl
ប្រតិភូ	prɑtepʰuː
ប្រតិលាភ	prɑteliəp
ប្រថាប់	prɑtʰap
ប្រទង់	prɑtŭəŋ
ប្រទាញ	prɑtiəɲ
ប្រទាន	prɑtiən
ប្រទីប	prɑtiːp
ប្រទេស	prɑteih
ប្រទះ	prɑtĕəh
ប្រធាន	prɑtʰiən
ប្រធានាធិបតី	prɑtʰiəniətʰɨppaʔɗəj
ប្របៀត	prɑɓiət
ប្រផេះ	prɑpʰeh
ប្រពន្ធ	prɑpŭən
ប្រពាន	prɑpiən
ប្រពាយ	prɑpiəj
ប្រពាល	prɑpiəl
ប្រពៃណី	prɑpɨjniː
ប្រព័ន្ធ	prɑpŏən
ប្រព្រឹត្ត	prɑprɨt
ប្រភព	prɑpʰup
ប្រភាគ	prɑpʰiəʔ
ប្រភាព	praʔpʰiəp
ប្រភេទ	prɑpʰeit
ប្រមា	prɑmaː
ប្រមាញ់	prɑmaɲ
ប្រមាណ	prɑmaːn
ប្រមាត់	prɑmŏət
ប្រមាត់ដី	prɑːmŏətɗəj
ប្រមាថ	prɑmaːt
ប្រមឹក	prɑmək
ប្រមុខ	prɑmuk
ប្រមូល	prɑmoul
ប្រមោទ	prɑmaot
ប្រមោយ	prɑmaoj
ប្រយុទ្ធ	prɑjut
ប្រយោគ	prɑjoːk
ប្រយោជន៍	prɑjaoc
ប្រយ័ត្ន	prɑjat
ប្រលាន	prɑlaːn
ប្រលែង	prɑlaeŋ
ប្រលោម	prɑlaom
ប្រវត្តិ	prɑʋŏət
ប្រវត្តិសាស្ត្រ	prɑʋŏəttesaːh
ប្រវត្តិសាស្ត្រិន	prɑʋŏəttesaːhstrən
ប្រវា	prɑʋaː
ប្រវេណី	prɑʋeːniː
ប្រវេសន៍	prɑʋeːh
ប្រវែង	prɑʋaeŋ
ប្រសា	prɑsaː
ប្រសាទ	prɑsaːt
ប្រសាសន៍	prɑsaːh
ប្រសិទ្ធ	prɑsət
ប្រសិន	prɑsən
ប្រសូត	prɑsout
ប្រសើរ	prɑsaə
ប្រស្នា	prɑsnaː
ប្រហារ	prɑhaː
ប្រហិត	prɑhət
ប្រហុក	prɑhok
ប្រហើរ	prɑhaə
ប្រហែល	prɑhael
ប្រហោង	prɑhaoŋ
ប្រឡង	prɑlɑːŋ
ប្រឡង់	prɑlɑŋ
ប្រឡាក់	prɑlaʔ
ប្រឡាយ	prɑlaːj
ប្រឡូស	prɑlouh
ប្រឡែង	prɑlaeŋ
ប្រអប់	prɑʔɑp
ប្រអូស	prɑʔouh
ប្រា	praː
ប្រាក	praːʔ
ប្រាកដ	praːkɑt
ប្រាក់	praʔ
ប្រាក្រឹត	praːʔrət
ប្រាង្គ	praːŋ
ប្រាង្គណ៍	praːŋ
ប្រាចិន	praːcən
ប្រាជ្ញ	praːc
ប្រាជ្ញា	praːcɲaː
ប្រាណ	praːn
ប្រាថ្នា	praːtʰnaː
ប្រាទីស្លាវ៉ា	praːtiːslaːʋaː
ប្រាប	praːp
ប្រាប់	prap
ប្រាម	praːm
ប្រាមោទ្យ	praːmaot
ប្រាយ	praːj
ប្រារព្ធ	praːrup
ប្រាសាទ	praːsaːt
ប្រាសេអូឌឹម	praːseːʔouɗɨm
ប្រាស៊ីលីយ៉ា	praːsiːliːjaː
ប្រាស់	prah
ប្រាំ	pram
ប្រិត	prət
ប្រីតា	prəjtaː
ប្រឹក្សា	prəksaː
ប្រឹង	prəŋ
ប្រឹថពី	prətʰaʔpiː
ប្រឹស្ឋ	prəh
ប្រុង	proŋ
ប្រុស	proh
ប្រូការីយ៉ូត	proukaːriːjout
ប្រូតុង	proutoŋ
ប្រូតេស្តង់	prouteːstɑŋ
ប្រូតេអ៊ីន	prouteːʔiːn
ប្រូផេន	proupʰeːn
ប្រូម	proum
ប្រូមេចូម	proumeicoum
ប្រូម៉ាស	proumaːh
ប្រូស្តាត	proustaːt
ប្រួល	pruəl
ប្រើ	praə
ប្រៀប	priəp
ប្រេកង់	preːkɑŋ
ប្រេង	preːŋ
ប្រេត	praet
ប្រេតូរីយ៉ា	preːtouriːjaː
ប្រេសិត	preːsət
ប្រេស៊ីល	preːsiːl
ប្រែ	prae
ប្រែង	praeŋ
ប្រៃ	praj
ប្រៃសណីយ៍	prajsaʔniː
ប្រោស	praoh
ប្រោះ	prɑh
ប្លង់	pʰlɑŋ
ប្លន់	pʰlɑn
ប្លម	pʰlɑːm
ប្លា	pʰlaː
ប្លាទីន	pʰlaːtiːn
ប្លាស្ទិក	pʰlaːstɨk
ប្លូក	pʰlouk
ប្លែក	pʰlaek
ប្លែង	pʰlaeŋ
ប្លោង	pʰlaoŋ
ប្លោត	pʰlaot
ប្អូន	pʔoun
ផ	pʰɑː
ផង	pʰɑːŋ
ផល	pʰɑl
ផលិក	pʰɑlək
ផលិត	pʰaʔlɨt
ផលិតកម្ម	pʰaʔlitaʔkam
ផលិតករ	pʰaʔlɨtkɑː
ផលិតផល	pʰaʔlitaʔpʰɑl
ផល្គុន	pʰɑlkun
ផល្លា	pʰɑllaː
ផស្ស	pʰahsaʔ
ផា	pʰaː
ផាក	pʰaːʔ
ផាត់	pʰat
ផាន	pʰaːn
ផាប់	pʰap
ផាយ	pʰaːj
ផារ៉ោន	pʰaːraon
ផាល	pʰaːl
ផាវ	pʰaːw
ផាស	pʰaːh
ផាសុក	pʰaːsok
ផាសុកា	pʰaːsokaː
ផឹក	pʰək
ផុត	pʰot
ផូង	pʰouŋ
ផើង	pʰaəŋ
ផើម	pʰaəm
ផេនដា	pʰeːnɗaː
ផេនស៊ីលវ៉ានៀ	pʰeːnsiːlʋaːniə
ផេះ	pʰeh
ផែ	pʰae
ផែន	pʰaen
ផោដ្ឋព្វៈ	pʰaottʰappĕəʔ
ផោន	pʰaon
ផោម	pʰaom
ផ្កា	pʰkaː
ផ្កាយ	pʰkaːj
ផ្គង់	pʰkŭəŋ
ផ្គត់	pʰkŭət
ផ្គរ	pʰkɔː
ផ្គាប់	pʰkŏəp
ផ្គាំ	pʰkŏəm
ផ្គុំ	pʰkum
ផ្ងូត	pʰŋout
ផ្ចង់	pʰcɑŋ
ផ្ចាញ់	pʰcaɲ
ផ្ចិត	pʰcət
ផ្ញើ	pʰɲaə
ផ្ដន្ទា	pɗɑntiə
ផ្ដល់	pɗɑl
ផ្ដាច់	pɗac
ផ្ដាសាយ	pɗaːhsaːj
ផ្ដាំ	pɗam
ផ្ដុស	pɗoh
ផ្ដុំ	pɗom
ផ្ដួល	pɗuəl
ផ្ដើម	pɗaəm
ផ្ដៀង	pɗiəŋ
ផ្ដោត	pɗaot
ផ្ទក់	pʰtŭəʔ
ផ្ទាត់	pʰtŏət
ផ្ទាប់	pʰtŏəp
ផ្ទាល់	pʰtŏəl
ផ្ទាំង	pʰtĕəŋ
ផ្ទឹម	pʰtɨm
ផ្ទុក	pʰtuk
ផ្ទុយ	pʰtuj
ផ្ទុះ	pʰtuh
ផ្ទួន	pʰtuən
ផ្ទៀង	pʰtiəŋ
ផ្ទៃ	pʰtɨj
ផ្ទំ	pʰtum
ផ្ទះ	pʰtĕəh
ផ្នូក	pʰnouk
ផ្នូរ	pʰnou
ផ្នួស	pʰnuəh
ផ្នែក	pʰnaek
ផ្រូក្រាមមីង	proukraːmmiːŋ
ផ្លរីដា	pʰlɑːriːɗaː
ផ្លាក	pʰlaːʔ
ផ្លាញ	pʰlaːɲ
ផ្លាស់	pʰlah
ផ្លាហ្សា	pʰlaːzaː
ផ្លិត	pʰlət
ផ្លុំ	pʰlom
ផ្លូវ	pʰləw
ផ្លើស	pʰlaəh
ផ្លេក	pʰleːk
ផ្លែ	pʰlae
ផ្លែង	pʰlaeŋ
ផ្លោក	pʰlaok
ផ្លោង	pʰlaoŋ
ផ្លោត	pʰlaot
ផ្លោះ	pʰlɑh
ផ្សង	pʰsɑːŋ
ផ្សាយ	pʰsaːj
ផ្សារ	pʰsaː
ផ្សាំង	pʰsaŋ
ផ្សិត	pʰsət
ផ្សើម	pʰsaəm
ផ្សេង	pʰseːŋ
ផ្សែង	pʰsaeŋ
ផ្សោត	pʰsaot
ផ្សោះ	pʰsɑh
ផ្សំ	pʰsɑm
ផ្អក	pʔɑːʔ
ផ្អប	pʔɑːp
ផ្អាក	pʔaːʔ
ផ្អួរ	pʔuə
ផ្អើល	pʔaəl
ផ្អៀង	pʔiəŋ
ផ្អែក	pʔaek
ផ្អែម	pʔaem
ព	pɔː
ពង	pɔːŋ
ពង្រាប	pŭəŋriəp
ពង្រាយ	pŭəŋriəj
ពង្រីក	pŭəŋriːk
ពង្រឹង	pŭəŋrɨŋ
ពង្រឹល	pŭəŋrɨl
ពង្រូល	pŭəŋruːl
ពង្រោះ	pŭəŋrŭəh
ពញា	pʰɲiə
ពណ៌	pŏə
ពណ៌នា	pŏənaʔniə
ពណ្ណរាយ	pŭənnaʔriəj
ពត់	pŭət
ពត៌មាន	pŏəɗɑːmiən
ពន្ធ	pŭən
ពន្ធនាគារ	pŏəntɔniəkiə
ពន្ធន៍	pŏən
ពន្ធភាព	pŭəntʰĕəʔpʰiəp
ពន្យល់	pŭənjŭəl
ពន្យារ	pŭənjiə
ពន្លាក	pŭənliəʔ
ពន្លឺ	pŭənlɨː
ពន្លុត	pŭənlut
ពន្លើស	pŭənləːh
ពន្លឿន	pŭənlɨən
ពន្លៃ	pŭənlɨj
ពន្លោត	pŭənloːt
ពពក	pɔpɔːʔ
ពពាន	pɔpiən
ពពិល	pɔpɨl
ពពុះ	pɔpuh
ពពួក	pɔpuəʔ
ពពែ	pɔpɛː
ពភក់	pɔpʰŭəʔ
ពភ្លើ	pɔpʰləː
ពល	pŭəl
ពលកម្ម	pŭəllĕəʔkɑːmmɔː
ពលករ	pŭəlkɑː
ពលជីវី	pŭəlciːʋiː
ពលរដ្ឋ	pŭəllĕəʔrŏət
ពលី	pĕəʔliː
ពស់	pŭəh
ពហុ	pĕəʔhuʔ
ពហុកោណ	pĕəʔhukaon
ពហុធា	pĕəʔhutʰiə
ពាក់	pĕəʔ
ពាក្យ	piəʔ
ពាង	piəŋ
ពាណិជ	piənɨc
ពាណិជ្ជ	piənɨc
ពាណិជ្ជកម្ម	piənɨccĕəʔkam
ពាទ្យ	piət
ពាន	piən
ពានា	piəniə
ពាន់	pŏən
ពាម	piəm
ពាយុ	piəjuʔ
ពាយ័ព្យ	piəjŏəp
ពារ	piə
ពាល	piəl
ពាល់	pŏəl
ពាំង	pĕəŋ
ពិការ	pikaː
ពិឃាដ	pikʰiət
ពិឃាត	pikʰiət
ពិចារណា	picaːraʔnaː
ពិជ	pɨc
ពិណ	pɨn
ពិត	pɨt
ពិតាន	pitaːn
ពិទូរ្យ	pituː
ពិទ្រុម	pɨtrum
ពិធាន	pitʰiən
ពិធី	pitʰiː
ពិធុរ	pitʰuʔ
ពិនិត្យ	pinɨt
ពិន័យ	pinɨj
ពិន្ទង	pɨntɔːŋ
ពិន្ទុ	pɨntuʔ
ពិន្ទុរេខីយ	pintureikʰəj
ពិបាក	piɓaːʔ
ពិផាត	pipʰaːt
ពិពណ៌នា	pipŏəniə
ពិពិធ	pipɨt
ពិពិធកម្ម	pipɨttʰĕəʔkam
ពិព័ណ៌	pipŏə
ពិព័រណ៍	pipŏə
ពិភព	pipʰup
ពិភាក្សា	pipʰiəkʰsaː
ពិរុទ្ធ	pirut
ពិរុទ្ធជន	piruttʰĕəʔcŭən
ពិរុទ្ធិកជន	piruttʰikaʔcŭən
ពិរោធ	piroːt
ពិល	pɨl
ពិស	pɨh
ពិសា	pisaː
ពិសាខ	pisaːʔ
ពិសិដ្ឋ	pisət
ពិសេស	pisaeh
ពិសោធ	pisaot
ពិសោធន៍	pisaot
ពិឡារ	pilaː
ពី	piː
ពីង	piːŋ
ពីជគណិត	piːcĕəʔkĕəʔnət
ពីជៈ	piːcĕəʔ
ពីតាករ	piːtaːkɑː
ពីរ	piː
ពីរោះ	piːrŭəh
ពឹង	pɨŋ
ពុក	puk
ពុង	puŋ
ពុត	put
ពុទ្ធ	put
ពុទ្ធិក	puttʰɨk
ពុទ្ធោ	puttʰoː
ពុធ	put
ពុម្ព	pum
ពុល	pul
ពុំ	pum
ពុំងា	pumŋiə
ពុះ	puh
ពូ	puː
ពូក	puːk
ពូជ	puːc
ពូត	puːt
ពូល	puːl
ពួក	puəʔ
ពួកម៉ាក	puəʔmaːʔ
ពួត	puət
ពួន	puən
ពួរ	puə
ពៀរ	piə
ពេក	peik
ពេចន៍	pɨc
ពេជ្ឈឃាដ	pɨccʰĕəʔkʰiət
ពេជ្ឈឃាត	pɨccʰĕəʔkʰiət
ពេជ្រ	pɨc
ពេញ	pɨɲ
ពេទ្យ	pɛːt
ពេល	peːl
ពេស្យា	peihsjaː
ពេស្យាស្ថាន	peihsjaːstʰaːn
ពែង	pɛːŋ
ពែរមី	pɛːmiː
ពែរ្ស	pɛːsɑː
ពោត	poːt
ពោធិ	poːtʰiʔ
ពោធិសត្វ	poːtʰisat
ពោធិ៍	poː
ពោធិ៍សាត់	poːsat
ពោល	poːl
ពោះ	pŭəh
ពៅ	pɨw
ពំនាល់	pumnŏəl
ព័ត	pŏət
ព័ត៌មាន	pŏəɗɑːmiən
ព័ទ្ធ	pŏət
ព័ន្ធ	pŏən
ព័ន្ធុ	pŏəntʰuʔ
ព័រទុយហ្គាល់	pŏətujgŏəl
ព័រម៉ូរេសប៊ី	pŏəmoureisɓiː
ព្កុល	pʰkol
ព្នង	pʰnɔːŋ
ព្នាយ	pʰniəj
ព្នៅ	pʰnɨw
ព្យញ្ជន	pʰjŭəɲcĕəʔnĕəʔ
ព្យញ្ជនៈ	pʰjŭəɲcĕəʔnĕəʔ
ព្យតិហារ	pʰjĕəʔtehaː
ព្យាករ	pʰjiəkɑː
ព្យាករណ៍	pʰjiəkɑː
ព្យាការី	pʰjiəkaːrəj
ព្យាង្គ	pʰjiəŋ
ព្យាធិ	pʰjiətʰiʔ
ព្យាធិ៍	pʰjiət
ព្យាបារ	pʰjiəɓaː
ព្យាបាល	pʰjiəɓaːl
ព្យាម	pʰjiəm
ព្យាយាម	pʰjiəjiəm
ព្យុងយ៉ាង	pʰjuŋjaːŋ
ព្យុះ	pʰjuh
ព្យួរ	pʰjuə
ព្រនង់	prɔnŭəŋ
ព្រម	prɔːm
ព្រមាន	prɔmiən
ព្រលឹង	prɔlɨŋ
ព្រលឹត	prɔlɨt
ព្រលឹម	prɔlɨm
ព្រហក់	prɔhŭəʔ
ព្រហស្បតិ៍	prɔhŏəh
ព្រហស្បត្ណិ	prɔhŏəh
ព្រហើន	prɔhaən
ព្រហ្ម	prum
ព្រហ្មចារិភាព	prummĕəʔcaːrepʰiəp
ព្រហ្មញ្ញ	prummaɲ
ព្រហ្មណ្យ	prumman
ព្រហ្មទណ្ឌ	prummĕəʔtŏən
ព្រាង	priəŋ
ព្រាន	priən
ព្រាប	priəp
ព្រាយ	priəj
ព្រាវ	priəw
ព្រិច	prɨc
ព្រិល	prɨl
ព្រីង	priːŋ
ព្រីស	priːh
ព្រីស្ទីណា	priːstiːnaː
ព្រឹក	prɨk
ព្រឹក្ស	prɨk
ព្រឹត្តិ	prɨt
ព្រឹត្តិការណ៍	prɨttekaː
ព្រឹត្តិប័ត្រ	prɨtteɓat
ព្រឹទ្ធ	prɨt
ព្រឹទ្ធសភា	prɨtsaʔpʰiə
ព្រឹន្ទ	prɨn
ព្រុចសែល	prucsael
ព្រុយណេ	prujneː
ព្រុស	pruh
ព្រូន	pruːn
ព្រួញ	pruəɲ
ព្រួយ	pruəj
ព្រួស	pruəh
ព្រើល	prəːl
ព្រេង	preiŋ
ព្រែ	prɛː
ព្រែក	prɛːk
ព្រៃ	prɨj
ព្រៃវែង	prɨjʋɛːŋ
ព្រោន	proːn
ព្រោះ	prŭəh
ព្រំ	prum
ព្រះ	prĕəh
ព្រះតេជព្រះគុណ	prĕəhtəcprĕəhkun
ព្រ័ត្រ	prŏət
ភ	pʰɔː
ភក់	pʰŭəʔ
ភក្ខ	pʰĕəʔ
ភក្តី	pʰĕəʔkɗəj
ភក្តីភាព	pʰĕəʔkɗəjpʰiəp
ភក្ត្រ	pʰĕəʔ
ភក្ស	pʰĕəʔ
ភក្សា	pʰĕəʔkʰsaː
ភណ្ឌាគារ	pʰŏənɗiəkiə
ភទ្របទ	pʰŏəttrĕəʔɓɑːt
ភព	pʰup
ភយន្តរាយ	pʰĕəʔjŏəntaʔraːj
ភយូបទ្រព	pʰĕəʔjuːpaʔtrup
ភរ	pʰɔː
ភរិយា	pʰĕəʔrijiə
ភវ័ន	pʰĕəʔʋŏən
ភស្តុ	pʰŏəh
ភាគ	pʰiəʔ
ភាគី	pʰiəkiː
ភាព	pʰiəp
ភាពយន្ត	pʰiəpjŭən
ភារ	pʰiə
ភារវត្ថុ	pʰiərĕəʔʋŏəttʰoʔ
ភារៈ	pʰiərĕəʔ
ភាវរស់	pʰiəʋĕəʔrŭəh
ភាសា	pʰiəsaː
ភាស៊ី	pʰiəsiː
ភិក្ខុ	pʰɨkkʰoʔ
ភិរុណ	pʰirun
ភី	pʰiː
ភីហ្សា	pʰiːzaː
ភីឡាដេលផ្យា	pʰiːlaːɗeːlpʰjaː
ភូគោល	pʰuːkoːl
ភូត	pʰuːt
ភូម	pʰuːm
ភូមធ្យរេខា	pʰuːmĕəʔtʰjĕəʔreikʰaː
ភូមរាវិទ្យា	pʰuːmĕəʔriəʋɨttʰjiə
ភូមា	pʰuːmiə
ភូមិ	pʰuːm
ភូមិន្ទ	pʰuːmɨn
ភូមិសាស្ត្រ	pʰuːmisaːh
ភូមិសាស្ត្រិន	pʰuːmisaːhstrən
ភូរាល	pʰuːriəl
ភួង	pʰuəŋ
ភួយ	pʰuəj
ភើ	pʰəː
ភឿន	pʰɨən
ភៀស	pʰiəh
ភេ	pʰei
ភេទ	pʰeit
ភេនឃ្វីន	pʰeinkʰʋiːn
ភេរវជន	pʰeirĕəʔʋĕəʔcŭən
ភេរវនិយម	pʰeirĕəʔʋĕəʔnijum
ភេរវារម្មណ៍	pʰeirĕəʔʋiərɑm
ភេសជ្ជ	pʰeisac
ភេសជ្ជាគារ	pʰeisacciəkiə
ភេសជ្ជៈ	pʰeisaccĕəʔ
ភោ	pʰoː
ភោគ	pʰoːk
ភោគសម្ប័ទ	pʰoːkĕəʔsɑmɓat
ភោជន	pʰoːcŭən
ភោជនាគារ	pʰoːcĕəʔniəkiə
ភោជនីយ	pʰoːcĕəʔniː
ភោជនីយដ្ឋាន	pʰoːcĕəʔniːjĕəʔtʰaːn
ភោជ្ជសាលី	pʰoːcsaːləj
ភ័ព្វ	pʰŏəp
ភ័យ	pʰɨj
ភ្ងា	pʰŋiə
ភ្ជង់	pʰcŭəŋ
ភ្ជាប់	pʰcŏəp
ភ្ជុំ	pʰcum
ភ្ជួរ	pʰcuə
ភ្ញាក់	pʰɲĕəʔ
ភ្ញៀវ	pʰɲiəw
ភ្នាក់	pʰnĕəʔ
ភ្នាល់	pʰnŏəl
ភ្នាស	pʰniəh
ភ្នែក	pʰnɛːk
ភ្នំ	pʰnum
ភ្រូណ	pruːn
ភ្រូណា	pruːnaː
ភ្រូន	pruːn
ភ្លាម	pʰliəm
ភ្លាំង	pʰlĕəŋ
ភ្លឺ	pʰlɨː
ភ្លុក	pʰluk
ភ្លុយអរ	pʰlujʔɑː
ភ្លើ	pʰləː
ភ្លើង	pʰləːŋ
ភ្លៀង	pʰliəŋ
ភ្លេង	pʰleiŋ
ភ្លេច	pʰlɨc
ភ្លែត	pʰlɛːt
ភ្លោះ	pʰlŭəh
ភ្លៅ	pʰlɨw
ម	mɔː
មក	mɔːʔ
មករា	mĕəʔkaʔraː
មកុដ	mĕəʔkot
មក្លឿ	mĕəʔkʰlɨə
មង្គល	mŭəŋkŭəl
មង្ឃុត	mŭəŋkʰut
មច្ឆព័ន្ធ	maccʰaʔpŏən
មច្ឆា	maccʰaː
មច្ឆានុ	maccʰaːnuʔ
មជ្ជ	maccĕəʔ
មជ្ឈដ្ឋាន	maccʰĕəʔtʰaːn
មជ្ឈន្តិកកាល	maccʰŏəntekaʔkaːl
មជ្ឈមណ្ឌល	maccʰĕəʔmŭənɗŭəl
មជ្ឈិម	maccʰɨm
មឈូស	mɔcʰuːh
មណី	mĕəʔniː
មណ្ឌល	mŭənɗŭəl
មណ្ឌលគិរី	mɔːnɗɔːlkiriː
មតិ	mĕəʔteʔ
មត៌ក	mɔtɑːʔ
មត្ត	mat
មត្តកសាសន៍	mattaʔkaʔsaːh
មត្តេយ្យសាលា	mattəjjĕəʔsaːlaː
មធុ	mĕəʔtʰuʔ
មធុរជាតិ	mĕəʔtʰurĕəʔciət
មធ្យម	mĕəʔtʰjum
មធ្យោបាយ	mattʰjoːɓaːj
មន	mɔːn
មនសិការ	mĕəʔnĕəʔsekaː
មនុស្ស	mɔnuh
មនុស្សគ្រាស	mĕəʔnuhsaʔkriəh
មនុស្សជាតិ	mĕəʔnuhsaʔciət
មនោ	mĕəʔnoː
មន្ត	mŭən
មន្ត្រ	mŭən
មន្ត្រី	mŭəntrəj
មន្ទីរ	mŭəntiː
មមាញ	mɔmiəɲ
មមាល	mɔmiəl
មមី	mɔmiː
មមីស	mɔmiːh
មមែ	mɔmɛː
មមៃ	mɔmɨj
មមោក	mɔmoːk
មយូរ	mĕəʔjuː
មយូរី	mĕəʔjuːriː
មរកត	mĕəʔrĕəʔkɑt
មរតក	mɔːrɨɗɑʔ
មសូរ	mĕəʔsou
មហទ្ធន	mĕəʔhattʰŭən
មហន្ត	mĕəʔhɑntaʔ
មហន្តរាយ	mĕəʔhɑntaʔraːj
មហា	mĕəʔhaː
មហាក្សត្រ	mĕəʔhaːkʰsat
មហាជន	mɔhaːcŭən
មហាផ្ទៃ	mɔːhaːpʰtɨj
មហារាជ	mĕəʔhaːriəc
មហារីក	mɔhaːriːk
មហាវិទ្យាល័យ	mɔhaːʋitʰjiəlaj
មហាសមុទ្រ	mĕəʔhaːsaʔmot
មហេសី	mĕəʔheːsəj
មហោរស្រព	mĕəʔhaosrɑp
មហោរី	mĕəʔhaoriː
មហោស្រព	mĕəʔhaosrɑp
មា	miə
មាគសិរ	miəkseʔ
មាគ៌ា	miəkiə
មាឃ	miəʔ
មាតា	miəɗaː
មាតិកា	miətekaː
មាតិកានុក្រម	miətekaːnukrɑm
មាតុ	miətoʔ
មាតុប្រទេស	miətoprɑːteih
មាតុភូមិ	miətopʰuːm
មាត់	mŏət
មាត់ស្បូន	mŏətsɓoun
មាត្រដ្ឋាន	miətrattʰaːn
មាត្រា	miətraː
មាន	miən
មានិត	miənɨt
មាន់	mŏən
មាយា	miəjiə
មារ	miə
មាល័យ	miəlɨj
មាស	miəh
មាំ	mŏəm
មិគសិរ	mikĕəʔseː
មិច	mɨc
មិច្ឆា	mɨccʰaː
មិញ	mɨɲ
មិត្ត	mɨt
មិត្តភក្តិ	mɨttaʔpʰĕəʔ
មិត្តភាព	mɨttaʔpʰiəp
មិថុន	mitʰon
មិថុនា	mitʰonaː
មិទ្ធៈ	mɨttʰĕəʔ
មិន	mɨn
មិល្លីក្រាម	mɨlliːkraːm
មិល្លីម៉ែត្រ	mɨlliːmaet
មី	miː
មីក្រុប	miːkrop
មីក្រូ	miːkrou
មីក្រូទស្សន៍	miːkroutŭəh
មីក្រូវ៉េវ	miːkrouʋeːw
មីង	miːŋ
មីឈីហ្គេន	miːcʰiːgein
មីតូកុងទ្រី	miːtoukoŋtriː
មីតូស	miːtouh
មីន	miːn
មីនស្ក៍	miːn
មីនា	miːnaː
មីនីសូតា	miːniːsoutaː
មីយ៉ាន់ម៉ា	miːjanmaː
មីលីលីត្រ	miːliːliːt
មីសូប្រូស្តុល	miːsouproustol
មីស៊ីស៊ីបពី	miːsiːsiːppiː
មីស៊ូរី	miːsuːriː
មីហ្វេប្រីស្តូន	miːfeːprəjstoun
មឹក	mɨk
មុក្តា	muktaː
មុខ	muk
មុង	muŋ
មុជ	muc
មុត	mut
មុត្តា	muttaː
មុទិតា	mutitaː
មុន	mun
មុម	mum
មុំ	mum
មូត្រ	mout
មូត្រាស័យ	muːtraːsaj
មូល	muːl
មូលដ្ឋាន	muːlattʰaːn
មូលតា	muːlĕəʔtaː
មូលធន	muːlĕəʔtʰŭən
មូលនិធិ	muːlənitʰiʔ
មូលបត្រ	muːlĕəʔɓat
មូលភាព	muːlĕəʔpʰiəp
មូលសព្ទ	muːllaʔsap
មូលហេតុ	muːlĕəʔhaet
មូលាណូ	muːllanou
មូស	muːh
មូសិកទន្ត	muːsekaʔtŏən
មូស្គូ	muːskuː
មូស្លីម	muːsliːm
មូហាំម៉ាត់	muːhammat
មួក	muəʔ
មួយ	muəj
មួល	muəl
មើម	məːm
មើល	məːl
មឿង	mɨəŋ
មៀន	miən
មៀម	miəm
មេ	meː
មេកា	meikaː
មេឃ	meik
មេដាយ	meiɗaːj
មេតាន	meitaːn
មេត្តា	meittaː
មេត្រី	meitrəj
មេត្រីភាព	meitrəjpʰiəp
មេថុន	meitʰon
មេទនី	meitĕəʔniː
មេធាវី	meitʰiəʋiː
មេន	mein
មេសបាល	meisaʔɓaːl
មេសបាលី	meisaʔɓaːliː
មេសា	meisaː
មេស្ស៊ី	meihsiː
មែក	mɛːk
មែន	mɛːn
មោទកភាព	moːtĕəʔkaʔpʰiəp
មោទនភាព	moːtĕəʔnĕəʔpʰiəp
មោរៈ	moːrĕəʔ
មំសៈ	mĕəŋsaʔ
ម៉	mɑː
ម៉ង់កាណែស	mɑŋkaːnaeh
ម៉ប	mɑːp
ម៉ាក	maːʔ
ម៉ាកសី	maːksəj
ម៉ាកាវ	maːkaːw
ម៉ាក់ម៉ា	maʔmaː
ម៉ាក្ស	maːʔ
ម៉ាក្សនិយម	maːʔnijum
ម៉ាញ៉េ	maːɲei
ម៉ាញ៉េស្យូម	maːɲeːsjoum
ម៉ាដាហ្គាស្ការ	maːɗaːgiəskaː
ម៉ាឌ្រីដ	maːɗriːt
ម៉ាណាម៉ា	maːnaːmaː
ម៉ាត់	mat
ម៉ាទ្រីស	maːtriːh
ម៉ានហ្គា	maːngaː
ម៉ានីតូបា	maːniːtouɓaː
ម៉ានីល	maːniːl
ម៉ាន់ដាឡាយ	manɗaːlaːj
ម៉ាយ	maːj
ម៉ាយូណេស	maːjuːneːh
ម៉ារីលែន	maːriːlɛːn
ម៉ារ៉ុក	maːrok
ម៉ាលី	maːliː
ម៉ាល់ឌីវ	malɗiːw
ម៉ាល់តា	maltaː
ម៉ាស	maːh
ម៉ាសក៍	mah
ម៉ាសាឈូសេត	maːsaːcʰuːseːt
ម៉ាសេដ្វាន	maːseːtʋiən
ម៉ាសេដ្វានខាងជើង	maːseːɗʋaːnkʰaːŋcəːŋ
ម៉ាស៊ីន	maːsɨn
ម៉ាស៊ូត	maːsuːt
ម៉ាស់	mah
ម៉ាស្កាត	maːskaːt
ម៉ាស្សា	maːhsaː
ម៉ាឡាយូ	maːlaːjuː
ម៉ាឡាវី	maːlaːʋiː
ម៉ាឡេ	maːleː
ម៉ាឡេស៊ី	maːleːsiː
ម៉ាំ	mam
ម៉ិចស៊ិក	məcsɨk
ម៉ឺន	məɨn
ម៉ឺនុយ	məɨnuj
ម៉ុង	moŋ
ម៉ុងតេនីក្រូ	moŋteːniːkrou
ម៉ុងរ៉េអាល់	moŋreːʔal
ម៉ុងសាយ	moŋsaːj
ម៉ុងហ្គោល	moŋgoːl
ម៉ុងហ្គោលី	moŋguːliː
ម៉ុនតាណា	montaːnaː
ម៉ុលដូវ៉ា	molɗouʋaː
ម៉ូដ	mout
ម៉ូដសក់	moutsɑʔ
ម៉ូដឹម	mouɗəm
ម៉ូដេស្តូ	mouɗeːstou
ម៉ូដែល	mouɗael
ម៉ូណាកូ	mounaːkou
ម៉ូត	mout
ម៉ូតសក់	moutsɑʔ
ម៉ូតូ	moutou
ម៉ូតែល	moutael
ម៉ូទ័រ	moutŏə
ម៉ូនីទ័រ	mouniːtŏə
ម៉ូរីតានី	mouriːtaːniː
ម៉ូរីស	mouriːh
ម៉ូល	moul
ម៉ូលីបដែន	mouliːpɗaen
ម៉ូលេគុល	mouleikul
ម៉ូសំប៊ិក	mousɑmɓɨk
ម៉ូហ្កាឌីស្យូ	mougiəɗiːsjou
ម៉េច	məc
ម៉េត្រូ	meːtrou
ម៉ែ	mae
ម៉ែត្រ	maet
ម៉ែលប៊ន	maelɓɔːn
ម៉ៃ	maj
ម៉ៃស័ក	majsaʔ
ម៉ោង	maoŋ
ម៉ៅ	maw
ម័រហ្វីន	mŏəfiːn
ម្កាក់	mkaʔ
ម្ខាង	mkʰaːŋ
ម្ចាស់	mcah
ម្ជុល	mcul
ម្ជូរ	mcuː
ម្ឈូស	mcʰuːh
ម្ដង	mɗɑːŋ
ម្ដាយ	mɗaːj
ម្ដេច	mɗəc
ម្ទេស	mteih
ម្នាក់	mnĕəʔ
ម្នាស់	mnŏəh
ម្ភៃ	mpʰɨj
ម្យ៉ាង	mjaːŋ
ម្រាម	mriəm
ម្រឹត	mrɨt
ម្រុំ	mrum
ម្រេច	mrɨc
ម្រះ	mrĕəh
ម្លប់	mlup
ម្លិះ	mlih
ម្លូ	mluː
ម្ល៉េះ	mleh
ម្សាញ់	msaɲ
ម្សិល	msəl
ម្សេវ	mseːw
ម្សៅ	msaw
ម្ហូប	mhoup
ម្អម	mʔɑːm
យ	jɔː
យក	jɔːʔ
យក់	jŭəʔ
យក្ខ	jĕəʔ
យក្ស	jĕəʔ
យញ្ញ	jaɲ
យន្ត	jŭən
យន្តម័យ	jŭəntaʔmaj
យន្តសាស្ត្រ	jŭəntaʔsaːh
យន្តសិក្សា	jŭəntaʔsəksaː
យន្ត្រ	jŭən
យប់	jup
យម	jum
យល់	jŭəl
យស	juəh
យសោធរា	jĕəʔsaotʰĕəʔriə
យាន	jiən
យានដ្ឋាន	jiənaʔtʰaːn
យានិក	jiənɨk
យាម	jiəm
យាយ	jiəj
យីកេ	jiːkeː
យីហោ	jiːhao
យឹត	jɨt
យឺត	jɨːt
យុគ	juk
យុគល	jukŭəl
យុគលៈ	jukĕəʔlĕəʔ
យុត្តិ	jutteʔ
យុត្តិធម៌	juttetʰŏə
យុថ្កា	juttʰkaː
យុទ្ធ	jut
យុទ្ធការ	juttʰĕəʔkaː
យុទ្ធការី	juttʰĕəʔkaːrəj
យុទ្ធជន	juttʰĕəʔcŭən
យុទ្ធនា	juttʰĕəʔniə
យុទ្ធនាការ	juttʰĕəʔniəkaː
យុទ្ធនីតិ	juttʰĕəʔniːteʔ
យុទ្ធសាស្ត្រ	juttʰĕəʔsaːh
យុន	jun
យុវជន	juʋĕəʔcŭən
យុវតី	juʋĕəʔɗəj
យុវវ័យ	juʋĕəʔʋɨj
យុវៈ	juʋĕəʔ
យូ	juː
យូកុង	juːkoŋ
យូដូ	juːɗou
យូតា	juːtaː
យូថាហ៍	juːtʰaː
យូរ	juː
យូហ្គា	juːgiə
យូហ្គោស្លាវ	juːgoːslaːw
យួន	juən
យួរ	juə
យើង	jəːŋ
យេមែន	jeimɛːn
យេស៊ូ	jeisuː
យោគៈ	joːkĕəʔ
យោង	joːŋ
យោជន៍	joːc
យោធ	joːtʰĕəʔ
យោធនិយម	joːtʰĕəʔnijum
យោធា	joːtʰiə
យោនី	joːniː
យោបល់	joːɓɑl
យោមរាជ	joːmĕəʔriəc
យោល	joːl
យំ	jum
យ៉	jɑː
យ៉ាក	jaːʔ
យ៉ាង	jaːŋ
យ៉ាដាំ	jaːɗam
យ៉ាបា	jaːɓaː
យ៉ាប់	jap
យ៉េរ៉េវ៉ាន់	jeːreːʋan
យ័ន្ត	jŭən
រ	rɔː
រក	rɔːʔ
រកា	rɔkaː
រកាំ	rɔkam
រក្សសី	rĕəʔkʰsaʔsəj
រក្សសៈ	rĕəʔkʰsaʔsaʔ
រក្សា	rĕəʔkʰsaː
រខិត	rɔkʰət
រង	rɔːŋ
រងា	rɔŋiə
រងាវ	rɔŋiəw
រងើក	rɔŋəːk
រងៃ	rɔŋɨj
រង់	rŭəŋ
រង្គ	rŭəŋ
រង្គាជីព	rŭəŋkiəciːp
រង្គើ	rŭəŋkəː
រង្វង់	rŭəŋʋŭəŋ
រង្វាន់	rŭəŋʋŏən
រង្វាស់	rŭəŋʋŏəh
រង្វះ	rŭəŋʋĕəh
រង្សី	rĕəŋsəj
រចនា	raʔcaʔnaː
រជក	rĕəʔcuəʔ
រជ្ជៈ	raccĕəʔ
រញ្ជួយ	rŭəɲcuəj
រដក	rɔɗɑːʔ
រដូវ	rɔɗəw
រដោះ	rɔɗɑh
រដ្ឋ	rŏət
រដ្ឋទូត	rŏəttʰaʔtuːt
រដ្ឋធានី	rŏəttʰaʔtʰiəniː
រដ្ឋបាល	rŏəttʰaʔɓaːl
រដ្ឋបុរស	rŏətɓorɑh
រដ្ឋប្បវេណី	rŏəttʰappaʔʋeːniː
រដ្ឋសភា	rŏəttʰaʔsaʔpʰiə
រដ្ឋាភិបាល	rŏəttʰaːpʰiɓaːl
រណ	rĕəʔnaʔ
រណប	rɔnɑːp
រណសិរ្ស	rĕəʔnaʔseː
រណារ	rɔnaː
រណោបាយ	rɔnaoɓaːj
រណៈ	rĕəʔnaʔ
រតនគិរី	rŏətaʔnaʔkiriː
រតនត្រ័យ	rŏətaʔnaʔtraj
រតិ	rĕəʔteʔ
រតិកម្ម	rĕəʔtekam
រតិគ្រឹះ	rĕəʔtekrɨh
រត់	rŭət
រថ	rŭət
រថភ្លើង	rŭətpʰləːŋ
រទច្ឆេទី	rĕəʔtĕəʔcʰeːtiː
រទេះ	rɔteh
រនង	rɔnɔːŋ
រនាត	rɔniət
រនាល	rɔniəl
រនាស់	rɔnŏəh
រនាំង	rɔnĕəŋ
រន្ឋ	rŭən
រន្ឋគវេសី	ruəntʰĕəʔkĕəʔʋeisəj
រន្ទះ	rŭəntĕəh
រន្ធ	rŭən
របត់	rɔɓɑt
របប	rɔɓɑːp
របរ	rɔɓɑː
របស់	rɔɓɑh
របាទ	rɔɓaːt
របាយ	rɔɓaːj
របាល	rɔɓaːl
របាំ	rɔɓam
របាំង	rɔɓaŋ
របឹង	rɔɓəŋ
របុក	rɔɓok
របួស	rɔɓuəh
របើក	rɔɓaək
របៀង	rɔɓiəŋ
របៀប	rɔɓiəp
របេង	rɔɓeːŋ
របោច	rɔɓaoc
រពីង	rɔpiːŋ
រមណីយ	rĕəʔmĕəʔniːjĕəʔ
រមណីយដ្ឋាន	rĕəʔmĕəʔniːjĕəʔtʰaːn
រមត់	rɔmŭət
រមាស	rɔmiəh
រមាស់	rɔmŏəh
រមាំង	rɔmĕəŋ
រមៀត	rɔmiət
រម្ភា	rumpʰiə
រម្យ	rɑm
រយ	rɔːj
រយាង	rɔjiəŋ
រយៈ	rɔjĕəʔ
រលក	rɔlɔːʔ
រលក់	rɔlŭəʔ
រលត់	rɔlŭət
រលស់	rɔlŭəh
រលាក	rɔliəʔ
រលាយ	rɔliəj
រលឹក	rɔlɨk
រលឹម	rɔlɨm
រលុង	rɔluŋ
រលូត	rɔluːt
រលួយ	rɔluəj
រលួស	rɔluəh
រលែក	rɔlɛːk
រលំ	rɔlum
រវល់	rɔʋŭəl
រវាង	rɔʋiəŋ
រវៃ	rɔʋɨj
រវ៉ាន់ដា	rɔʋanɗaː
រស	rŭəh
រសាយនវិទ្យា	rĕəʔsaːjaʔnaʔʋitʰjiə
រសឹប	rɔsəp
រសៀល	rɔsiəl
រសោះ	rɔsɑh
រស់	rŭəh
រស្មី	rĕəʔsməj
រស្ស	rŏəhsaʔ
រហូត	rɔhout
រហើរ	rɔhaə
រហែ	rɔhae
រហ័ស	rɔhah
រអា	rɔʔaː
រអិល	rɔʔəl
រឥល	rɔʔəl
រឭក	rɔlɨk
រា	riə
រាក	riəʔ
រាក្ស័ស	riəkʰsah
រាគ	riəʔ
រាង	riəŋ
រាជ	riəc
រាជធានី	riəctʰiəniː
រាជា	riəciə
រាជាណាចក្រ	riəciənaːcaʔ
រាជាធិបតេយ្យ	riəciətʰɨppaʔtaj
រាជាធិរាជ	riəciətʰiriəc
រាជិនី	riəciniː
រាជ្យ	riəc
រាត្រី	riətrəj
រាន	riən
រាប	riəp
រាប់	rŏəp
រាមញ្ញ	riəmaɲɲĕəʔ
រាយ	riəj
រាល់	rŏəl
រាវ	riəw
រាសី	riəsəj
រាសីចក្រ	riəsəjcaʔ
រាស់	rŏəh
រាស្ត្រ	riəh
រាហុល	riəhul
រាហុ៍	riə
រាំ	rŏəm
រាំង	rĕəŋ
រាំវង់	rŏəmʋŭəŋ
រិទ្ធិ	rɨt
រិល	rɨl
រិះ	rih
រិះគិត	rihkɨt
រី	riː
រីក	riːk
រីត	riːt
រីបូសូម	riːɓousoum
រីហ្កា	riːgiə
រឹង	rɨŋ
រឹត	rɨt
រឹល	rɨl
រឺត	rɨːt
រុក	ruk
រុក្ខ	ruk
រុក្ខជាតិ	rukkʰaʔciət
រុក្ខរស	rukkʰaʔrŭəh
រុក្ខា	rukkʰaː
រុង	ruŋ
រុជា	ruciə
រុញ	ruɲ
រុយ	ruj
រុយតេញ៉ូម	rujteːɲoum
រុយប៊ីដ្យូម	rujɓiːɗjoum
រុស្សី	ruhsəj
រុស្ស៊ី	rusiː
រុំ	rum
រូ	ruː
រូង	ruːŋ
រូត	ruːt
រូប	ruːp
រូបធាតុ	ruːpaʔtʰiət
រូបមន្ត	ruːpmŭən
រូបយន្ត	ruːpaʔjŭən
រូបវិទ្យា	ruːppaʔʋitʰjiə
រូបសព្ទតា	ruːpsaptĕəʔtaː
រូបសាស្ត្រ	ruːppaʔsaːh
រូបាទ្យារម្មណ៍	ruːpaːtʰjiərɑm
រូបិយវត្ថុ	ruːpəjjĕəʔʋŏəttʰoʔ
រូម៉ានី	ruːmaːniː
រូស	ruːh
រួច	ruəc
រួញ	ruəɲ
រួប	ruəp
រួម	ruəm
រួយ	ruəj
រួល	ruəl
រើ	rəː
រើស	rəːh
រឿង	rɨəŋ
រៀង	riəŋ
រៀន	riən
រៀប	riəp
រៀល	riəl
រេខាគណិត	reikʰaːkĕəʔnət
រេញ	rɨɲ
រេណបថ	reinaʔɓɑːt
រេផៈ	reipʰaʔ
រេស៊ីស្ទ័រ	reisiːstŏə
រែក	rɛːk
រៃ	rɨj
រោគ	roːk
រោគី	roːkiː
រោង	roːŋ
រោទ៍	roː
រោម	roːm
រោយ	roːj
រោរព	roːrup
រោល	roːl
រោហិណី	roːheniː
រំខាន	rumkʰaːn
រំចេក	rumceːk
រំដួល	rumɗuəl
រំដេង	rumɗeːŋ
រំដោះ	rumɗɑh
រំពត់	rumpŭət
រំពាត់	rumpŏət
រំពឹង	rumpɨŋ
រំពុះ	rumpuh
រំលង	rumlɔːŋ
រំលស់	rumlŭəh
រំលាយ	rumliəj
រំលឹក	rumlɨk
រំលូត	rumluːt
រំលែក	rumlɛːk
រំលោភ	rumloːp
រំលំ	rumlum
រំសេវ	rumseːw
រំសោះ	rumsɑh
រំហូរ	rumhou
រំហួត	rumhuət
រំហែ	rumhae
រំអិល	rumʔəl
រំឭក	rumlɨk
រះ	rĕəh
រ៉	rɑː
រ៉ក	rɑːʔ
រ៉ង់ហ្គូន	rɑŋguːn
រ៉ស់	rɑh
រ៉ាដា	raːɗaː
រ៉ាឌីកាល់	raːɗiːkal
រ៉ាឌីយោ	raːɗiːjoː
រ៉ាបា	raːɓaː
រ៉ាប៊ី	raːɓiː
រ៉ាប់	rap
រ៉ាមេន	raːmein
រ៉ាម៉ាដាន	raːmaːɗaːn
រ៉ឺកុម្មងដេ	rəɨkommɑŋɗeː
រ៉ឺត្រែត	rəɨtraet
រ៉ុកកែត	rokkaet
រ៉ុយ	roj
រ៉ូដអៃឡិន្ដ	routʔajlən
រ៉ូដ្យូម	rouɗjoum
រ៉ូម	roum
រ៉ូម៉ង់	roumɑŋ
រ៉េទីន	reːtiːn
រ៉េអ័កស្យុង	reːʔaksjoŋ
រ៉ែ	rae
រ៉ៃក្យាវិក	rajkjaːʋɨk
រ៉ោតទ័រ	raottŏə
រ័ក្ស	rĕəʔ
ល	lɔː
លក់	lŭəʔ
លក្ខ	lĕəʔ
លក្ខការ	lĕəʔkʰaʔ
លក្ខខណ្ឌ	lĕəʔkʰan
លក្ខណៈ	lĕəʔkʰaʔnaʔ
លក្ស្មី	lĕəksməj
លង	lɔːŋ
លង់	lŭəŋ
លង្វែក	lŭəŋʋɛːk
លជ្ជាភាព	lacciəpʰiəp
លញ្ឆករ	laɲcʰaʔkɑː
លត	lɔːt
លតា	lĕəʔɗaː
លត់	lŭət
លទ្ធ	lattʰĕəʔ
លទ្ធកម្ម	lattʰĕəʔkam
លទ្ធផល	lattʰĕəʔpʰɑːl
លទ្ធភាព	lattʰĕəʔpʰiəp
លទ្ធិ	lattʰiʔ
លន់	lŭən
លប	lɔːp
លម៉ើ	lĕəʔmaə
លម្អ	lumʔɑː
លយ	lɔːj
លលា	lĕəʔliə
លលាដ៍	lɔliə
លស់	lŭəh
លា	liə
លាក់	lĕəʔ
លាក់ពុត	lĕəʔput
លាង	liəŋ
លាជ	liəc
លាញ	liəɲ
លាន	liən
លាន់	lŏən
លាប	liəp
លាប់	lŏəp
លាភ	liəp
លាមក	liəmŭəʔ
លាមកកម្ម	liəmĕəʔkaʔkam
លាមកជន	liəmĕəʔkaʔcŭən
លាមកភាព	liəmĕəʔkaʔpʰiəp
លាយ	liəj
លាវ	liəw
លាវ័ណ្យ	liəʋŏən
លាស់	lŏəh
លាំងសាត	lĕəŋsaːt
លិខិត	likʰət
លិង្គ	lɨŋ
លិច	lɨc
លិចតិនស្តាញ	lɨctənstaːɲ
លិឍ	lɨt
លិទ្ធ	lɨt
លិនជី	lɨnciː
លិបិការ	lipekaː
លិម	lɨm
លី	liː
លីកង់	liːkɑŋ
លីង	liːŋ
លីច្យូម	liːcjoum
លីត្រ	liːt
លីទុយអានី	liːtujʔaːniː
លីបង់	liːɓɑŋ
លីបេរីយ៉ា	liːɓeːriːjaː
លីប៊ី	liːɓiː
លីពីត	liːpiːt
លីម	liːm
លីមីត	liːmiːt
លីវ	liːw
លីសបោន	liːsɓaon
លីឡ្ហា	liːlhaː
លឺ	lɨː
លុក	luk
លុង	luŋ
លុចសំបួ	lucsɑmɓuə
លុត	lut
លុន	lun
លុប	lup
លុម្បក	lumɓɑʔ
លុយ	luj
លុះ	luh
លូ	luː
លូក	luːk
លូត	luːt
លូន	luːn
លួង	luəŋ
លួច	luəc
លួស	luəh
លើ	ləː
លើក	ləːk
លើស	ləːh
លឿង	lɨəŋ
លឿន	lɨən
លៀង	liəŋ
លៀស	liəh
លេខ	leːk
លេខនា	leikʰaʔnaː
លេខនី	leikʰaʔniː
លេខា	leikʰaː
លេខាធិការ	leikʰaːtʰikaː
លេង	leiŋ
លេច	lɨc
លេណ	lein
លេណក	leinɑʔ
លេនីន	leiniːn
លេនីននិយម	leiniːnnijum
លេប	leip
លេវីវិន័យ	leiʋiːʋinɨj
លេស	leih
លែក	lɛːk
លែង	lɛːŋ
លៃ	lɨj
លោ	loː
លោក	loːk
លោការីត	loːkaːriːt
លោកិយ	loːkəj
លោកុប្បត្តិ	loːkupɓat
លោត	loːt
លោម	loːm
លោហធាតុ	loːhaʔtʰiət
លោហាករ	loːhaːkɑː
លោហិត	loːhət
លោហិតាគារ	loːhetaːkiə
លោហៈ	loːhaʔ
លោះ	lŭəh
លំចង់	lumcɑŋ
លំដាប់	lumɗap
លំនៅ	lumnɨw
លំនៅឋាន	lumnɨwtʰaːn
លំបាក	lumɓaːʔ
លំពង់	lumpŭəŋ
លំពែង	lumpɛːŋ
លំពោង	lumpoːŋ
លំហ	lumhɑː
លំហាត់	lumhat
លំហែ	lumhae
លំអ	lumʔɑː
លំអង	lumʔɑːŋ
លំអិត	lumʔət
លំអៀង	lumʔiəŋ
លំអោត	lumʔaot
លះ	lĕəh
ល័ក្ត	lĕəʔ
ល័ខ	lĕəʔ
ល្ខោន	lkʰaon
ល្ង	lŋɔː
ល្ងង់	lŋŭəŋ
ល្ងាច	lŋiəc
ល្បក់	lɓɑʔ
ល្បង	lɓɑːŋ
ល្បី	lɓəj
ល្បឺ	lɓəɨ
ល្បុក្កតោ	lɓokkaʔtao
ល្បួង	lɓuəŋ
ល្បឿន	lɓɨən
ល្បែង	lɓaeŋ
ល្បះ	lɓah
ល្ពៅ	lpɨw
ល្មម	lmɔːm
ល្មុង	lmuŋ
ល្មុត	lmut
ល្មូន	lmuːn
ល្មើស	lməːh
ល្ម៉ើ	lmaə
ល្វា	lʋiə
ល្វីង	lʋiːŋ
ល្វីហ្ស៊ីណា	lʋiːziːnaː
ល្វឹង	lʋɨŋ
ល្វើយ	lʋəːj
ល្វែង	lʋɛːŋ
ល្ហ	lhɑː
ល្ហុង	lhoŋ
ល្ហែ	lhae
ល្អ	lʔɑː
ល្អង	lʔɑːŋ
ល្អាន	lʔaːn
ល្អិត	lʔət
ល្អី	lʔəj
ល្អៀង	lʔiəŋ
វ	ʋɔː
វក	ʋɔːʔ
វក្កំ	ʋĕəʔkaŋ
វគ្គ	ʋĕəʔ
វគ្គីករណ៍	ʋĕəʔkiːkaː
វង់	ʋŭəŋ
វង្វេង	ʋŭəŋʋeiŋ
វង្ស	ʋŭəŋ
វចន	ʋaccaʔnaʔ
វចនតា	ʋaccaʔnaʔtaː
វចនានុក្រម	ʋĕəʔcaʔnaːnukrɑm
វចនៈ	ʋaccaʔnaʔ
វចី	ʋĕəʔcəj
វច្ច	ʋaccaʔ
វជីរ	ʋĕəʔciː
វឌ្ឍន	ʋŏəttʰĕəʔnĕəʔ
វឌ្ឍនភាព	ʋŏəttʰĕəʔnĕəʔpʰiəp
វឌ្ឍនៈ	ʋŏəttʰĕəʔnĕəʔ
វឌ្ឍន៍	ʋŏət
វណ	ʋĕəʔnaʔ
វណវេឋន៍	ʋĕəʔnaʔʋeit
វណិជ្ជា	ʋĕəʔnɨcciə
វណ្ណ	ʋannaʔ
វណ្ណា	ʋannaː
វណ្ណាង្គ	ʋannaːŋ
វណ្ណៈ	ʋannaʔ
វត្ត	ʋŏət
វត្តមាន	ʋŏəttaʔmaːn
វត្តមានកាល	ʋŏəttaʔmiənĕəʔkaːl
វត្តមានា	ʋŏəttaʔmaːnaː
វត្ថុ	ʋŏəttʰoʔ
វត្ស	ʋŏət
វត្សរ៍	ʋŏət
វធភូមិ	ʋĕəʔtʰĕəʔpʰuːm
វធូ	ʋĕəʔtʰuː
វន្ទា	ʋŏəntiə
វប្ប	ʋŏəppaʔ
វប្បធម៌	ʋŏəppaʔtʰŏə
វរ	ʋɔː
វរលញ្ឆករ	ʋĕəʔrĕəʔlaɲcʰaʔkɑː
វរ្ម័ន	ʋŏəman
វលី	ʋĕəʔliː
វល់	ʋŭəl
វល្លិ	ʋŏə
វសនដ្ឋាន	ʋĕəʔsaʔnattʰaːn
វស្សា	ʋŏəhsaː
វា	ʋiə
វាក្យ	ʋiəkjaʔ
វាក្យសព្ទ	ʋiəkjaʔsap
វាគុរា	ʋiəkuriə
វាគុរិក	ʋiəkurɨk
វាគ្មិន	ʋiəʔmɨn
វាង	ʋiəŋ
វាទ	ʋiət
វាទកៈ	ʋiətĕəʔkaʔ
វាយ	ʋiəj
វាយុ	ʋiəjuʔ
វារ	ʋiə
វារុណី	ʋiəruniː
វាល	ʋiəl
វាល	ʋiəlĕəʔ
វាវ	ʋiəw
វាសនដ្ឋាន	ʋiəsaʔnattʰaːn
វាសនា	ʋiəsaʔnaː
វាស់	ʋŏəh
វាំង	ʋĕəŋ
វិកប្ប	ʋikap
វិការ	ʋikaː
វិការដ្ឋាន	ʋikaːtʰaːn
វិក្កយបត្រ	ʋɨkkaʔjĕəʔɓat
វិគីភីឌា	ʋikiːpʰiːɗiə
វិចតូរីយ៉ា	ʋɨctouriːjaː
វិចត្រសាល	ʋicetraʔsaːl
វិចារកៈ	ʋicaːraʔkaʔ
វិចិត្រ	ʋicət
វិចិត្រករ	ʋicetraʔkɑː
វិចិត្រសាល	ʋicetraʔsaːl
វិច្ឆិកា	ʋɨccʰekaː
វិច្ឆេទ	ʋɨccʰaet
វិច្ឆេទកម្ម	ʋɨcceːtĕəʔkam
វិជយិន	ʋicĕəʔjɨn
វិជាតិ	ʋiciət
វិជ្ជមាន	ʋɨccĕəʔmiən
វិជ្ជមានាណូ	ʋɨccĕəʔmiəniənou
វិជ្ជា	ʋɨcciə
វិជ្ជាជីវៈ	ʋɨcciəciːʋĕəʔ
វិជ្ជុ	ʋɨccuʔ
វិញ	ʋɨɲ
វិញ្ញាណ	ʋɨɲɲiən
វិញ្ញាបនបត្រ	ʋɨɲɲiəpaʔnaʔɓat
វិញ្ញាសា	ʋɨɲɲiəsaː
វិតាល់	ʋital
វិថី	ʋitʰəj
វិទូ	ʋituː
វិទ្យា	ʋitʰjiə
វិទ្យាល័យ	ʋitʰjiəlaj
វិទ្យាសាស្ត្រ	ʋitʰjiəsaːh
វិទ្យាស្ថាន	ʋɨttʰjiəstʰaːn
វិទ្យុ	ʋitʰjuʔ
វិទ្យុសកម្ម	ʋitʰjusaʔkam
វិធវា	ʋitʰĕəʔʋiə
វិធាន	ʋitʰiən
វិធានការ	ʋitʰiənəkaː
វិធិ	ʋitʰiʔ
វិធី	ʋitʰiː
វិធីសាស្ត្រ	ʋitʰiːsaːh
វិនាទី	ʋiniətiː
វិនាស	ʋiniəh
វិនិយោគ	ʋinijoːk
វិន័យ	pinɨj
វិបត្តិ	ʋipatteʔ
វិបស្ចិត	ʋipahscət
វិបស្សនា	ʋipahsaʔnaː
វិបាក	ʋiɓaːʔ
វិបុល	ʋiɓol
វិប្បដិសារី	ʋɨppaʔɗesaːrəj
វិប្បយោគ	ʋɨppaʔjoːk
វិប្រយោគ	ʋɨppaʔjoːk
វិភាគ	ʋipʰiəʔ
វិមាន	ʋimiən
វិម្ហយសញ្ញា	ʋɨmhaʔjĕəʔsaɲɲaː
វិរាម	ʋiriəm
វិរុទ្ធ	ʋirut
វិរូបកាយ	ʋiruːpaʔkaːj
វិល	ʋɨl
វិលោកនៈ	ʋiloːkaʔnaʔ
វិវត្តន៍	ʋiʋŏət
វិសាល	ʋisaːl
វិសាលគម	ʋisaːlaʔkum
វិសាលវិហារ	ʋisaːlʋihiə
វិសុវ័ត	ʋisoʋŏət
វិសេស	ʋisaeh
វិសេសន	ʋiseːsaʔnaʔ
វិស័យ	ʋisaj
វិស្វករ	ʋɨhsʋaʔkɑː
វិហារ	ʋihiə
វិហារដ្ឋាន	ʋihaːrattʰaːn
វិហារៈ	ʋihaːrĕəʔ
វី	ʋiː
វីដេអូ	ʋiːɗeːʔou
វីតាមីន	ʋiːtaːmiːn
វីថិ	ʋitʰəj
វីមង្សា	ʋiːmĕəŋsaː
វីយែន	ʋiːjɛːn
វីយោឡុង	ʋiːjouloŋ
វីយ៉ូមីង	ʋiːjoumiːŋ
វីរ	ʋiːrĕəʔ
វីរជន	ʋiːrĕəʔcŭən
វីរបុរស	ʋiːrĕəʔɓorɑh
វីរភាព	ʋiːrĕəʔpʰiəp
វីរិយ	ʋiːrijĕəʔ
វីរុស	ʋiːruh
វីលនីស	ʋiːlniːh
វីលីនីស	ʋiːliːniːh
វីសាណូ	ʋiːsaːnou
វីស្កុនស៊ីន	ʋiːskonsiːn
វីស្គី	ʋiːskiː
វឺជីញ៉ា	ʋɨːciːɲaː
វឺម៉ុន	ʋɨːmon
វុឌ្ឍី	ʋuttʰiː
វូ	ʋuː
វៀង	ʋiəŋ
វៀងច័ន្ទន៍	ʋiəŋcan
វៀន	ʋiən
វេច	ʋɨc
វេជ្ជ	ʋɨccĕəʔ
វេជ្ជបញ្ញត្តិ	ʋɨccĕəʔɓaɲɲat
វេជ្ជបណ្ឌិត	ʋɨccĕəʔɓɑnɗɨt
វេណេហ្ស៊ុយអេឡា	ʋeineːzujʔeːlaː
វេត្រាណូ	ʋeitraːnou
វេទ	ʋeit
វេទនា	ʋeittĕəʔniə
វេទិកា	ʋeitikaː
វេន	ʋein
វេនីស	ʋeiniːh
វេយ្យាករណ៍	ʋɨjjiəkɑː
វេរ	ʋei
វេលា	ʋeiliə
វេវចនៈ	ʋeːʋĕəʔcaʔnaʔ
វេសវឺជីញ៉ា	ʋeihʋɨːciːɲaː
វេឡុវ័ន	ʋeiloʋŏən
វែក	ʋɛːk
វែង	ʋɛːŋ
វែនឃូវើ	ʋɛːnkʰuːʋəː
វែលីងតោន	ʋɛːliːŋtoːn
វៃ	ʋɨj
វៃយរាពណ៍	ʋɨjjĕəʔriəp
វៃយាករណ៍	ʋɨjjiəkɑː
វោត	ʋoːt
វោហារុបជីវី	ʋoːhaːrupaʔciːʋiː
វះ	ʋĕəh
វ៉ាក់សាំង	ʋaksaŋ
វ៉ាង	ʋaːŋ
វ៉ាឌូស	ʋaːɗuːh
វ៉ាណាដ្យូម	ʋaːnaːɗjoum
វ៉ាត់	ʋat
វ៉ាទីកង់	ʋaːtiːkɑŋ
វ៉ានីឡា	ʋaːniːlaː
វ៉ាន់ស៊ុយ	ʋansuj
វ៉ារស្សាវ៉ា	ʋaːssaːʋaː
វ៉ាលីស៍	ʋaːliː
វ៉ាសាប៊ី	ʋaːsaːɓiː
វ៉ាសូវី	ʋaːsouʋiː
វ៉ាស៊ីនតោន	ʋaːsiːntaon
វ៉ាហ្គុង	ʋaːguŋ
វ៉ាឡង់	ʋaːlɑŋ
វ៉ិចទ័រ	ʋəctŏə
វ៉ុល	ʋol
វ៉ុលទែរ	ʋoltɛː
វ៉ូង	ʋouŋ
វ៉ែល	ʋael
វ៉ែសបែង	ʋaehɓaeŋ
វ៉ោយ	ʋaoj
វ័យ	ʋɨj
ស	sɑː
សក	sɑːʔ
សកម្ម	saʔkam
សកម្មជន	saʔkammaʔcɔːn
សកម្មភាព	saʔkammaʔpʰiəp
សករាជ	saʔkaʔraːc
សកល	saʔkɑl
សកលលោក	saʔkɑlloːk
សកុណាយន្ត	saʔkonaːjŭən
សក់	sɑʔ
សក្ខី	saʔkʰəj
សក្តា	saʔkɗaː
សក្តានុពល	saʔkɗaːnupŭəl
សក្តិ	saʔ
សង	sɑːŋ
សង់	sɑŋ
សង់ខ្យា	sɑŋkjaː
សង់ទីម៉ែត្រ	sɑŋtiːmaet
សង្កត់	sɑŋkɑt
សង្ករ	sɑŋkɑː
សង្កាត់	sɑŋkat
សង្ការី	sɑŋkaːrəj
សង្កិន	sɑŋkən
សង្កុបកម្ម	saŋkopaʔkam
សង្កួត	sɑŋkuət
សង្កើច	sɑŋkaəc
សង្កេត	sɑŋkeːt
សង្ក្រាន្ត	sɑŋkraːn
សង្ខារ	sɑŋkʰaː
សង្គតិ	sɑŋkĕəʔteʔ
សង្គម	sɑŋkum
សង្គមនិយម	sɑŋkumnijum
សង្គីតនាដន៍	sɑŋkiːtaʔniət
សង្គ្រាម	sɑŋkriəm
សង្គ្រោះ	sɑŋkrŭəh
សង្ឃ	sɑŋ
សង្ឃរា	sɑŋkʰĕəʔriə
សង្ឃាដី	sɑːŋkʰiəɗəj
សង្ឃឹម	sɑŋkʰɨm
សង្រួម	sɑŋruəm
សង្រែក	sɑŋrɛːk
សង្វាក់	sɑŋʋaʔ
សង្វៀន	sɑŋʋiən
សង្វេគ	sɑŋʋeik
សង្វែង	sɑŋʋɛːŋ
សង្សារ	sɑŋsaː
សង្ស័យ	sɑŋsaj
សង្ហា	sɑŋhaː
សច្ច	sac
សច្ចំ	saccaŋ
សជន	saʔcŭən
សញ្ជាតិ	saɲciət
សញ្ជីវ័ន	saɲciːʋŏən
សញ្ឈា	sɑɲcʰiə
សញ្ញា	saɲɲaː
សញ្ញាណ	saɲɲaːn
សញ្ញាបត្រ	saɲɲaːɓat
សណ្ដ	sɑnɗɑː
សណ្ដាន់	sɑnɗan
សណ្ដាប់	sɑnɗap
សណ្ដែក	sɑnɗaek
សណ្ឋាគារ	sɑntʰaːkiə
សណ្ឋាគារដ្ឋាន	sɑntʰaːkiərĕəʔtʰaːn
សណ្ឋាន	sɑntʰaːn
សត	saʔtaʔ
សតវត្ស	saʔtaʔʋŏət
សតវត្សរ៍	saʔtaʔʋŏət
សតិ	saʔteʔ
សត្តាហៈ	sattaːhaʔ
សត្យ	sat
សត្យា	sattʰjaː
សត្រី	sattrəj
សត្រូវ	sattrəw
សត្វ	sat
សត្វឃាតស្ថាន	sattʰʋaʔkʰiətaʔstʰaːn
សទ្ទ	sattĕəʔ
សទ្ទតា	sattĕəʔtaː
សទ្ធា	sattʰiə
សន	sɑːn
សន្ដិភាព	sɑntepʰiəp
សន្តតិ	sɑntaʔteʔ
សន្តិ	sɑnteʔ
សន្តិនិយម	sɑntenijum
សន្តិភាព	sɑntepʰiəp
សន្តិសុខ	sɑntesok
សន្ថាគារ	sɑntʰaːkiə
សន្ទនា	sɑntĕəʔniə
សន្ទមាលា	sɑːntĕəʔmiəliə
សន្ទរកថា	sɑntĕəʔrĕəʔkaʔtʰaː
សន្ទស្សន៍	sɑntŭəh
សន្ទុះ	sɑntuh
សន្ទូច	sɑntuːc
សន្ទះ	sɑntĕəh
សន្ធាន	sɑntʰiən
សន្ធិ	sɑntʰiʔ
សន្ធិសញ្ញា	sɑntʰisaɲɲaː
សន្និបាត	sɑnniɓaːt
សន្និសីទ	sɑnnisət
សន្យា	sɑnjaː
សន្លប់	sɑnlɑp
សន្លាក់	sɑnlaʔ
សន្លឹក	sɑnlək
សន្សឹម	sɑnsəm
សន្សើម	sɑnsaəm
សន្សំ	sɑnsɑm
សប	sɑːp
សបថ	saʔpaʔtʰaʔ
សប់	sɑp
សប្តាហៈ	sappɗaːhaʔ
សប្តាហ៍	sappəɗaː
សប្តិ	sɑp
សប្បាយ	sapɓaːj
សព	sɑp
សព្ទ	sap
សព្វ	sɑp
សព្វនាម	sɑppĕəʔniəm
សព្វាវុធ	sɑppiəʋut
សភា	saʔpʰiə
សភាព	saʔpʰiəp
សម	sɑm
សម	sɑːm
សមញ្ញា	saʔmaɲɲaː
សមត្ថ	saʔmattʰaʔ
សមត្ថកិច្ច	saʔmattʰaʔkəc
សមត្ថភាព	saʔmattʰaʔpʰiəp
សមភាព	saʔmaʔpʰiəp
សមមិត្ត	saʔmaʔmɨt
សមរ	saʔmaʔraʔ
សមស្តនិយម	saʔmaːtaʔnijum
សមាគម	saʔmaːkum
សមាជិក	saʔmaːcɨk
សមាជិកភាព	saʔmaːcɨkpʰiəp
សមាធិ	saʔmaːtʰiʔ
សមាន	saʔmaːn
សមានកម្ម	saʔmaːnaʔkam
សមានការ	saʔmaːnaʔkaː
សមាភាគ	saʔmaːpʰiəʔ
សមិន្ធន៍	saʔmɨn
សមីការ	saʔməjkaː
សមុទ្ទ	saʔmot
សមុទ្រ	saʔmot
សមោធាន	saʔmaotʰiən
សមោសរ	saʔmaosɑː
សម៉	saʔmɑː
សម័យ	saʔmaj
សម្គាល់	sɑmkŏəl
សម្ងាត់	sɑmŋat
សម្ងួត	sɑmŋuət
សម្ដេច	sɑmɗac
សម្ដែង	sɑmɗaeŋ
សម្ទាយ	sɑmtiəj
សម្បក	sɑmɓɑːʔ
សម្បត្តិ	sɑmɓat
សម្បថ	sɑmɓɑt
សម្បុក	sɑmɓok
សម្បុរ	sɑmɓoʔ
សម្បូរ	sɑmɓou
សម្បើម	sɑmɓaəm
សម្បោរ	sɑmɓao
សម្ប័ទ	sɑmɓat
សម្ផស្ស	sampʰahsaʔ
សម្ពន្ធ	sɑmpŭən
សម្ពាធ	sɑmpiət
សម្ពាហកម្ម	sɑmpiəhaʔkam
សម្ពោធ	sɑmpoːt
សម្ព័ន្ធ	sɑmpŭən
សម្ភព	sɑmpʰup
សម្ភារ	sɑmpʰiə
សម្ភារៈ	sɑmpʰiərĕəʔ
សម្ភារៈមុខ	sɑmpʰiərĕəʔmuk
សម្ភាស	sɑmpʰiəh
សម្ភាសន៍	sɑmpʰiəh
សម្ភូតិ	sɑmpʰuːteʔ
សម្ភោរ	sɑmpʰoː
សម្មតិ	sɑmmat
សម្មតិកម្ម	sɑmmaʔtekam
សម្មាន	sɑmmaːn
សម្មានការ	sɑmmaːnĕəʔkaː
សម្មាភាគ	sammaːpʰiəʔ
សម្រក	sɑmrɑːʔ
សម្រង់	sɑmrɑŋ
សម្រន់	sɑmrɑn
សម្រប	sɑmrɔːp
សម្រស់	sɑmrɑh
សម្រាក	sɑmraːʔ
សម្រាជ	sɑmraːc
សម្រាប់	sɑmrap
សម្រាម	sɑmraːm
សម្រាល	sɑmraːl
សម្រួល	sɑmruəl
សម្រើប	sɑmraəp
សម្រេក	sɑmreːk
សម្រេច	sɑmrac
សម្រែក	sɑmrɛːk
សម្ល	sɑmlɑː
សម្លាក	sɑmlaːʔ
សម្លាញ់	sɑmlaɲ
សម្លាប់	sɑmlap
សម្លឹង	sɑmləŋ
សម្លៀក	sɑmliəʔ
សម្លេង	sɑmleːŋ
សយ	sɑːj
សយនដ្ឋាន	saʔjaʔnattʰaːn
សយនៈ	saʔjaʔnaʔ
សរ	sɑː
សរទៈ	saʔraʔtĕəʔ
សរសើរ	sɑːsaə
សរសេរ	sɑseː
សរីរាង្គ	saʔrəjriəŋ
សរីរៈ	saʔrəjraʔ
សរុប	saʔrop
សល់	sɑl
សល្យ	saljĕəʔ
សល្យកម្ម	saljĕəʔkam
សល្យសាស្ត្រ	saljĕəʔsaːh
សវ	saʔʋaʔ
សវនដ្ឋាន	saʔʋaʔnaʔtʰaːn
សវនៈ	saʔʋaʔnaʔ
សសរ	sɑsɑː
សសិត	sɑsət
សសោះ	sɑsɑh
សស្លោ	sɑslao
សហ	saʔhaʔ
សហការ	saʔhaʔkaː
សហការិនី	saʔhaʔkaːrenəj
សហការី	saʔhaʔkaːrəj
សហគមន៍	saʔhaʔkum
សហគ្រាស	saʔhaʔkriəh
សហគ្រិន	saʔhakrɨn
សហជីព	saʔhaʔciːp
សហប្រតិបត្តិ	saʔhaʔprɑteɓat
សហពន្ធុ	saʔhaʔpŏəntʰuʔ
សហពលកម្ម	saʔhaʔpŭəllĕəʔkam
សហព័ន្ធ	saʔhaʔpŏən
សហភាព	saʔhaʔpʰiəp
សហរដ្ឋ	saʔhaʔrŏət
សហរាជាណាចក្រ	saʔhaʔriəciənaːcaʔ
សហាយ	saʔhaːj
សាក	saːʔ
សាកល	saːkɑl
សាកលលោក	saːkɑlloːk
សាកាដូ	saːkaːɗou
សាកេ	saːkeː
សាក់	saʔ
សាក់សូហ្វូន	saksoufoun
សាក្រាមេនតូ	saːkraːmeintou
សាក្សី	saksəj
សាខា	saːkʰaː
សាគរ	saːkɔː
សាគ្រែប	saːkrɛːp
សាង	saːŋ
សាច់	sac
សាណា	saːnaː
សាណិ	saːneʔ
សាត	saːt
សាតាំង	saːtaŋ
សាត់	sat
សាទរ	saːtɔː
សាធក	saːtʰĕəʔkaʔ
សាធារណរដ្ឋ	saːtʰiərĕəʔnaʔrŏət
សាធារណៈ	saːtʰiərĕəʔnaʔ
សាធារណ៍	saːtʰiə
សាធុ	saːtʰuʔ
សាន	saːn
សានម៉ារីណូ	saːnmaːriːnou
សាន់	san
សាន់ឌីអេហ្គោ	sanɗiːʔeːgoː
សាន្ត	saːn
សាប៊ូ	saːɓuː
សាប់	sap
សាមគ្គី	saːmaʔkiː
សាមញ្ញ	saːmaɲ
សាមញ្ញ	saːmaɲɲaʔ
សាមណេរ	saːmaʔneː
សាមិនី	saːminiː
សាមី	saːməj
សាម៉ារ្យ៉ូម	saːmaːrjoum
សាយ	saːj
សាយណ្ហ	saːjan
សាយមាស	saːjaʔmiəh
សារ	saː
សារធាតុ	saːraʔtʰiət
សារពត៌មាន	saːpŏəɗɑːmiən
សារព័ន	saːraʔpŏən
សារព័នសីតកម្ម	saːraʔpŏənsəjtaʔkam
សារមន្ទីរ	saːraʔmŭəntiː
សារសំខាន់	saːraʔsɑmkʰan
សារាយ	saːraːj
សារិទ្ធ	saːrɨt
សារី	saːriː
សារៈសំខាន់	saːraʔsɑmkʰan
សារ៉ាយ៉េវ៉ូ	saːraːjeːʋou
សាល	saːl
សាលម៉ុន	saːlmon
សាលា	saːlaː
សាលាដ	saːlaːt
សាលាមត្តេយ្យ	saːlaːmattəj
សាលី	saːləj
សាវ	saːw
សាវត្ថី	saːʋattʰəj
សាវា	saːʋaː
សាសន	saːsaʔnaʔ
សាសនា	saːsnaː
សាសនិក	saːsaʔnɨk
សាសនិកា	saːsaʔnikaː
សាសន៍	saːh
សាស្កាឆេវ៉ាន	saːskaːcʰeːʋaːn
សាស្ត្រ	saːh
សាស្ត្រចារ្យ	saːhstraːcaː
សាស្ត្រា	saːhstraː
សាស្ត្រាចារ្យ	saːhstraːcaː
សាហារ៉ា	saːhaːraː
សាហាវ	saːhaːw
សាហេតុ	saːhaet
សាឡាក់	saːlaʔ
សាំង	saŋ
សាំងកាប៉ូ	saŋkaːpou
សាំង្កសី	saŋkaʔsəj
សិក្សា	səksaː
សិខា	sekʰaː
សិខិន	sekʰən
សិគាល	sekiəl
សិង	səŋ
សិង្ឃានិក	səŋkʰiənɨk
សិង្ហបុរី	səŋhaʔɓorəj
សិច	səc
សិត	sət
សិទ្ធ	sət
សិទ្ធិ	səttʰiʔ
សិន	sən
សិបយន្ត	səpjŭən
សិប្ប	səppaʔ
សិប្បករ	səppaʔkɑː
សិប្បៈ	səppaʔ
សិរ	seː
សិរិ	sereʔ
សិរី	serəj
សិរីសោភ័ណ	serəjsaopʰŏən
សិរ្ស	seː
សិលា	selaː
សិល្ប	səlləpaʔ
សិល្បករ	səlləpaʔkɑː
សិល្បៈ	səlləpaʔ
សិវិកា	seʋikaː
សិវៈ	seʋaʔ
សិសិរៈ	seserĕəʔ
សិស្ស	səh
សី	səj
សីត	səjtaʔ
សីតកម្ម	səjtaʔkam
សីតុណ្ហភាព	səjtonhaʔpʰiəp
សីមា	səjmaː
សីល	səl
សីលធម៌	səjlaʔtʰŏə
សីហលោ	səjhaʔloː
សីហា	səjhaː
សីហៈ	səjhaʔ
សឹក	sək
សឹង	səŋ
សឹង្ហ	səŋ
សឹម	səm
សឺន	səɨn
សឺរ៉ាំង	səɨraŋ
សុក	sok
សុក្រ	sok
សុខ	sok
សុខភាព	sokʰaʔpʰiəp
សុខា	sokʰaː
សុខាភិបាល	sokʰaːpʰiɓaːl
សុខុម	sokʰom
សុគត	sokŭət
សុង	soŋ
សុង្ក	soŋkaʔ
សុញ្ញកាស	soɲɲaʔkaːh
សុដន់	soɗɑn
សុទ្ធ	sot
សុទ្ធាវាស	sottʰiəʋiəh
សុធា	sotʰiə
សុន	son
សុនក	sonɑːʔ
សុនខ	sonɑːʔ
សុន្ទរ	sontĕəʔrĕəʔ
សុបិន	soɓən
សុប្រាត	sopraːt
សុផល	sopʰɑːl
សុផាត	sopʰaːt
សុភ	sopʰĕəʔ
សុភនិច្ឆ័យ	sopʰĕəʔnɨccʰaj
សុភមង្គល	sopʰĕəʔmŭəŋkŭəl
សុភា	sopʰiə
សុភាព	sopʰiəp
សុភាសិត	sopʰiəsət
សុភោជន	sopʰoːcŭən
សុរ	soraʔ
សុរា	soraː
សុរាគារ	soraːkiə
សុរាមត្ត	soraːmat
សុរិយ	sorejaʔ
សុរិយោទ័យ	sorejaotɨj
សុលកាករ	solkaːkɑː
សុល្ក	solkaʔ
សុវណ្ណ	soʋan
សុវត្ថិ	soʋŏət
សុវត្ថិភាព	soʋattʰepʰiəp
សុស្ម័ន	sohsman
សុំ	som
សូក	souk
សូកូឡា	soukoulaː
សូក្រាត	soukraːt
សូដ្យូម	souɗjoum
សូឌីយ៉ូម	souɗiːjoum
សូត្រ	sout
សូន្យ	soun
សូប	soup
សូភ្វីយ៉ា	soufiːjaː
សូម	soum
សូម៉ាលី	soumaːliː
សូម្បី	soumɓəj
សូរ	sou
សូរ	souraʔ
សូរង	sourɑːŋ
សូរីណាម	souriːnaːm
សូលុយស្យុង	soulujsjoŋ
សូវ	səw
សូវៀត	souʋiət
សូហ្វវែរ	soufʋae
សួគ៌	suə
សួង	suəŋ
សួត	suət
សួន	suən
សួរ	suə
សួស្ដី	suəsɗəj
សួស្តី	suəsɗəj
សើ	saə
សើច	saəc
សើន	saən
សើម	saəm
សឿង	sɨəŋ
សៀក	siəʔ
សៀកូញ៉ូម	siəkouɲoum
សៀង	siəŋ
សៀត	siət
សៀម	siəm
សៀរ៉ាឡេអូន	siəraːleːʔoun
សៀវ	siəw
សេ	seː
សេក	seːk
សេកង់	seːkɑŋ
សេក្ខ	seːk
សេង	seːŋ
សេចក្ដី	sackɗəj
សេចក្តី	sackɗəj
សេដា	seːɗaː
សេដ្ឋ	seːttʰaʔ
សេដ្ឋកិច្ច	seːttʰaʔkəc
សេដ្ឋសាស្ត្រ	seːttʰaʔsaːh
សេដ្ឋី	seːttʰəj
សេណុង	seːnoŋ
សេណេហ្គាល់	seːneːgiəl
សេត	saet
សេតវនីត	seːtaʔʋɔniːt
សេតូន	seːtoun
សេន	seːn
សេនហ្វ្រេនស៊ីស្កូ	seːnfreːnsiːskou
សេនា	seːnaː
សេនាសន	seːnaːsaʔnaʔ
សេនីយ៍	seːnəj
សេព	saep
សេមហកលា	seːmhaʔkaʔlaː
សេម្ហៈ	seːmhaʔ
សេរី	seːrəj
សេរីភាព	seːrəjpʰiəp
សេរ៉្យូម	seːrjuːm
សេលេញ៉ូម	seːleiɲoum
សេវកៈ	seːʋaʔkaʔ
សេវា	seːʋaː
សេវាកម្ម	seːʋaːkam
សេស	seːh
សេសែល	seːsael
សេស្យូម	seːsjoum
សេអ៊ូល	seːʔuːl
សេះ	seh
សែ	sae
សែក	saek
សែង	saeŋ
សែន	saen
សែនមនោរម្យ	saenmɔːnoːrɔːm
សែល	sael
សៃយ	saj
សៃហ្គន	sajgɔːn
សោ	sao
សោក	saok
សោត	saot
សោធន	saotʰŭən
សោធនី	saotʰĕəʔniː
សោភ័ណ	saopʰŏən
សោម	saom
សោយ	saoj
សោហ៊ុយ	saohuj
សោះ	sɑh
សៅ	saw
សៅការ៉ូលីណា	sawkaːrouliːnaː
សៅដាកូតា	sawɗaːkoutaː
សៅរ៍	saw
សំកាត់	somkat
សំខាន់	sɑmkʰan
សំខ្យា	sɑŋkjaː
សំខ្យានុគ្រោះ	sɑŋkjaːnukrŭəh
សំគាល់	sɑmkŏəl
សំងាត់	sɑmŋat
សំចត	sɑmcɑːt
សំដី	sɑmɗəj
សំដែង	sɑmɗaeŋ
សំដោះ	sɑmɗɑh
សំដៅ	sɑmɗaw
សំណ	sɑmnɑː
សំណង	sɑmnɔːŋ
សំណង់	sɑmnɑŋ
សំណល់	sɑmnɑl
សំណាក	sɑmnaːʔ
សំណាក់	sɑmnaʔ
សំណាង	sɑmnaːŋ
សំណាញ់	sɑmnaɲ
សំណឹក	sɑmnək
សំណុំ	sɑmnom
សំណូក	sɑmnouk
សំណូម	sɑmnoum
សំណួរ	sɑmnuə
សំណើ	sɑmnaə
សំណើច	sɑmnaəc
សំណើម	sɑmnaəm
សំណោក	sɑmnaok
សំទង់	sɑmtŭəŋ
សំទុះ	sɑmtuh
សំនួន	sɑmnuən
សំនួរ	sɑmnuə
សំនៀង	sɑmniəŋ
សំបក	sɑmɓɑːʔ
សំបុក	sɑmɓok
សំបុត្រ	sɑmɓot
សំបួរ	sɑmɓuə
សំបែង	sɑmɓaeŋ
សំប៉ាញ	sɑmpaːɲ
សំពត់	sɑmpŭət
សំពាយ	sɑmpiəj
សំពោច	sɑmpoːc
សំពៅ	sɑmpɨw
សំពះ	sɑmpĕəh
សំភោរ	sɑmpʰoː
សំយោគ	saŋjoːk
សំរង	sɑmrɔːŋ
សំរង់	sɑmrɑŋ
សំរស់	sɑmrɑh
សំរាក	sɑmraːʔ
សំរាប់	sɑmrap
សំរាម	sɑmraːm
សំរាល	sɑmraːl
សំរឹទ្ធ	sɑmrət
សំរុត	sɑmrot
សំរួច	sɑmruəc
សំរួល	sɑmruəl
សំរេក	sɑmreːk
សំរែក	sɑmrɛːk
សំរោង	sɑmroːŋ
សំលោហៈ	sɑmloːhaʔ
សំវេគ	sɑmʋeik
សំស្ក្រឹត	saŋskrət
សំឡ	sɑmlɑː
សំឡី	sɑmləj
សំឡេង	sɑmleiŋ
សំអប់	sɑmʔɑp
សំអាង	sɑmʔaːŋ
សំអាត	sɑmʔaːt
ស៊ក	sɔːʔ
ស៊ន	sɔːn
ស៊យ	sɔːj
ស៊ិនសែ	sɨnsae
ស៊ី	siː
ស៊ីក្លូ	siːkʰlou
ស៊ីញេ	siːɲei
ស៊ីដនីយ៏	siːtniː
ស៊ីដា	siːɗaː
ស៊ីឌី	siːɗiː
ស៊ីនុស	siːnuh
ស៊ីប	siːp
ស៊ីបេរី	siːɓeːriː
ស៊ីមបាវ៉េ	siːmɓaːʋeː
ស៊ីមហ្វូនី	siːmfouniː
ស៊ីម៉ងត៍	siːmɑːŋ
ស៊ីយ៉ូន	siːjoun
ស៊ីរី	siːriː
ស៊ីរ៉ូ	siːrou
ស៊ីលី	siːliː
ស៊ីលីស្យូម	siːliːsjoum
ស៊ីវិល	siːʋɨl
ស៊ីហ្គា	siːgiə
ស៊ីឡាំង	siːlaŋ
ស៊ីអាថុល	siːʔaːtʰol
ស៊ីអ៊ីវ	siːʔiːw
ស៊ឺបៀ	sɨːɓiə
ស៊ុកូឡា	sukoulaː
ស៊ុត	sut
ស៊ុន	sun
ស៊ុប	sup
ស៊ុម	sum
ស៊ុយ	suj
ស៊ុយអែត	sujʔaet
ស៊ុលតង់	sultɑŋ
ស៊ូ	suː
ស៊ូដង់	suːɗɑŋ
ស៊ូណាមិ	suːnaːmiʔ
ស៊ូល	suːl
ស៊ូស៊ី	suːsiː
ស៊ើប	səːp
ស៊េប៊ី	seiɓiː
ស៊ែម៉ាញ៉ូម	sɛːmaːɲoum
ស័ក	saʔ
ស័ក្តិ	saʔ
ស័ង្កសី	saŋkaʔsəj
ស័ង្គសី	saŋkaʔsəj
ស័ព្ទ	sap
ស្កង់ដ្យូម	skɑŋɗjoum
ស្កង់ឌីណាវី	skɑŋɗiːnaːʋiː
ស្កប់	skɑp
ស្ករ	skɑː
ស្កាត	skaːt
ស្កាត់	skat
ស្កុតលែនដ៍	skotlɛːn
ស្កុបជេ	skopcei
ស្កួយ	skuəj
ស្គម	skɔːm
ស្គរ	skɔː
ស្គាល់	skŏəl
ស្គី	skiː
ស្ងាត់	sŋat
ស្ងាប	sŋaːp
ស្ងាវ	sŋaːw
ស្ងួត	sŋuət
ស្ងៀម	sŋiəm
ស្ងោ	sŋao
ស្ងោរ	sŋao
ស្ញប់	sɲɑp
ស្ញែង	sɲaeŋ
ស្ដាប់	sɗap
ស្ដាយ	sɗaːj
ស្ដាំ	sɗam
ស្ដឹង	sɗəŋ
ស្ដើង	sɗaəŋ
ស្ដេច	sɗac
ស្ដែង	sɗaeŋ
ស្ដោះ	sɗɑh
ស្ដៅ	sɗaw
ស្ដ្រី	strəj
ស្តង់	stɑŋ
ស្តង់ដារ	stɑŋɗaː
ស្តាលីននិយម	staːliːnnijum
ស្តុកខុល	stokkʰol
ស្តុកតុន	stokton
ស្តុតិ	stoteʔ
ស្តូបនីយដ្ឋាន	stoupniːjĕəʔtʰaːn
ស្តេតូ	steːtou
ស្តេរ៉ូអ៊ីត	steːrouʔiːt
ស្ត្រប៊េរី	sɗɑːɓeiriː
ស្ត្រី	strəj
ស្ត្រីនិយម	strəjnijɔːm
ស្ត្រុងចូម	stroŋcoum
ស្ថាន	stʰaːn
ស្ថានភាព	sətʰaːnaʔpʰiəp
ស្ថានីយ	stʰaːniː
ស្ថានីយ៍	stʰaːniː
ស្ថាបត្យកម្ម	stʰaːpattʰjaʔkam
ស្ថាបនា	stʰaːpaʔnaː
ស្ថាប័ន	stʰaːɓan
ស្ថិត	stʰət
ស្ថិតិ	stʰeteʔ
ស្ថិតិវិទ្យា	stʰeteʋitʰjiə
ស្ថិរ	stʰeraʔ
ស្ថិរភាព	stʰeraʔpʰiəp
ស្ទង	stɔːŋ
ស្ទង់	stŭəŋ
ស្ទន់	stŭən
ស្ទាំង	stĕəŋ
ស្ទីឡូ	stiːlou
ស្ទឹង	stɨŋ
ស្ទឹងត្រែង	stɨŋtraeŋ
ស្ទុះ	stuh
ស្ទូង	stuːŋ
ស្ទូច	stuːc
ស្ទើរ	stəː
ស្ទះ	stĕəh
ស្នង	snɑːŋ
ស្នប់	snɑp
ស្នា	snaː
ស្នាក់	snaʔ
ស្នាន	snaːn
ស្នាប់	snap
ស្នាម	snaːm
ស្នាយុ	snaːjuʔ
ស្និត	snət
ស្និទ្ធ	snət
ស្នូក	snouk
ស្នូល	snoul
ស្នើ	snaə
ស្នៀត	sniət
ស្នេហា	snaehaː
ស្នេហ៍	snae
ស្នែង	snaeŋ
ស្នោ	snao
ស្បង់	sɓɑŋ
ស្បថ	sɓɑt
ស្បូន	sɓoun
ស្បូវ	sɓəw
ស្បើយ	sɓaəj
ស្បែក	sɓaek
ស្បៃ	sɓaj
ស្បោង	sɓaoŋ
ស្ប៉ាហ្គេតទី	spaːgeittiː
ស្ពក	spɔːʔ
ស្ពាន	spiən
ស្ពាន់	spŏən
ស្ពាយ	spiəj
ស្ពឹក	spɨk
ស្ពឺ	spɨː
ស្ពុតនីក	sputniːk
ស្ពៃ	spɨj
ស្មង	smɑːŋ
ស្មា	smaː
ស្មាតហ្វូន	smaːtfoun
ស្មាធិ៍	smaːt
ស្មាន	smaːn
ស្មាន់	sman
ស្មារតី	smaːɗəj
ស្មិត	smət
ស្មូត	smout
ស្មូន	smoun
ស្មូម	smoum
ស្មើ	smaə
ស្មៀន	smiən
ស្មេរ	smeː
ស្មោះ	smɑh
ស្មៅ	smaw
ស្ម័គ្រ	smaʔ
ស្យង់	sjɑŋ
ស្យាម	sjaːm
ស្រ	srɑː
ស្រក	srɑːʔ
ស្រករ	srɑkɑː
ស្រកា	srɑkaː
ស្រក់	srɑʔ
ស្រង់	srɑŋ
ស្រណោះ	srɑnɑh
ស្រទប	srɑtɔːp
ស្រទំ	srɑtum
ស្រន់	srɑn
ស្រប	srɑːp
ស្របក់	srɑɓɑʔ
ស្រពោន	srɑpoːn
ស្រមុក	srɑmuk
ស្រមៃ	srɑmaj
ស្រមោច	srɑmaoc
ស្រមោល	srɑmaol
ស្រលាញ់	srɑlaɲ
ស្រល់	srɑl
ស្រវា	srɑʋaː
ស្រវឹង	srɑʋəŋ
ស្រស់	srɑh
ស្រឡទែន	srɑːlɑːtɛːn
ស្រឡប់	srɑlɑp
ស្រឡាញ់	srɑlaɲ
ស្រឡៃ	srɑlaj
ស្រា	sraː
ស្រាក	sraːʔ
ស្រាប់	srap
ស្រាពណ៍	sraːp
ស្រាយ	sraːj
ស្រាល	sraːl
ស្រាវ	sraːw
ស្រី	srəj
ស្រុក	srok
ស្រុង	sroŋ
ស្រុត	srot
ស្រូប	sroup
ស្រូវ	srəw
ស្រួច	sruəc
ស្រួយ	sruəj
ស្រួល	sruəl
ស្រើប	sraəp
ស្រេក	sreːk
ស្រេង	sreːŋ
ស្រេច	srac
ស្រែ	srae
ស្រែក	sraek
ស្រែង	sraeŋ
ស្រោប	sraop
ស្រោម	sraom
ស្រះ	srah
ស្រៈ	sraʔ
ស្ល	slɑː
ស្លប	slɑːp
ស្លា	slaː
ស្លាក	slaːʔ
ស្លាប	slaːp
ស្លាប់	slap
ស្លាំង	slaŋ
ស្លឹក	slək
ស្លឹង	sləŋ
ស្លូវេនី	slouʋeiniː
ស្លូវ៉ាគី	slouʋaːkiː
ស្លៀក	sliəʔ
ស្លេក	sleːk
ស្លេស្ម	slaeh
ស្លែ	slae
ស្លែង	slaeŋ
ស្លោក	slaok
ស្វទេស	sʋaʔteih
ស្វរៈ	sʋaʔraʔ
ស្វស្តិក	sʋahstekaʔ
ស្វស្តិកៈ	sʋahstekaʔ
ស្វា	sʋaː
ស្វាគមន៍	sʋaːkum
ស្វាន	sʋaːn
ស្វាមី	sʋaːməj
ស្វាយ	sʋaːj
ស្វាយរៀង	sʋaːjriəŋ
ស្វាស	sʋaːh
ស្វាស៊ីឡង់	sʋaːsiːlɑŋ
ស្វាហៈ	sʋaːhaʔ
ស្វិត	sʋət
ស្វីស	sʋiːh
ស្វែង	sʋaeŋ
ស្វ័យ	sʋaj
ស្វ័យសត្យ	sʋajsat
ស្អប់	sʔɑp
ស្អាត	sʔaːt
ស្អិត	sʔət
ស្អី	sʔəj
ស្អុយ	sʔoj
ស្អែក	sʔaek
ស្អំ	sʔɑm
ហ	hɑː
ហង្ស	hɑŋ
ហត់	hɑt
ហត្ថ	hat
ហត្ថលេខា	hattʰaʔleikʰaː
ហនុមាន	haʔnumaːn
ហយពល	haʔjĕəʔpŭəl
ហយៈ	hɑjĕəʔ
ហរិត	haʔrɨt
ហសាភិប្រាយ	haʔsaːpʰipraːj
ហស្ត	hŏəh
ហហ្មុក	hɑmok
ហឫទ័យ	haʔrɨtɨj
ហា	haː
ហាក់	haʔ
ហាង	haːŋ
ហាជ្ជី	haːcciː
ហាណូយ	haːnouj
ហាត់	hat
ហាត់ប្រាណ	hatpraːn
ហាន	haːn
ហានិយភ័យ	haːniːpʰɨj
ហានុកា	haːnukaː
ហាប	haːp
ហាម	haːm
ហាយនៈ	haːjĕəʔnĕəʔ
ហារ	haː
ហារ៉ាម	haːraːm
ហាល	haːl
ហាវ៉ាណា	haːʋaːnaː
ហាវ៉ៃ	haːʋaj
ហាស	haːsaʔ
ហាសវត្ថុ	haːsaʔʋŏəttʰoʔ
ហាឡាល	haːlaːl
ហាំប៊ឺហ្គឺ	hamɓɨːgɨː
ហិកតា	həktaː
ហិង្សា	həŋsaː
ហិណ្ឌី	hənɗiː
ហិន	hən
ហិប	həp
ហិមៈ	hemĕəʔ
ហិរញ្ញ	heraɲ
ហិរញ្ញវត្ថុ	heraɲɲĕəʔʋŏəttʰoʔ
ហិរណ្យ	heran
ហិរិ	heriʔ
ហឹរ	haə
ហឺត	həɨt
ហុកកៀន	hokkiən
ហុង	hoŋ
ហុងកុង	hoŋkoŋ
ហុងគ្រី	hoŋkriː
ហុងឌូរ៉ាស	hoŋɗuːraːh
ហុច	hoc
ហូ	hou
ហូជីមិញ	houciːmɨɲ
ហូណូលូលូ	hounouluːluː
ហូតែល	houtael
ហូប	houp
ហូរ	hou
ហូឡង់	houlɑŋ
ហួច	huəc
ហួត	huət
ហួស	huəh
ហើប	haəp
ហើម	haəm
ហើយ	haəj
ហើរ	haə
ហៀរ	hiə
ហេង	heːŋ
ហេតុ	haet
ហេព្រើរ	heːprəː
ហេមន្ត	heːmɑn
ហែ	hae
ហែក	haek
ហែល	hael
ហែលស៊ិនគី	haelsɨnkiː
ហៃទី	hajtiː
ហោច	haoc
ហោតិល	haotəl
ហោរា	haoraː
ហោរាសាស្ត្រ	haoraːsaːh
ហោះ	hɑh
ហៅ	haw
ហ៊	hɔː
ហ៊ាន	hiən
ហ៊ីត្លែរ	hiːtlɛː
ហ៊ុន	hun
ហ៊ុប	hup
ហ៊្វីជី	hʋiːciː
ហ៊្វុនស៊ិនប៉ិច	hʋunsɨnpəc
ហ៊្សកដានី	zɔːʔɗaːniː
ហ័វ	haw
ហ្គាណា	gaːnaː
ហ្គាបុង	gaːɓoŋ
ហ្គាស	gaːh
ហ្គាស្សា	gaːssaː
ហ្គាំ	gam
ហ្គីណេ	hkiːneː
ហ្គីតា	giːtaː
ហ្គីយ៉ាន	giːjaːn
ហ្គូហ្គល	guːgŭəl
ហ្គេយ៍	geij
ហ្គំប៊ី	gumɓiː
ហ្គ្រិនលែនដ៍	grɨnlɛːn
ហ្នាំង	naŋ
ហ្នឹង	nɨŋ
ហ្នុង	noŋ
ហ្ន័ង	naŋ
ហ្ម	mɑː
ហ្លាក់	laʔ
ហ្លួង	luəŋ
ហ្វាម៉ាស៊ី	faːmaːsiː
ហ្វារ	faː
ហ្វាស៊ីស	faːsiːh
ហ្វាំងឡង់	faŋlɑŋ
ហ្វីត	fəjt
ហ្វីល	fiːl
ហ្វីលីពីន	fiːliːpiːn
ហ្វីលីព្ពីន	fiːliːppiːn
ហ្វឹក	ʋək
ហ្វូង	ʋouŋ
ហ្វូស្វ័រ	fousʋŏə
ហ្វើ	faə
ហ្វេ	ʋeː
ហ្វេន	feːn
ហ្វេសប៊ុក	feːsɓuk
ហ្វ្រង្ក	frɑŋ
ហ្វ្រាំង	fraŋ
ហ្វ្រូម៉ាហ្ស	froumaː
ហ្វ្រែហ្ស៍	hʋrɛːh
ហ្វ្រ័ង	fraŋ
ហ្សកហ្ស៊ី	zɑʔziː
ហ្សាម៉ាអ៊ីក	zaːmaːʔiːk
ហ្សីរ៉ាហ្វ	ziːraːf
ហ្សេរុយសាឡឹម	zeːrujsaːləm
ហ្សែន	zaen
ហ្សំប៊ី	zɑmɓiː
ហ្ស៊ីប	ziːp
ឡ	lɑː
ឡក	lɑːʔ
ឡង់	lɑŋ
ឡង់តាន	lɑŋtaːn
ឡត	lɑːt
ឡប់	lɑp
ឡាក	laːʔ
ឡាក់	laʔ
ឡាក់តូស	laʔtouh
ឡាញ់	laɲ
ឡាតាំង	laːtaŋ
ឡាតាំងនីយកម្ម	laːtaŋniːjĕəʔkam
ឡាតាំងយានកម្ម	laːtaŋjiənnĕəʔkam
ឡាន	laːn
ឡាប	laːp
ឡាប៉ាស	laːpaːh
ឡាប៊ីយែរ	laːɓiːjɛː
ឡាប់សង	lapsɑːŋ
ឡាម	laːm
ឡាយ	laːj
ឡាវ	laːw
ឡាវេនឌឺ	laːʋeinɗɨː
ឡាំ	lam
ឡុង	loŋ
ឡុងដ៍	loŋ
ឡុងប៊ិច	loŋɓɨc
ឡូ	lou
ឡូរី	louriː
ឡូវែល	louʋɛːl
ឡូសអេនជឺលេស	louhʔeːncɨːleih
ឡើង	laəŋ
ឡើយ	laəj
ឡេតូនី	leːtouniː
ឡេវ	leːw
ឡេសស្បៀន	leːhsɓiən
ឡេសូតូ	leːsoutou
ឡែក	laek
ឡោម	laom
អ	ʔɑː
អកម្ម	ʔaʔkam
អកម្មភាព	ʔaʔkammaʔpʰiəp
អកុសល	ʔaʔkosɑl
អក្ខរកម្ម	ʔaʔkʰaʔraʔkam
អក្ខរា	ʔaʔkʰaʔraː
អក្ខរាវិរុទ្ធ	ʔaʔkʰaʔraːʋirut
អក្ខរៈ	ʔɑʔkʰɑraʔ
អក្ខោសាន	ʔaʔkʰaosaːn
អក្សរ	ʔaksɑː
អគារ	ʔaʔkiə
អគ័រដេអុង	ʔɑːkŏəɗeːʔoŋ
អគ្គ	ʔaʔkĕəʔ
អគ្គជៈ	ʔaʔkĕəʔcĕəʔ
អគ្គនាយក	ʔaʔkĕəʔniəjŭəʔ
អគ្គលេខាធិការ	ʔaʔkĕəʔleikʰaːtʰikaː
អគ្គិ	ʔaʔkiʔ
អគ្គិភ័យ	ʔaʔkipʰɨj
អគ្គិសនី	ʔaʔkisaʔniː
អគ្គី	ʔaʔkiː
អគ្គីភ័យ	ʔaʔkiːpʰɨj
អគ្គីសនី	ʔaʔkiːsaʔniː
អគ្និ	ʔaʔniʔ
អគ្យសនី	ʔaʔkjĕəʔsaʔniː
អឃោសៈ	ʔaʔkʰoːsaʔ
អង់	ʔɑŋ
អង់ការ៉ា	ʔɑŋkaːraː
អង់គ្លេស	ʔɑŋkʰleih
អង់ដូរ៉ា	ʔɑŋɗouraː
អង់តាទិក	ʔɑŋtaːtɨk
អង់តាល់ពី	ʔɑŋtalpiː
អង់ត្រាក់	ʔɑŋtraʔ
អង់ត្រូពី	ʔɑŋtroupiː
អង់ទីម៉ាន់	ʔɑŋtiːman
អង់ទីហ្សែន	ʔɑŋtiːzaen
អង់ស៊ីម	ʔɑŋsiːm
អង់ស្ត្រុម	ʔɑŋstrom
អង់ហ្គោឡា	ʔɑŋgoːlaː
អង្ក	ʔɑŋkaʔ
អង្កត់	ʔɑŋkɑt
អង្កន់	ʔɑŋkɑn
អង្ករ	ʔɑŋkɑː
អង្កាញ់	ʔɑŋkaɲ
អង្កាម	ʔɑŋkaːm
អង្កាល	ʔɑŋkaːl
អង្កាល់	ʔɑŋkal
អង្កេត	ʔɑŋkeːt
អង្គ	ʔɑŋ
អង្គញ់	ʔɑŋkŭəɲ
អង្គរ	ʔɑŋkɔː
អង្គរក្ស	ʔɑŋkĕəʔrĕəʔ
អង្គារ	ʔɑŋkiə
អង្គុយ	ʔɑŋkuj
អង្គុលី	ʔɑŋkuliː
អង្គុលីលេខ	ʔɑŋkuliːleːk
អង្គែ	ʔɑŋkɛː
អង្គំ	ʔɑŋkum
អង្គ័ល	ʔɑŋkŏəl
អង្រន់	ʔɑŋrŭən
អង្រឹង	ʔɑŋrɨŋ
អង្រូស	ʔɑŋruːh
អង្រួន	ʔɑŋruən
អង្រែ	ʔɑŋrɛː
អង្វរ	ʔɑŋʋɑː
អង្វែង	ʔɑŋʋɛːŋ
អង្សា	ʔɑŋsaː
អង្អែល	ʔɑŋʔael
អចលនវត្ថុ	ʔaʔcaʔlaʔnaʔʋŏəttʰoʔ
អច្ឆរា	ʔaccʰaʔraː
អញ	ʔaɲ
អញ្ចឹង	ʔɑɲcəŋ
អញ្ចុះ	ʔɑɲcoh
អញ្ចេះ	ʔɑɲceh
អញ្ជើញ	ʔɑɲcəːɲ
អញ្ជ័ន	ʔaɲcŏən
អញ្ញត្រ	ʔaɲɲat
អដវី	ʔaʔɗaʔʋiː
អដ្ឋករ	ʔattʰaʔkɑː
អដ្ឋកោន	ʔattʰaʔkaon
អដ្ឋបាន	ʔattʰaʔɓaːn
អដ្ឋិ	ʔattʰeʔ
អដ្ឋិចម្មសត្វ	ʔattʰecammaʔsat
អឌ្ឍ	ʔattʰĕəʔ
អឌ្ឍចន្ទ	ʔattʰĕəʔcan
អណូ	ʔaʔnou
អណ្ដាត	ʔɑnɗaːt
អណ្ដូង	ʔɑnɗouŋ
អណ្ដើក	ʔɑnɗaək
អណ្ដើរ	ʔɑnɗaə
អណ្ដែត	ʔɑnɗaet
អណ្ឌៈ	ʔɑnɗĕəʔ
អណ្ណាម	ʔɑnnaːm
អតិ	ʔaʔte
អតិថិ	ʔaʔtetʰeʔ
អតិថិជន	ʔaʔtetʰecŭən
អតិថី	ʔaʔtetʰəj
អតិផរណា	ʔaʔtepʰaʔraʔnaː
អតិសុខុម	ʔaʔtesokʰom
អតិសុខុមកាយ	ʔaʔtesokʰomĕəʔkaːj
អតិសុខុមទស្សន៍	ʔaʔtesokʰomĕəʔtŭəh
អតិសុខុមប្រាណ	ʔaʔtesokʰomĕəʔpraːn
អតីត	ʔaʔɗət
អតីតកាល	ʔaʔtəjtaʔkaːl
អត់	ʔɑt
អត្ត	ʔattaʔ
អត្តឃាត	ʔattaʔkʰiət
អត្តពលកម្ម	ʔattaʔpŏəlləkam
អត្តពលិក	ʔattaʔpŏəllɨk
អត្តាធិបតី	ʔattaːtʰipaʔɗəj
អត្តាធិបតេយ្យ	ʔattaːtʰipaʔtaj
អត្ថ	ʔat
អត្ថន័យ	ʔattʰaʔnɨj
អត្ថបទ	ʔattʰaʔɓɑt
អត្ថប្រយោជន៍	ʔattʰaʔprɑjaoc
អត្ថរស	ʔattʰaʔrŭəh
អត្ថិភាព	ʔattʰepʰiəp
អត្រា	ʔaʔtraː
អថេរ	ʔɑtʰeː
អទេវនិយម	ʔaʔteiʋĕəʔnijum
អទ្ធាន	ʔattʰiən
អធន	ʔaʔtʰŭən
អធិក	ʔaʔtʰɨk
អធិការ	ʔaʔtʰikaː
អធិការបតី	ʔaʔtʰikaːraʔpaʔɗəj
អធិក្រម	ʔaʔtʰikrɑm
អធិក្រឹតិ	ʔaʔtʰikrət
អធិដ្ឋាន	ʔaʔtʰɨttʰaːn
អធិបតី	ʔaʔtʰipaʔɗəj
អធិបតេយ្យ	ʔaʔtʰɨppaʔtaj
អធិរាជ	ʔaʔtʰiriəc
អធិរាជិនី	ʔaʔtʰiriəciniː
អធីន	ʔaʔtʰiːn
អធ្រាត្រ	ʔattriət
អនតារីយ៉ូ	ʔɑːntaːriːjou
អនត្តា	ʔaʔnattaː
អនត្ថ	ʔaʔnattʰaʔ
អនត្ថការ	ʔaʔnattʰaʔkaː
អនន្ត	ʔaʔnɑn
អនន្តភាព	ʔaʔnɑntaʔpʰiəp
អនឡាញ	ʔɑnlaːɲ
អនាគត	ʔaʔnaːkŭət
អនាថា	ʔaʔnaːtʰaː
អនាធិបតេយ្យ	ʔaʔnaːtʰɨppaʔtaj
អនាម័យ	ʔaʔnaːmaj
អនាម័យដ្ឋាន	ʔaʔnaːmajtʰaːn
អនិច្ច	ʔaʔnɨccaʔ
អនិច្ចកម្ម	ʔaʔnɨccaʔkam
អនិច្ចា	ʔaʔnɨccaː
អនិទ្រា	ʔaʔnɨttriə
អនុ	ʔaʔnuʔ
អនុក្រម	ʔaʔnukrɑm
អនុក្រឹត្យ	ʔɑːnukrət
អនុគមន៍	ʔaʔnukum
អនុគ្រោះ	ʔɑnukrŭəh
អនុញ្ញាត	ʔaʔnuɲɲaːt
អនុត្តរ	ʔaʔnuttaʔraʔ
អនុត្តរភាព	ʔaʔnuttaʔraʔpʰiəp
អនុបណ្ឌិត	ʔaʔnuɓɑnɗɨt
អនុប្រធាន	ʔaʔnuprɑtʰiən
អនុព័ន្ធ	ʔaʔnupŏən
អនុម័ត	ʔaʔnumat
អនុរក្ស	ʔaʔnurĕəʔ
អនុវត្ត	ʔaʔnuʋŏət
អនុវត្តន៍	ʔaʔnuʋŏət
អនុសាស	ʔaʔnusaːh
អនុសោក	ʔaʔnusaok
អនុស្វារ	ʔaʔnuhsʋaːraʔ
អនុស្សរណៈ	ʔaʔnuhsaʔraʔnaʔ
អនុស្សាវរីយ	ʔaʔnuhsaːʋaʔriː
អនុស្សាវរីយ៍	ʔaʔnuhsaːʋaʔriː
អន្ត	ʔɑn
អន្តរ	ʔɑntaʔraʔ
អន្តរវាសក	ʔɑntaʔraʔʋaːsɑʔ
អន្តរាគមន៍	ʔɑntaʔraːkum
អន្តរាយ	ʔɑntaʔraːj
អន្តោ	ʔɑntao
អន្តោប្រវេសន៍	ʔɑntaoprɑʋeːh
អន្តោប្រវេសន្ត	ʔɑntaoprɑʋeːsɑn
អន្តៈ	ʔɑntaʔ
អន្ទង់	ʔɑntŭəŋ
អន្ទាក់	ʔɑntĕəʔ
អន្លង់	ʔɑnlŭəŋ
អន្លើ	ʔɑnləː
អន្វេស	ʔanʋeih
អន្សម	ʔɑnsɑːm
អបនីត	ʔaʔpaʔniːt
អបាយមុខ	ʔaʔɓaːjĕəʔmuk
អប់	ʔɑp
អប្សរ	ʔappʰsɑː
អប្សរា	ʔappʰsaʔraː
អផាសុក	ʔaʔpʰaːsok
អផ្សុក	ʔɑppʰsok
អពយព	ʔɑppʰjup
អព្ភន្តរ	ʔappʰŏəntaʔraʔ
អព្យព	ʔɑppʰjup
អព្យយ	ʔappʰjĕəʔjĕəʔ
អព្យយសព្ទ	ʔappʰjĕəʔjĕəʔsap
អព្យយៈ	ʔappʰjĕəʔjĕəʔ
អភិ	ʔaʔpʰi
អភិធម្ម	ʔaʔpʰitʰŏəm
អភិបាល	ʔaʔpʰiɓaːl
អភិបូជា	ʔaʔpʰiɓouciə
អភិមាន	ʔaʔpʰimiənĕəʔ
អភិវឌ្ឍ	ʔaʔpʰiʋŏət
អភិវឌ្ឍន៍	ʔaʔpʰiʋŏət
អភិសេក	ʔaʔpʰisaek
អភ័យ	ʔaʔpʰɨj
អម្ចាស់	ʔɑmcah
អម្បាយ	ʔɑmɓaːj
អម្បូរ	ʔɑmɓou
អម្ពា	ʔɑmpiə
អម្ពិល	ʔɑmpɨl
អម្ភ័ស	ʔɑmpʰŏəh
អម្រស់	ʔɑmrɑh
អយ	ʔaʔjĕəʔ
អយបថ	ʔaʔjĕəʔɓɑt
អយស្ម័យ	ʔaʔjaʔsmaj
អយោ	ʔaʔjoː
អយោធ	ʔaʔjoːt
អយ្យ	ʔajjĕəʔ
អយ្យកា	ʔajjĕəʔkaː
អយ្យកោ	ʔajjĕəʔkao
អយ្យិកា	ʔajjikaː
អរ	ʔɑː
អរប៊ីតាល់	ʔɑːɓiːtal
អរម៉ូន	ʔɑmoun
អរិយ	ʔaʔrejaʔ
អរិយធម៌	ʔaʔrejaʔtʰŏə
អរុណ	ʔaʔrun
អរូបធាតុ	ʔaʔruːpaʔtʰiət
អល់ឡោះ	ʔɑllɑh
អវកាស	ʔaʔʋĕəʔkaːh
អវិជ្ជមាន	ʔaʔʋɨccĕəʔmiən
អវិរុទ្ធ	ʔaʔʋirut
អវីចី	ʔaʔʋiːcəj
អសង្ខេយ្យ	ʔaʔsɑŋkʰaj
អសង្ហារិម	ʔaʔsɑŋhaːrɨm
អសង្ហារិមៈ	ʔaʔsɑŋhaːrimĕəʔ
អសនី	ʔaʔsaʔniː
អសនីបថ	ʔaʔsaʔniːɓɑt
អសន្យាណូ	ʔaʔsɑnjaːnou
អសន្យាណូវិទ្យា	ʔaʔsɑnjaːnouʋitʰjiə
អសន្យាណូសារ	ʔaʔsɑnjaːnousaː
អសាធារណ	ʔaʔsaːtʰiə
អសាធារណៈ	ʔaʔsaːtʰiərĕəʔnaʔ
អសាធារណ៍	ʔaʔsaːtʰiə
អសុរ	ʔaʔsol
អសុរា	ʔaʔsoraː
អសុរី	ʔaʔsorəj
អសុរោះ	ʔaʔsorɑh
អសេរិនី	ʔaʔseireniː
អសេរី	ʔaʔseirəj
អសំហារិមៈ	ʔaʔsɑŋhaːrimĕəʔ
អស់	ʔɑh
អស្ចារ្យ	ʔɑhcaː
អស្តង្គត	ʔɑhsɗɑŋkŭət
អស្តា	ʔahsɗaː
អស្វ	ʔahsʋaʔ
អស្វឫទ្ធិ	ʔahsʋaʔrɨt
អស្វិន	ʔahsʋən
អស្សាភរណ៍	ʔahsaːpʰɔː
អស្សុ	ʔahsoʔ
អស្សុជ	ʔɑhsoc
អហិង្សា	ʔaʔhəŋsaː
អា	ʔaː
អាកទិក	ʔaːʔtɨk
អាកប្ប	ʔaːkappaʔ
អាករ	ʔaːkɑː
អាកានសាស	ʔaːkaːnsaːh
អាកាស	ʔaːkaːh
អាកាសចរ	ʔaːkaːsaʔcɑː
អាកាសចរណ៍	ʔaːkaːsaʔcɑː
អាកាសធាតុ	ʔaːkaːsaʔtʰiət
អាកាសបាតុភូត	ʔaːkaːsaʔpaːtopʰuːt
អាកាសយានដ្ឋាន	ʔaːkaːsaʔjiənaʔtʰaːn
អាកុង	ʔaːkoŋ
អាកុល	ʔaːkol
អាក្រក់	ʔaːʔrɑʔ
អាគម	ʔaːkum
អាគារ	ʔaːkiə
អាគាំង	ʔaːkĕəŋ
អាគុយ	ʔaːkuj
អាគ័រ	ʔaːkŏə
អាគ្នេយ៍	ʔaːkʰneː
អាឃាត	ʔaːkʰiət
អាឃ្លោក	ʔaːʔloːk
អាង	ʔaːŋ
អាងោះ	ʔaːŋŭəh
អាច	ʔaːc
អាចម៍	ʔac
អាចរិយ	ʔaːcaʔrejaʔ
អាចារ្យ	ʔaːcaː
អាច់	ʔac
អាជីព	ʔaːciːp
អាជីវ	ʔaːciːʋĕəʔ
អាជីវកម្ម	ʔaːciːʋĕəʔkam
អាជីវៈ	ʔaːciːʋĕəʔ
អាជ្ញា	ʔaːcɲaː
អាជ្ញាធរ	ʔaːcɲaːtʰɔː
អាជ្ញាប័ណ្ណ	ʔaːcɲaːɓan
អាញ៉ុង	ʔaːɲoŋ
អាណត្តិ	ʔaːnat
អាណា	ʔaːnaː
អាណាចក្រ	ʔaːnaːcaʔ
អាណានិគម	ʔaːnaːnikum
អាណានិគមកិច្ច	ʔaːnaːnikumkəc
អាណានិគមនិយម	ʔaːnaːnikumnijum
អាណូត	ʔaːnout
អាតូម	ʔaːtoum
អាត់	ʔat
អាត្មា	ʔaːtmaː
អាត្លង់ទិក	ʔaːtʰlɑŋtɨk
អាថែនស៍	ʔaːtʰaen
អាថ៌	ʔaː
អាទិ	ʔaːtiʔ
អាទិត្យ	ʔaːtɨt
អាទិទេព	ʔaːtiteip
អាន	ʔaːn
អានីមេ	ʔaːniːmei
អានុភាព	ʔaːnupʰiəp
អាប	ʔaːp
អាបណ	ʔaːpaʔnaʔ
អាបណក	ʔaːpaʔnaʔkɑː
អាបណិកា	ʔaːpaʔnekaː
អាប៊ុយដាប៊ី	ʔaːɓujɗaːɓiː
អាប់	ʔap
អាពាធិក	ʔaːpiətʰɨk
អាពុក	ʔaːpuk
អាភាស	ʔaːpʰiəh
អាភៀន	ʔaːpʰiən
អាភ្លើ	ʔaːpləː
អាមាតិសារ	ʔaːmaːtesaː
អាមីដ	ʔaːmiːt
អាមីន	ʔaːmiːn
អាមីប	ʔaːmiːp
អាមេនី	ʔaːmeiniː
អាមេរិក	ʔaːmeirɨk
អាយ	ʔaːj
អាយតនៈ	ʔaːjaʔtaʔnaʔ
អាយឡែន	ʔaːjlaen
អាយអូវ៉ា	ʔaːjʔouʋaː
អាយុ	ʔaːjuʔ
អាយុវឌ្ឍន៍	ʔaːjuʋŏət
អាយ៉ង	ʔaːjɑːŋ
អាយ៉ៃ	ʔaːjaj
អាយ័ត	ʔaːjat
អារ	ʔaː
អារក្ខ	ʔaːraʔ
អារក្ស	ʔaːraʔ
អារម្មណ៍	ʔaːrɑm
អារាមិក	ʔaːraːmɨk
អារាមិកា	ʔaːraːmikaː
អារីស្តូត	ʔaːriːstout
អារីហ្សូណា	ʔaːriːzounaː
អារ៉ាប	ʔaːraːp
អារ៉ាប់	ʔaːrap
អាល	ʔaːl
អាលុយមីញ៉ូម	ʔaːlujmiːɲoum
អាល់កាន	ʔalkaːn
អាល់ដេអ៊ីត	ʔalɗeːʔiːt
អាល់បានី	ʔalɓaːniː
អាល់ប៊ឺតា	ʔalɓɨːtaː
អាល់សែន	ʔalsaen
អាល់ស៊ីន	ʔalsiːn
អាល់ហ្វា	ʔalfaː
អាល់ហ្សេ	ʔalzeː
អាល់ហ្សេរី	ʔalzeːriː
អាល័យ	ʔaːlaj
អាល្លឺម៉ង់	ʔaːlləɨmɑŋ
អាវ	ʔaːw
អាវាស	ʔaːʋaːh
អាវុធ	ʔaːʋut
អាវេសិក	ʔaːʋeisək
អាវ៉ូកាចេរ	ʔaːʋoukaːceː
អាវ៉ូកាត៍	ʔaːʋoukaː
អាសន្ទិ	ʔaːsɑntiʔ
អាសន្ន	ʔaːsɑn
អាសន្នរោគ	ʔaːsɑnnaʔroːk
អាសយដ្ឋាន	ʔaːsaʔjattʰaːn
អាសហ្គាបាត	ʔaːhgiəɓaːt
អាសា	ʔaːsaː
អាសាឍ	ʔaːsaːt
អាសូត	ʔaːzout
អាសេតូន	ʔaːseːtoun
អាសេនិក	ʔaːseːnɨk
អាស៊ី	ʔaːziː
អាស៊ីត	ʔaːsiːt
អាស៊ីន	ʔaːsiːn
អាស៊ីល	ʔaːsiːl
អាស៊ែបៃហ្សង់	ʔaːsɛːɓajzɑŋ
អាស់សង់ស័រ	ʔahsɑŋsŏə
អាស្កាបាត	ʔaːskaːɓaːt
អាស្តាណា	ʔaːstaːnaː
អាស្ប៊ែស	ʔaːsɓɛːh
អាស្មារ៉ា	ʔaːsmaːraː
អាស្រូវ	ʔaːsrəw
អាស្រ័យ	ʔaːsraj
អាហរ័ណ	ʔaːhaʔran
អាហារ	ʔaːhaː
អាហារដ្ឋាន	ʔaːhaːrattʰaːn
អាហារប័ណ្ណ	ʔaːhaːraʔɓan
អាហារិន	ʔaːhaːrɨn
អាហារូបករណ៍	ʔaːhaːruːpaʔkɑː
អាហ្កា	ʔaːgaː
អាហ្មុក	hɑmok
អាហ្វហ្គានីស្ថាន	ʔaːfgiəniːstʰaːn
អាហ្វ្រិក	ʔaːfrɨk
អាហ្សង់ទីន	ʔaːzɑŋtiːn
អាឡា	ʔaːlaː
អាឡាបាម៉ា	ʔaːlaːɓaːmaː
អាឡាស្កា	ʔaːlaːskaː
អាឡូ	ʔaːlou
អាឡែរហ្សី	ʔaːlaezəj
អាឡែល	ʔaːlael
អាំង	ʔaŋ
អាំងដ្យូម	ʔaŋɗjoum
អាំងតេក្រាល	ʔaŋteːkraːl
អាំងស៊ុយលីន	ʔaŋsujliːn
អាំស្ទែដាំ	ʔamstɛːɗam
អិម	ʔəm
អិស្លាម	ʔihslaːm
អី	ʔəj
អីវ៉ាន់	ʔəjʋan
អឺ	ʔəɨ
អឺការីយ៉ូត	ʔəɨkaːriːjout
អឺរ៉ាស៊ី	ʔəɨraːziː
អឺរ៉ុប	ʔəɨrop
អឺរ៉ូ	ʔəɨrou
អឺរ៉ូព្យ៉ូម	ʔəɨroupʰjuːm
អុក	ʔok
អុកតាន	ʔoktaːn
អុកស៊ីដ	ʔoksiːt
អុកស៊ីត	ʔoksiːt
អុកស៊ីហ្សែន	ʔoksiːzaen
អុង	ʔoŋ
អុត	ʔot
អុនសេន	ʔonseːn
អុរ	ʔol
អុលម៉្ញូម	ʔolmɲuːm
អុស	ʔoh
អុំ	ʔom
អូ	ʔou
អូកឡិន	ʔouklən
អូក្លាហូម៉ា	ʔoukʰlaːhoumaː
អូខី	ʔoukʰəj
អូដ្ឋ	ʔout
អូតង់	ʔoutɑŋ
អូតាវ៉ា	ʔoutaːʋaː
អូតូការ	ʔoutoukaː
អូតូប៊ុស	ʔoutouɓuh
អូតូម៉ង់	ʔoutoumɑŋ
អូតូរុត	ʔoutourut
អូតែល	ʔoutael
អូទ្រីស	ʔoutriːh
អូន	ʔoun
អូប៉ាល័រ	ʔoupaːlŏə
អូប៉េរ៉ា	ʔoupeːraː
អូប័រ	ʔouɓŏə
អូម	ʔoum
អូមែន	ʔoumɛːn
អូរ	ʔou
អូរីហ្គិន	ʔouriːgɨn
អូលីវ	ʔouliːw
អូវែ	ʔouʋɛː
អូស	ʔouh
អូសេអានី	ʔouseːʔaːniː
អូស្ត្រាលី	ʔoustraːliː
អូស្មូស	ʔousmouh
អូស្រ្តាលី	ʔoustraːliː
អូស្លូ	ʔouslou
អូហៃយ៉ូ	ʔouhajjou
អូអេស៊ីស	ʔouʔeːsiːh
អួត	ʔuət
អួល	ʔuəl
អើ	ʔaə
អើយ	ʔaəj
អៀ	ʔiə
អៀង	ʔiəŋ
អៀន	ʔiən
អៀម	ʔiəm
អៀរឡង់	ʔiəlɑŋ
អៀវ	ʔiəw
អេក	ʔeːk
អេកូស	ʔeːkouh
អេក្រង់	ʔeːkrɑŋ
អេក្វាទ័រ	ʔeːkʰʋaːtŏə
អេដស៍	ʔeːt
អេត្យូពី	ʔeːtʰjoupiː
អេទែ	ʔeːtɛː
អេប៉ុង	ʔeːpoŋ
អេប៉ុងហ្ស៍	ʔeːpoŋ
អេពីណា	ʔeːpiːnaː
អេមីរ៉ាត	ʔeːmiːraːt
អេរីត្រេ	ʔeːriːtreː
អេលីកុបទែរ	ʔeːliːkoptɛː
អេលីប	ʔeːliːp
អេល្យូម	ʔeːljuːm
អេវ៉េគ	ʔeːʋeːk
អេវ៉ែក	ʔeːʋaek
អេស្តូនី	ʔeːstouniː
អេស្ត្រូសែន	ʔeːstrousaen
អេស្ទែ	ʔeːstɛː
អេស្ប៉ាញ	ʔeːspaːɲ
អេហ្ស៊ីប	ʔeːziːp
អេឡិចត្រុង	ʔeːləctroŋ
អេឡិចត្រូត	ʔeːləctrout
អេះ	ʔeh
អែប	ʔaep
អែប្យូម	ʔaepʰjoum
អែម	ʔaem
អែលសាល់វ៉ាឌ័រ	ʔaelsalʋaːɗŏə
អៃដាហូ	ʔajɗaːhou
អោនស៍	ʔaon
អោប	ʔaop
អោយ	ʔaoj
អំណត់	ʔɑmnɑt
អំណប់	ʔɑmnɑp
អំណរ	ʔɑmnɑː
អំណស់	ʔɑmnɑh
អំណាច	ʔɑmnaːc
អំណាន	ʔɑmnaːn
អំណឹះ	ʔɑmnəh
អំណោយ	ʔɑmnaoj
អំនាន	ʔɑmnaːn
អំនួត	ʔɑmnuət
អំបាត	ʔɑmɓaːt
អំបាល	ʔɑmɓaːl
អំបិល	ʔɑmɓəl
អំបុក	ʔɑmɓok
អំបូរ	ʔɑmɓou
អំបែង	ʔɑmɓaeŋ
អំបោស	ʔɑmɓaoh
អំបោះ	ʔɑmɓɑh
អំប៊ូឡង់ស៍	ʔɑmɓuːlɑŋ
អំផូង	ʔɑmpʰouŋ
អំពក	ʔɑmpɔːʔ
អំពល់	ʔɑmpŭəl
អំពាច	ʔɑmpiəc
អំពាន់	ʔɑmpŏən
អំពារ	ʔɑmpiə
អំពាវ	ʔɑmpiəw
អំពាស	ʔɑmpiəh
អំពី	ʔɑmpiː
អំពូល	ʔɑmpuːl
អំពើ	ʔɑmpəː
អំពែ	ʔɑmpɛː
អំពែរ	ʔɑmpɛː
អំពៅ	ʔɑmpɨw
អំឡុង	ʔɑmloŋ
អ៊ី	ʔiː
អ៊ីចឹង	ʔiːcəŋ
អ៊ីចុង	ʔiːcoŋ
អ៊ីចុះ	ʔiːcoh
អ៊ីចេះ	ʔiːceh
អ៊ីញ	ʔiːɲ
អ៊ីដ្រាត	ʔiːɗraːt
អ៊ីដ្រុកស៊ីត	ʔiːɗroksiːt
អ៊ីដ្រូកាបូ	ʔiːɗroukaːɓou
អ៊ីដ្រូសែន	ʔiːɗrousaen
អ៊ីតាលី	ʔiːtaːliː
អ៊ីទែប្យូម	ʔiːtɛːpʰjoum
អ៊ីទ្រីយ៉ូម	ʔiːtriːjoum
អ៊ីនឌីយ៉ាណា	ʔiːnɗiːjaːnaː
អ៊ីនធឺណិត	ʔiːntʰɨːnət
អ៊ីប៉ូតេនុស	ʔiːpouteːnuh
អ៊ីមែល	ʔiːmɛːl
អ៊ីម៉ាម	ʔiːmaːm
អ៊ីយ៉ុង	ʔiːjoŋ
អ៊ីយ៉ូត	ʔiːjout
អ៊ីរ៉ង់	ʔiːrɑŋ
អ៊ីរ៉ាក់	ʔiːraʔ
អ៊ីលីណយ	ʔiːliːnɑːj
អ៊ីសូតូប	ʔiːsoutoup
អ៊ីសូមែ	ʔiːsoumɛː
អ៊ីស្ទើរ	ʔiːstəː
អ៊ីស្រាអែល	ʔiːsraːʔael
អ៊ីស្លង់	ʔiːslɑŋ
អ៊ីស្លាម	ʔihslaːm
អ៊ុច	ʔuc
អ៊ុត	ʔut
អ៊ុនតាក់	ʔuntaʔ
អ៊ុយ	ʔuj
អ៊ុយក្រែន	ʔujkraen
អ៊ុយរូហ្គាយ	ʔujruːgiəj
អ៊ុយរ៉ាញ៉ូម	ʔujraːɲoum
អ៊ុលត្រាសោន	ʔultraːsaon
អ៊ូ	ʔuː
អ៊ូបេគីស្ថាន	ʔuːɓeːkiːstʰaːn
អ៊ូហ្គង់ដា	ʔuːgŭəŋɗaː
អ៊ំ	ʔum
អ័ក្ស	ʔaʔ
អ័ព្ទ	ʔap
អ័ព្ភ	ʔap
អ័ភ្រ	ʔap
អ្នក	nĕəʔ
អ្វី	ʔʋəj
ឥ	ʔeʔ
ឥច្ឆា	ʔəccʰaː
ឥដ្ឋ	ʔət
ឥណ	ʔinaʔ
ឥណទាន	ʔinaʔtiən
ឥណពន្ធ	ʔinaʔpŭən
ឥណ្ឌា	ʔənɗiə
ឥណ្ឌូ	ʔənɗuː
ឥណ្ឌូចិន	ʔenɗuːcən
ឥណ្ឌូនេស៊ី	ʔənɗuːneisiː
ឥណ្ឌៀ	ʔənɗiə
ឥត	ʔət
ឥតិហាស	ʔetehaːh
ឥត្ថី	ʔəttʰəj
ឥទ្ធិ	ʔəttʰiʔ
ឥទ្ធិពល	ʔəttʰipŭəl
ឥន្ទ	ʔən
ឥន្ទធនូ	ʔəntʰĕəʔnuː
ឥន្ទនេល	ʔəntĕəʔneil
ឥន្ទុ	ʔɨn
ឥន្ទ្រិយ	ʔəntriː
ឥន្ទ្រី	ʔəntriː
ឥន្ធនៈ	ʔəntʰĕəʔnĕəʔ
ឥរា	ʔiraː
ឥរាវតី	ʔiraːʋĕəʔtəj
ឥរិយា	ʔerejaː
ឥរិយាបថ	ʔerejaːɓɑt
ឥរុវេទ	ʔiruʋeit
ឥលូវ	ʔəjləw
ឥស	ʔəh
ឥសិ	ʔiseʔ
ឥសី	ʔisəj
ឥសីភេសជ្ជ	ʔesəjpʰeisac
ឥសុការ	ʔisokaː
ឥសូរ	ʔisou
ឥស្លាម	ʔihslaːm
ឥស្លាម៉ាបាដ	ʔihslaːmaːɓaːt
ឥស្សរ	ʔɨhsaʔraʔ
ឥស្សរិយ	ʔihsaʔrejaʔ
ឥស្សរៈ	ʔəhsaʔraʔ
ឥស្សា	ʔihsaː
ឥឡូវ	ʔəjləw
ឦ	ʔəj
ឦតិហាស	ʔetehaːh
ឦស	ʔiːsaʔ
ឦសធរ	ʔiːsaʔtʰɔː
ឦសាន	ʔəjsaːn
ឦសូរ	ʔiːsou
ឧ	ʔoʔ
ឧក	ʔok
ឧកញ៉ា	ʔokɲaː
ឧកាស	ʔukaːsaʔ
ឧក្កដ្ឋ	ʔukkattʰaʔ
ឧក្កដ្ឋិសព្ទ	ʔukkattʰesap
ឧក្កាបាត	ʔukkaːɓaːt
ឧក្រិដ្ឋ	ʔokkrət
ឧក្រិដ្ឋកម្ម	ʔokkrətkam
ឧក្រិដ្ឋជន	ʔokkrəttʰaʔcŭən
ឧគ្ឃោសន	ʔukkʰoːsaʔnaʔ
ឧច្ច	ʔuccaʔ
ឧច្ចារ	ʔuccaːraʔ
ឧជុ	ʔucuʔ
ឧជ្ឈាន	ʔuccʰiən
ឧដុង្គ	ʔuɗoŋ
ឧណ្ណា	ʔunnaː
ឧណ្ហ	ʔun
ឧណ្ហីស	ʔunhəh
ឧតុ	ʔutoʔ
ឧតុរាជ	ʔutoriəc
ឧត្ដម	ʔutɗɑm
ឧត្តម	ʔutɗɑm
ឧត្តរ	ʔutɗɑː
ឧត្តរិ	ʔuttaʔreʔ
ឧត្តាន	ʔuttaːn
ឧត្តាស	ʔuttaːsaʔ
ឧទរ	ʔutɔː
ឧទាន	ʔutiən
ឧទានសញ្ញា	ʔutiənĕəʔsaɲɲaː
ឧទានសព្ទ	ʔutiənĕəʔsap
ឧទានស័ព្ទ	ʔutiənĕəʔsap
ឧទាហរណ៍	ʔutiəhɑː
ឧទ្ទាម	ʔuttiəm
ឧទ្ទិន	ʔuttɨn
ឧទ្ធម្ភាគចក្រ	ʔuttʰŏəmpʰiəkĕəʔcaʔ
ឧទ្យាន	ʔuttʰjiən
ឧបករណ៍	ʔupaʔkɑː
ឧបជ្ឈា	ʔupaccʰiə
ឧបជ្ឈាយ៍	ʔupaccʰiə
ឧបដ្ឋាន	ʔupattʰaːn
ឧបត្ថម្ភ	ʔupattʰam
ឧបទ្រព	ʔupaʔtrup
ឧបទ្វីប	ʔupattʰʋiːp
ឧបយុវរាជ	ʔupaʔjuʋĕəʔriəc
ឧបរាជ	ʔupaʔraːc
ឧបសគ្គ	ʔupaʔsaʔ
ឧបសម្បន្ន	ʔupaʔsamɓan
ឧបាយ	ʔuɓaːj
ឧបេក្ខា	ʔupeːkkʰaː
ឧបោសថ	ʔupaosaʔtʰaʔ
ឧប្បត្តិ	ʔupɓat
ឧប្បាទធម៌	ʔupɓaːtĕəʔtʰŏə
ឧភយោរាជ	ʔupʰĕəʔjoːriəc
ឧម្មង្គ	ʔummɑŋ
ឧម្មត្តកោ	ʔummattaʔkao
ឧម្មត្តកៈ	ʔummattaʔkaʔ
ឧម្មុង្គ	ʔummoŋ
ឧរគ	ʔuraʔkĕəʔ
ឧរង្គ	ʔurɑŋkĕəʔ
ឧរង្គសត្វ	ʔurɑŋkĕəʔsat
ឧរា	ʔuraː
ឧរ៉ៃ	ʔuraj
ឧស	ʔoh
ឧសភា	ʔosaʔpʰiə
ឧស្ម័ន	ʔusman
ឧស្សវៈ	ʔuhsaʔʋaʔ
ឧស្សាហកម្ម	ʔuhsaːhaʔkam
ឧស្សាហូបនីយកម្ម	ʔuhsaːhoupaʔniːjĕəʔkam
ឧស្សាហៈ	ʔuhsaːhaʔ
ឧស្សាហ៍	ʔuhsaː
ឩកា	ʔuːkaː
ឩដ្ឋ	ʔout
ឩរុ	ʔuːruʔ
ឪ	ʔəw
ឪទឹន	ʔəwtɨn
ឪពុក	ʔəwpuk
ឪម៉ាល់	ʔəwmal
ឪឡឹក	ʔəwlək
ឫក	rɨk
ឫកពា	rɨkpiə
ឫគ្វេទ	rɨkʋeit
ឫទ្ធិ	rɨt
ឫស	rɨh
ឫសការេ	rɨhkaːreː
ឫសការ៉េ	rɨhkaːreː
ឫស្យា	rɨhsjaː
ឫស្សី	rɨhsəj
ឬ	rɨː
ឮ	lɨː
ឯ	ʔae
ឯក	ʔaek
ឯកជន	ʔaekaʔcŭən
ឯកតា	ʔaektaː
ឯកតោ	ʔeːkaʔtao
ឯកទេស	ʔaekteih
ឯកភាព	ʔaekaʔpʰiəp
ឯករាជ	ʔaekaʔriəc
ឯករាជ្យ	ʔaekaʔriəc
ឯកសារ	ʔaekaʔsaː
ឯកសិទ្ធិ	ʔaekaʔsət
ឯកា	ʔaekaː
ឯកាធិកម្ម	ʔaekaːtʰikam
ឯកាធិភាព	ʔaekaːtʰipʰiəp
ឯកោ	ʔaekao
ឯង	ʔaeŋ
ឯរាវ័ណ	ʔeːraːʋŏən
ឯវំ	ʔeːʋaŋ
ឰរាវ័ត	ʔajraːʋŏət
ឰសូរ	ʔajsou
ឱកាស	ʔaokaːh
ឱក័ស	ʔaokah
ឱឃ	ʔaokʰĕəʔ
ឱជ	ʔaoc
ឱដ្ឋជ	ʔaottʰaʔcĕəʔ
ឱនភាព	ʔaonaʔpʰiəp
ឱប	ʔaop
ឱរា	ʔaoraː
ឱរ៉ាល់	ʔaoral
ឱរ៉ុប	ʔaorop
ឱរ៉ូប	ʔaoroup
ឱលោកដ្ឋាន	ʔaoloːkattʰaːn
ឱវាទ	ʔaoʋaːt
ឱសថ	ʔaosɑt
ឱសថស្ថាន	ʔaosaʔtʰaʔstʰaːn
ឱសថាល័យ	ʔaosotʰaːlaj
ឱសានវាទ	ʔaosaːnaʔʋiət
ឱស្ឋ	ʔaoh
ឱស្រព	ʔaosrɑp
ឱហាត	ʔaohaːt
ឱឡារិក	ʔaolaːrɨk
ឱឡិគល្ល	ʔaolekŏəl
ឱ្យ	ʔaoj
ឲ្យ	ʔaoj
ឳ	ʔəw
ឳពុក	ʔəwpuk
៘	laʔ
