آ	ɑ
آتل	atəl
آثار	ɑsɑːr
آثارو	ɑsaːro
آټک	ɑʈək
آدا	ɑda
آدرس	adrəs
آدم	ɑdəm
آذان	ɑzan
آر	ɑr
آرام	ɑram
آرامیو	ɑramijo
آرټ	ɑrʈ
آرزو	ɑrzo
آره	ɑra
آزادي	ɑzaːdi
آس	ɑs
آسان	ɑsan
آسانه	ɑsaːna
آسمان	ɑsman
آسمانی	ɑsmaniː
آسيا	ɑsja
آسیا	ɑsja
آشکې	ɑʃkeː
آلمان	ɑlmɑn
آله	ɑla
آمو	ɑmo
آهسته	ɑhəsta
آو	ɑw
آيا	ɑjɑ
آيات	ɑjɑt
آيرلنډ	ɑjrlənɖ
آیا	ɑjɑ
ؤنه	wona
إلا	ilɑ
إله	ilə
ئ	j
ئې	jeː
ا	a
اٶ	aw
ابا	aba
ابادول	abɑdawəl
ابادۍ	abaːdəy
ابلک	əblk
اپ	ap
اپر	apar
اپريدی	apridaɪ
اپریدي	apridi
اپيم	apim
اپين	apin
اترو	atro
اترې	atəreː
اتل	atəl
اتلان	atəlaːn
اتلانو	atəlaːno
اتلس	atələs
اتله	atəla
اتلې	atəleː
اتم	atəm
اتمو	atəmo
اتڼ	ataɳ
اته	atə
اتو	ato
اتوار	itwar
اتيا	atja
اثار	asaːr
اثر	asar
اټکل	aʈkəl
اجر	ad͡d͡ʒar
اجل	ad͡d͡ʒəl
اجمل	ad͡d͡ʒmal
اچول	at͡ʃawəl
احساس	ihsɑːs
احسان	ihsɑn
احوال	ahwaːl
اخ	ax
اختر	axtar
اختراع	ixtera
اخته	axta
اختيار	ixtjaːr
اخرت	axirat
اخښل	axxəl
اخښی	axxai
اخلاص	ixlaːs
اخلاق	ixlaːq
اخلاقو	axlaːqo
اخلم	axləm
اخلي	axli
اخير	axiːr
اخيستل	axistəl
اخيستى	axiste
اخیستونکو	axiːstonko
اڅک	asək
ادا	ada
اداره	idara
ادارو	idaro
اداري	idaːriː
ادارې	idaːreː
اداکاره	adakaːra
ادب	adəb
ادبي	adəbiː
ادبياتو	adəbjaːto
ادبیاتو	adəbijaːto
ادرار	adraːr
ادراک	adraːk
ادرس	adrəs
ادم	adəm
ادیب	adiːb
ادینه	adiːna
ادې	adeː
اذان	azan
اذکار	azkaːr
اراده	iraːda
ارام	araːm
ارب	arb
ارزان	arzɑn
ارزانه	arzɑna
ارزښت	arzəxt
ارزي	arzi
ارم	arm
ارمان	armɑn
اروپا	aropa
اروزګان	arozɡaːn
اري	ari
اريک	arik
اريوب	arjub
از	az
ازاد	azaːd
ازادي	azaːdi
ازبکو	azbako
ازغی	azɣi
ازمول	azmol
اړتیا	aɺtijaː
اړخ	aɺx
اړخه	aɺxa
اړخونه	aɺxona
اړه	aɺa
اړو	aɺo
اړول	aɺawəl
اړين	əɺin
اړیکې	aɺikeː
اس	as
اساس	asaːs
اساسات	asaːsaːt
اساساتو	asaːsaːto
اساسي	asaːsi
اسانه	asaːna
اسانۍ	asaːniː
اسپانيا	ɑspɑnjɑ
اسپه	aspa
استادانو	ostaːdaːno
استاذ	ostaːz
استاذان	ostaːzaːn
استازو	ostaːzo
استازي	ostaːzi
استازی	ostaːzi
استلزام	astalzaːm
استول	astawəl
اسټراليا	asʈrɑljɑ
اسکيمو	askimo
اسل	asl
اسلام	ɪslɑm
اسلامي	islaːmi
اسمان	asmɑn
اسماني	asmɑni
اسناد	asnaːd
اسونو	asuno
اسیا	asja
اشاره	aʃaːra
اشرف	aʃraf
اشغال	aʃɣaːl
اصلي	asli
اعتبار	etbaːr
اعمال	aʕmaːl
اغزي	aɣzi
اغزی	aɣzai
اغږل	aɣgəl
اغږم	aɣagəm
اغوستل	aɣostəl
اغوندم	aɣundəm
اغوندي	aɣundi
اغیار	aɣjaːr
اغېز	aɣez
افسانې	afsaːneː
افغان	afɣɑn
افغانستان	apɣɑnɪstɑn
افکارو	afkaːro
اقبال	iqbaːl
اقتصادي	iqtɛsaːdi
اقلیمي	iqleːmi
اکا	akaː
اکبر	akbar
اکبرخان	akbarxaːn
اکثره	aksara
اکر	akar
اکسوس	aksos
اکوزو	akozo
اګل	agal
الا	ilaː
البانيا	albɑnjɑ
البته	albata
البند	ilband
الپورۍ	alpurəi
الحَمْدُ	alhamdu
السلام	assalaːm
اَلسَلامُ	alsalaːmu
الله	allaːh
اَللهِ	allaːhi
المان	alman
المانيا	almɑnjɑ
المانی	almɑnai
اله	ala
الو	alu
الوبالو	alubɑlu
الوتکه	alwatəka
الوتل	alwətəl
الوځي	alwozi
الوزم	alwəzəm
ام	am
اما	amaː
امارت	amaːrat
امام	amaːm
امان	amaːn
امبر	ambar
امپراتور	ampraːtoːr
امپراتورۍ	ampraːtoːrəi
اُمتي	umati
امر	amar
امريکا	amrikɑ
امريکايی	amrikɑjaɪ
امريکه	amrika
املاء	imlaː
امله	amla
املوک	amluk
امن	aman
امنيه	amniːa
امنیت	amniːat
امير	amiːr
امیر	amiːr
امېل	amel
ان	an
انا	anɑ
اناپ	anap
انار	anɑr
انتخاب	intixaːb
انتظار	intizaːr
انځر	and͡d͡ʒar
انځور	anzor
انځورګر	anzorgar
انځورګري	anˈzurgəri
اند	and
اندي	andi
انسان	insan
انسانه	insana
انسانیت	insaniːat
انصاف	insaːf
انقلابي	inqlaːbi
انګړ	anˈgəɺ
انګلستان	ɪnglɪstɑn
انګور	angur
انګوړی	angoɺai
انګيزه	anɡeːza
اهل	ahl
اهوړ	ahuɺ
او	aw
اوبازي	aobɑzi
اوباسم	ubɑsəm
اوبدل	obdəl
اوبه	obe
اوبو	obo
اوپه	awpa
اودس	odas
اور	aor
اورګاډی	orgɑɖe
اورلوبه	orloba
اورم	awrəm
اوره	awra
اورول	awrawəl
اوري	ori
اوريګامي	origɑmi
اوریزه	orizə
اورېدل	awredəl
اورېدونکی	awredunkai
اوړم	awɺəm
اوړی	oɺaɪ
اوړېدل	awɺedəl
اوږد	awɡəd
اوږده	awɡəda
اوږه	oga
اوس	os
اوسم	osəm
اوسه	osa
اوسېدل	osedəl
اوسېدونکی	osedunkaɪ
اوسېدونکې	osedunke
اوش	oʃ
اوشه	oʃa
اوکښته	okəʈa
اوگره	oɡəra
اول	awal
اولس	uləs
اوله	awla
اولو	awlo
اولې	awleː
اوم	um
اومامي	umɑmi
اونۍ	onai
اوه	owa
اوو	owo
اوولس	awolas
اووم	awom
اووه	awwa
اويا	awja
اويم	ojəm
اویا	awja
ايا	aja
ايستل	istəl
ايسلنډ	aislənɖ
ايسي	ajsi
ايغلو	iɣlu
ايله	ajla
ايمان	ajman
اينځر	inzar
اينکى	ajnaːkai
اينو	ino
ای	ai
ایا	aja
ایران	airaːn
ایس	ais
ایمان	ima:n
اې	eː
اېخ	ex
اېږدې	eːɡde
اېسټونيا	esʈonjɑ
اېکوادور	ekwɑdor
اېموجي	emod͡d͡ʒi
ب	b
بآغ	baːɣ
با	baː
بابا	baːbaː
باچا	bɑt͡ʃɑ
باد	bɑd
بادار	baːdaːr
بادام	baːdaːm
بادول	bɑdawəl
بار	bɑr
باران	bɑrɑn
بارانه	baːraːna
باراني	baːraːni
بارکزي	baːrəkziː
بارکزی	bɑrəkzai
باره	baːra
بارول	bɑrawəl
باز	bɑz
بازار	baːzaːr
بازو	bɑzu
بازۍ	baːzai
باسي	baːsi
باغ	bɑɣ
باغوان	bɑɣwɑn
بالا	baːlaː
بالر	baːlar
بالښت	bɑləxt
بام	bɑm
بامفهوم	baːmafhum
باندي	baːndi
باندی	baːndi
باندې	baːnde
بانک	baːnk
بانه	baːna
باڼه	baːɳa
باور	baːwar
بايد	baːjad
بايلل	bɑiləl
باید	baːjad
بته	bəta
بجو	bad͡d͡ʒo
بجی	bad͡d͡ʒe:
بچ	bat͡ʃ
بچو	bat͡ʃo
بختي	baxti
بخښل	baxxəl
بخښنه	baxxna
بخښي	baxxi
بخل	baxəl
بخن	baxan
بخۍ	baxiː
بڅرکی	bəsərkaɪ
بد	bəd
بدترين	badtariːn
بدر	badar
بدسترګی	badstərge
بدل	badal
بدلاری	badlɑre
بدله	badala
بدلول	badalawəl
بدلون	badluːn
بدلېدل	badledəl
بدمخی	bədməxai
بدن	badan
بدني	badani
بده	bəda
بدو	badu
بدي	bədi
بدۍ	badəi
بډايه	bəɖaːja
بډای	bəɖaːj
بر	bar
برابر	barɑbar
برابري	baraːbari
برانډ	baraːnɖ
برايي	bərɑji
بربنډ	bərbəŋɖ
برتانيه	bartɑnja
برج	brad͡z
برخه	barxa
برخو	barxo
برخی	barxe
برخې	barxeː
برس	bars
برطانيه	bartɑnja
برغټ	bərɣəʈ
برقه	barqa
برکت	barkat
برکته	barkata
برکي	barki
برنډې	baraːɳɖeː
بره	bara
بريا	barijaː
بريالي	barijaːli
بريالی	barijaːli
بريتانيا	britɑnijɑ
بريتونه	baritona
بريښي	barəxi
بریا	barijaː
برید	barid
برېت	bret
برېښنا	bareːxna
بزمي	bazmi
بزه	baza
بزې	bazeː
بړستن	bɺəstən
بس	bas
بستر	bastar
بسیا	basijaː
بشام	baʃaːm
بشپړ	baʃpəɺ
بشپړولو	baʃpəɺulo
بشپړې	baʃpəɺeː
بشر	baʃar
بشري	baʃari
بشیر	baʃiːr
بښل	bəxəl
بښنه	poxtəna
بښه	bəxa
بغاري	baɣaːri
بغری	baɣare
بغلان	baɣlaːn
بغلاني	baɣlaːni
بغور	bəɣwər
بغیر	baɣer
بقا	baqaː
بکاڼه	bakɑɳa
بگرام	baɡraːm
بل	bəl
بلا	balaː
بلال	balaːl
بلاوي	balaːwi
بلغارستان	bolɣɑrɪstɑn
بلغاريا	bolɣɑrjɑ
بلغاريه	bulɣɑrja
بلکه	balka
بلکې	balke
بلل	baləl
بله	bala
بلوک	bluk
بلي	bali
بلۍ	baləi
بلې	baleː
بلېږم	baleɡəm
بمي	bami
بن	bən
بنا	banaː
بنج	band͡z
بند	band
بنده	banda
بندول	baŋdəwəl
بندي	bəndi
بنډار	banɖaːr
بنزیو	banzio
بنسټ	bənst
بنسټیز	bansəˈtiːz
بنګېدل	bəngedəl
بنو	bano
بنۍ	banaːi
بڼ	baɳ
بڼکی	bəɳke
بڼه	baɳa
بڼهار	bəɳəhɑr
بڼو	baɳo
بڼوال	bəɳwɑl
بڼې	baɳeː
به	ba
بهار	bahaːr
بهر	bahr
بهير	bahir
بهیر	bahir
بهېدل	bəhedəl
بهېږم	bahegəm
بوټان	buʈɑn
بوټي	boʈi
بوټی	boʈi
بوخت	boxt
بوځي	bozi
بور	bor
بوره	bura
بوزېدل	buzedəl
بولم	boləm
بونا	bonɑ
بوڼېدل	buɳedəl
بوى	buj
بوی	boj
بي	biː
بيا	bjɑ
بيايم	bjɑjəm
بيخ	bix
بيزه	biza
بيزو	bizo
بيړه	biɺa
بيژکۍ	bid͡ʒakəi
بيسيم	bisiːm
بيليون	biljon
بيلېږي	bileːɡi
بيول	biwəl
بييی	bijaɪ
بی	biː
بیا	biɑ
بیان	bijaːn
بیرته	birta
بیرون	birun
بیلګه	bilɡa
بیه	bija
بې	be
بېټ	beːʈ
بېخي	bexi
بېرته	berta
بېړۍ	beɺəi
بېعقل	beːaql
بېل	bjel
بېلا	beːlaː
بېلتون	beltun
بېلو	beːlo
پ	p
پابند	pɑˈband
پاته	ˈpɑta
پاتې	pɑˈte
پاچا	pɑˈt͡ʃɑ
پاخه	ˈpɑxa
پاخې	pɑˈxe
پاڅي	pɑˈsi
پارسه	pɑrsa
پارسیوان	pɑrsiwɑn
پارک	pɑrk
پارکینګ	pɑrˈkiŋ
پارلمان	pɑrleˈmɑn
پاره	ˈpɑra
پاړسي	pɑɺˈsi
پاړو	pɑɺu
پاس	pɑs
پاستا	pɑsˈtɑ
پاسته	ˈpɑsta
پاشلی	ˈpɑʃli
پاک	pɑk
پاکستان	pɑkɪstɑn
پاکه	ˈpɑka
پاکول	pɑˈkowəl
پاکولو	pɑkoˈlu
پاکي	pɑˈki
پاکې	pɑˈke
پالنګر	pɑlənˈɡar
پالنه	pɑlˈna
پالنې	pɑlˈne
پاله	ˈpɑla
پام	pɑm
پامدور	pɑmador
پاملرنې	pɑmlərˈne
پانګه	ˈpɑŋa
پانګې	pɑˈŋe
پاڼ	pɑɳ
پاڼه	pɑɳa
پاڼو	pɑˈɳu
پاى	pɑj
پايډل	pɑjˈɖal
پايله	pɑila
پايول	pɑyawəl
پای	pɑj
پایښت	pɑjˈxat
پایلې	pɑjˈle
پت	pat
پتخ	patax
پتخه	patəxa
پتنګ	pataŋg
پته	ˈpata
پتې	paˈte
پټ	pəʈ
پټه	ˈpəʈa
پټو	pəˈʈu
پټي	ˈpəʈi
پټې	pəˈʈe:
پخپل	pəxˈpal
پخپله	pəxˈpala
پخلا	pəxˈlɑ
پخلنځي	pəxlanˈzi
پخلي	pəxˈli
پخلی	pəxlai
پخه	ˈpəxa
پخوا	pəˈxwɑ
پخوانی	pəxwɑˈnai
پخول	paxawəl
پخير	pəˈxir
پخیر	pəˈxir
پخېدل	pəxedəl
پخېږي	pəˈxeɡi
پدې	pəˈde
پر	pər
پراته	pəˈrɑta
پراخ	pəˈrɑx
پراختیا	pərɑxˈtja
پراخه	pəˈrɑxa
پراخو	pərɑˈxu
پراخې	pərɑˈxe
پرتله	partala
پرتمين	pərtaˈmin
پرته	ˈpərta
پرتوګ	partug
پرچو	pərˈt͡ʃu
پرخلاف	pərxəˈlɑf
پرځان	pərˈzɑn
پرڅو	pərˈsu
پردي	pərˈdi
پردۍ	pərˈdəi
پرزي	pərˈzi
پرست	pərast
پرلت	pərˈlat
پرله	ˈpərla
پرما	pərˈmɑ
پرمخ	pərˈmax
پرمختګ	parmaxtɑg
پرمنځ	pərˈmanz
پروا	pərˈwɑ
پروت	prot
پروړه	proɺe
پروړو	proˈɺu
پروژه	proˈd͡d͡ʒa
پروژو	proˈd͡d͡ʒu
پروژې	proˈd͡d͡ʒe
پروسه	parwaˈsa
پرون	pəˈrun
پري	pəˈri
پریښودل	priˈxodal
پریکړو	prikˈɺu
پرې	pre
پرېز	pare:z
پرېږده	preˈɡda
پرېکړه	prekɺa
پز	pəz
پزه	ˈpəza
پړ	pəɺ
پړانګ	pɺɑŋg
پړاو	pəˈɺɑw
پړسوب	paɺsob
پړي	pəˈɺi
پس	pas
پسرلى	pasərlai
پسرلي	pasərˈli
پسرلی	pəsərlai
پسهٔ	psə
پسي	ˈpəsi
پسې	pəse
پشايې	pʃɑˈje
پشترود	pəʃtaˈrod
پشتو	pʊʃˈto
پشتون	pʊʃˈtun
پشتين	pəʃˈtin
پشه	ˈpəʃa
پشير	pəˈʃir
پشۍ	pəʃəi
پښتانه	pʊxˈtɑna
پښتنه	pʊʃtana
پښتنو	pʊxˈtənu
پښتني	pʊxˈtəni
پښتو	pʊxto
پښتورگى	pʊxtorˈɡe
پښتون	pʊxtun
پښه	xpa
پښه	pəˈxa
پښو	pəˈxu
پښي	pəˈxi
پښين	pəˈxin
پښې	pəˈxe
پک	pak
پکار	pəˈkɑr
پکان	pakɑn
پکت	pəkt
پکتيا	pəkˈtiɑ
پکتيکا	pəktiˈkɑ
پکتیا	pəkˈtiɑ
پکتیکا	pəktiˈkɑ
پکښي	pəkˈxi
پکنک	pikˈnik
پکنیک	pikˈnik
پکه	ˈpəka
پکی	ˈpəke
پکې	pəˈke
پل	pal
پلار	plɑr
پلاز	plɑz
پلازمینه	plɑzmiˈna
پلازمېنه	plɑzmena
پلاله	plɑla
پلان	plɑn
پلانونه	plɑˈnuna
پلاو	plɑw
پلټنې	pəlʈəˈne
پلم	pɪləm
پلمه	ˈpalma
پلمې	palˈme
پلو	ˈpalu
پلور	plor
پلورل	plorəl
پلونو	ploˈnu
پلوه	ˈpalwa
پلي	pli
پليت	plit
پلی	ˈpali
پلې	ˈpale
پمنکی	pamankaɪ
پنا	pəˈnɑ
پناه	pəˈnɑh
پنجاب	pənˈd͡d͡ʒɑb
پنځلس	pinzəlas
پنځم	pənzəm
پنځه	pinzə
پنځو	pənˈzu
پنځوس	pənˈzos
پنډوس	pənɖus
پنير	panir
په	pə
پہ	pah
پۀ	pə
پوخ	poʊx
پوځي	pawzˈi
پوڅه	posa
پور	por
پورته	ˈporta
پوره	ˈpora
پوري	poːri
پوری	poˈri
پورې	poˈre
پوړ	poɺ
پوړه	ˈpoɺa
پوست	post
پوستکي	posˈtəki
پوسټ	post
پوښتنه	poxtəna
پوښته	ˈpoxta
پول	pol
پوله	pula
پولو	poˈlu
پولي	poˈli
پوليس	polis
پولیسو	poliˈsu
پولیو	poliˈjo
پونده	punda
پوه	poh
پوهان	poˈhɑn
پوهاند	poˈhɑnd
پوهنتون	poˈhɑntun
پوهنه	pohəna
پوهه	ˈpohɑ
پوهولو	pohoˈlu
پوهې	poˈhe
پوهېدل	pohedəl
پوهېږي	pohegi
پياله	piˈɑla
پيدا	peˈdɑ
پير	pir
پيژنتون	ped͡ʒanˈtun
پيژند	peˈd͡ʒand
پيسو	piˈsu
پيسې	paise
پيشو	piʃo
پيل	pil
پينځه	pinˈza
پی	pi
پیدا	peːˈda
پیزا	ˈpeːza
پیژندل	peːd͡ʒanˈdal
پیژني	peːd͡ʒaˈni
پیسو	peːˈso
پیسې	peːˈse
پیښه	ˈpeːxa
پیښو	ˈpeːxo
پیښور	peːˈxor
پیغام	peːˈɣaːm
پیل	pil
پیوستون	peːwəsˈtun
پې	pe
پېر	peːr
پېرل	peːrˈəl
پېړۍ	peɺəi
پېړې	peːˈɺe
پېژنم	peːd͡ʒanˈum
پېښه	peːˈxa
پېښو	peːˈxo
پېښور	pexəwər
پېښورۍ	peːxoˈraːi
پېښې	peːˈxe
ت	t
تآمین	tamiːn
تا	taː
تابع	taːbeː
تاته	taːta
تاج	taːd͡d͡ʒ
تاجکو	taːd͡d͡ʒko
تاريخ	taːrix
تاريخي	taːrixi
تاريخې	taːrixeː
تاریخ	taːrix
تاریخي	taːrixi
تاریخی	taːrixi
تازه	taːza
تاسره	taːsra
تاسو	tɑso
تاسي	taːsi
تاسیس	taːsiːs
تاسې	tɑso
تاک	tak
تال	taːl
تانۀ	tɑnə
تانوکی	tɑnukaɪ
تاو	tɑw
تاوان	taːwaːn
تاوده	taːwda
تاوول	tɑwawəl
تبادلې	tabaːdleː
تباره	tabaːra
تباهي	tabaːhi
تبر	tabar
تبرک	tabarak
تبلیغ	tabliːɡ
تبه	taba
تبی	tabiː
تپوس	tapus
تجارت	tad͡d͡ʒaːrat
تجربه	tad͡d͡ʒarba
تجربو	tad͡d͡ʒarbo
تجربې	tad͡d͡ʒarbeː
تجزيې	tad͡d͡ʒziːjeː
تحکال	tahkaːl
تداوے	tadawa
تر	tar
ترافیکو	taraːfiːko
ترانې	taraːneː
تربیې	tarbjeː
ترتیب	tarteːb
ترخو	tarkho
ترڅنګ	tart͡sang
ترڅو	tart͡so
ترسره	tarsara
ترکمنو	tarkmano
ترکی	tarki
ترکیب	tarkiːb
ترکیې	tarkijeː
ترلاسه	tarlasə
ترمنځ	tarmanz
تروش	taroʃ
تروه	tarwa
تريخ	tariːx
ترينو	tarino
ترین	tareːn
ترې	tareː
تړاو	taɺaːw
تړل	təɺəl
تړلي	taɺli
تړون	taɺon
تړي	taɺi
تږي	tagi
تسبیحو	tasbiːho
تشبیه	taʃbiːh
تشخص	taʃaxos
تشکيل	taʃkil
تشه	taʃa
تشویقول	təʃweˈqawal
تښتي	taxti
تعالی	taʕaːliː
تعريف	tarif
تعریف	tarif
تعلق	taluq
تعليم	taʕliːm
تغير	taɣeːr
تقسیم	taqsiːm
تقلید	taqliːd
تکامل	takaːmul
تکرار	takraːr
تکړه	takəɺa
تکليف	takliːf
تکلیف	takliːf
تکه	taka
تګ	taɡ
تګلاره	taɡlaːra
تگ	taɡ
تل	təl
تلتک	taltək
تلل	tləl
تللي	talləi
تللی	talli
تللې	talleː
تله	tala
تلو	talo
تلوار	taluːaːr
تلین	taliːn
تم	tam
تماله	tamɑla
تمام	tamaːm
تمدن	tamadun
تمرکز	tamərkəz
تمرین	tamriːn
تمه	tama
تن	tan
تناره	tanaːra
تنبلي	tanbəli
تندی	tandi
تنګ	taŋɡ
تنه	tana
تنور	tanuːr
تڼۍ	taɳəi
ته	ta
تـه	ta
تہ	ta
تۀ	tə
توان	tawaːn
توب	taub
توپ	taup
توپان	topɑn
توت	tut
توتکۍ	tautkai
توتي	tuti
توخي	taxi
تود	tod
توده	tawda
تودوخي	təwduxi
تور	taur
تورن	tauran
توره	taura
توری	tauriː
تورې	taureː
توغ	tauɣ
توکل	taukal
توکم	taukam
توکو	tauko
توکي	tauki
توګه	tauɡa
تول	taul
تولید	tauliːd
تومنه	taumana
تون	tun
تويول	tojawəl
تيار	tijaːr
تياري	tijaːri
تيپي	tipi
تير	tiːr
تيره	tiːra
تيش	tiːʃ
تیار	tijaːr
تیارې	tijaːreː
تیره	tiːra
تې	teː
تېر	teːr
تېره	teːra
تېرۀ	terə
تېروتل	terwatəl
تېروتنه	terwatəna
تېز	teːz
ث	se
ثبت	sabət
ثبتول	sabətawəl
ثواب	sawaːb
ټ	ʈe
ټاپو	ʈɑpu
ټاپي	ˈʈaːpi
ټاکل	ˈʈaːkəl
ټاکلو	ˈʈaːklo
ټاکنه	ˈʈaːkəna
ټاکنو	ˈʈaːkəno
ټاکنې	ˈʈaːkəne
ټاکي	ˈʈaːki
ټال	ˈʈaːl
ټبر	ʈabar
ټپ	ʈap
ټپاکی	ʈupɑkai
ټپه	ˈʈapa
ټپي	ˈʈapi
ټرانسپورټ	transpoˈrt
ټغر	ˈʈaɣar
ټک	ʈək
ټکالې	ʈkɑˈle
ټکر	ʈəˈkar
ټکرې	ʈkəˈre
ټکله	ˈʈakla
ټکوي	ʈkəˈwi
ټکي	ʈəˈki
ټل	ˈʈal
ټماټر	ʈamɑʈər
ټنډه	ʈənɖa
ټنګ	ˈʈaŋɡ
ټه	ˈʈa
ټوپک	ʈuˈpak
ټوپکی	ʈupakai
ټوک	ʈok
ټوکر	ʈukər
ټوکه	ʈoka
ټوکي	ʈoki
ټوکې	ʈoˈke
ټول	ˈʈoːl
ټولګي	ʈolˈɡi
ټولنه	ˈʈoːləna
ټولنو	ˈʈoːləno
ټولنیز	ˈʈoːlniz
ټولنې	ʈolˈne
ټوله	ʈoˈlɑ
ټولو	ʈoˈlu
ټولوي	ʈoˈluj
ټيت	ʈit
ټيکاله	ʈiˈkɑla
ټيم	ʈim
ټينګ	ʈiŋg
ټینګار	ʈinˈɡɑr
ج	d͡d͡ʒ
جادو	d͡d͡ʒaːdu
جارو	d͡d͡ʒaːro
جام	d͡zɑm
جامه	d͡d͡ʒaːma
جامو	d͡d͡ʒaːmo
جامې	d͡d͡ʒaːmeː
جان	d͡d͡ʒaːn
جانان	d͡d͡ʒaːnaːn
جاوید	d͡d͡ʒaːweːd
جبین	d͡d͡ʒabiːn
جدي	d͡d͡ʒadi
جذب	d͡d͡ʒazb
جرګو	d͡d͡ʒərɡo
جرګې	d͡d͡ʒərɡeː
جرم	d͡d͡ʒurm
جرمني	d͡d͡ʒarmani
جږګی	d͡zagaɪ
جشن	d͡d͡ʒaʃn
جفا	d͡d͡ʒafaː
جکړ	d͡zakaɺ
جګ	d͡zɪg
جګتيا	d͡zəgtjɑ
جګړن	d͡zəgɺən
جګړه	d͡zəgəɺa
جګړول	d͡zagɺawəl
جګړې	d͡d͡ʒəɡreː
جل	d͡d͡ʒal
جلا	d͡zəlɑ
جلال	d͡d͡ʒalaːl
جلاله	d͡d͡ʒalaːla
جم	d͡d͡ʒam
جمعه	d͡d͡ʒumʕa
جمعې	d͡d͡ʒumʕeː
جمله	d͡d͡ʒumla
جملو	d͡d͡ʒumlo
جملي	d͡d͡ʒumli
جملې	d͡d͡ʒumleː
جنت	d͡d͡ʒannat
جنرال	d͡d͡ʒənraːl
جنسي	d͡d͡ʒənsi
جنکۍ	d͡zinəkəi
جنګ	d͡zəng
جنګه	d͡d͡ʒəŋa
جنګول	d͡zangawəl
جنګي	d͡d͡ʒəŋi
جنګيالی	d͡zəngjɑlai
جنوبي	d͡d͡ʒənubi
جنۍ	d͡zinəi
جهان	d͡d͡ʒahaːn
جهاني	d͡d͡ʒahaːni
جهنم	d͡d͡ʒahannam
جوړ	d͡zoɺ
جوړښت	d͡d͡ʒoɺaxt
جوړول	d͡zoɺawəl
جوګ	d͡d͡ʒoɡ
جولا	d͡d͡ʒulaː
جومات	d͡d͡ʒoːmat
جيب	d͡d͡ʒeːb
جیپ	d͡d͡ʒiːp
جې	d͡ze
جېبوتي	d͡zebuti
چ	t͡ʃ
چا	t͡ʃa
چاپ	t͡ʃaːp
چاته	t͡ʃaˈta
چارجر	t͡ʃaːrˈd͡d͡ʒar
چاره	ˈt͡ʃaːra
چارو	t͡ʃaro
چارواکي	t͡ʃaːroˈwaːki
چاړه	t͡ʃaːɺa
چاکلېټ	t͡ʃɑkleʈ
چاه	t͡ʃaːh
چاودنې	t͡ʃaːoˈd͡ɳe
چاودون	t͡ʃaːoˈd͡un
چاي	ˈt͡ʃaːj
چاينک	t͡ʃɑinək
چای	t͡ʃɑi
چپ	t͡ʃəp
چپه	t͡ʃəˈpa
چپې	t͡ʃəˈpe
چپېږي	t͡ʃəˈpeːɡi
چت	t͡ʃət
چټي	t͡ʃəˈʈi
چر	t͡ʃar
چراغ	t͡ʃaːˈraːɣ
چرته	t͡ʃarˈta
چرګ	t͡ʃəɺg
چرگ	t͡ʃarɡ
چښم	t͡ʃəχm
چغک	t͡ʃəˈɣək
چک	t͡ʃək
چکر	t͡ʃəkˈar
چکي	t͡ʃəˈki
چکېسر	t͡ʃəkesər
چل	t͡ʃəl
چلند	t͡ʃaːˈland
چمتو	t͡ʃəmˈto
چمن	t͡ʃaˈman
چندي	t͡ʃənˈdi
چنګاش	t͡ʃənˈɡaːʃ
چه	t͡ʃa
چو	t͡ʃo
چوپړ	t͡ʃopəɺ
چوپـړ	t͡ʃoˈpəɺ
چورلکه	t͡ʃurləka
چوغکه	t͡ʃoˈɣaka
چوک	t͡ʃok
چونګښه	t͡ʃuŋxa
چوڼيا	t͡ʃuɳjɑ
چي	t͡ʃi
چيچل	t͡ʃit͡ʃəl
چيرته	ˈt͡ʃirˈta
چيلۍ	ˈt͡ʃile
چين	t͡ʃin
چی	t͡ʃi
چیرت	ˈt͡ʃirt
چیک	t͡ʃik
چین	t͡ʃin
چې	t͡ʃe
چې	t͡ʃe
چېرته	ˈt͡ʃerte
ح	h
حال	haːl
حالت	haːlat
حبیب	habiːb
حج	had͡d͡ʒ
حجاب	həd͡d͡ʒaːb
حد	had
حساب	hisaːb
حسن	hasan
حشر	haʃar
حضرت	hazrat
حقوق	huquːq
حل	hal
حماس	hamaːs
حمام	hamaːm
حمزه	hamza
حمیدبه	hamiːdba
حيواني	hajwaːni
خ	x
خادم	xaːdəm
خارښت	xarəxt
خاصو	xaːso
خاطر	xaːtər
خاک	xaːk
خال	xaːl
خالا	xaːlaː
خالق	xaːleq
خالي	xaːli
خام	xɑm
خاموش	xaːmoːʃ
خاموشي	xaːmoːʃi
خان	xaːn
خانده	xaːnda
خانۍ	xaːnaːi
خاورو	xaːwro
خاورې	xaːwreː
خاونده	xaːwanda
خبر	xabˈar
خبره	xabˈara
خبرو	xabˈaro
خبري	xabˈari
خبری	xabˈari
خبریاله	xabriˈala
خبرې	xabˈare
خپسه	xəpəsa
خپګان	xpalgˈan
خپل	xpal
خپله	xpaˈla
خپلو	xpaˈlo
خپلواک	xpalˈwak
خپلواکي	xpalwaˈki
خپلواکۍ	xpalwaˈkai
خپلى	xpalai
خپلي	xpaˈli
خپلې	xpaˈle
خپه	xəpa
خت	xət
ختا	xta
ختل	xatəl
ختمول	xatˈmol
ختيځ	xatiz
خټک	xatˈak
خټګ	xatˈaɡ
خټه	xta
خټو	xaˈto
خځلي	xaˈd͡ʒli
خداى	xaˈdai
خدای	xudɑj
خدمت	xadˈmat
خر	xar
خراب	xaˈrab
خرابه	xaˈraba
خرابو	xaraˈbo
خرڅوي	xarˈsowi
خرما	xaɾˈma
خره	xaˈra
خرې	xaˈre
خزانه	xaˈzana
خړ	xəɺ
خړو	xaˈro
خړي	xaˈre
خړېږي	xaˈred͡ʒi
خسرو	xasˈro
خښتو	xaxˈto
خطا	xaˈta
خطرناک	xatarˈnak
خطيب	xaˈtib
خفګان	xafˈgan
خفه	xaˈfa
خلاص	xlaˈs
خلاف	xlaˈf
خلافت	xlaˈfat
خلق	xlak
خلک	xlak
خلکه	xlaˈka
خلکو	xlaˈko
خلګ	xlaɡ
خلګو	xlaˈɡo
خمار	xmaˈr
خمچې	xəmat͡ʃe
خنجر	xanˈd͡d͡ʒar
خندا	xanˈda
خندل	xanˈdal
خنډ	xand
خه	xa
خو	xo
خوا	xwa
خوابه	xwaˈba
خواته	xwaˈta
خواخوږي	xwaˈxoɡi
خوار	xwaˈr
خوارکي	xwaˈraki
خواړه	xwaˈra
خواړو	xwaˈro
خواږه	xwɑgə
خواشينی	xwɑʃinai
خواکار	xwaˈkar
خوب	xob
خوبه	xoˈba
خوبونو	xoˈbono
خوټه	xwəʈa
خود	xod
خودۍ	xoˈdai
خور	xor
خورئ	xoˈre
خورا	xwaˈra
خوراک	xwaˈrak
خورم	xwoˈram
خوره	xoˈra
خورو	xoˈro
خوري	xoˈri
خورې	xoˈre
خوړ	xwaɺ
خوړل	xwaɺəl
خوړلي	xwaˈrli
خوړنځی	xwəɺənzaɪ
خوږ	xog
خوږه	xwaˈɡa
خوږو	xwaˈɡo
خوږې	xwaˈɡe
خوست	xost
خوشال	xoˈʃal
خوشالي	xoʃaˈli
خوشبو	xoʃˈbo
خوشحال	xoʃˈhal
خوشحالي	xoʃhaˈli
خوشحالۍ	xoxˈhɑliː
خوښ	xoʃ
خوښي	xoˈʃi
خوښۍ	xoˈʃai
خوښې	xoˈʃe
خوله	xwlə
خولې	xoˈle
خوند	xwand
خوندي	xwanˈdi
خونه	xuna
خونې	xwaˈne
خوى	xwai
خوي	xwai
خوی	xwai
خيدک	xaidək
خير	xeˈr
خيرات	xeˈrat
خيرن	xirən
خيره	xeˈra
خيژي	xiˈd͡d͡ʒi
خيښي	xiˈʃi
خيل	xil
خیبر	xaibar
خیر	xeˈr
خیرو	xeˈro
خېټه	xeʈa
خېر	xaer
خېل	xel
ځ	z
ځئ	zai
ځار	zɑr
ځان	zan
ځانه	zaˈna
ځاني	zaˈni
ځاى	zai
ځاي	zai
ځايه	zaˈja
ځايي	zaiˈji
ځای	zai
ځپل	zpəl
ځپلو	zəpˈlo
ځغستل	zɣəstəl
ځغلم	zɣələm
ځغلول	zɣəlawəl
ځغلي	zɣaˈli
ځکه	zəka
ځګ	zəɡ
ځل	zəl
ځلمی	zɘlmaɪ
ځله	zəˈla
ځلې	zəˈle
ځم	zəm
ځما	zəˈma
ځمکپوهنه	zməkpohəna
ځمکه	zmaka
ځمکو	zəmˈko
ځمکې	zəmˈke
ځمه	zəˈma
ځنډ	zanɖ
ځنګل	zəŋgəl
ځني	zəˈni
ځه	za
ځو	zo
ځواک	zwɑk
ځوان	zwɑn
ځواني	zwaˈni
ځوي	zwaˈji
ځي	zi
ځيرک	zirak
ځيني	zəˈni
ځينې	zine
ځی	zai
ځیر	zir
ځیرک	zirək
ځیږ	zig
ځینی	zini
ځینې	zəˈne
ځې	ze
ځېل	zel
څ	s
څا	sa
څاپېړه	sɑpeɺa
څادر	sɑdar
څارونکى	sɑrunkaɪɪ
څاروى	sɑrwaɪ
څاښکه	sɑʃka
څانګه	saːŋa
څاوار	sɑwɑr
څپلۍ	sapləi
څپې	səˈpe
څپېړه	sapeɺa
څټ	sət
څټک	saʈak
څټلو	sətˈlo
څخه	səxa
څرخ	səˈraχ
څرخول	sarxawəl
څرک	səˈrak
څرګند	sərgəŋd
څښاک	sxɑːk
څښل	səχl
څکل	skəl
څکه	səka
څلور	salwur
څلورم	səloˈram
څلویښت	səloˈwext
څلوېښت	salwext
څلی	səˈli
څنډه	sənɖa
څنګ	sang
څنګل	səŋgəl
څنګه	səŋˈɡa
څه	sa
څہ	sə
څۀ	sə
څو	so
څوارلس	swaːrˈlas
څوک	sok
څوکي	suˈki
څومره	sumra
څونوټ	sonoʈ
څيز	siz
څیر	sir
څیړنه	siˈɺəna
څې	se
څېر	ser
څېره	sera
څېړنه	seːɺˈnɑ
څېړنیز	seˈɺəˈniz
څېړنیزې	seˈɺəˈnize
د	d
دَ	da
دئ	dai
دا	da
داخلي	daˈxli
داد	dad
داده	daˈda
دار	dar
داره	daˈra
دارو	dɑru
داړل	dɑɺəl
داسي	dɑsi
داسی	daˈsi
داسې	dɑse
داغ	daˈɡ
داغسي	daˈɡsi
دان	dan
دانګ	ɖɑŋg
دانه	dɑna
داوړ	dawˈaɺ
داوي	daˈwi
داي	daj
دبام	daˈbam
دبل	daˈbal
دپاره	dəpɑra
دپاسه	dapasa
دپلار	daplar
دپيغور	dapigoːr
دټول	daʈol
دچا	daʈʃa
دحق	daˈhaq
دخبرو	daˈxabro
دخپلې	daˈxpalai
دخداى	daˈxaˈdai
دخره	daˈxara
دخور	daˈxor
دخولې	daˈxole
ددي	dadi
ددې	dade
در	dar
درتلای	darˈtlai
درته	darˈta
درختي	daraxˈti
درد	dard
درزي	darzi
درس	daras
درسره	darˈsara
درسي	darˈsi
درشه	darˈʃa
درک	darak
درکړم	darˈkram
درکول	darkawəl
درلود	darˈlod
درلېږل	darlˈeɡal
درمل	darmal
درملپوهنه	dərməlpohəna
درملتون	dərməltun
درملو	darˈmalo
درنه	drəna
دره	daˈra
درو	daˈro
دروازې	darˈwaze
درواغ	darwaˈɡ
درود	daˈrud
دروزه	druze
دروستل	dərwəstəl
دروغ	dʊrwɑɣ
درول	dərəwəl
درولم	darwaləm
درون	daˈron
دروند	druŋd
دري	daˈri
دريا	darˈja
درياب	darˈjab
دريم	darim
دری	dari
دریاب	darˈjab
درې	dare
درېدل	dredəl
درېږم	daregəm
دړ	dəɺ
دړد	dəɺd
دشپې	daˈʃpe
دښمن	daxman
دښمني	daxmani
دښمنۍ	daxmanai
دښې	daxe
دعا	daˈʔa
دعاء	daˈʔa
دعلم	daˈʕilm
دعوه	dɑwa
دغله	daˈɣla
دغه	dəɣa
دغې	daˈɣe
دفاع	daˈfa
دفتر	dofˈtar
دفن	dofan
دقت	daqˈat
دکتور	daktor
دکوم	dakum
دلارې	dalaˈre
دلته	dəlta
دلدار	dalˈdar
دلري	dalˈri
دلسا	dalˈsa
دلیل	dalil
دلې	dəle
دم	dam
دماشومانو	daˈmaʃumano
دماغ	daˈmaɡ
دمخه	damˈxa
دملا	damˈla
دمه	daˈma
دمي	daˈmi
دندو	danˈdo
دنګو	danˈɡo
دنى	dani
دنيا	dunˈja
ده	da
دهرات	dahaˈrat
دهغو	daˈɣo
دهغې	daˈɣe
دههم	daˈham
دو	do
دواړه	dwaˈra
دوبی	dobai
دوحې	doˈhe
دود	dod
دودونه	doˈdona
دور	dor
دورې	dore
دوږخ	dogax
دوست	dost
دوستانو	dostano
دوستم	dostam
دوعا	dua
دوکتور	doktor
دولي	doli
دومره	dumra
دونه	dona
دوه	doa
دوهم	doham
دوو	doo
دووسي	doosi
دوولس	dwolas
دويم	dwajəm
دوی	duj
دویم	dojem
دوې	doe
دوېم	dojem
دى	di
دي	di
دي	di
ديارلس	djɑrləs
ديب	dib
ديرش	diːrʃ
دين	diːn
ديني	diːni
ديوال	diwal
ديوالونه	diwalona
دی	di
دی	di
دیدے	diːde
دیر	diːr
دیګ	diɡ
دین	diːn
دیني	diːni
دیوه	diwa
دې	de
دېرش	diːrʃ
دېرو	dero
دېګ	deg
دېګلی	deglaɪ
دېو	dew
دے	de
دے۔	de
ذ	z
ذات	zaːt
ذکر	zɪkər
ذهن	zehn
ذوق	zoq
ډ	ɖ
ډؤل	ɖol
ډاریږم	ɖaːriˈjəm
ډاکتر	ɖaːkˈtar
ډاکټر	ɖaːkˈtər
ډاکو	ɖɑku
ډاله	ɖaːˈla
ډانډ	ɖɑŋɖ
ډب	ɖəb
ډبره	ɖəbˈra
ډبل	ɖabəl
ډبوي	ɖəbˈoːi
ډډه	ɖəˈɖa
ډرامې	ɖraːˈme
ډز	ɖaz
ډغرې	ɖaːɣˈre
ډک	ɖak
ډکه	ɖəˈka
ډکې	ɖəˈke
ډګر	ɖəˈɡar
ډګه	ɖəga
ډله	ɖala
ډلو	ɖəˈlo
ډلې	ɖəˈle
ډنډ	ɖanɖ
ډنګ	ɖəŋɡ
ډنګر	ɖaŋgər
ډوبه	ɖoˈba
ډوډئ	ɖoːˈdai
ډوډی	ɖoːˈdi
ډوډۍ	doːˈdai
ډول	ɖol
ډوله	ɖoːˈla
ډولونه	ɖoːlˈuna
ډولونو	ɖoːlˈuno
ډولي	ɖəʊli
ډيپلوما	ɖiːpluˈmaː
ډير	ɖeːr
ډيرو	ɖeːˈro
ډيرې	ɖeːˈre
ډیر	ɖeːr
ډیره	ɖeːˈra
ډیرو	ɖeːˈro
ډیری	ɖeːˈri
ډېر	ɖer
ډېره	ɖeːˈra
ډېرو	ɖeːˈro
ډېری	ɖeːˈri
ډېرې	ɖeːˈre
ر	r
رأس	raʔas
رئيس	raʔiːs
را	rɑ
راباڼي	raːbaːɳi
راپه	raːpa
راپور	raːpor
راپورته	raːporte
راتلل	rɑtləl
راتلو	raːtlo
راتلی	raːtli
راته	raːta
راځي	raːzi
رادرومه	raːdrom-a
رارسيږي	raːrseːɡi
راز	raːz
رازِ	raːze
رازده	raːzda
رازق	raːzaq
راستون	raːstuːn
راستي	raːsti
راسه	raːsa
راسې	rɑse
راشئ	raːʃe
راشم	raːʃam
راشمه	raːʃma
راشه	raːʃa
راشي	raːʃi
راشی	raːʃi
راغلاست	raːɣlast
راغلم	raːɣlam
راغلی	raːɣli
راغي	raːɣi
راغی	raːɣi
راکړئ	raːkaɺe
راکړه	raːkaɺa
راکه	raːka
راکول	rɑkawəl
راګیر	raːɡiːr
رامه	raːma
رانه	raːna
راهيسې	raːhiːse
راهیسې	rɑhise
راواوړي	raːwaoɺi
راوړل	rɑwɺəl
راوړه	raːwɺa
راوړي	raːwaɺi
راوست	raːwast
راوستل	rɑwəstəl
راوستلو	raːwastlo
راولم	rɑwaləm
راولي	raːwali
رب	rab
ربع	raba
ربه	raba
رپ	rap
رپوټ	rapot
رټئ	raʈe
رحم	raxəm
رحمت	rahmat
رحمه	rahma
رخ	rax
رخسار	raxsar
رد	rad
رډ	raɖ
رډي	raɖi
رزمک	razmak
رژیم	rad͡d͡ʒiːm
رسمي	rasmi
رسنۍ	rəsənai
رسول	rasul
رسولو	rasulo
رسۍ	rasiː
رسېدو	raseːdu
رشاد	raʃaːd
رښتيا	raxtijaː
رښتین	raxtiːn
رضاکاره	razaːkaːra
رکعته	rakata
رکم	rakum
رګ	raɡ
رم	ram
رنځور	rand͡d͡ʒoːr
رنډۍ	rənɖəi
رنګ	raŋɡ
رنګه	raŋɡa
رنگ	raŋɡ
رڼا	rəɳɑ
رڼې	raɳe
رهبر	rahbar
رهبري	rahbari
روان	rwaːn
روانې	rwaːne
روپۍ	ropai
روپې	rope
روزانه	roːzaːna
روزنه	roːzana
روزنې	roːzane
روزي	roːzi
روژه	roːd͡d͡ʒa
روژې	roːd͡d͡ʒe
روسيه	rusja
روشن	roːʃan
روښانه	roːxaːna
روغ	roːɣ
روغتانۀ	roɣtɑnə
روغتون	roːɣtoːn
روغتيا	roɣtjɑ
روغتیا	roːɣtijaː
روغه	roːɣa
روغې	roːɣe
رول	rol
روم	rom
روي	roi
رويه	roja
رېبز	rebəz
ز	z
زابل	zaːbil
زابلي	zaːbili
زار	zaːr
زاګرېب	zɑgreb
زامبه	zɑmba
زامن	zaːman
زاڼه	zɑɳa
زباتل	zbɑtəl
زباني	zabaːni
زبرګ	zbərg
زبه	zaba
زخم	zaxm
زخمه	zaxma
زده	zda
زر	zar
زرغون	zərɣun
زرغونه	zarɣuna
زرګونه	zarɡuna
زرلښته	zarlaxte
زرم	zaram
زرمت	zarmat
زره	zara
زرو	zaro
زړګی	zrɡe
زړه	zra
زړهور	zɺawar
زړو	zro
زړې	zre
زغره	zɣəra
زغم	zaɣam
زغمل	zɣaməl
زکات	zakaːt
زکر	zakar
زل	zal
زلزله	zəlˈzələ
زلفو	zolfo
زلمی	zalmi
زلیخا	zʊləixa
زما	zmaː
زمانو	zamaːno
زمانې	zamaːne
زمري	zamri
زمری	zamri
زمرۍ	zmarəi
زمه	zama
زموږ	zəmung
زمونږ	zəmung
زنا	zənaː
زنار	zanaːr
زنانو	zanaːno
زنګ	zaŋ
زنه	zəna
زڼکی	zɘɳkɑi
زه	zə
ﺯه	ˈzə
زهٔ	zə
زہ	za
زۀ	za
زو	zoː
زوئ	zoːe
زور	zoːr
زوړ	zoːɺ
زول	zoːl
زوم	zoːm
زون	zoːn
زوى	zoːi
زوی	zoɪ
زيات	zijat
زياتره	zijaːtra
زيړ	ziɺ
زیات	zijaːt
زیاته	zijaːta
زیار	zijaːr
زیان	zɪˈjɑn
زیتونو	zeˈtuno
زیربنايي	ziːrbanɑˈjiː
زېږېدل	zegedəl
ړ	ɺ
ړومبی	ɺumbai
ړوند	ɺund
ږ	g
ږدي	ɡədi
ږغ	ɡəɣ
ږغېدل	gaɣedəl
ږلۍ	ɡəˈli
ږمنځ	gm̩əŋz
ږمې	ɡəˈme
ږوب	ɡoˈb
ږیری	ɡeːˈri
ژ	d͡ʒ
ژاړم	d͡ʒaːɺəm
ژاړي	d͡ʒaːɺi
ژاړې	d͡ʒaːɺe
ژامه	d͡ʒɑma
ژامې	d͡ʒaːˈme
ژانر	d͡ʒaːnar
ژانرونه	d͡ʒaːnarˈuna
ژباړل	d͡ʒbɑɺəl
ژبپوهنه	d͡ʒəbpohəna
ژبکۍ	d͡ʒabakəi
ژبه	d͡ʒəbə
ژبو	d͡ʒəˈbo
ژبی	d͡ʒəˈbe
ژبې	d͡ʒəˈbe
ژر	d͡ʒar
ژرچې	d͡ʒarˈt͡ʃe
ژرنده	d͡ʒranda
ژرندہ	d͡ʒarˈanda
ژړا	d͡ʒəˈɺa
ژګاګ	d͡ʒɪgɑg
ژمن	d͡ʒəˈmən
ژمنه	d͡ʒəˈmana
ژمي	d͡ʒəˈmi
ژوب	d͡ʒoːb
ژوبل	d͡ʒoːbəl
ژوبڼ	d͡ʒoːbən
ژور	d͡ʒawar
ژوره	d͡ʒoːˈra
ژورې	d͡ʒoːˈre
ژوند	d͡ʒwənd
ژونده	d͡ʒonˈda
ژوندو	d͡ʒonˈdo
ژوندي	d͡ʒonˈdi
ژوندينکه	d͡ʒwandinaka
ژوندی	d͡ʒwəndai
ژونکه	d͡ʒwanaka
ژېړ	d͡ʒeɺ
س	s
سا	sɑ
سابه	ˈsɑbə
سابو	ˈsɑbo
ساپټ	sɒpaʈ
ساتل	sɑˈtəl
ساتلو	sɑˈtlo
ساتلي	sɑˈtəli
ساتلې	sɑˈtəle
ساتنه	sɑˈtənə
ساتنې	sɑˈtəne
ساته	ˈsɑtə
ساتي	ˈsɑti
ساتۍ	ˈsɑtəj
ساحل	ˈsɑħel
ساده	ˈsɑdə
سارايي	sɑrɑˈjəj
سازمان	sɑzˈmɑn
ساړه	sɑɺ̢ə
ساعت	ˈsɑət
سالم	ˈsɑləm
سالمن	ˈsɑlmən
سالمه	sɑˈlmə
سالمو	sɑˈlmo
سام	ˈsɑm
ساه	ˈsɑhə
ساينس	ˈsɑjəns
ساينس	ˈsɑjəns
سايه	ˈsɑjə
سایټ	ˈsɑjet
سایل	ˈsɑjel
سبا	səˈbɑ
سبب	səbəb
سبک	ˈsəbək
سبو	ˈsəbo
سپارل	ˈspɑrəl
سپتمبر	sepˈtembər
سپرلي	ˈsprəle
سپره	spəra
سپک	spək
سپما	ˈspəmə
سپنج	spənd͡ʒ
سپور	ˈspor
سپورت	ˈspoɾt
سپورټ	ˈspoj
سپوږمۍ	spogməi
سپى	ˈspi
سپي	ˈspi:
سپيتانه	speˈtɑnə
سپين	spin
سپينه	ˈspinə
سپی	spe
سپیو	ˈspijo
سپېرې	speˈre
سپېلني	spelani
ستا	stə
ستاسو	stɑso
ستاسې	stɑse
ستايل	stɑjəl
ستاینه	stəˈjənə
ستر	stər
سترګه	stərga
سترګو	ˈstərgo
سترګي	ˈstərgi
سترګې	ˈstərge
سترگو	ˈstərgo
سترو	ˈstɾo
سترې	ˈstərə
ستړو	ˈstəɾo
ستړي	ˈstəri
ستړیا	stərˈjɑ
سته	ˈstə
ستورڅک	storsak
ستوري	ˈstori
ستوری	storaɪ
ستون	ˈstun
سټک	saʈak
سجده	ˈsəd͡d͡ʒdə
سحر	ˈsəhər
سخاوت	səxɑˈwət
سخت	ˈsəxt
سخته	ˈsəxtə
سختو	ˈsəxto
سختي	ˈsəxti
سخر	ˈsəxər
سخط	ˈsəxt
سخندر	səxənˈdər
سخوندر	sxwəunˈdər
سخی	sxaɪ
سر	ˈsər
سراسر	sərɑˈsər
سراسري	sərɑˈsəri
سرته	sərˈtə
سرتیرو	sərˈtiro
سرچینو	sərˈt͡ʃino
سردار	sərˈdɑr
سرکه	ˈsərkə
سرکې	ˈsərke
سرلیکونه	sərliˈkuna
سرمشق	sərˈməʃq
سره	ˈsərə
سرۀ	ˈsərə
سرو	ˈsəro
سرونه	səˈruna
سرېښ	sreʃ
سړک	ˈsərk
سړه	səɺa
سړو	ˈsəɾo
سړى	ˈsəɾəj
سړي	ˈsəri
سړی	səˈɺai
سږ	ˈsəz
سږو	ˈsəzo
سږى	səd͡ʒaɪ
سستو	ˈsəsto
سستي	ˈsəsti
سعد	ˈsæd
سفر	ˈsəfər
سکاره	ˈskɑrə
سکال	ˈskɑl
سکالو	skɑlo
سکرو	skərˈu
سکرین	ˈskrin
سکه	saka
سکو	ˈsko
سکور	ˈskor
سکول	ˈskol
سل	ˈsəl
سلام	səˈlɑm
سلګونه	ˈsəlgune
سلم	ˈsələm
سلنه	səˈlənə
سلو	ˈsəlo
سم	səm
سمارټ	səˈmɑrt
سمبال	səmˈbɑl
سمبول	ˈsəmbol
سمدستي	səmdəˈsti
سمسور	səmˈsor
سمندر	səməndər
سمنډوله	səmənˈdolə
سمه	ˈsəmə
سمولو	səˈmolo
سمون	ˈsəmon
سموي	ˈsəmoj
سمي	ˈsəmi
سمیر	səˈmiɾ
سمینار	səˈminɑr
سمې	ˈsəme
سنتو	ˈsənto
سنډا	sanɖɑ
سنګر	ˈsəŋɡər
سه	sə
سهار	səˈhɑr
سهاره	səˈhɑrə
سهکه	ˈsəhkə
سو	so
سواد	ˈswɑd
سوارلۍ	ˈswɑrləj
سوال	soˈwɑl
سوپ	ˈsop
سُوپر	ˈsuper
سوټک	soʈak
سوخت	ˈsoxt
سوځي	ˈsuzəj
سودا	soˈdɑ
سور	ˈsor
سورت	ˈsurət
سورلنډی	surlənɖai
سوري	ˈsuri
سوز	ˈsuz
سوړ	soɺ
سوژو	ˈsogo
سوشل	ˈsoʃəl
سوک	ˈsok
سول	ˈsol
سوله	ˈsolə
سولی	ˈsoli
سولې	ˈsole
سوم	ˈsom
سوماليا	somɑljɑ
سومر	sumər
سومره	ˈsomrə
سون	ˈson
سوه	so
سوو	ˈsowo
سوى	ˈswej
سوي	ˈswoj
سوی	ˈswej
سوۍ	ˈswəj
سوې	ˈswe
سي	si
سياست	sijɑˈsət
سياسي	siˈjɑsi
سيل	ˈsel
سيلونو	ˈseluno
سيلۍ	siləi
سيمه	sima
سيمې	ˈseme
سيند	sin̪d
سی	si
سیاسي	siˈjɑsi
سیال	ˈsijɑl
سیستم	ˈsistəm
سیم	ˈsem
سیمه	ˈseme
سیمې	ˈseme
سیند	ˈsind
سینې	ˈsene
سې	ˈse
سېف	ˈsef
سېلاب	ˈselɑb
سېلابونو	selɑˈbuno
سېلۍ	seləi
سېي	ˈseji
ش	ʃin
شئ	ʃəi
شئ	ʃəi
شا	ˈʃɑ
شاباسي	ˈʃɑbɑsi
شابه	ˈʃɑbə
شات	ˈʃɑt
شاته	ˈʃɑtə
شاتو	ˈʃɑto
شاخ	ˈʃɑx
شاخص	ˈʃɑxəs
شاشې	ˈʃɑʃe
شاعر	ˈʃɑɛɾ
شاعري	ˈʃɑɛri
شاکر	ʃaˈker
شاکړم	ʃaˈkaɺəm
شال	ˈʃɑl
شالي	ʃɑli
شامل	ˈʃɑməl
شان	ˈʃɑn
شانګله	ˈʃɑŋɡlə
شانه	ˈʃɑnə
شاه	ˈʃɑh
شاهد	ʃɑhed
شاهین	ˈʃɑhin
شاوخوا	ˈʃɑwxwɑ
شاید	ˈʃaːjad
شبِ	ʃab
شبانه	ʃaˈbana
شبکه	ʃaˈbaka
شبکې	ʃaˈbakə
شپاړس	ʃpɑɺəs
شپاړسم	ʃpaˈɺsəm
شپاړلس	ʃpaˈɺləs
شپانه	ʃpaˈna
شپږ	ʃpəɡ
شپږم	ʃpəɡəm
شپږمه	ʃpəɡəˈma
شپه	ʃpə
شپو	ʃpo
شپون	ʃpuːn
شپيشتو	ʃpeˈʃto
شپې	ʃpe
شپېته	ʃpeˈta
شتمن	ʃatˈman
شتمني	ʃatˈmani
شته	ʃta
شتون	ʃtuːn
شډل	ʃəɖəl
شر	ʃər
شراب	ʃaˈrab
شرابو	ʃaˈrabo
شرابي	ʃaˈrabi
شرایط	ʃaˈɾaːjət
شرط	ʃart
شرقي	ʃarˈqi
شرم	ʃaram
شرمښ	ʃʊrməx
شرموي	ʃarˈmoi
شروع	ʃʊːrʊː
شريک	ʃaˈrik
شری	ʃaˈri
شریف	ʃaˈrif
شریک	ʃaˈrik
شړۍ	ʃaɺai
شعر	ʃiʔr
شعرونو	ʃiˈʔɾuno
شعري	ʃaˈʔɾi
شعور	ʃaˈu:ɾ
شغال	ʃaɣɑl
شفیق	ʃaˈfiq
شک	ʃək
شکاڼه	ʃaˈkana
شکر	ʃaˈkar
شکل	ʃakl
شکلونه	ʃakˈlona
شکمن	ʃakˈman
شکه	ʃaka
شکونه	ʃaˈkuna
شکوڼ	ʃˈkuɳ
شکي	ʃaki
شکیلا	ʃaˈkila
شګه	ʃaɡa
شګو	ʃaɡo
شګې	ʃəɡe
شل	ʃəl
شلتالو	ʃaltɑlu
شلم	ʃələm
شلمه	ʃaˈləma
شلمو	ʃalˈmo
شلو	ʃəlo
شلوم	ʃaˈlom
شلومبې	ʃaˈlombe
شم	ʃəm
شمال	ʃaˈmal
شمالي	ʃmɑli
شمسي	ʃamˈsi
شمله	ʃamˈla
شمولیت	ʃaˈmolijat
شمیر	ʃaˈmiɾ
شمیره	ʃaˈmiɾa
شمېر	ʃeˈmeɾ
شمېرپوهنه	ʃmerpohəna
شنبې	ʃamˈbe
شنډ	ʃand
شنني	ʃanˈani
شنه	ʃəna
شنو	ʃəno
شنې	ʃəne
شڼ	ʃaɳ
شه	ʃa
شهرت	ʃˈʊhrat
شهيد	ʃaˈhiːd
شو	ʃo
شوئ	ʃwe
شوال	ʃoˈwal
شوپه	ʃoˈpa
شوتالو	ʃawtɑlu
شوخ	ʃoχ
شوخه	ʃoχa
شور	ʃoɾ
شورا	ʃoˈɾa
شوق	ʃoˈq
شول	ʃol
شولو	ʃolo
شوم	ʃom
شوملې	ʃumle
شومه	ʃoˈma
شومېر	ʃumer
شونی	ʃonai
شوه	ʃoˈwa
شوو	ʃu
شوى	ʃwe
شوي	ʃwi
شوی	ʃwiː
شوې	ʃwe
شي	ʃi
شيتک	ʃiˈtak
شيخ	ʃeχ
شيدې	ʃiˈde
شيطان	ʃeˈtaːn
شيګره	ʃigara
شين	ʃin
شينواري	ʃiˈnwaːɾi
شی	ʃi
شیان	ʃiˈjan
شیانو	ʃiˈjano
شیبه	ʃiˈba
شیدې	ʃiˈde
شیک	ʃik
شیګل	ʃiˈɡal
شین	ʃin
شۍ	ʃi
شې	ʃe
شېبه	ʃeˈba
شېر	ʃeːɾ
شے	ʃe
ښ	x
ښآر	xaːr
ښاده	xaːˈda
ښار	xɑr
ښاره	xaːˈra
ښارو	xɑro
ښاري	xaːˈri
ښاغلي	xaːɣˈli
ښاغلی	xɑɣəlai
ښامار	xɑmɑr
ښايسته	xaːjəsˈta
ښايي	xɑyi
ښخ	xax
ښخي	xaxˈi
ښخې	xaːxe
ښځه	xxa
ښځينه	xəzina
ښځې	xəˈze
ښرنه	xaːˈrana
ښکار	xkɑr
ښکاره	xkɑra
ښکاري	xəˈkaːri
ښکرو	xəkˈro
ښکل	xəˈkl
ښکلا	xəkˈla
ښکلي	xəkˈli
ښکلی	xkwəlai
ښکلې	xəkˈle
ښکنځل	xkənzəl
ښکېل	xəkˈil
ښنده	xanˈda
ښه	ˈxa
ښه	ˈxa
ِښه	ˈxa
ښۀ	xə
ښو	ˈxo
ښود	xoːd
ښور	xoːr
ښوونځی	xoːnˈzai
ښوونکو	xoˈwanko
ښوونکی	xowunkaɪ
ښوونکې	xowunke
ښوونیز	xoˈniːz
ښي	xi
ښی	xi
ښیرا	xiˈra
ښې	xe
ښېرا	xeˈra
ښېرې	xere
ص	s
صبر	sabər
صدقه	saˈdaqa
صلوات	salwaːt
ض	z
ضايع	zaˈja
ضربان	zarˈbaan
ضمانت	zamˈanat
ط	t
طالب	tɑlɪb
طامع	taˈmɛʕ
طب	tab
طبيعت	təbiaːt
طرز	taɾz
ظ	z
ظلم	zʊlm
ع	a
عادت	aˈdat
عاقبت	ʔaːqibat
عالم	ʔaːlam
عالي	ʔaːli
عام	ʔaːm
عامه	ʔaːma
عامې	ʔaːme
عبادت	ʔebadat
عبارت	ʔebarat
عباس	ʔabˈbas
عجیبه	aˈd͡d͡ʒiba
عدالت	ʔaːdaːlat
عدل	ʔadl
عدم	ʔadəm
عدنان	ʔadˈnaːn
عرب	ʔaːrab
عربو	ʔaːrabo
عربي	ʔaːrabi
عزت	ʔɛzət
عزم	ʔəzm
عسکر	ʔəsˈkar
عشق	ʔɛʃq
عصر	ʔəsɾ
عصري	ʔəsˈri
عطرو	ʔətɾo
عفوه	ʔəfwa
عقل	ʔəqəl
عکاسي	ʔəkasi
عکس	ʔəkas
عکسونه	ʔəkasuna
علامې	ʔəlaːme
علایم	ʔalaːjəm
علت	ʔələt
علم	ʔəlm
علماء	ʔuləmaː
علمي	ʔəlmi
علوم	ʔuluːm
علومو	ʔuluːmo
على	ʔali
علي	ʔəli
علی	ʔaliː
علیکم	ʔaliːkam
عمره	ʔumra
عمري	ʔumri
عمل	ʔəməl
عمله	ʔəməla
عملي	ʔəməli
عمومي	ʔumumi
عن	ʔan
عنه	ʔanə
عواملو	ʔawaːmlo
عيب	ʔeːb
غ	ɣ
غار	ɣaːr
غازي	ɣaːzi
غاړه	ɣaːɺa
غاړی	ɣɑɺai
غاښ	ɣɑx
غالب	ɣaːləb
غالباً	ɣaːləbən
غالۍ	ɣɑləi
غبرګاوی	ɣbargɑwai
غبرګه	ɣəbəɾga
غبي	ɣabi
غپا	ɣapɑ
غپل	ɣapəl
غپول	ɣapawəl
غپېدل	ɣapedəl
غټ	ɣaʈ
غټه	ɣaʈa
غټي	ɣaʈi
غټې	ɣaʈe
غذا	ɣəza
غر	ɣar
غربت	ɣəɾbat
غربي	ɣəɾbi
غرڅنی	ɣarsənai
غرق	ɣəɾaq
غرمه	ɣərma
غرمې	ɣərme
غرني	ɣərni
غره	ɣəɾa
غرور	ɣəɾuɾ
غرونه	ɣəɾuna
غرونو	ɣəɾuno
غريب	ɣəˈrib
غريبانو	ɣəɾiˈbano
غريو	ɣɾijo
غریب	ɣɾi:b
غزا	ɣaza
غزل	ɣazal
غزلچی	ɣazalt͡ʃi
غزنوي	ɣaznawi
غزني	ɣazni
غزه	ɣaza
غزوه	ɣazwa
غړپ	ɣaɾp
غړو	ɣaɾo
غړومبل	ɣɺumbəl
غړي	ɣaɾi
غړی	ɣəɺaɪ
غړے	ɣaɾe
غږ	ɣaɣ
غږيز	ɣaɣiz
غږېدل	gaɣedəl
غسل	ɣʊsl
غښتل	ɣəxtəl
غل	ɣal
غلا	ɣlɑ
غلامان	ɣʊlamɑn
غلط	ɣalat
غلمينه	ɣalminə
غله	ɣala
غلۀ	ɣala
غلې	ɣale
غم	ba
غماز	ɣamɑz
غمبور	ɣambor
غمجن	ɣamd͡ʒan
غمه	ɣama
غمو	ɣamo
غمی	ɣamai
غنا	ɣana
غندل	ɤandəl
غنم	ɣanəm
غنمو	ɣanmo
غني	ɣani
غنی	ɣani
غڼ	ɣan
غڼه	ɣəɳa
غو	ɣo
غوآړي	ɣwaːɾi
غوا	ɣwa
غواړم	ɣwɑɺ̢əm
غواړو	ɣwaɾo
غواړي	ɣwaɾi
غواړې	ɣwaɾe
غوبه	ɣoba
غوټه	ɣoʈa
غوربند	ɣoɾband
غورځول	ɣorzawəl
غورځي	ɣoɾzi
غوره	ɣwəra
غوړ	ɣoɾ
غوړو	ɣoɾo
غوړي	ɣwaɺ̢i
غوږ	ɣwag
غوږو	ɣogo
غوسه	ɣosa
غوښتل	ɣwaxtal
غوښتنه	ɣwaxtana
غوښه	ɣwaxa
غوښو	ɣwaxo
غول	ɣoːl
غولي	ɣoli
غومبه	ɣumba
غوندي	ɣonde
غونډ	ɣwəŋɖ
غونډاری	ɣwənɖɑrai
غونډۍ	ɣondɪj
غونه	ɣuna
غوول	ɣowəl
غويی	ɣwajaɪ
غویي	ɣwəji
غيم	ɣəjəm
غيڼ	ɣun
غيي	ɣiji
غیر	ɣejɾ
غیرتي	ɣejɾati
غېږ	ɣwjeg
غېږه	ɣega
ف	f
فارس	faɾs
فارم	faɾm
فارمیسټانو	faɾmistɑno
فاروق	faɾoq
فاع	faːʕ
فتنې	fatane
فدا	fada
فدای	fadɑj
فراغت	faɾaːɣat
فرانس	prɑŋs
فرانسه	ɸrɑnsa
فراه	faɾɑ
فردوس	fɪrdaws
فرش	faɾx
فرعي	faɾʕi
فرق	faɾaq
فرهنګ	faɾhanga
فرهنګي	faɾhange
فریښتو	faɾiʃto
فشار	fəʃaːɾ
فصل	fasal
فضل	fazal
فعال	faʕal
فعالان	faʕalɑn
فعل	faʕl
فکر	fɪkaɾ
فکري	fɪkaɾi
فلسفي	falsafi
فلم	fɪlm
فني	fani
فهام	fahaːm
فهمه	fahma
فوټبال	fotbal
فورم	foɾm
فورمول	foɾmol
فولکلور	folkaloɾ
ق	q
قائل	qaːel
قام	qam
قامت	qamat
قاموس	kɑmos
قبر	qabɾ
قبول	qabʊl
قبيلو	qabilo
قبیله	qabɪla
قتل	qat͡l
قدر	qadar
قــدر	qadar
قدره	qadra
قدم	qadam
قر	qaɾ
قرآن	qʊɾaːn
قرار	qaɾaːɾ
قران	qaɾan
قرض	qaɾz
قسم	qasəm
قطار	qataɾ
قطر	qatər
قلم	qalam
قمبر	qambɾ
قمر	qamɑɾ
قمعل	qamʕal
قهر	qahɾ
قهوه	qahwa
قوت	qʊwat
قول	qowl
قوم	qawm
قومونو	qawmʊno
قومي	qawmi
قوه	qoha
قوي	qawi
قوې	qawe
قيامت	qijaːmat
قیمت	qimat
كاچوغه	kɑt͡ʃoɣa
كره	kara
كړو	kaɾo
كوتره	kawtəra
ک	k
کؤل	koːl
کؤه	koːh
کئ	kai̯
کا	ka
کابل	kɑbəl
کابلي	kaːbˈəli
کابينې	kaːbiˈne
کاپي	kaːˈpi
کاپيوره	kɑpiwara
کار	kaːr
کارت	kaːrt
کارغان	kaːrˈɣaːn
کارګر	kaːrˈɡar
کاره	kaːˈra
کاروان	kaːroˈwaːn
کاروبار	kaːroˈbaːr
کارول	kaːˈrol
کارونه	kaːˈruna
کارونو	kaːˈruno
کاري	kaːˈri
کاریږي	kaːˈriːd͡ʒi
کاږه	kaːɣa
کاسه	kaːˈsa
کاسې	kaːˈse
کاشوغه	kaːˈʃoːɣa
کاغذ	kaːˈɣəz
کافي	kaːˈfi
کاک	kaːk
کاکا	kaːˈka
کاکړ	kaːˈkəɺ
کاکو	kaːˈko
کاکونه	kaːˈkuna
کاګل	kɑgəl
کال	kɑl
کالنی	kɑlanai
کاله	kaːˈla
کالو	kaːˈlo
کالي	kɑli
کامل	kaːˈmal
کامه	kama
کاميابي	kaːmjaˈbi
کامیاب	kaːmˈjaːb
کامیابه	kaːmjaːˈba
کامې	kaːˈme
کاناډا	kaːnaːˈɖaː
کانال	kaːˈnaːl
کانکور	kaːnˈkor
کاڼه	kaːˈɳa
کاڼو	kaːˈɳo
کاڼي	kaːˈɳi
کاوه	kaːˈwa
کاوو	kaːˈwo
کب	kab
کبر	kəbˈər
کبله	kəbˈla
کبير	kabiːr
کتاب	keˈtɑb
کتابخانه	kitɑbxaˈnɑ
کتابونو	kətaːˈbuno
کتل	katəl
کتنځي	kətanˈzi
کټ	kəʈ
کجکي	kəd͡d͡ʒaːˈki
کچه	ˈkat͡ʃa
کچې	ˈkat͡ʃe
کډه	kəɖa
کډو	kəɖo
کر	kar
کرام	kaːˈraːm
کرب	kərəb
کرټ	krəʈ
کرښه	kəˈraxa
کرښو	kəˈraxo
کرښې	kəˈraxe
کرک	kərk
کرکټ	kərkəʈ
کرکره	karkara
کرل	kəˈral
کرلاڼو	kərˈlaːno
کرم	kəˈram
کرن	kərən
کرنه	kəˈrana
کرنې	kəˈre
کره	kəˈra
کرور	kəˈror
کروړ	kəˈroɺ
کري	kəˈri
کریم	kaˈriːm
کرۍ	kəˈraj
کرې	kəˈre
کړ	kəɺ
کړٸ	ˈkɾaɪ
کړئ	kəɺai̯
کړئ	kəɺai̯
کړاوو	kəraːwo
کړای	kəraːj
کړل	kəˈral
کړم	ˈkɾəm
کړمه	ˈkɾəma
کړنلار	kəɺnˈlɑr
کړنه	ˈkəɾəna
کړنې	ˈkɾəne
کړه	ˈkɾə
کړهچې	ˈkəɾhat͡ʃe
کړو	ˈkɾo
کړونو	kɾuˈno
کړي	ˈkɾi
کړی	ˈkɾai
کړې	ˈkɾe
کړے	ˈkɾe
کږه	ˈkəga
کږې	ˈkəge
کس	kas
کسان	kaːˈsaːn
کسم	kəsəm
کش	kəʃ
کشتۍ	kəʃˈtaj
کشر	kəxar
کشف	kəʃəf
کشمير	kəʃˈmiːr
کشور	kəʃˈwar
کښ	ˈkx
کښت	kxˈt
کښي	ˈkai
کښی	ˈkai
کښې	ke
کفن	kəfən
کلا	kaːˈla
کلاسیک	kaːlaːˈsik
کلام	kaːˈlaːm
کلب	kaləb
کلتور	kəlˈtoːr
کلتورپالنه	kəltuːrˈpɑlɑnə
کلتوري	kəltoːˈri
کلک	klak
کلکوالى	klakwɑlaɪ
کلمه	kəlˈma
کلمې	kəlˈme
کلن	kəlan
کله	kɘla
کلو	kəˈlo
کلونو	kəˈluno
کلي	kəˈli
کليم	kaːˈliːm
کلی	kəlaɪ
کلیزې	kəˈliːze
کم	kam
کمال	kaːˈmaːl
کمالي	kaːmaːˈli
کمبل	kəmˈbəl
کمبلي	kəmˈbli
کمپيوټر	kampjuːˈʈər
کمپیوټر	kampjuːˈʈər
کمپیوټرونه	kampjuːˈʈəruna
کمښت	kəməxt
کمک	kəˈmak
کمکي	kəməˈki
کموالي	kəmoˈwaːli
کموي	kəˈmoji
کمیس	kəˈmiːs
کمې	kəˈme
کندهار	kandəˈhar
کندې	kənˈde
کنګال	kangɑl
کنګل	kənɡəl
کنه	kəˈna
کنوه	kɪnwa
کني	kəˈni
کنیو	kəˈnju
کڼکۍ	ˈkaɳkai
کڼې	ˈkaɳe
که	kə
کہ	ka
کۀ	ka
کو	ko
کوٸ۔	koːi
کوئ	koˈe
کوئ	koˈe
کوبا	kubɑ
کوت	koːt
کوټ	koʈ
کوټه	koʈa
کوټې	koːˈte
کوچنی	kut͡ʃnai
کوڅه	koːˈsa
کوڅو	koːˈso
کوڅې	koːˈse
کور	kor
کوربه	korba
کورت	koːrt
کورته	koːrˈta
کورني	koːrˈni
کورنی	koːrˈni
کورنیو	koːrnˈjo
کورنۍ	koranəi
کوره	koːˈra
کورونه	koːˈruna
کوریا	koːˈrjaː
کوزې	koːˈze
کوړ	koːɺ
کوږ	koːɡ
کوس	kwəs
کوشس	koːˈʃəs
کوشش	koːˈʃəʃ
کوښښ	koːˈxəx
کول	kawəl
کولای	koːˈlaɪ̯
کولمو	koːlˈmo
کوله	koːˈla
کولو	koːˈlo
کولي	koːˈli
کولی	koːˈli
کولې	koːˈle
کوم	kom
کومک	koːˈmak
کومه	koːˈma
کومو	koːˈmo
کومي	koːˈmi
کومی	kumai
کومې	koːˈme
کونړ	kunaɺ
کونګرى	kungraɪ
کونه	kwəna
کوني	koːˈni
کوڼ	kuɳ
کوه	kəwə
کوهي	koːˈhi
کوو	koːˈwo
کوور	koːˈwar
کوي	koːˈji
کوی	koːˈji
کوې	koːˈje
کى	kai̯
کي	ki
کيداى	kiːˈdaːj
کيدل	kiːˈdal
کيږه	kiːɣa
کيږي	kiːˈd͡ʒi
کيسو	keːˈso
کيسې	keːˈse
کيڼ	kiɳ
کی	ki
کیسه	ˈkisa
کیسو	ˈkiso
کیسې	ˈkise
کیفې	ˈkejfe
کیک	kik
کیله	ˈkila
کینخي	kinaxxi
کې	ke
کېدل	kedəl
کېدو	keˈdo
کېږه	ˈkega
کېږي	ˈkeɟi
کېږې	ˈkeɟe
ګ	g
ګاډی	gɑɖaɪ
ګاز	ˈɡɑz
ګام	gɑm
ګانو	ˈɡɑno
ګاڼه	gɑɳa
ګبين	gabin
ګټل	gaʈəl
ګټه	gəʈa
ګټو	ɡaʈˈo
ګټور	ˈɡaʈawˈaɾ
ګټوره	ˈɡaʈawˈaɾa
ګټې	ˈɡaʈe
ګډ	ˈɡəɖ
ګډه	ˈɡəɖa
ګډو	ˈɡəɖo
ګډون	gaɖun
ګډوي	ɡəˈɖoj
ګډی	gəɖaɪ
ګډې	ˈɡəɖe
ګډېدل	gaɖedəl
ګرامر	ɡɾaˈmaɾ
ګرامري	ɡɾaˈmaɾi
ګران	ˈɡɾan
ګرانه	ɡɾaˈna
ګرانې	ɡɾaˈne
ګرځندوی	ɡɾəd͡d͡ʒanˈdoj
ګرځول	gərzawəl
ګرځي	ˈɡɾzi
ګرځېدل	gərzedəl
ګرد	gərd
ګردی	gərdai
ګردېز	ɡɾaˈɺeːz
ګرزي	ˈɡɾzi
ګرل	ˈɡɾal
ګرم	ˈɡɾam
ګرمي	garmi
ګرمۍ	ˈɡɾamiː
ګروه	groh
ګړدود	gəɺdod
ګړندی	gəɺ̢anɖai
ګل	gʊl
ګلاب	ɡuˈlab
ګلابي	gwəlɑbi
ګلان	ɡuˈlan
ګلزار	ɡəlˈzaɾ
ګله	ˈɡəla
ګلو	ˈɡulu
ګلونو	ɡuˈluno
ګناه	ɡuˈna
ګنده	sxɑ
ګنډل	ˈɡəndəl
ګنډم	ˈɡəndəm
ګنه	ɡəˈna
ګڼ	gaɳ
ګڼل	ˈɡaɳəl
ګڼم	ˈɡaɳəm
ګڼو	ˈɡaɳo
ګهيځ	gəhiz
ګهیځ	ɡaˈhig
ګواښ	ˈɡwax
ګودر	gudar
ګودره	ɡuˈdaɾa
ګوډي	ˈɡoɺi
ګورل	gorəl
ګورم	gorəm
ګوره	ˈɡoɾa
ګوري	ˈɡoɾi
ګوړه	gwəɺa
ګولی	golai
ګونو	ˈɡuno
ګيټۍ	giʈəi
ګيلي	ˈɡili
ګیر	ˈɡiɾ
ګۍ	ˈɡai
ګېډه	geɖa
ګېنډی	genɖaɪ
گ	ɡ
گاڼه	ˈɡaɳa
گټي	ˈɡaʈi
گرځي	ˈɡɾzi
گرول	ˈɡɾol
گز	ɡəz
گله	ˈɡəla
گنډلى	ˈɡəndəlai
گوتي	ˈɡoti
گوروان	ɡoˈɾwan
گوز	ɡoz
گوى	ˈɡoːi
ل	l
لآتَقْنَطُوْا	laː taqnatuː
لا	laː
لار	lɑːr
لارښود	laːɾxod
لاره	laːɾa
لارو	laːɾo
لاري	laːɾi
لاريون	lɑrjun
لارې	laːɾe
لازم	laːzəm
لازما	laːzɪma
لاړم	laːʈəm
لاړي	laːʈi
لاړې	laːʈe
لاس	laːs
لاسته	laːsta
لاسرسي	laːsaɾsi
لاسليک	laːslɪk
لاسلیک	laːslɪk
لاسه	laːsa
لاسونه	laːsʊna
لاښه	laːxa
لاښي	laːxi
لالا	laːlaː
لالي	laːli
لامبل	lɑmbəl
لامبو	lɑmbo
لامل	laːmal
لانجه	ɡərzanˈdoai
لاندي	laːnde
لاندۍ	laːndiː
لاندې	laːnde
لاهم	laham
لباس	lɪbaːs
لپاره	lapara
لپه	lapa
لټه	lata
لټوه	laʈwa
لخوا	laxwaː
لڅ	las
لر	laɾ
لرئ	laɾe
لرئ	laɾe
لرغونپوهنه	lərɣunpohəna
لرغوني	laɾɣoni
لرغونی	laɾɣoni
لرګيو	laɾɡijo
لرګی	lərgai
لرګیو	laɾɡijo
لرل	larəl
لرله	laɾla
لرلید	laɾlid
لرلې	laɾle
لرم	laɾəm
لره	laɾa
لرو	laɾo
لرونکی	laɾʊnki
لرى	laɾe
لري	laɾi
لري	laɾi
لري۔	laɾi
لری	laɾi
لری۔	laɾi
لرې	laɾe
لړ	laɺ
لړم	laɺam
لړمانو	laɺmaːno
لړه	ləɺa
لړۍ	laɺai
لږ	ləg
لږه	laɡa
لس	lɑs
لسم	lasəm
لسو	laso
لسيزو	lasizo
لسی	lasi
لشه	laʃa
لښته	laxta
لښکر	laxkar
لغات	lɪɣat
لغت	lɪɣat
لغتونه	lɪɣatʊna
لغړي	lɪɣaɾi
لک	lak
لکه	laka
لکه	laka
لکو	lako
لکۍ	lakiː
لکې	lake
لګ	laɡ
لګته	laɡta
لګښت	laɡaxt
لګه	laɡa
لګي	laɡi
ِلله	lɪˈlːaːh
لمانځل	lmɑnzəl
لمبې	lambɪ
لمر	lamar
لمريز	lmariz
لمریز	lamɾiz
لمسول	ləmsəwəl
لمسی	lmasai
لمسۍ	lamsiː
لمن	lamən
لمونځ	lamonz
لنډ	land
لنډې	lande
لنګه	laŋa
لنګوټې	laŋʊʈe
له	la
له	la
لهجه	lahd͡d͡ʒa
لهجو	lahd͡d͡ʒo
لهجې	lahd͡d͡ʒe
لہ	la
لۀ	la
لو	lo
لوئ	loai
لوبغالي	lobɣaːli
لوبه	loba
لوبو	loːbo
لوبول	lobawəl
لوبولی	loːboli
لوبوي	loːbowi
لوبې	loːbe
لوبېدل	lobedəl
لوپټه	loːpaʈa
لوټ	loːt
لوټه	loːta
لوڅ	lus
لور	lor
لوز	ləoːz
لوړ	lwaɺ
لوړل	loɺəl
لوړه	loɺa
لوړو	loɺo
لوړې	loɺe
لوست	lwəst
لوستل	lwəstəl
لوستنې	loːstane
لوښي	loʃi
لوک	lok
لوکس	loːks
لوګر	loɡar
لوګی	loɡi
لولم	lolam
لولي	loli
لولی	loːli
لومړي	lomrai
لومړی	lumɺai
لومه	loma
لوند	lund
لوى	loj
لوي	loj
لويه	loja
لويو	lojo
لويې	loje
لوی	loi
لویه	loja
لویې	loje
لوې	loːja
لوېديځ	loediz
ليا	lja
ليدل	lidəl
ليږو	liɡo
ليست	list
ليکل	liːkal
ليکلي	liːkli
ليکلی	liːkli
ليکم	liːkam
ليکو	liːko
ليکوال	likwɑl
ليوان	liːwaːn
لیا	ljaː
لید	lid
لیدلو	lidl̩o
لیدنې	lidne
لیدو	lido
لیږم	liɡam
لیست	list
لیک	liːk
لیکل	liːkal
لیکلي	liːkli
لیکو	liːko
لیکوال	liːkwaːl
لینک	link
لېږل	legəl
لېسې	lese
لېور	lewar
لېونی	lewanai
لېونۍ	lewənəi
لېوۀ	lewə
م	m
مآر	maːr
مؤثق	moːsaq
ما	mɑ
مات	maːt
ماتمه	maːtma
ماته	maːta
ماتې	maːte
ماخوستن	maːxostan
ماځيګر	maːzdigar
ماځيگر	maːzdigar
مار	maːr
مارشل	maːrʃal
مارغه	maːrɡa
مارګله	maːrɡala
مازدیګر	maːzdigar
ماسپښین	maːspahin
ماسک	maːsk
ماشوم	maːʃum
ماشومان	mɑʃuˈmɑn
ماشومانو	maːʃumaːno
ماشومه	maːʃuma
ماشين	maːʃin
ماښام	mɑxɑm
ماغزو	maːɡzo
ماکو	maːko
مال	mɑl
مالداري	maːlɖaːri
مالک	mɑlɪk
مالګه	mɑlga
مالګې	maːlɡe
ماله	maːla
مالومات	maːlumaːt
مالوماتو	maːlumaːto
مالي	maːli
مالیاتو	maːlijaːto
ماما	mɑmɑ
مانا	maːna
مانامې	maːnaːme
مانګر	maːŋgər
مانه	maːna
ماڼو	mɑɳo
ماڼۍ	mɑɳəi
ماهيان	maːhijaːn
ماى	maːj
مایار	maːjaːr
مباح	mabaːh
مبارز	mubaːrez
مبارزه	mubaːreza
مبارزین	mubaːreziːn
مبارک	mubaːrak
مبو	mabo
مت	mat
مترجمان	mətərˈd͡ʒəma:n
مترو	matro
متل	matl
متل	matl
متلي	matli
متن	matn
متوقع	mutaːwaqq
مثال	mesaːl
مثبت	musbat
مثبتو	musbato
مټ	məʈ
مټونګى	məʈungai
مټې	mətˈte
مجرم	mud͡d͡ʒrim
مجله	mad͡d͡ʒala
مچ	mət͡ʃ
مچان	mət͡ʃan
مچه	mət͡ʃa
مچیو	mət͡ʃijo
محبوب	maːhbuːb
محتاجه	muhtaːd͡d͡ʒa
محشر	maːhʃar
محکمې	maːhkame
محله	mahalla
محلي	mahalli
محمد	mohammad
مخ	maːx
مخامخ	maːxamax
مختګ	muxtag
مختلف	muxtalif
مختلفو	muxtalifo
مخکې	maːxke
مخلوقاتو	maxluːkaːto
مخه	maːxa
مخوېينه	məxwejəna
مخي	maːxi
مخې	maːxe
مځکه	məd͡ʒka
مد	mad
مدرسو	madraso
مدني	madani
مدنیت	madanijjat
مدیریت	mʊdiːriˈjɑt
مذهب	mazhab
مذهبي	mazhabi
مر	mar
مراتب	maraːtib
مراجعو	maraːd͡d͡ʒo
مراسمو	maraːsmo
مرجان	mard͡d͡ʒaːn
مرجع	mard͡d͡ʒaʕ
مرخېړی	marxeɺ̢ai
مردار	mʊrdar
مردان	mardaːn
مرسته	marestːa
مرستو	marestu
مرستونی	mrastunaɪ
مرستې	mareste
مرض	maraz
مرغ	mraɣ
مرغانو	marɡaːno
مرغړی	marɣaɺ̢ai
مرغه	mərɣə
مرغۀ	mʊrɣa
مرغۍ	marɡaj
مرکز	markaz
مرکزي	markazi
مرکې	marke
مرګ	marg
مرګه	marɡa
مرم	marm
مرو	maro
مروت	marwat
مروه	marwa
مري	mari
مرۍ	mari
مز	maz
مزار	mazaːr
مزری	mzaraɪ
مزل	mazal
مړ	məɺ
مړؤی	mɪɺoj
مړه	məɺa
مړه	mɪɺa
مړوښه	mɪɺoxa
مړوي	mɪɺoːi
مړۍ	maɺ̢əi
مړې	məɺe
مږه	məɣa
مږوري	məɣoːri
مسؤل	masʔuːl
مسؤليته	masʔulijta
مسافر	masaːfer
مسايلو	masaːjelo
مسایل	masaːjel
مستانه	mastaːna
مستحب	mustahab
مستغني	mustaɣna
مستقل	mustaql
مستۍ	mastiː
مستې	masta
مسح	masah
مسکين	maskin
مسکین	maskin
مسلک	maslak
مسلکي	maslaki
مسلمان	muslmaːn
مسله	masala
مسه	m̩sa
مسې	mase
مشتري	muʃtari
مشر	maʃar
مشران	maʃraːn
مشرانو	maʃraːno
مشرتوب	məxəˈrotob
مشري	məxˈri
مشکل	moʃˈkil
مشکلات	moʃkiˈlat
مشهور	məxˈhoːr
مشهوره	məxˈhoːra
مشوره	məˈʃoːra
مشې	məxe
مصر	mɪsɾ
مصرف	mɑsˈrəf
مضمون	məzˈmun
مطلب	mətˈləb
مظلوم	mɑzˈluːm
معاش	maˈʔaːʃ
معالجه	moˈɑləd͡zɑ
معتبرو	muʔtæˈbəro
معدن	mɑdən
معدې	mæˈɺe
معرفي	maʔrəˈfi
معلومات	maːluˈmat
معما	muʔamˈma
معمول	maːˈmuːl
معنا	mæʔˈna
معنیٰ	mæʔˈna
معين	muˈʕin
مغز	məɣz
مغزي	məɣˈzi
مغل	moˈɣəl
مغولو	məˈɣoːlo
مُفغن	mʊfˈɣən
مفکر	moˈfəkir
مفکورو	məfəˈkoːro
مفید	moˈfiːd
مقابل	moqaˈbil
مقابلې	moqaˈbile
مقام	maˈqam
مقاومت	moqɑˈwəmat
مکان	məˈkan
مکتب	məkˈtab
مکرو	mʊkˈro
مکړه	məkˈra
مکمل	məkəmˈmal
مکه	məˈka
مکې	məke
مګر	məgər
مگر	məgər
مل	mal
ملا	məˈla
ملاتړ	mɪlætˈəɺ
ملالۍ	məˈlaːle
ملالې	məˈlaːle
ملامت	məlaˈmat
ملت	mɪlˈlat
ملتانه	mɪltaˈna
ملغلره	mɪlɣaˈlara
ملک	mɪlˈək
ملکي	mɪlˈki
ملکیت	mɪlkiˈjat
ملګرو	mɪlɡəˈro
ملګري	mɪlˈɡri
ملګری	məlgərai
ملګرې	məlgəre
ملنګ	məˈlaŋ
ملي	mɪˈli
ملی	mɪˈli
ممکن	momˈkən
من	mæn
مناسب	moˈnasɪb
منت	mɪnˈt
منتر	mɪnˈtər
منټ	mɪnəʈ
منځ	manz
منځني	mənzˈni
منځنی	mənzənəi
منځه	mənˈza
منده	mɪnˈda
مندوزي	mɪnˈdoːzi
منډه	mənɖa
منزل	mænˈzɪl
منزله	mænˈzɪla
منږک	məngak
منظرو	mænˈzaro
منظرې	mænˈzare
منظم	mʊˈnazəm
منظور	mænˈzuːr
منع	mæna
منعه	mæˈnʕa
منګر	maŋgər
منگر	mənɡar
منل	manəl
منلی	mænˈli
منم	mænˈam
مننه	mænˈna
منو	mænˈo
مني	mani
منیر	muˈniːr
منې	mənˈe
مڼی	mɳi
مڼې	mɳe
مه	ma
مهٔ	ma
مهارت	məhaˈrat
مهال	məˈhal
مهم	mʊˈham
مهمه	məˈhama
مهمو	mʊˈhamo
مهمې	məˈhame
مو	mu
مواد	moˈwad
موادو	moˈwado
موبایل	moˈbajəl
موټر	moˈʈər
موټک	muʈak
موجود	moˈd͡d͡ʒud
موخه	moxa
موخو	moˈxo
موده	moˈda
مودی	moˈdi
مور	moːr
موره	moˈra
موزي	moˈzi
موړ	moːɺ
موږ	mug
موږک	mugək
موږي	moːɡi
موژ	moːg
موسم	moːˈsam
موسيقي	musiqi
موقع	moˈqa
مولا	moˈla
مولوي	moˈlowi
موندل	mundəl
موندلی	monˈdɪli
مونږ	mung
مونګ	moŋ
مي	mi
مياشت	mjɑʃt
ميان	miˈjan
ميرويس	miˈroːis
ميز	miz
ميړانه	miˈɺana
ميژ	miːg
ميشت	miˈʃt
ميلمه	milma
ميليون	miˈlion
مينه	mina
مينې	miˈne
ميوي	mijoːi
ميوې	mijoːe
ميېر	mjer
می	mi
میاشت	miɑʃt
میراث	miˈras
میرزا	mirzɑ
میرمن	miˈrman
میز	miz
میړنو	miɺno
میشته	miˈʃta
مین	min
مینځل	miˈnzal
مینه	miˈna
مینې	miˈne
میوو	mijoːo
مې	me
مېجی	med͡ʒɑi
مېچن	met͡ʃən
مېخ	me:x
مېرمنې	mermaˈne
مېز	meːz
مېړګی	meɺgɑi
مېړه	meːɺa
مېړۀ	meɺə
مېږو	meːɣo
مېشت	meʃt
مېشته	meʃˈta
مېشکوړ	meʃkoɺ
مېشيکو	meʃiko
مېښه	mexa
مېکسیکاني	meksiˈkani
مېلمنې	melmaˈne
مېلمه	melma
مېله	mela
مېلوه	melawa
مېنه	meˈna
مېوه	meˈwa
ن	n
نا	nɑ
ناپوه	naːpoˈha
ناټک	naːʈək
ناحق	naˈhaq
ناراضي	naːraˈzi
نارنجي	nɑrənd͡ʒi
ناره	naˈra
ناروا	naːroˈwa
ناروغه	naːroˈɣa
ناروغۍ	naːroˈɣai
ناري	naːri
ناری	naːˈri
نارې	naːre
ناز	naz
نازک	naˈzak
نازل	naˈzal
نازو	nazu
ناړولی	nɑɺawɘlai
ناست	naːst
ناستي	naːsti
ناستې	naːste
ناسم	nɑsəm
ناشته	naːʃta
ناصر	naːsir
ناکامه	naːˈkama
ناکتلى	naːkˈtali
نام	naːm
نامه	naːma
نان	naːn
نبي	nabi
نثر	naˈsar
نثري	nasˈri
نجات	naˈd͡d͡ʒat
نجلۍ	nəd͡ʒələi
نجونو	naːd͡d͡ʒoːno
نجيب	nad͡d͡ʒib
نجېب	nad͡d͡ʒeb
نخترو	naxtaro
نڅا	nət͡saː
نده	nəda
ندی	nədi
ندې	nəde
نر	nar
نرخ	narx
نرکاشه	nərkɑʃa
نرى	narai
نرے	naːre
نزدې	nizde
نړيدلى	nəɺiˈdalai
نړۍ	naɺəj
نږدم	nəɣˈdam
نږدې	nigde
نژدې	nid͡ʒde
نس	nas
نسٸ	nasˈi
نسته	nasˈta
نسخو	nasˈxo
نسل	nasl
نسم	nəsəm
نسواري	naswɑri
نسې	nəse
نشئ	nəʃai
نشت	nəʃt
نشته	nəʃta
نشتوالي	nɪʃˈtwaːləi
نشر	naˈʃar
نشم	naʃˈʊm
نشه	ˈnaʃa
نشو	naˈʃo
نشي	naˈʃi
نشی	naˈʃi
نشیب	naˈʃeːb
نښانې	nəˈʃaːne
نښتر	nəxtar
نښه	ˈnəʃa
نښو	nəˈʃo
نښې	nəˈʃe
نصيب	naˈseːb
نطفه	nʊtpa
نظارت	nazˈaːrat
نظر	ˈnazɪr
نظریاتي	nazəˈrjaːtiː
نظمونه	nazˈmuna
نغمه	naɣˈma
نغمو	naɣˈmo
نفره	naˈfara
نفس	nəfˈs
نقش	naqˈʃ
نقشه	naqˈʃa
نکړ	nəkˈɺ
نکړي	nəkˈɺi
نکل	nəkal
نکلي	nəˈkli
نل	nal
نلري	nalˈri
نمایش	namˈjaːʃ
نمه	ˈnama
نمونځ	nəmuŋz
نمی	ˈnami
نن	nan
ننګ	nəŋg
ننګه	ˈnanga
ننګیالی	nəŋɡiˈaːlai
ننه	ˈnana
نه	nə
نهر	ˈnahr
نهم	nəˈham
نهمو	nəˈhmo
نهه	nəh
نهو	nəˈho
نهي	nəˈhi
نۀ	na
نو	no
نوئ	noˈe
نواقص	nwaːˈqɪs
نوبل	ˈnobl
نور	nor
نورو	noˈro
نوري	noˈri
نورې	noˈre
نوش	noˈʃ
نوک	noˈk
نوکغوڅی	nukɣwəsai
نولا	noˈla
نولس	noˈlas
نوم	noˈm
نوملړ	numlaɺ
نومونه	noˈmuna
نومیالۍ	nomˈjaːlai
نوو	noˈwo
نوي	ˈnwe
نويزونو	nweːzˈuno
نوی	nəwai
نوې	noˈwe
نيا	njɑ
نياز	njaːz
نياو	njɑw
نيت	ˈnɪjat
نيچې	ˈnit͡ʃe
نيستۍ	nisˈtaj
نيسي	ˈnisi
نيک	nik
نيکه	ˈnika
نيکو	ˈniko
نيلي	nili
نيم	nim
نيمبو	nimbu
نيمه	ˈnima
نيوکه	niwəka
نيوي	ˈniwe
نیټې	ˈnite
نیک	nik
نیکه	ˈnika
نیکونو	niˈkono
نیکي	ˈniki
نیمې	ˈnime
نې	ne
نېغ	neːɣ
نېک	nek
نېکو	ˈneko
نېکي	ˈneki
ڼ	ɳ
ه	ə
ها	ha
هار	haːr
هاضمې	haːˈzma
هبة	ˈhibat
هتمن	hatˈman
هجران	həd͡d͡ʒˈraːn
هڅکه	haska
هڅه	hasa
هڅو	hət͡so
هڅول	hət͡soˈwal
هڅې	hət͡se
هدف	ˈhadaf
هډ	həd
هډو	həˈdo
هر	har
هرڅوک	harˈsok
هره	haˈra
هرو	haˈro
هرې	haˈre
هسک	hask
هسکې	həˈske
هسي	həˈsi
هسې	həˈse
هغسي	haɣˈsi
هغه	háɣə
هغو	haˈɣo
هغوی	haˈɣoi
هغې	haˈɣe
هفته	hafˈta
هک	hak
هکله	hakˈla
هګل	haˈɡəl
هګۍ	əŋgəi
هلال	haˈlal
هلته	halta
هلک	ələk
هلکه	haˈlka
هلې	haˈle
هم	həm
هماليۀ	hɪmɑləjə
همت	həmt
همدا	hamˈda
همدارنګه	hamdaːˈraŋa
همداسې	hamˈdasə
همدردۍ	həmˈdɑrdəi
همدې	hamˈde
همسايه	hamsaˈja
همغږي	həmɣəˈɣi
همغږۍ	hamɣaːj
همکار	hamˈkaːr
همکارۍ	həmkaˈrəi
همېشه	həˈmeʃa
همېل	hamel
هند	hind
هنر	haˈnar
هنرونو	hanəˈrono
هنري	hanaˈri
هو	ho
هوا	hawa
هواره	hoˈra
هوټل	hoˈtal
هوډ	hoˈd
هورې	hure
هوساوو	hosaˈwo
هوسي	həˈsi
هوښيار	huxjɑr
هوکړه	hokɺa
هيټه	ˈhiʈa
هيڅ	his
هير	ˈhir
هيله	hila
هيواد	hiwaːd
هیڅ	his
هیڅوک	hisˈok
هیله	ˈhiːla
هیلو	ˈhiːlo
هیواد	hiˈwaːd
هېڅکله	hisˈkəla
هېر	yer
هېلۍ	heləi
هېواد	hewɑd
ۀ	ə
و	wo
وٸ	wi
وئ	wəi
وا	wa
واپس	waˈpas
واټ	wɑʈ
واخان	waˈxan
واخلئ	waˈxle
واخله	waˈxla
واخيسته	waˈxista
واده	waˈda
وار	waːr
وارختا	waːrxˈta
وارګۀ	waːrˈɡa
واره	waːˈra
واري	waːˈri
واسطه	waˈsta
واک	wɒk
واکدار	waːkˈdar
واکمن	wɑkman
واکي	waːˈki
وال	waːl
والو	waːˈlo
والى	waːˈli
والۍ	waːˈlaːi
وانګې	waˈŋe
واورئ	waˈore
واورتون	wɑwratun
واوره	wɑwra
واوري	waˈori
واي	waːj
وايرسي	waːjərˈsi
وايم	waˈjem
وايه	waˈje
وايو	waˈju
وايي	waˈji
وايې	waˈje
وای	waːj
وایی	waːˈji
وباسو	waˈbaso
وبلل	waˈbləl
وبه	waˈba
وبې	waˈbe
وتل	watəl
وثره	waˈθra
وټ	ˈwoːʈ
وټه	wəʈa
وجه	ˈwəd͡d͡ʒa
وچ	ˈut͡ʃ
وچه	ʊˈt͡ʃa
وچو	ʊˈt͡ʃo
وچې	ʊˈt͡ʃe
وخ	wax
وخت	waxt
وختي	waxti
وختې	waˈxte
وخورم	waˈxorəm
وخوره	waˈxora
وخوري	waˈxori
وځو	wˈzu
وځي	oˈzi
وڅکي	oˈsaki
وڅکې	oˈsake
وڅېـړي	oˈseːɺi
ودان	wədɑn
ودانول	wadɑnawəl
ودرېد	wədˈred
وده	waˈda
ودې	waˈde
وډار	ʊˈɖaːr
ور	war
ورانه	waˈrana
ورايه	waˈraja
ورته	waˈrta
ورخه	waˈrəxa
ورځ	wraz
ورځم	warzəm
ورځو	warzo
ورځي	warzi
ورځې	warze
وردګي	wardaˈɡi
ورزده	warˈzda
ورزش	warˈzaʃ
ورسره	warˈsara
ورسوي	warsəˈwi
ورشم	warˈʃəm
ورشو	warʃo
ورغلي	warˈɣli
ورغوی	warˈɣoi
ورک	wərk
ورکړ	wərkˈre
ورکړئ	wərkˈre
ورکړه	wərkˈra
ورکړي	wərkˈri
ورکړې	wərkˈre
ورکه	wərˈka
ورکو	wərˈko
ورکول	warkawəl
ورکوه	wərˈkohe
ورکوو	wərkˈo
ورکوي	wərkˈawi
ورو	wroʊ
ورور	waˈror
وروره	waˈrora
وروستل	warwastəl
وروسته	waˈrosta
وروستي	warˈosti
ورولم	warwaləm
وريجې	wrid͡ʒe
وريزي	waˈrezi
وريږي	waˈreɡi
وريژې	wrid͡ʒe
ورېښمو	wəreˈʃmo
وزارت	waˈzara
وزګاري	wazˈɡaːri
وزلي	wazˈli
وزن	wazn
وزه	waˈza
وزي	waˈzi
وزير	waˈzir
وزیر	waˈzir
وزیرستان	wəzirɪstɑn
وزې	waˈze
وړ	wuɺ
وړل	oˈɺəl
وړه	ʊˈɺa
وړوکی	waɺ̢ukai
وړيا	wəɺjɑ
وړۍ	ʊˈɺe
وړې	ʊˈɺe
وږو	ʊˈɣo
وږي	ʊˈɣi
وږی	wəgai
وژل	oˈd͡ʒəl
وژلي	oˈd͡ʒəli
وس	wəs
وساته	wəˈsata
وساتو	wəˈsatu
وساتې	wəˈsate
وسلم	wəˈsələm
وسله	wəˈsala
وسلو	wəˈsalo
وسه	wəˈsa
وسوه	wəˈsowa
وش	wəʃ
وشرم	wəˈʃram
وشو	wəˈʃo
وشول	wəˈʃol
وشوه	wəˈʃwa
وشي	wəˈʃi
وښود	oˈxoːd
وطن	waˈtan
وطنه	waˈtana
وقف	waqf
وكړ	wəkˈɺ
وكړي	wəkˈɺi
وکارول	oˈkaːrol
وکړ	oˈkɺ
وکړئ	oˈkɺai
وکړل	oˈkɺəl
وکړم	oˈkɺəm
وکړم	oˈkɺəm
وکړه	oˈkɺa
وکړو	oˈkɺu
وکړي	oˈkɺi
وکړې	oˈkɺe
وکښل	oˈkaxəl
وکم	oˈkam
وکه	oˈka
وکي	oˈki
وکیل	waˈkil
وکیله	waˈkile
وګټه	oˈɡaʈa
وګړواکي	wəgəɺwɑki
وګړي	waˈɡəɺi
وګړی	wəgəɺai
وګورم	oˈɡorəm
وګوري	oˈɡori
ول	wal
ولاړ	waˈlaɺ
ولاړه	waˈlaɺa
ولايت	waˈlaːjat
ولایت	waˈlaːjat
ولرو	walˈro
ولري	walˈri
ولس	wəlˈəs
ولسمشر	wəlˈmasər
ولسوالي	wələswɑli
ولسوالۍ	wələswɑləi
ولسي	wəlˈsi
وله	wala
ولولی	wəloˈli
ولي	waˈli
ولی	waˈli
ولیاړې	waliˈjaːɺe
ولیکل	waˈlikəl
ولۍ	waˈli
ولې	waˈle
وم	wəm
ومو	wəˈmo
ومومئ	wəˈmoməi
ومومي	wəˈmomi
ونلري	wənəlˈri
ونه	wəna
ونو	woˈno
وه	ˈwah
وهل	waˈhəl
وهلي	waˈhəli
وهه	ˈwaha
وهي	waˈhi
وهينه	waˈhiːna
وهې	waˈhe
وو	ˈwo
ووت	ˈwoːt
ووړکی	woɺ̢kai
ووړکۍ	woɺ̢kəi
ووړی	woɺai
ووهئ	woˈhej
وويل	woˈjel
وویل	woˈjel
وى	we
وي	wi
ويده	widə
ويشت	ˈwiʃt
ويشتل	wiʃtəl
ويشتو	wiʃˈto
ويکټ	wiˈkəʈ
ويل	ˈweːl
وينګ	wajaŋg
وينم	winəm
وينه	ˈweːna
وينې	ˈweːne
ويه	waja
وييپانګه	wəjipɑŋga
وييونه	wijuna
ويی	wəjai
وی	wi
ویاړ	ˈwjaːɺ
ویاړم	ˈwjaːɺəm
وید	ˈweːd
ویده	weːˈda
ویشي	wiˈʃi
ویل	ˈweːl
ویلو	weːˈlo
ویلي	weːˈli
ویلې	weːˈle
ویناوې	weːˈnaːwe
وینځل	wiːnˈzəl
وینه	ˈweːna
وینې	weːˈne
ویي	wiˈji
وې	we
وېره	wera
وېرول	werawəl
وېرېدل	weredəl
وېشل	weˈʃəl
وېښتان	wextɑn
وېښته	wextə
ى	i
ي	i
يؤه	joˈha
يا	ja
ياد	jɑːd
يار	ˈjaːr
ياره	ˈjaːra
ياست	ˈjaːst
يانې	ˈjaːne
يتيم	jaˈtim
يخ	ˈjax
يخې	ˈjaxe
يعنی	jaˈni
يک	jak
يم	jəm
يم	jəm
يم۔	jəm
يمه	ˈjəmə
يه	je
يه	je
يهک	jhak
يو	jo
يوازي	joˈwaːzi
يوازې	joˈwaːze
يودي	joˈdi
يولس	joˈlas
يوم	jum
يونی	yunai
يوه	joˈwa
يوولس	jawolas
يوې	joˈwe
يي	ji
يی	ji
يې	je
ی	j
یا	ja
یاران	jaˈɾan
یاره	ˈjaɾa
یاري	ˈjaɾi
یخ	ˈjəx
یعنې	ˈjaʔne
یم	jam
یمه	ˈjama
یو	ju
یوازي	juˈwazi
یوازې	juˈwaze
یوه	ˈjuha
یوې	ˈjuwe
یي	ji:
یې	je:
ۍ	əi
ې	ɪ