กก	gok
กกไม้	gokmai
กด	got
กน	gon
กบ	gop
กม	gom
กวด	gu:at
กวยเตียว	gu:aiti:ao
กว่า	gwa:
กว้าง	gwa:ŋ
กอง	gɔ:ŋ
กองไฟ	gɔ:ŋfai
กอน	gɔ:n
กอบ	gɔ:p
กะ	ga
กะคุ	gaku
กะจก	gajok
กะดอง	gadɔ:ŋ
กะดาด	gada:t
กะดาดแข็ง	gada:tkhɛŋ
กะดาน	gada:n
กะดิก	gadik
กะดุม	gadum
กะดูก	gadu:k
กะด้อกะเดี้ย	gadɔ:kgadi:a
กะต่า	gata:
กะทะ	gatha
กะปอง	gapɔŋ
กะปุก	gapuk
กะละกะดาคม	galagada:khom
กะละมัง	galamaŋ
กะลัง	galaŋ
กะหล้ำ	galam
กะหล้ำปี	galampi:
กะเดย	gadə:i
กะเทียม	gathi:am
กะเปา	gapao
กะเปาเป้	gapaope:
กะเพาะ	gaphɔ
กะโดด	gado:t
กะโปง	gapo:ŋ
กะโหลก	galo:k
กัด	gat
กัน	gan
กันญาย๊น	ganɲa:yon
กันไก	gangai
กับ	gap
กับตัน	gaptan
กับเข้า	gapkhao
กั้น	gan
กากะบาด	ga:gaba:t
กากี	ga:gi:
กาง	ga:ŋ
กางเกง	ga:ŋge:ŋ
กาตูน	ga:tu:n
กาน	ga:n
กานเมือง	ga:nmʉ:aŋ
กาบ	ga:p
กาย	ga:i
กาละเทสะ	ga:lathe:sa
กาแฟ	ga:fɛ:
กำปั้น	gamban
กำลัง	gamlaŋ
กำแพง	gamphɛ:ŋ
กิดจะกัม	gitjagam
กิน	gin
กิ่ง	giŋ
กิ่น	gin
กีบ	gi:p
กีลา	gi:la:
กุงเทบ	guŋthe:p
กุงไทย	guŋthai
กุนแก	gungɛ:
กุนแกข้อมือ	gungɛ:khɔ:mʉ:
กุนแจ	gunjɛ:
กุมพา	gumpha:
กุมพาพัน	gumpha:phan
กุ่บ	gup
กู	gu:
กู้	gu:
ก่น	gon
ก่อ	gɔ:
ก่อกน้ำ	gɔkna:m
ก่อง	gɔŋ
ก่องแก่ง	gɔŋgɛŋ
ก่อน	gɔ:n
ก่อส้าง	gɔ:sa:ŋ
ก่ำ	gam
ก้น	gon
ก้ม	gom
ก้วย	gu:ai
ก้อกๆ	gɔ:k
ก้อง	gɔ:ŋ
ก้อน	gɔ:n
ก้อนหิน	gɔ:nhin
ก้อนเมก	gɔ:nme:k
ก้า	ga:
ก้ากๆ	ga:kga:k
ก้าน	ga:n
ก้าม	ga:m
ก้าว	ga:o
ขดตะหมาด	khottama:t
ขน	khon
ขนส่ง	khonsoŋ
ขม	khom
ขวด	khu:at
ขวน	khu:an
ขวา	khwa:
ขอ	khɔ:
ของ	khɔ:ŋ
ของขวน	khɔ:ŋkhu:an
ของหวาน	khɔ:ŋwa:n
ของเหล้น	khɔ:ŋlen
ขอซ้าง	khɔ:sa:ŋ
ขอทาน	khɔ:tha:n
ขอนไม้	khɔ:nmai
ขอบ	khɔ:p
ขอบคุณ	khɔ:pkhun
ขอบิ่น	khɔ:bin
ขอบใจ	khɔ:pjai
ขอโต	khɔ:to:
ขะบวน	khabu:an
ขะยะ	khaya
ขะหนม	khanom
ขะหนาด	khana:t
ขะโมย	khamo:i
ขัง	khaŋ
ขัน	khan
ขับ	khap
ขั้น	khan
ขั้นตอน	khantɔ:n
ขั้วน	khu:an
ขา	kha:
ขาด	kha:t
ขาตั้ง	kha:taŋ
ขาย	kha:i
ขาว	kha:o
ขิ้น	khin
ขีด	khi:t
ขี่	khi:
ขี้	khi:
ขี้ดิน	khi:din
ขี้ตม	khi:tom
ขี้ผึ้ง	khi:pʉŋ
ขี้ฝ้า	khi:fa:
ขี้มึน	khi:mʉn
ขึง	khʉŋ
ขึงขัง	khʉŋkhaŋ
ขึ้น	khʉn
ขึ้นซื่อ	khʉnsʉ:
ขุด	khut
ข่าว	kha:o
ข้อง	khɔŋ
ข้อต่อ	khɔ:tɔ:
ข้อน	khɔn
ข้อมูน	khɔ:mu:n
ข้อย	khɔ:i
ข้อหล้อ	khɔ:lɔ:
ข้า	kha:
ข้าง	kha:ŋ
ข้างขวา	kha:ŋkwa:
ข้างซ้าย	kha:ŋsa:i
ข้างนอก	kha:ŋnɔ:k
ข้างล่าง	kha:ŋla:ŋ
ข้างหน้า	kha:ŋna:
ข้างหลัง	kha:ŋlaŋ
ข้างเทิง	kha:ŋthə:ŋ
ข้างใน	kha:ŋnai
ข้าม	kha:m
คก	khok
คน	khon
คนป่วย	khonpu:ai
คนละ	khonla
คนไข้	khonkhai
คม	khom
ควน	khu:an
ควย	khu:ai
ความ	khwa:m
ความคิด	khwa:mkhit
ความทุก	khwa:mthuk
ความปอดพัย	khwa:mpɔ:tphai
ความฝัน	khwa:mfan
ความลู้	khwa:mlu:
ความสุข	khwa:msuk
ความหมาย	khwa:mma:i
ความหายยะนะ	khwa:mha:iyana
ความฮู้	khwa:mhu:
ความฮ้อน	khwa:mhɔ:n
ความเย็น	khwa:myen
คอ	khɔ:
คอก	khɔ:k
คอง	khɔ:ŋ
คอบคัว	khɔ:pkhu:a
คอสอ	khɔ:sɔ:
คะนิด	khanit
คะนิดตะสาด	khanittasa:t
คะนิดสาด	khanitsa:t
คะแนน	khanɛ:n
คัก	khak
คัด	khat
คัน	khan
คันเล่ง	khanleŋ
คับ	khap
คัว	khu:a
คาง	kha:ŋ
คาน	kha:n
คาบ	kha:p
คาย	kha:i
คาว	kha:o
คำ	kham
คำนวน	khamnu:an
คิด	khit
คิบ	khip
คิว	kiu
คิหนิก	khi:nik
คิ้ว	khiu
คีบ	khi:p
คึ้ม	khʉm
คืนหลัง	khʉ:nlaŋ
คือ	khʉ:
คือกัน	khʉ:gan
คือเก่า	khʉ:gao
คือใดบุ	khʉ:daibu
คื้น	khʉ:n
คุณ	khun
คุม	khum
คุย	khui
คู	khu:
คู่	khu:
ค็อนกีด	khɔngi:t
ค็อนโด	khondo:
ค็อม	khom
ค็อมพิวเต้อ	khompiutə:
ค่อย	khɔ:i
ค่า	kha:
ค่าวๆ	kha:o
ค่ำ	kham
ค้อย	khɔ:i
ค้า	kha:
ค้าง	kha:ŋ
ค้าย	kha:i
ค้าวๆ	kha:okha:o
งวง	ŋu:aŋ
งอ	ŋɔ:
งัด	ŋat
งับ	ŋap
งัว	ŋu:a
งา	ŋa:
งาน	ŋa:n
งาม	ŋa:m
ง่า	ŋa:
ง่าย	ŋa:i
จก	jok
จดจำ	jotjam
จน	jon
จบ	jop
จอ	jɔ:
จอด	jɔ:t
จะ	ja
จะเลิน	jalə:n
จัก	jak
จักกะย๊าน	jakgaya:n
จักอย่าง	jakya:ŋ
จังหวะ	jaŋwa
จังหวัด	jaŋwat
จัด	jat
จับ	jap
จั่ง	jaŋ
จั่งซั้น	jaŋsan
จั่งซี้	jaŋsi:
จั่งใด	jaŋdai
จา	ja:
จาก	ja:k
จาน	ja:n
จานฮองกาแฟ	ja:nhɔ:ŋga:fɛ:
จำ	jam
จำนวน	jamnu:an
จำเป็น	jampen
จิก	jik
จิง	jiŋ
จินตะนา	jintana:
จินตะนากาน	jintana:ga:n
จิ้ม	jim
จีวอน	ji:wɔ:n
จึ่งคื่ง	jʉŋkhʉ:ŋ
จืด	jʉ:t
จุก	juk
จุด	jut
จุดมุ่งหมาย	jutmuŋma:i
จุดหมาย	jutma:i
จุ่นพู่น	junphu:n
จุ่ม	jum
จ่ง	joŋ
จ่อย	jɔ:i
จ่าย	ja:i
จ้อง	jɔŋ
จ้อย	jɔ:i
จ้า	ja:
ชะนิด	chanit
ชักกะเย้อ	chakgayə:
ชักโคก	chakkho:k
ชาว	cha:o
ชาวบ้าน	cha:oba:n
ซง	soŋ
ซงผม	soŋphom
ซงสี	soŋsi:
ซม	som
ซมพู	somphu:
ซวน	su:an
ซวย	su:ai
ซอก	sɔ:k
ซอง	sɔ:ŋ
ซะนะ	sana
ซะสั้น	sasan
ซัก	sak
ซัด	sat
ซัน	san
ซัว	su:a
ซั่ง	saŋ
ซั่วคาว	su:akha:o
ซั่วโมง	su:amo:ŋ
ซั้น	san
ซั้นวางหนังสือ	sanwa:ŋnaŋsʉ:
ซาน	sa:n
ซานซาลา	sa:nsa:la:
ซาย	sa:i
ซายหาด	sa:iha:t
ซาว	sa:o
ซำบาย	samba:i
ซิด	sit
ซิม	sim
ซิ้น	sin
ซิ้นเนี้ย	sinni:a
ซีวิด	si:wit
ซี้	si:
ซื่อ	sʉ:
ซื่อๆ	sʉ:
ซื้อ	sʉ:
ซุด	sut
ซุดโซม	sutso:m
ซุม	sum
ซูด	su:t
ซู่	su:
ซู่มื้อนี้	su:mʉ:ni:
ซู่สิ่งซู่อย่าง	su:siŋsu:ya:ŋ
ซ่อก	sɔk
ซ่อย	sɔ:i
ซ่อยเหลีย	sɔ:ili:a
ซ่าง	sa:ŋ
ซ่างตัดผม	sa:ŋtatphom
ซ่าด	sa:t
ซ่าว่า	sa:wa:
ซ้วง	su:aŋ
ซ้วน	su:an
ซ้อง	sɔ:ŋ
ซ้อน	sɔ:n
ซ้อนซา	sɔ:nsa:
ซ้อนส้อม	sɔ:nsɔm
ซ้า	sa:
ซ้าง	sa:ŋ
ซ้าย	sa:i
ซ้ำ	sam
ซ้ำแมะ	sammɛ
ญก	ɲok
ญัง	ɲaŋ
ญาก	ɲa:k
ญาด	ɲa:t
ญาม	ɲa:m
ญาว	ɲa:o
ญิง	ɲiŋ
ญุง	ɲuŋ
ญู้	ɲu:
ญ่าง	ɲa:ŋ
ญ้อง	ɲɔ:ŋ
ญ้อน	ɲɔ:n
ญ้อย	ɲɔ:i
ญ้าย	ɲa:i
ดง	doŋ
ดม	dom
ดวง	du:aŋ
ดวงจัน	du:aŋjan
ดวงดาว	du:aŋda:o
ดวงตะเว็น	du:aŋtawen
ดอก	dɔ:k
ดอกบัว	dɔ:kbu:a
ดอกวา	dɔ:kwa:
ดอกว่า	dɔ:kwa:
ดอกไม้	dɔ:kmai
ดัง	daŋ
ดับ	dap
ดาก	da:k
ดาว	da:o
ดำ	dam
ดำนา	damna:
ดำไฮ่ดำนา	damhaidamna:
ดิน	din
ดิบ	dip
ดิ้น	din
ดี	di:
ดีใจ	di:jai
ดึก	dʉk
ดึง	dʉŋ
ดืน	dʉ:n
ดุ	du
ดุล้าย	dula:i
ดู	du:
ดูด	du:t
ดูแล	du:lɛ:
ด่า	da:
ด้น	don
ด้วย	du:ai
ด้วยกัน	du:aigan
ด้วยดี	du:aidi:
ด้าน	da:n
ด้าม	da:m
ด้าย	da:i
ตก	tok
ตกดิน	tokdin
ตกแต่ง	toktɛŋ
ตกใจ	tokjai
ตง	toŋ
ตน	ton
ตบ	top
ตวด	tu:at
ตวดสอบ	tu:atsɔ:p
ตอก	tɔ:k
ตอน	tɔ:n
ตอนนี้	tɔ:nni:
ตอบ	tɔ:p
ตอบแทน	tɔ:pthɛ:n
ตอม	tɔ:m
ตะก้า	taga:
ตะขอ	takhɔ:
ตะปู	tapu:
ตะลี	tali:
ตะหลก	talok
ตะหลอดเวลา	talɔ:twe:la:
ตะหลาด	tala:t
ตะหลาดนัด	tala:tnat
ตะเกียบ	tagi:ap
ตะเว็น	tawen
ตัก	tak
ตัด	tat
ตับ	tap
ตัว	tu:a
ตั้ง	taŋ
ตั้งค้า	taŋkha:
ตั้งจิด	taŋjit
ตั้งแต่	taŋtɛ:
ตั้งใจ	taŋjai
ตั๊วะ	tu:a
ตา	ta:
ตาก	ta:k
ตาข่าย	ta:kha:i
ตาซั่ง	ta:saŋ
ตาบอด	ta:bɔ:t
ตาพุฮ้าย	ta:phuha:i
ตาม	ta:m
ตามสั่ง	ta:msaŋ
ตามีความสุข	ta:mi:khwa:msuk
ตามีแฮง	ta:mi:hɛ:ŋ
ตาม่วน	ta:mu:an
ตาย	ta:i
ตาย้าน	ta:ya:n
ตาลิโตน	ta:lito:n
ตาหน่าย	ta:na:i
ตาอยากหัว	ta:ya:khu:a
ตาฮัก	ta:hak
ตาเบิ่ง	ta:bəŋ
ตาแซบ	ta:sɛ:p
ตำ	tam
ตำบน	tambon
ตำบักหุ่ง	tambakhuŋ
ตำหลวด	tamlu:at
ติ	ti
ติด	tit
ติ่ก	tik
ตี	ti:
ตีน	ti:n
ตีนเปิ่ม	ti:npə:m
ตึก	tʉk
ตึ่บ	tʉp
ตื่น	tʉ:n
ตื้น	tʉ:n
ตุลาคม	tula:khom
ตุ่กตุ่ก	tuktuk
ตุ้มม้อง	tummɔŋ
ตุ้ย	tui
ตู้	tu:
ตู้เย็น	tu:yen
ต่น	ton
ต่อ	tɔ:
ต่อคิว	tɔ:kiu
ต่อสู้	tɔ:su:
ต่อไป	tɔ:pai
ต่อไปนี้	tɔ:paini:
ต่าง	ta:ŋ
ต่างปะเทด	ta:ŋpathet
ต่างๆ	ta:ŋta:ŋ
ต่ำ	tam
ต้น	ton
ต้นก้า	tonga:
ต้นเข้า	tonkhao
ต้นไม้	tonmai
ต้ม	tɔm
ต้อง	tɔŋ
ต้องกาน	tɔŋga:n
ถก	thok
ถอด	thɔ:t
ถะหนน	thanon
ถะหนนลาดยาง	thanonla:tya:ŋ
ถะหนัด	thanat
ถะหวาย	thawa:i
ถะแหมะ	thamɛ
ถัง	thaŋ
ถังขะยะ	thaŋkhaya
ถัดไป	thatpai
ถั่วงอก	thu:aŋɔ:k
ถาด	tha:t
ถานะ	tha:na
ถาม	tha:m
ถิ้ม	thim
ถีบ	thi:p
ถี่	thi:
ถึง	thʉŋ
ถืก	thʉ:k
ถืกกัน	thʉ:kgan
ถืกปาก	thʉ:kpa:k
ถืกหู	thʉ:khu:
ถือ	thʉ:
ถุง	thuŋ
ถุงตีน	thuŋti:n
ถุงเท้า	thuŋthao
ถู	thu:
ถ่าน	tha:n
ถ่าย	tha:i
ถ้วม	thu:am
ถ้วย	thu:ai
ถ้อน	thɔ:n
ถ้า	tha:
ทงซาด	thoŋsa:t
ทดแทน	thotthɛ:n
ทน	thon
ทนทาน	thontha:n
ทบทวน	thopthu:an
ทอง	thɔ:ŋ
ทอด	thɔ:t
ทอน	thɔ:n
ทอละมาน	thɔlama:n
ทะนาคาน	thana:kha:n
ทะวีบ	thavi:p
ทะหาน	thaha:n
ทะเล	thale:
ทะเลาะวิวาท	thalɔwiwa:t
ทักทาย	thaktha:i
ทัน	than
ทันที	thanti:
ทันวาคม	thanwa:khom
ทันเวลา	thanwe:la:
ทันได้	thandai
ทับ	thap
ทัพพี	thapphi:
ทัมมะซาด	thammasa:t
ทัมมะดา	thammada:
ทั่น	than
ทั่ว	thu:a
ทั้งหลาย	thaŋla:i
ทา	tha:
ทาง	tha:ŋ
ทางหน้า	tha:ŋna:
ทางหลัง	tha:ŋlaŋ
ทางเลี้ยว	tha:ŋli:ao
ทางแย้ก	tha:ŋyɛ:k
ทาน	tha:n
ทำ	tham
ทำความสะอาด	thamkhwa:msaa:t
ทำงาน	thamŋa:n
ทำนอง	thamnɔ:ŋ
ทำบุน	thambun
ทำล้าย	thamla:i
ทิด	thit
ทีบ	thi:p
ทีละ	thi:la
ทีหลัง	thi:laŋ
ที่	thi:
ที่ดิน	thi:din
ที่สุด	thi:sut
ที่อยู่อาสัย	thi:yu:a:sai
ที้ลี้	thi:li:
ทุก	thuk
ทุละ	thula
ทุละกิด	thulagit
ทุ่ง	thuŋ
ทุ้ม	thum
ทูบ	thu:p
ท่วน	thu:an
ท่อ	thɔ:
ท่อน	thɔn
ท่อนไม้	thɔnmai
ท่า	tha:
ท่าทาง	tha:tha:ŋ
ท่าเทบพะบุด	tha:the:pphabut
ท้อง	thɔ:ŋ
ท้องถะหนน	thɔ:ŋthanon
ท้องฟ้า	thɔ:ŋfa:
ท้องเสีย	thɔ:ŋsi:a
ท้อน	thɔ:n
ท้าย	tha:i
นก	nok
นม	nom
นวน	nu:an
นอก	nɔ:k
นอกจาก	nɔ:kja:k
นอน	nɔ:n
นอนหลับ	nɔ:nlap
นะ	na
นักล้อง	naklɔ:ŋ
นักเลียน	nakli:an
นัด	nat
นับ	nap
นับถือ	napthʉ:
นัว	nu:a
นั่ง	naŋ
นั้น	nan
นั้นหนะ	nanna
นั้นหละ	nanla
นั้นเอง	nane:ŋ
นา	na:
นางพะยาบาน	na:ŋphaya:ba:n
นางเอก	na:ŋe:k
นาที	na:thi:
นาย	na:i
นาลิกา	na:liga:
นาลิกาปุก	na:liga:puk
นำ	nam
นำกัน	namgan
นิยม	niyom
นิ้ว	niu
นิ้วกาง	niuga:ŋ
นิ้วก้อย	niugɔ:i
นิ้วซี้	niusi:
นิ้วตีน	niuti:n
นิ้วนาง	niuna:ŋ
นิ้วโป้	niupo:
นี้	ni:
นี้หละ	ni:la
นุ่งห่ม	nuŋhom
นุ้ม	num
นูน	nu:n
น่วย	nu:ai
น่วยตา	nu:aita:
น่อ	nɔ:
น้อ	nɔ:
น้อง	nɔ:ŋ
น้องซาย	nɔ:ŋsa:i
น้องสาว	nɔ:ŋsa:o
น้อย	nɔ:i
น้า	na:
น้ำ	na:m
น้ำตา	na:mta:
น้ำตาน	na:mta:n
น้ำปั่น	na:mpan
น้ำปา	na:mpa:
น้ำมัน	na:mman
น้ำหนัก	na:mnak
น้ำอัดลม	na:matlom
น้ำเชื้อม	na:mchʉ:am
น้ำเป่า	na:mpao
น้ำแข็ง	na:mkhɛŋ
น้ำแดง	na:mdɛ:ŋ
น้ำโค่ก	na:mkho:k
บก	bok
บดบาด	botba:t
บวด	bu:at
บอก	bɔ:k
บอด	bɔ:t
บอลิกาน	bɔ:liga:n
บอลิสุด	bɔ:lisut
บัก	bak
บักคัก	bakkhak
บักคักหนึ่ง	bakkhaknʉŋ
บักจก	bakjok
บักนาว	bakna:o
บักพาย	bakpha:i
บักพิก	bakphik
บักพ้าว	bakpha:o
บักม่วง	bakmu:aŋ
บักหล้า	bakla:
บักหุ่ง	bakhuŋ
บักเขียเคีย	bakkhi:akhi:a
บักแตง	baktɛ:ŋ
บักแตงโม	baktɛ:ŋmo:
บัง	baŋ
บังคับ	baŋkhap
บัด	bat
บัดนี้	batni:
บัดหนิ	batni
บันจุ	banju
บันชี	banchi:
บันญากาด	banya:ga:t
บันทัด	banthat
บันทุก	banthuk
บันเทา	banthao
บันได	bandai
บัว	bu:a
บาง	ba:ŋ
บางสิ่งบางอย่าง	ba:ŋsiŋba:ŋya:ŋ
บาด	ba:t
บาท	ba:t
บาน	ba:n
บิน	bin
บินทะบาด	binthaba:t
บีบ	bi:p
บึ่ด	bʉt
บืน	bʉ:n
บุ	bu
บูชา	bu:cha:
บูด	bu:t
บ่	bɔ:
บ่ค่อย	bɔ:khɔ:i
บ่งบอก	boŋbɔ:k
บ่ทันได้	bɔ:thandai
บ่อน	bɔn
บ่ฮู้อีโหน้อีเหน้	bɔ:hu:i:no:i:ne:
บ่า	ba:
บ่าด	ba:t
บ่าย	ba:i
บ่าไหล่	ba:lai
บ่แม่น	bɔ:mɛ:n
บ้า	ba:
บ้าน	ba:n
บ้านนอก	ba:nnɔ:k
บ้านเมียง	ba:nmi:aŋ
บ้านเลียน	ba:nli:an
ปก	pok
ปกกะติ	pokgati
ปน	pon
ปวด	pu:at
ปอก	pɔ:k
ปอดพัย	pɔ:tphai
ปอบ	pɔ:p
ปะ	pa
ปะชาชน	pacha:chon
ปะดับ	padap
ปะติทิน	patithin
ปะติเสด	patise:t
ปะตู	patu:
ปะมาน	pama:n
ปะลินญาเอก	palinɲa:e:k
ปะลินญาโท	palinɲa:tho:
ปะลิมาน	palima:n
ปะสา	pasa:
ปะเทด	pathet
ปะเลียน	pali:an
ปะโยก	payo:k
ปะโยด	payo:t
ปะโล่งโป่งเป่ง	palo:ŋpo:ŋpe:ŋ
ปัดจุบัน	patjuban
ปัดโท	pattho:
ปับ	pap
ปั่ก	pak
ปั่น	pan
ปั้ม	pam
ปา	pa:
ปาก	pa:k
ปากกา	pa:kga:
ปากกืก	pa:kgʉ:k
ปากด	pa:got
ปากดี	pa:kdi:
ปากเป็น	pa:kpen
ปาด	pa:t
ปาตี้	pa:ti:
ปานนั้น	pa:nnan
ปานใด	pa:ndai
ปาย	pa:i
ปายทาง	pa:itha:ŋ
ปาแดก	pa:dɛ:k
ปิด	pit
ปิดบัง	pitbaŋ
ปิว	piu
ปี	pi:
ปีก	pi:k
ปีน	pi:n
ปี้ๆ	pi:pi:
ปึก	pʉk
ปึกสา	pʉksa:
ปึ่กซึก	pʉksʉk
ปึ่บ	pʉp
ปืน	bʉ:n
ปุก	puk
ปุง	puŋ
ปุย	pui
ปุ่ม	pum
ปู	pu:
ปูก	pu:k
ปูน	pu:n
ป่วย	pu:ai
ป่อง	pɔŋ
ป่อน	pɔn
ป่อย	pɔ:i
ป่า	pa:
ป่าไม้	pa:mai
ป้องกัน	pɔŋgan
ป้อน	pɔ:n
ป้า	pa:
ป้าย	pa:i
ป๊าด	pa:t
ผง	phoŋ
ผงชูลด	phoŋchu:lot
ผงสะหัว	phoŋsahu:a
ผนผะหลิด	phonphalit
ผนละไม้	phonlamai
ผม	phom
ผะหลิด	phalit
ผัก	phak
ผักกะเสด	phakgase:t
ผักกาดขาว	phakga:tkha:o
ผักบุ้ง	phakbuŋ
ผักอี่เสด	phaki:se:t
ผัด	phat
ผัว	phu:a
ผาย	pha:i
ผิดกดหมาย	phitgotma:i
ผิดใจ	phitjai
ผิว	piu
ผิวหนัง	phiunaŋ
ผืน	phʉ:n
ผูก	phu:k
ผ่า	pha:
ผ่าน	pha:n
ผ้า	pha:
ผ้าขนหนู	pha:khonnu:
ผ้าปูโต่ะ	pha:pu:to
ผ้าม้าน	pha:ma:n
ผ้าห่ม	pha:hom
ผ้าเซ็ดโต	pha:setto:
ฝน	fon
ฝะลั่ง	falaŋ
ฝักบัว	fakbu:a
ฝัน	fan
ฝั่ง	faŋ
ฝา	fa:
ฝาก	fa:k
ฝาน	fa:n
ฝาผะหนัง	fa:pha:naŋ
ฝิงไฟ	fiŋfai
ฝ่าตีน	fa:ti:n
ฝ่าย	fa:i
พกพา	phokpha:
พวก	phu:ak
พวงมาลัย	phu:aŋma:lai
พวน	phu:an
พอ	phɔ:
พอดี	phɔ:di:
พอน	phɔ:n
พอปะมาน	phɔ:pama:n
พอสมควน	phɔ:somkhu:an
พอใจ	phɔ:jai
พะ	pha
พะทัม	phatham
พะทาด	phatha:t
พะนม	phanom
พะนักงาน	phanakŋa:n
พะพุดทะลูบ	phaphutthalu:p
พะพุดทะเจ้า	phaphutthajao
พะม่า	phama:
พะยาบาน	phaya:ba:n
พะละกำลัง	phalagamlaŋ
พะลัง	phalaŋ
พะลังงาน	phalaŋŋa:n
พะสะติก	phasatik
พะอาทิด	phaa:thit
พะเอก	phae:k
พัก	phak
พัง	phaŋ
พัด	phat
พัดลม	phatlom
พัน	phan
พับ	phap
พับเพียบ	phapphi:ap
พัย	phai
พั้ว	phu:a
พา	pha:
พาก	pha:k
พาชะนะ	pha:chana
พาบ	pha:p
พาบถ่าย	pha:ptha:i
พาบวาด	pha:pwa:t
พาย	pha:i
พาสา	pha:sa:
พาหะนะ	pha:hana
พาเข้า	pha:khao
พิดสุนักบ้า	phitsunakba:
พิม	phim
พี่ซาย	phi:sa:i
พี่สาว	phi:sa:o
พี้	phi:
พึสะจิกาย๊น	phʉsajiga:yon
พึสะพาคม	phʉsapha:khom
พืด	phʉ:t
พื้น	phʉ:n
พื้นดิน	phʉ:ndin
พื้นที้	phʉ:nthi:
พุ	phu
พุข้า	phukha:
พุซาย	phusa:i
พุบ่าว	phuba:o
พุป่วย	phupu:ai
พุล้าย	phula:i
พุสาว	phusa:o
พุหญิง	phuɲiŋ
พุเดียว	phudi:ao
พุเถ้า	phuthao
พุโดยสาน	phudo:isa:n
พุโถ	phutho:
พุใด	phudai
พุใหญ่	phuɲai
พุใหญ่บ้าน	phuɲaiba:n
พุ้น	phun
พุ้นหนะ	phunna
พุ้นหละ	phunla
พุ้นแหล้ว	phunlɛ:o
พู	phu:
พูมถาน	phu:mtha:n
พูมิพาก	phu:mipha:k
พูมใจ	phu:mjai
พูเขา	phu:khao
พ่อ	phɔ:
พ่อค้า	phɔ:kha:
พ่อใหญ่	phɔ:ɲai
พ้อ	phɔ:
พ้อม	phɔ:m
พ้อมกัน	phɔ:mgan
พ้อมเพียง	phɔ:mphi:aŋ
ฟอง	fɔ:ŋ
ฟองน้ำ	fɔ:ŋna:m
ฟัง	faŋ
ฟัน	fan
ฟิสิก	fisik
ฟิ่ว	fiu
ฟืน	fʉ:n
ฟุดบาด	futba:t
ฟู	fu:
ฟ้ง	foŋ
ฟ้า	fa:
ฟ้าผ่า	fa:pha:
ฟ้าว	fa:o
มกกะลาคม	mokgala:khom
มวนอากาด	mu:ana:ga:t
มอ	mɔ:
มอบ	mɔ:p
มอเตอไซ	mɔ:tə:sai
มะละกอ	malagɔ:
มะเล็ด	malet
มะเล็ดพัน	maletphan
มะโล่งโจ่งเจ่ง	malo:ŋjo:ŋje:ŋ
มัก	mak
มัด	mat
มัน	man
มัว	mu:a
มั่วซั่ว	mu:asu:a
มา	ma:
มากกว่า	ma:kgwa:
มากมาย	ma:kma:i
มาละย้าด	ma:laya:t
มิด	mit
มิดซิด	mitsit
มิถุนาย๊น	mithuna:yon
มี	mi:
มีด	mi:t
มีดโกน	mi:tgo:n
มีดโกนหนวด	mi:tgo:nnu:at
มีนา	mi:na:
มีนาคม	mi:na:khom
มีแฮง	mi:hɛ:ŋ
มึง	mʉŋ
มึน	mʉn
มืด	mʉ:t
มืน	mʉ:n
มือ	mʉ:
มื้อ	mʉ:
มื้อก่อน	mʉ:gɔ:n
มื้อคืน	mʉ:khʉ:n
มื้อนี้	mʉ:ni:
มื้อวาน	mʉ:wa:n
มื้อหลัง	mʉ:laŋ
มื้ออื่น	mʉ:ʉ:n
มื้อฮือ	mʉ:hʉ:
มื้อเซ้า	mʉ:sao
มื้อเว็น	mʉ:wen
มื้อแก้ง	mʉ:gɛ:ŋ
มื้อแลง	mʉ:lɛ:ŋ
มุง	muŋ
มุด	mut
มุม	mum
มุ่น	mun
ม่น	mon
ม่วน	mu:an
ม่ำ	mam
ม้า	ma:
ยอก	yɔ:k
ยัง	yaŋ
ยา	ya:
ยาง	ya:ŋ
ยาดโย๊ม	ya:tyo:m
ยานพาหะนะ	ya:npha:hana
ยาสีฟัน	ya:si:fan
ยินดี	yindi:
ยิ้ม	yim
ยี่ห้อ	yi:hɔ:
ยี้บ	yi:p
ยี้สิบ	yi:sip
ยี้ฮ้อ	yi:hɔ:
ยืน	yʉ:n
ยื่น	yʉ:n
ย่อน	yɔn
ย้าง	ya:ŋ
ย้าน	ya:n
ย๊น	yon
ลง	loŋ
ลงทุน	loŋthun
ลด	lot
ลดกะบะ	lotgaba
ลดขนของ	lotkhonkhɔ:ŋ
ลดซาด	lotsa:t
ลดตุ่กตุ่ก	lottuktuk
ลดตู้	lottu:
ลดบันทุก	lotbanthuk
ลดบั่ด	lotbat
ลดปะจำทาง	lotpajamtha:ŋ
ลดพิกอั่บ	lotphikap
ลดยน	lotyon
ลดลับส่ง	lotlapsoŋ
ลดสามล้อ	lotsa:mlɔ:
ลดสิบล้อ	lotsiplɔ:
ลดเก็ง	lotgeŋ
ลดเข็น	lotkhen
ลดเม	lotme:
ลดแท็กซี้	lotthɛksi:
ลดโลงบาน	lotlo:ŋba:n
ลดโลงพะยาบาน	lotlo:ŋphaya:ba:n
ลดไถ	lotthai
ลดไฟ	lotfai
ลบ	lop
ลม	lom
ลวก	lu:ak
ลวดลาย	lu:atla:i
ลวม	lu:am
ลวย	lu:ai
ลอง	lɔ:ŋ
ลองเท้าผ้าใบ	lɔ:ŋthaopha:bai
ลอด	lɔ:t
ลอบ	lɔ:p
ลอย	lɔ:i
ละ	la
ละคอน	lakhɔ:n
ละงับ	laŋap
ละบาย	laba:i
ละยะ	laya
ละลาย	lala:i
ละวัง	lawaŋ
ละว่าง	lawa:ŋ
ละเกะละกะ	lagelaga
ละเบียง	labi:aŋ
ละเบียบ	labi:ap
ละเหย	lahə:i
ละเหล้น	lalen
ละแวก	lawɛ:k
ลัก	lak
ลักสะนะ	laksana
ลักสา	laksa:
ลัง	laŋ
ลับ	lap
ลับจ้าง	lapja:ŋ
ลับลู้	laplu:
ลับส่ง	lapsoŋ
ลาก	la:k
ลาคา	la:kha:
ลาง	la:ŋ
ลาด	la:t
ลาน	la:n
ลายกาน	la:iga:n
ลายได้	la:idai
ลาว	la:o
ลาวๆ	la:ola:o
ลำ	lam
ลำคาน	lamkha:n
ลำต้น	lamton
ลำโต	lamto:
ลำโพง	lampho:ŋ
ลำไย	lamyai
ลำไส้	lamsai
ลิง	liŋ
ลิน	lin
ลิบบิ้น	lipbin
ลิ้น	lin
ลิ้นชัก	linchak
ลีโหมด	li:mo:t
ลีไซเคิน	li:saikən
ลี้	li:
ลึก	lʉk
ลึดู	lʉdu:
ลึดูฝน	lʉdu:fon
ลึดูฮ้อน	lʉdu:hɔ:n
ลึดูแล้ง	lʉdu:lɛ:ŋ
ลืม	lʉ:m
ลุก	luk
ลุง	luŋ
ลุน	lun
ลุล่วง	lulu:aŋ
ลุ้น	lun
ลูก	lu:k
ลูกกก	lu:kgok
ลูกค้า	lu:kkha:
ลูกซาย	lu:ksa:i
ลูกซิ้น	lu:ksin
ลูกบอน	lu:kbɔ:n
ลูกสอน	lu:ksɔ:n
ลูกสาว	lu:ksa:o
ลูกหวีด	lu:kwi:t
ลูบ	lu:p
ลูบพาบ	lu:pphap
ลูบพาบถ่าย	lu:ppha:ptha:i
ลูบลัก	lu:plak
ลูบแบบ	lu:pbɛ:p
ลู้	lu:
ลู้จัก	lu:jak
ลู้สึก	lu:sʉk
ล็อก	lɔk
ล่วมกัน	lu:amgan
ล้น	lon
ล้อ	lɔ:
ล้อง	lɔ:ŋ
ล้อม	lɔ:m
ล้อมลอบ	lɔ:mlɔ:p
ล้อย	lɔ:i
ล้า	la:
ล้าง	la:ŋ
ล้างกาย	la:ŋga:i
ล้าน	la:n
ล้านขายของ	la:nkha:ikhɔ:ŋ
ล้านตัดผม	la:ntatphom
ล้านอาหาน	la:na:ha:n
ล้านแนวกิน	la:nnɛ:ogin
ล้าย	la:i
วง	woŋ
วงกม	woŋgom
วงเล็บ	woŋlep
วะสั้น	wasan
วัด	wat
วัดทะนะทัม	watthanatham
วัน	wan
วันจัน	wanjan
วันพะ	wanpha
วันพะลึหัด	wanphalʉhat
วันพุด	wanphut
วันสุก	wansuk
วันอังคาน	wanaŋkha:n
วันอาทิด	wana:thit
วันเกิด	wangə:t
วันเสา	wansao
วัย	wai
วัยทอง	waithɔ:ŋ
วัยลุ้น	wailun
วั่งหั้น	waŋhan
วา	wa:
วาง	wa:ŋ
วาจา	wa:ja:
วาด	wa:t
วิชา	wicha:
วิดีโอ	widi:o:
วิทะยุ	withayu
วิที	withi:
วินาที	wina:thi:
ว่า	wa:
ว่าแต่	wa:tɛ:
ว้อ	wɔ:
ว้าง	wa:ŋ
สกกะปก	sokgapok
สงคาม	soŋkha:m
สงสัย	soŋsai
สด	sot
สดซื้น	sotsʉ:n
สดใส	sotsai
สนทะนา	sonthana:
สบ	sop
สมมุด	sommut
สวด	su:at
สวน	su:an
สวนสัด	su:ansat
สอก	sɔ:k
สอง	sɔ:ŋ
สอด	sɔ:t
สอน	sɔ:n
สอบ	sɔ:p
สะ	sa
สะดวก	sadu:ak
สะดุด	sadut
สะถานที่	satha:nti:
สะถานะกาน	satha:naga:n
สะถานี	satha:ni:
สะบาย	saba:i
สะบู	sabu:
สะพาน	sapha:n
สะพาย	sapha:i
สะมะแจะ	samajɛ
สะมาชิก	sama:chik
สะวิด	sawit
สะหนาม	sana:m
สะหนามกีลา	sana:mgi:la:
สะหนิด	sanit
สะหมอง	samɔ:ŋ
สะหมัย	samai
สะหมุด	samut
สะหมุนไพ	samunphai
สะหลิด	salid
สะหลึง	salʉŋ
สะหลุบ	salup
สะหวัดดี	sawatdi:
สะหว่าง	sawa:ŋ
สะหว้ายน้ำ	sawa:ina:m
สะออน	saɔ:n
สะอาด	saa:t
สะอาดหูสะอาดตา	saa:thu:saa:tta:
สะแดง	sadɛ:ŋ
สักสิด	saksit
สังสัน	saŋsan
สัด	sat
สัดเคิ่งบกเคิ่งน้ำ	satkhəŋbokkhəŋna:m
สัดเลี้ยง	satli:aŋ
สัน	san
สันญะลัก	sanɲalak
สันญาน	sanɲa:n
สันยะกัม	sanyagam
สับ	sap
สั่ง	saŋ
สั่น	san
สั้น	san
สาก	sa:k
สาด	sa:t
สาม	sa:m
สามสิบ	sa:msip
สามาด	sa:ma:t
สามเหลี่ยม	sa:mli:am
สามแย้ก	sa:myɛ:k
สาย	sa:i
สายไฟ	sa:ifai
สาละ	sa:la
สาละคะดี	sa:lakadi:
สาลา	sa:la:
สาลาวัด	sa:la:wat
สาสะนา	sa:sana:
สาสะนาพุด	sa:sana:phut
สำคัน	samkhan
สำลอง	samlɔ:ŋ
สำหลับ	samlap
สิ	si
สิงหาคม	siŋha:khom
สิบ	sip
สิ่ง	siŋ
สิ่งของ	siŋkhɔ:ŋ
สิ้น	sin
สี	si:
สีก	si:k
สีดยา	si:tya:
สีตับหมู	si:tapmu:
สีน	si:n
สีสัน	si:san
สีหน้า	si:na:
สีหน้าสีตา	si:na:si:ta:
สี่	si:
สี่สิบ	si:sip
สี่เหลี่ยม	si:li:am
สึกสา	sʉksa:
สึม	sʉm
สุก	suk
สุกขะพาบ	sukkhapha:p
สุข	suk
สุด	sut
สุดท้อง	sutthɔ:ŋ
สุบ	sup
สุพาบ	supha:p
สูง	su:ŋ
สูด	su:t
สูน	su:n
สูบ	su:p
สู่	su:
สู้	su:
ส่ง	soŋ
ส่วน	su:an
ส่วนปะกอบ	su:anpagɔ:p
ส่วนมาก	su:anma:k
ส่วนหน้อย	su:annɔ:i
ส่วนหลาย	su:anla:i
ส่วนโต	su:anto:
ส่อง	sɔŋ
ส่าย	sa:i
ส่ำ	sam
ส่ำนั้น	samnan
ส่ำนี้	samni:
ส้ง	soŋ
ส้น	son
ส้ม	som
ส้มตำ	somtam
ส้อม	sɔm
ส้อมแซม	sɔmsɛ:m
ส้อย	sɔ:i
ส้าง	sa:ŋ
หก	hok
หงอก	ŋɔ:k
หงอน	ŋɔ:n
หญอง	ɲɔŋ
หญัง	ɲaŋ
หญุ้ง	ɲuŋ
หญุ้งญาก	ɲuŋɲa:k
หญ้ม	ɲom
หญ้า	ɲa:
หนทาง	hontha:ŋ
หนวด	nu:at
หนอง	nɔ:ŋ
หนะ	na
หนัก	nak
หนัง	naŋ
หนังสือ	naŋsʉ:
หนังสือพิม	naŋsʉ:phim
หนั้น	nan
หนั้นหละ	nanla
หนา	na:
หนาว	na:o
หนิ	ni
หนิหละ	nila
หนี	ni:
หนีบ	ni:p
หนี้	ni:
หนึ่ง	nʉŋ
หนุ่ม	num
หน่อย	nɔ:i
หน่อยหนึ่ง	nɔ:inʉŋ
หน่อยเดียว	nɔ:idi:ao
หน้อย	nɔ:i
หน้า	na:
หน้าจอ	na:jɔ:
หน้าจะ	na:ja
หน้าตา	na:ta:
หน้าต่าง	na:ta:ŋ
หน้าที่	na:thi:
หน้าผาก	na:pha:k
หน้าฝน	na:fon
หน้าหนาว	na:na:o
หน้าฮ้อน	na:hɔ:n
หน้าเอิก	na:ək
หน้าแล้ง	na:lɛ:ŋ
หมวก	mu:ak
หมวกกันน็อก	mu:akgannɔk
หมอ	mɔ:
หมอง	mɔ:ŋ
หมอน	mɔ:n
หมอฟัน	mɔ:fan
หมั้น	man
หมั้นใจ	manjai
หมา	ma:
หมากไม้	ma:kmai
หมาด	ma:t
หมายความ	ma:ikhwa:m
หมายถึง	ma:ithʉŋ
หมื่น	mʉ:n
หมุน	mun
หมู	mu:
หมู่	mu:
หมู่บ้าน	mu:ba:n
หม้น	mon
หม้อ	mɔ:
หม้อง	mɔŋ
หยาบ	ya:p
หยิบ	yip
หยุด	yut
หลก	lok
หลงเหลีย	loŋli:a
หลบ	lop
หลบซ้อน	lopsɔn
หลอด	lɔ:t
หละ	la
หลัก	lak
หลักอากาด	laka:ga:t
หลัง	laŋ
หลังกะสี	laŋgasi:
หลังคา	laŋka:
หลังจาก	laŋja:k
หลับ	lap
หลาน	la:n
หลาย	la:i
หลายสิ่งหลายอย่าง	la:isiŋla:iya:ŋ
หลายเติบ	la:itə:p
หลือ	lʉ:
หลุด	lut
หลุดมือ	lutmʉ:
หลุม	lum
หล่น	lon
หล่อ	lɔ:
หล่อเลี้ยง	lɔ:li:aŋ
หล้า	la:
หวอ	wɔ:
หวัดดี	watdi:
หวาน	wa:n
หวี	wi:
หว่าน	wa:n
หว้าย	wa:i
หว้ายน้ำ	wa:ina:m
หอ	hɔ:
หอบ	hɔ:p
หอม	hɔ:m
หอมหัวแดง	hɔ:mhu:adɛ:ŋ
หอั้น	an
หัก	hak
หัน	han
หันใจ	hanjai
หัว	hu:a
หัวขวัน	hu:akwan
หัวล้อ	hu:alɔ:
หัวหน้า	hu:ana:
หัวหอม	hu:ahɔ:m
หัวเข่า	hu:akhao
หัวเตอะหัวเติน	hu:atəhu:atə:n
หัวใจ	hu:ajai
หั่น	han
หั้น	han
หา	ha:
หาง	ha:ŋ
หาย	ha:i
หายใจ	ha:ijai
หิน	hin
หิว	hiu
หิ้ว	hiu
หุ่น	hun
หุ้ม	hum
หู	hu:
หูจับ	hu:jap
หูฟัง	hu:faŋ
หูหนวก	hu:nu:ak
ห่ม	hom
ห่อ	hɔ:
ห่าง	ha:ŋ
ห้อง	hɔŋ
ห้องนอน	hɔŋnɔ:n
ห้องน้ำ	hɔŋna:m
ห้องสะหมุด	hɔŋsamut
ห้องเลียน	hɔŋli:an
ห้อย	hɔ:i
ห้า	ha:
ห้าง	ha:ŋ
ห้าสิบ	ha:sip
อก	ok
อง	oŋ
องสา	oŋsa:
อบอุ่น	opun
อยาก	ya:k
อยากหัว	ya:khu:a
อยู่	yu:
อย่า	ya:
อย่าง	ya:ŋ
อย่างหลาย	ya:ŋla:i
อย่างเซ้น	ya:ŋsen
อย่างเดียว	ya:ŋdi:ao
ออก	ɔ:k
ออกกำลังกาย	ɔ:kgamlaŋga:i
ออนสอน	ɔ:nsɔ:n
อะดีด	adi:t
อะทิดถาน	athittha:n
อะทิบาย	athiba:i
อะนาคด	ana:khot
อะพิทัม	aphitham
อะวัยยะวะ	awaiyawa
อักสน	aksɔ:n
อังกิด	aŋgit
อัด	at
อัน	an
อันตะลาย	antala:i
อันแต่ว่า	antɛ:wa:
อับ	ap
อา	a:
อากาด	a:ga:t
อากาน	a:ga:n
อาจาน	a:ja:n
อาซีบ	a:si:p
อาด	a:t
อาดจะ	a:tja
อาทิ	a:thi
อาทิด	a:thit
อาบ	a:p
อาบน้ำ	a:pna:m
อายุ	a:yu
อาลม	a:lom
อาวุโส	a:wuso:
อาสัย	a:sai
อาหาน	a:ha:n
อำเพอ	amphə:
อิด	it
อิ่จิ่หนึ่ง	ijinʉŋ
อิ่ม	im
อีก	i:k
อี่ปู	i:pu:
อี่สาน	i:sa:n
อี่หยัง	i:yaŋ
อี่หลี	i:li:
อี่หลีอี่หลอ	i:li:i:lɔ:
อี่หล้า	i:la:
อี่เกิ้ง	i:gə:ŋ
อี่แม่	i:mɛ:
อึ้งตึ้ง	ʉŋtʉŋ
อึ้มคึ้ม	ʉmkhʉm
อื่น	ʉ:n
อุดมสมบูน	udomsombu:n
อุบะติเหด	ubatihe:t
อุปะกอน	upagɔ:n
อุ่น	un
อุ้ม	um
อุ้ย	ui
อุ้ยปุ้ย	uipui
อ่มๆ	om
อ่วย	u:ai
อ่องต่อง	ɔŋtɔŋ
อ่อน	ɔ:n
อ่าง	a:ŋ
อ่างล้างหน้า	a:ŋla:ŋna:
อ่าน	a:n
อ่ามล่าม	a:mla:m
อ้วน	u:an
อ้อม	ɔ:m
อ้อยต้อย	ɔ:itɔ:i
อ้า	a:
อ้าย	a:i
ฮวมกัน	hu:amgan
ฮอง	hɔ:ŋ
ฮอด	hɔ:t
ฮอย	hɔ:i
ฮัก	hak
ฮับ	hap
ฮั่ว	hu:a
ฮั้ว	hu:a
ฮาก	ha:k
ฮาน	ha:n
ฮาว	ha:o
ฮำ	ham
ฮึ	hʉ
ฮึ่มๆ	hʉm
ฮุ	hu
ฮุ่ง	huŋ
ฮูด	hu:t
ฮู้	hu:
ฮู้จัก	hu:jak
ฮู้สึก	hu:sʉk
ฮู้สึกโต	hu:sʉkto:
ฮ่ม	hom
ฮ่อน	hɔn
ฮ้อง	hɔ:ŋ
ฮ้องไห้	hɔ:ŋhai
ฮ้อน	hɔ:n
ฮ้าง	ha:ŋ
ฮ้าน	ha:n
ฮ้าย	ha:i
เก	ge:
เกม	ge:m
เกสอน	ge:sɔ:n
เกะกะ	gega
เกาะ	gɔ
เกิด	gə:t
เกิน	gə:n
เกินเหด	gə:nhe:t
เกิบ	gə:p
เกิบคีบ	gə:pkhi:p
เกิบผ้าใบ	gə:ppha:bai
เกิบแตะ	gə:ptɛ
เกิบโบก	gə:pbo:k
เกีย	gi:a
เกียก	gi:ak
เกียบ	gi:ap
เกี่ยว	gi:ao
เกี่ยวกับ	gi:aogap
เกี้ยง	gi:aŋ
เกี้ยงมิ่นลิ่น	gi:aŋminlin
เกี้ยงเกา	gi:aŋgao
เก็ด	get
เก็บ	gep
เก่ง	geŋ
เก่ด	get
เก่า	gao
เก้า	gao
เก้าอี้	gaoi:
เขา	khao
เขียน	khi:an
เขียว	khi:ao
เข็ม	khem
เข่า	khao
เข้ง	kheŋ
เข้ม	khem
เข้า	khao
เข้างาย	khaoŋa:i
เข้าสวย	khaosu:ai
เข้าสาน	khaosa:n
เข้าเจ้า	khaojao
เข้าเซ้า	khaosao
เข้าแลง	khaolɛ:ŋ
เคย	khə:i
เคา	khao
เคาลบ	khaolop
เคาเต้อ	khaotə:
เคิ่ง	khəŋ
เคียง	khi:aŋ
เคียด	khi:at
เคี่ยง	khi:aŋ
เคี่ยงคิดเลข	khi:aŋkitle:k
เคี่ยงญก	khi:aŋɲok
เคี่ยงบิน	khi:aŋbin
เคี่ยงปุง	khi:aŋpuŋ
เคี่ยงสำอาง	khi:aŋsama:ŋ
เคี้ยงหมาย	khi:aŋma:i
เคื้อนที้	khʉ:anthi:
เค็ม	khem
เค่งเคียด	kheŋkhi:at
เงิน	ŋən
เงินสด	ŋənsot
เจดี	je:di:
เจ็ด	jet
เจ็บ	jep
เจ้า	jao
เจ้าของ	jaokhɔ:ŋ
เช็ค	chek
เซา	sao
เซียก	si:ak
เซี้ยม	si:am
เซี้ยวซาน	si:aosa:n
เซี้ยโลก	si:alo:k
เซื้อเพิง	sʉ:aphə:ŋ
เซเว้น	se:wen
เซ็ก	sek
เซ็ด	set
เซ้น	sen
เซ้า	sao
เญียง	?
เญี่ย	ɲi:a
เญี่ยว	ɲi:ao
เญ็บ	ɲep
เดา	dao
เดินทาง	də:ntha:ŋ
เดิ่น	də:n
เดียน	di:an
เดียว	di:ao
เดียวกัน	di:aogan
เด็ก	dek
เด็กน้อย	deknɔ:i
เด็กเสิบ	deksə:p
เด่	de:
เด่ะ	de
เด้อ	də:
เด๊	de:
เตะ	te
เตา	tao
เติบ	tə:p
เติม	tə:m
เตียง	ti:aŋ
เตียม	ti:am
เตี้ย	ti:a
เตือน	tʉ:an
เตือนสะติ	tʉ:ansati
เต็น	ten
เต็ม	tem
เต็มปี้ลี้	tempi:li:
เต่า	tao
เต้น	ten
เถียง	thi:aŋ
เถ้า	thao
เท	the:
เทา	thao
เทิง	thə:ŋ
เทิงเบิด	thə:ŋbət
เทียน	thi:an
เที่ย	thi:a
เที่ยง	thi:aŋ
เที่ยงคืน	thi:aŋkhʉ:n
เที่ยว	thi:ao
เท่า	thao
เท่านั้น	thaonan
เท่านี้	thaoni:
เท่าใด	thaodai
เนาะ	nɔ
เนิน	nə:n
เนินเขา	nə:nkhao
เนี้ย	ni:a
เนี้ยง	ni:aŋ
เนื้อหา	nʉ:aha:
เน่า	nao
เบก	be:k
เบา	bao
เบาหวาน	baowa:n
เบาะ	bɔ
เบาะนั่ง	bɔnaŋ
เบิด	bə:t
เบิด	bət
เบิดมื้อเบิดค่ำ	bətmʉ:bətkham
เบิ่ง	bəŋ
เบิ่งแญง	bəŋɲɛ:ŋ
เบิ้น	bən
เบีย	bi:a
เป	pe:
เปวไฟ	pe:ofai
เปิด	pə:t
เปียก	pi:ak
เปียง	pi:aŋ
เปียบเทียบ	pi:apthi:ap
เปี่ยง	pi:aŋ
เปี่ยน	pi:an
เปี่ยย	pi:ai
เปี้ยน	pi:an
เปี้ยว	pi:ao
เป็ด	pet
เป็น	pen
เป็นที่เป็นทาง	penthi:pentha:ŋ
เป่ง	peŋ
เป่า	pao
เป้าหมาย	paoma:i
เผา	phao
เผี้ย	phi:a
เผ็ด	phet
เฝ้า	fao
เพ	phe:
เพง	phe:ŋ
เพงซาด	phe:ŋsa:t
เพดาน	phe:da:n
เพน	phe:n
เพาะว่า	phɔwa:
เพาะสะนั้นแล้ว	phɔsananlɛ:o
เพิง	phə:ŋ
เพิดเพิน	phə:tphə:n
เพิ่น	phən
เพิ้ม	phə:m
เพีย	phi:a
เพียง	phi:aŋ
เพี่ย	phi:a
เพื่อ	phʉ:a
เพื่อที่	phʉ:athi:
เพ็ด	phet
เฟอนิเจอ	fə:nijə:
เฟียง	fi:aŋ
เมสา	me:sa:
เมสาย๊น	me:sa:yon
เมา	mao
เมีย	mi:a
เมียง	mi:aŋ
เมียงหลวง	mi:aŋlu:aŋ
เมี่ยย	mi:ai
เมี้ยน	mi:an
เม็ด	met
เม็ดพัน	metphan
เม้ม	mem
เย็น	yen
เลข	le:k
เลน	le:n
เลย	lə:i
เลว	le:o
เลาะ	lɔ
เลิก	lə:k
เลิ้ม	lə:m
เลีย	li:a
เลียก	li:ak
เลียง	li:aŋ
เลียด	li:at
เลียน	li:an
เลียบ	li:ap
เลียบล้อย	li:aplɔ:i
เลี่ยง	li:aŋ
เลี้ยง	li:aŋ
เลี้ยน	li:an
เลี้ยยๆ	li:ai
เล็ก	lek
เล็บ	lep
เล็บตีน	lepti:n
เล็ว	leo
เวลา	we:la:
เวียดนาม	vi:atna:m
เว้า	wao
เว้าพื้น	waophʉ:n
เสด	se:t
เสย	sə:i
เสา	sao
เสิบ	sə:p
เสิมสวย	sə:msu:ai
เสีย	si:a
เสียง	si:aŋ
เสียงดัง	si:aŋdaŋ
เสียบ	si:ap
เสียหลัก	si:alak
เสียหาย	si:aha:i
เสียใจ	si:ajai
เสี่ยง	si:aŋ
เสี้ย	si:a
เสี้ยผ้า	si:apha:
เสี้ยยื้ด	si:ayʉ:t
เสี้ยว	si:ao
เสี้ยเกาะอก	si:agɔok
เส็ด	set
เส้น	sen
เส้า	sao
เหงียก	ŋi:ak
เหงี่ย	ŋi:a
เหด	he:t
เหดกาน	he:tga:n
เหดผน	he:tphon
เหดล้าย	he:tla:i
เหน้ก	nek
เหมาะสม	mɔsom
เหมิกเถิก	mə:kthə:k
เหม็น	men
เหม้	me:
เหยียด	yi:at
เหยียบ	yi:ap
เหลว	le:o
เหลีย	li:a
เหลียง	li:aŋ
เหลียน	li:an
เหลียว	li:ao
เหลี่ยม	li:am
เหล็ก	lek
เหล้น	len
เหล้ม	lem
เหล้า	lao
เหี่ย	hi:a
เห็น	hen
เห่า	hao
เอง	e:ŋ
เอทีเอ็ม	e:thi:em
เอน	e:n
เออ	ə:
เอา	ao
เอาโลด	aolo:t
เอิก	ək
เอิ้น	ə:n
เอี่ยม	i:am
เอื้อย	ʉ:ai
เอเซีย	e:si:a
เอ็ด	et
เอ่ย	ə:i
เอ่าะเจ่าะ	ɔjɔ
เอ่าะเญาะ	ɔɲɔ
เอ้ม	em
เอ้ย	ə:i
เอ้อเฮ้อ	ə:hə:
เอ๊า	ao
เฮา	hao
เฮียง	hi:aŋ
เฮียน	hi:an
เฮ็ด	het
เฮ็ดกานเฮ็ดงาน	hetga:nhetŋa:n
เฮ็ดงาน	hetŋa:n
เฮ็ดนา	hetna:
เฮ็ดบุน	hetbun
เฮ็ดไฮ่	hethai
เฮ้ย	hə:i
แก	gɛ:
แกง	gɛ:ŋ
แกะ	gɛ
แก่	gɛ:
แก่งจ่างป่าง	gɛŋja:ŋpa:ŋ
แก้	gɛ:
แก้ง	gɛ:ŋ
แก้ม	gɛ:m
แก้ว	gɛ:o
แขน	khɛ:n
แข็ง	khɛŋ
แข็งแลง	khɛŋlɛ:ŋ
แข่ง	khɛŋ
แข้ว	khɛ:o
แค่	khɛ:
แจ้ง	jɛ:ŋ
แชะ	chɛ
แซง	sɛ:ŋ
แซบ	sɛ:p
แซม	sɛ:m
แซมพู	sɛ:mphu:
แซ่	sɛ:
แซ่แข็ง	sɛ:khɛŋ
แญง	ɲɛ:ŋ
แดง	dɛ:ŋ
แดด	dɛ:t
แตก	tɛ:k
แตกต่าง	tɛ:kta:ŋ
แตงโม	tɛ:ŋmo:
แต่	tɛ:
แต่กี้	tɛ:gi:
แต่ง	tɛŋ
แต่งงาน	tɛŋŋa:n
แต่งโต	tɛŋto:
แต่ละ	tɛ:la
แต่ว่า	tɛ:wa:
แต่ใส	tɛ:sai
แถว	thɛ:o
แถะ	thɛ
แทน	thɛ:n
แท่ง	thɛŋ
แท้	thɛ:
แนบ	nɛ:p
แนม	nɛ:m
แนมเบิ่ง	nɛ:mbəŋ
แนว	nɛ:o
แนวกิน	nɛ:ogin
แนวขั้น	nɛ:okhan
แนวค้อง	nɛ:okhɔ:ŋ
แนวญก	nɛ:oɲok
แนวบำลุง	nɛ:obamluŋ
แนวบิด	nɛ:obit
แนวมัก	nɛ:omak
แนวหนีบ	nɛ:oni:p
แนวโกนหนวด	nɛ:ogo:nnu:at
แนวใส่	nɛ:osai
แนะนำ	nɛnam
แน่	nɛ:
แน่ใจ	nɛ:jai
แบก	bɛ:k
แบน	bɛ:n
แบนเนม	bɛ:nne:m
แบบ	bɛ:p
แบ็ด	bɛt
แบ็ดเตอลี้	bɛttə:li:
แบ็น	bɛn
แบ้ง	bɛŋ
แป	pɛ:
แปง	pɛ:ŋ
แปงสีฟัน	pɛ:ŋsi:fan
แปด	pɛ:t
แปน	pɛ:n
แป่บเดียว	pɛpdi:ao
แป้นพิม	pɛ:nphim
แผ	phɛ:
แผนที่	phɛ:nthi:
แผนผัง	phɛ:nphaŋ
แผ่น	phɛn
แพง	phɛ:ŋ
แฟน	fɛ:n
แฟบ	fɛ:p
แมง	mɛ:ŋ
แมงวัน	mɛ:ŋwan
แมงหวี่	mɛ:ŋwi:
แมว	mɛ:o
แม่	mɛ:
แม่ค้า	mɛ:kha:
แม่ซี	mɛ:si:
แม่น	mɛ:n
แม่นบ่	mɛ:nbɔ:
แม่น้ำ	mɛ:na:m
แม่บ้าน	mɛ:ba:n
แม่หญิง	mɛ:ɲiŋ
แย้ก	yɛ:k
แลก	lɛ:k
แลง	lɛ:ŋ
แลบลิ้น	lɛ:plin
และ	lɛ
แล่น	lɛ:n
แล้ว	lɛ:o
แล้วแต่	lɛ:otɛ:
แว่นตา	wɛnta:
แสง	sɛ:ŋ
แหน้น	nɛn
แหลก	lɛ:k
แหลม	lɛ:m
แหล้ว	lɛ:o
แหวน	wɛ:n
แหวว	wɛ:o
แห่ง	hɛŋ
แห้ง	hɛ:ŋ
แห้งแล้ง	hɛ:ŋlɛ:ŋ
แห้น	hɛ:n
แอ	ɛ:
แออัด	ɛ:at
แอ็นกอฮอ	ɛngɔ:hɔ:
แอ็ปเปิ้น	ɛppən
แฮง	hɛ:ŋ
โกน	go:n
โก่งโด่ง	go:ŋdo:ŋ
โคก	kho:k
โค้ง	kho:ŋ
โจก	jo:k
โจน	jo:n
โจ่งโป่ง	jo:ŋpo:ŋ
โจ่โล่	jo:lo:
โจ้กๆ	jo:k
โจ้น	jo:n
โซ	so:
โซกดี	so:kdi:
โซฟา	so:fa:
โซ้	so:
โญก	ɲo:k
โญน	ɲo:n
โดด	do:t
โดน	do:n
โดยสาน	do:isa:n
โด่งดัง	do:ŋdaŋ
โต	to:
โตหนังสือ	to:naŋsʉ:
โตอย่าง	to:ya:ŋ
โต่ง	to:ŋ
โต่ะ	to
โถส้วม	tho:su:am
โถแก้ว	tho:gɛ:o
โท	tho:
โทน	tho:n
โทละทัด	tholathat
โทละสับ	tholasap
โนน	no:n
โน่ดบุ่ก	no:tbuk
โบก	bo:k
โบด	bo:t
โผ่	pho:
โพด	pho:t
โพดโพ	pho:tpho:
โมง	mo:ŋ
โมโห	mo:ho:
โล	lo:
โลก	lo:k
โลงบาน	lo:ŋba:n
โลงพะยาบาน	lo:ŋphaya:ba:n
โลงหนัง	lo:ŋnaŋ
โลงเลียน	lo:ŋli:an
โลตั่ด	lo:tat
โล่งโจ่ง	lo:ŋjo:ŋ
โล้ง	lo:ŋ
โล้น	lo:n
โอ	o:
โอกาด	o:ga:t
โอน	o:n
โอ่ง	o:ŋ
โอ่งโล่ง	o:ŋlo:ŋ
โอ๊ย	o:i
ใก้	gai
ใคแน่	khainɛ:
ใจ	jai
ใจกาง	jaiga:ŋ
ใจฮ้าย	jaiha:i
ใซ้	sai
ใซ้งาน	saiŋa:n
ใซ้ซีวิด	saisi:wit
ใด	dai
ใต้	tai
ใน	nai
ในเมียง	naimi:aŋ
ใบ	bai
ใบดอก	baidɔ:k
ใบหน้า	baina:
ใบเส็ด	baiset
ใบไม้	baimai
ใบ้	bai
ใผ	phai
ใส	sai
ใส่	sai
ใหญ่	ɲai
ใหม่	mai
ให้	hai
ไก	gai
ไก่	gai
ไขมัน	khaiman
ไข่	khai
ไข่ขาว	khaikha:o
ไข่ดาว	khaida:o
ไข่เจียว	khaiji:ao
ไข่แดง	khaidɛ:ŋ
ไข้เลือดออก	khailʉ:atɔ:k
ไง่	ŋai
ไซ	sai
ได้	dai
ได้ญิน	daiɲin
ได้ลับ	dailap
ได้ฮับ	daihap
ไต	tai
ไต้	tai
ไถ	thai
ไถฮุด	thaihut
ไทย	tha:i
ไบบ่าย	baiba:i
ไป	pai
ไป่	pai
ไพเลาะ	phailɔ
ไฟ	fai
ไฟฟ้า	faifa:
ไฟแซ็ก	faisɛk
ไม	ma:i
ไม้	mai
ไม้ขีด	maikhi:t
ไม้ไผ่	maiphai
ไล่	lai
ไว	wai
ไว้	wai
ไว้ถ้า	waitha:
ไหน	nai
ไหม้	mai
ไหล	lai
ไหล่	lai
ไหล้	lai
ไหว	wai
ไหว้	wai
ไหว้พะ	waipha
ไอ	ai
ไอติม	aitim
ไอน้ำ	aina:m
ไฮ่	hai
