一下咬指甲	liam˨˦mi˥˥ka˧˧tsiŋ˥˧kaʔ˨
一下子	tsit˦kʰun˨˩a˥˧
一下拉拔頭髮	liam˨˦mi˥˥kʰiu˥˧tʰau˨˦tsaŋ˥˥
一二三	io˥˥dzi˧˧sã˥˥
一些借給我	tsit˦sut˨a˥˧tsioʔ˨gua˥˧
一人一個家庭，祖先牌位各自供奉；謂兄弟分家後，各管各的事，互不相干	tsit˦laŋ˨˦tsit˦ke˥˥tai,7koŋ˥˥ma˥˧sui˨˦laŋ˨˦tsʰai˧˧
一人要出一半	tsit˦laŋ˨˦ai˨˩tsʰut˨tsit˦pũã˨˩
一來我沒時間	it˨lai˨˦gua˥˧bo˨˦si˨˦kan˥˥
一個好老婆勝過三個老天爺保佑。比喻太太至上之意	tsit˦e˨˦bɔ˥˧kʰaʔ˨ho˥˧sã˥˥e˨˦tʰĩ˥˥koŋ˥˥tsɔ˥˧
一個月之內	tsit˦ko˨˩gueʔ˦lai˧˧
一個鼻子	tsit˦ki˥˥pʰĩ˧˧
一分錢	tsit˦hun˥˥tsĩ˨˦
一分錢	tsit˦sian˥˧tsĩ˨˦
一分鐘	tsit˦hun˥˥tsiŋ˥˥
一包米	tsit˦pau˥˥bi˥˧
一匹布	tsit˦pʰit˨pɔ˨˩
一千元	tsit˦tsʰiŋ˥˥kʰɔ˥˥
一升米	tsit˦tsin˥˥bi˥˧
一口井	tsit˦kʰau˥˧tsẽ˥˧
一句話	tsit˦ku˨˩ue˧˧
一台電視	tsit˦tai˨˦tian˧˧si˧˧
一向	it˨hioŋ˨˩
一天	tsit˦dzit˦
一家之主	it˨ka˥˥tsi˥˥tsu˥˧
一家人	tsit˦ke˥˥kʰau˥˧
一小步也行走不得，喻處境困窘	tsʰun˨˩pɔ˧˧lan˨˦hiŋ˨˦
一層土	tsit˦un˨˦tʰɔ˨˦
一年	tsit˦taŋ˥˥
一張嘴	tsit˦ki˥˥tsʰui˨˩
一戶	tsit˦kʰau˥˧tsau˨˩
一戶人家	tsit˦hɔ˧˧dzin˨˦ke˥˥
一打汽水	tsit˦tã˥˧kʰi˨˩tsui˥˧
一把劍	tsit˦kʰau˥˧kiam˨˩
一旁、一邊	tsit˦piŋ˨˦
一旦地震	it˨tan˨˩te˧˧taŋ˧˧
一本書	tsit˦pun˥˧tsʰeʔ˨
一朵花	tsit˦lui˥˧hue˥˥
一枝香蕉花所結的一長串香蕉	tsit˦kiŋ˥˥kiŋ˥˥tsio˥˥
一根香蕉	tsit˦dzi˥˧kiŋ˥˥tsio˥˥
一樣重	pẽ˨˦taŋ˧˧
一比五	it˨pi˥˧gɔ˧˧
一流	it˨liu˨˦
一片木板	tsit˦pʰĩ˨˩paŋ˥˥a˥˧
一片西瓜	tsit˦piŋ˨˦si˥˥kue˥˥
一生	it˨siŋ˥˥
一疊衛生紙	tsit˦tsi˥˧ue˧˧siŋ˥˥tsua˥˧
一直向前走過去	it˨tit˦hioŋ˨˩tsian˨˦kĩã˨˦
一知半解	pũã˨˩tsai˥˥pũã˨˩m˥˥tsai˥˥
一般人都很愛面子	it˨pũã˥˥laŋ˨˦loŋ˥˧tsin˥˥ai˨˩bin˧˧tsu˥˧
一般陰沉的人，平常多是默不作聲，一狠起來，就會狠咬一口	im˥˥tʰim˥˥im˥˥thim,1ka˧˧laŋ˨˦sã˥˥tsʰun˨˩tsʰim˥˥
一覺睡醒之後	kʰun˨˩pa˥˧liau˥˧au˧˧
一輛車	tsit˦tai˨˦tsʰia˥˥
一輩子	tsit˦si˨˩laŋ˨˦
一邊讀書	tsit˦bin˧˧tʰak˦tsʰeʔ˨
一餐可以吃掉六碗飯	tsit˦tǹg1e˧˧taŋ˨˩tsiaʔ˦lak˦ũã˥˧pŋ˥˥
一點也不會小氣吝嗇	loŋ˥˧be˧˧taŋ˨˩sŋ˥˥
一點小事不用放在心上	sio˥˧kʰua˥˧a˥˧tai˧˧tsi˨˩m˥˥bian˥˧khǹg1ti˧˧sim˥˥kũã˥˥lai˧˧
一點小事情都辦不好	tsit˦sut˨a˥˧tai˧˧tsi˨˩to˥˥pan˧˧be˧˧ho˥˧se˨˩
一點點	tsit˦si˥˥a˥˧
一點點	tsit˦tiam˥˧a˥˧
七個人	tsʰit˨e˨˦laŋ˨˦
七分靠努力。取自流行歌曲歌詞	tsʰit˨hun˥˥kʰo˨˩pʰaʔ˨pĩã˨˩
丈夫的弟弟	sio˥˧tsik˨a˥˧
丈夫的父親	aŋ˥˥sai˨˩e˨˦lau˧˧pe˧˧
三八婦女節	sam˥˥pat˨hu˧˧li˥˧tseʔ˨
三分天注定	sã˥˥hun˥˥tʰĩ˥˥tsu˨˩tĩã˧˧
三千以上	sã˥˥tsʰiŋ˥˥i˥˧sioŋ˧˧
三叩首	sam˥˥kʰio˨˩siu˥˧
三思而後行	sam˨˩su˥˥dzi˨˦hio˧˧hiŋ˨˦
三教九流	sam˥˥kau˨˩kiu˥˧liu˨˦
三斗米	sã˥˥tau˥˧bi˥˧
三更半夜	sã˥˥kẽ˥˥pũã˨˩me˨˦
三條狗	sã˥˥tsiaʔ˨kau˥˧
三毛錢	sã˥˥kak˨gin˨˦
三生有幸	sam˥˥siŋ˥˥iu˥˧hiŋ˧˧
三百五十	sã˥˥a˥˧gɔ˧˧
三腳貓笑獨眼狗。即五十步笑百步	sã˥˥kʰa˥˥niau˥˥tsʰio˨˩tsit˦bak˦kau˥˧
上個禮拜我們一群人登山去看風景	tiŋ˥˧le˥˧pai˨˩guan˥˧tsit˦tin˧˧laŋ˨˦tsĩũ˧˧sũã˥˥kʰi˨˩kʰũã˨˩hoŋ˥˥kiŋ˥˧
上午九點到十一點	tsi˧˧si˨˦
上午十一點到下午一點	gɔ˧˧si˨˦
上半身	tiŋ˥˧pũã˨˩sin˥˥
上山	tsĩũ˧˧sũã˥˥
上班登記簿	tsʰut˨kʰin˨˦pʰɔ˧˧
上等料理	sioŋ˧˧tiŋ˥˧liau˧˧li˥˧
上車	tsĩũ˧˧tsʰia˥˥
下午一點到三點	bi˧˧si˨˦
下午我們要去圖書館讀書	e˧˧tau˨˩guan˥˧beʔ˨lai˨˦kʰi˨˩tɔ˨˦su˥˥kuan˥˧tʰak˦tsʰeʔ˨
下半身	e˧˧pũã˨˩sin˥˥
下巴	tsʰui˨˩e˧˧tau˥˧
下巴尖尖的	e˧˧hai˨˦tsiam˥˥tsiam˥˥
下班	ha˧˧pan˥˥
下級	ha˧˧kip˨
下課	ha˧˧kʰo˨˩
下集	ha˧˧tsip˦
下雨天	loʔ˨hɔ˧˧tʰĩ˥˥
下雨天的時候	loʔ˨hɔ˧˧tʰĩ˥˥e˨˦si˨˦tsun˧˧
不公平	bo˨˦koŋ˥˥pẽ˨˦
不可以學人家當不良少年	m˥˥tʰaŋ˥˥oʔ˨laŋ˨˦tso˨˩pʰãĩ˥˧kĩã˥˧
不可以說不贏人家就要翻桌子	m˥˥tʰaŋ˥˥koŋ˥˧be˧˧ĩã˨˦laŋ˨˦to˧˧beʔ˨piŋ˥˧toʔ˨
不可縮水	be˧˧sai˥˧kiu˥˥tsui˥˧
不同	bo˨˦kaŋ˧˧
不喜歡你就說嘛	bo˨˦kaʔ˨i˨˩li˥˧to˧˧koŋ˥˧
不好的東西不要買	pʰãĩ˥˧miʔ˦m˥˥tʰaŋ˥˥be˥˧
不好的習性	pʰãĩ˥˧pʰiaʔ˨pʰĩ˨˩
不孝	put˨hau˨˩
不孝子	put˨hau˨˩kĩã˥˧
不完全了解	it˨ti˥˥puan˨˩kai˥˧
不幸	put˨hiŋ˧˧
不幸事件	kʰo˥˧lian˨˦tai˧˧
不得已	kɔ˥˥put˨tsioŋ˥˥
不必再浪費力氣了	m˥˥bian˥˧koʔ˨ke˥˥kaŋ˥˥laʔ˨
不是代理人	m˥˥si˧˧hun˥˥sin˥˥
不是外孫	m˥˥si˧˧gua˧˧sun˥˥
不是師傅	m˥˥si˧˧tʰau˨˦tsʰiu˥˧
不是高等級的貨色	m˥˥si˧˧ko˥˥kip˨hue˨˩
不會向外彎。比喻偏袒自己人	kʰut˨dzip˦bo˨˦kʰut˨tsʰut˨
不會多髒啦	be˧˧gua˧˧laʔ˨sap˨laʔ˨
不會有人把你當啞巴	bo˨˦laŋ˨˦e˧˧koŋ˥˧li˥˧si˧˧e˥˧kau˥˧
不然我要送別人了	m˥˥gua˥˧beʔ˨saŋ˨˩hɔ˧˧pat˦laŋ˨˦
不用怕沒地方去	bian˥˧kĩã˥˥bo˨˦sɔ˥˧tsai˧˧tʰaŋ˥˥kʰi˨˩
不用怕買不到	bian˥˧kĩã˥˥be˥˧bo˨˦
不用想也知道	tʰɔ˥˧sĩũ˧˧ma˧˧tsai˥˥
不用相爭	m˥˥bian˥˧sio˥˥tsẽ˥˥
不用計較	m˥˥bian˥˧ke˨˩kau˨˩
不用轉彎	m˥˥bian˥˧tńg1uat˨
不用那麼多禮	m˥˥bian˥˧hiaʔ˨kaŋ˥˥hu˥˥
不知去向	he˧˧loʔ˨put˨biŋ˨˦
不知道他究竟想怎樣	m˥˥tsai˥˥i˥˥tau˨˩te˥˧si˧˧beʔ˨an˥˧tsũã˥˧
不祥的預兆	hioŋ˥˥tiau˧˧
不義之財	put˨gi˧˧tsi˥˥tsai˨˦
不能反悔	be˧˧sai˥˧huan˥˧hue˥˧
不能喝酒	be˧˧sai˥˧lim˥˥tsiu˥˧
不能就此縮手	be˧˧taŋ˨˩kiu˥˥kʰa˥˥
不能說停就停	be˧˧sai˥˧huaʔ˨tʰiŋ˨˦to˧˧tʰiŋ˨˦
不要交到不三不四的人	m˥˥tʰaŋ˥˥kʰi˨˩kau˥˥tioʔ˨oŋ˨˦ko˥˥liu˥˧ko˥˥
不要做敗家子	m˥˥tʰaŋ˥˥tso˨˩liau˥˧bue˥˧a˥˧kĩã˥˧
不要又在外面到處閒晃	m˥˥tʰaŋ˥˥koʔ˨teʔ˨gua˧˧kʰau˥˧si˨˩ke˨˩so˨˦
不要吃	m˥˥tʰaŋ˥˥tsiaʔ˦
不要太古板	m˥˥tʰaŋ˥˥sĩũ˥˥kɔ˥˧pan˥˧
不要妥協	m˥˥tʰaŋ˥˥tʰo˨˩hiap˦
不要常常說大話	m˥˥tʰaŋ˥˥tĩã˧˧tĩã˧˧koŋ˥˧tua˧˧ue˧˧
不要戴面具在那邊嚇人	mai˨˩ti˨˩siau˥˧kui˥˧a˥˧kʰak˨ti˧˧hia˥˥ka˧˧laŋ˨˦heʔ˨kĩã˥˥
不要把外人牽扯進來	mai˨˩ka˧˧gua˧˧laŋ˨˦kʰan˥˥tʰua˥˥dzip˦lai˨˦
不要結交不正經的朋友	m˥˥tʰaŋ˥˥kau˥˥put˨sam˥˥put˨su˨˩e˨˦piŋ˨˦iu˥˧
不要被牠抓到	m˥˥tʰaŋ˥˥kʰi˨˩hɔ˧˧i˥˥dziau˨˩tioʔ˨
不要讓他一個人包辦	m˥˥tʰaŋ˥˥hɔ˧˧tsit˦e˨˦laŋ˨˦pau˥˥pan˧˧
不要走這麼快	mai˨˩kĩã˨˦hiaʔ˨kin˥˧
不要跑出去玩	m˥˥tʰaŋ˥˥tsau˥˧tsʰut˨kʰi˨˩sńg1
不要跟別人說	mai˨˩ka˧˧laŋ˨˦koŋ˥˧
不要這麼小家子氣	m˥˥tʰaŋ˥˥hiaʔ˨taŋ˨˩sŋ˥˥
不要騎太快	m˥˥tʰaŋ˥˥kʰia˨˦sĩũ˥˥kin˥˧
不規矩的手。意指有不良習慣或行為	pʰãĩ˥˧tsʰiu˥˧dziau˥˧
不論是誰問你	m˥˥kuan˥˧si˧˧sĩã˥˧laŋ˨˦ka˧˧li˥˧mŋ˥˥
不過你還是得去工作	put˨dzi˨˦ko˨˩li˥˧ma˧˧si˧˧ai˨˩kʰi˨˩tso˨˩kʰaŋ˥˥kʰue˨˩
世事	se˨˩su˧˧
世人都自私	se˨˩kan˥˥laŋ˨˦loŋ˥˧tsin˥˥tsu˧˧su˥˥
世局	se˨˩kiok˨
世界這麼大	tʰĩ˥˥te˧˧hiaʔ˨ni˧˧a˥˧tua˧˧
丙等	pĩã˥˧tiŋ˥˧
丟掉工作	sit˨giap˦
中元食品多的是	mɔ˨˦hõ˥˥ku˥˥kue˥˧tsaŋ˨˩
中午	tioŋ˥˥ŋɔ˥˧
中古時代	tioŋ˥˥kɔ˥˧si˨˦tai˧˧
中古車	tioŋ˥˥kɔ˥˧tsʰia˥˥
中大獎	tioŋ˨˩tua˧˧tsioŋ˥˧
中學	tioŋ˥˥hak˦
中庭	tʰĩ˥˥tsẽ˥˧
中毒	tioŋ˨˩tok˨
中等	tioŋ˥˥tiŋ˥˧
中計	tioŋ˨˩ke˨˩
中間	tioŋ˥˥ŋ˥˥
丹藥	ioʔ˨tan˥˥
主動的態度和奮鬥的精神是做人成功的基本條件	tsu˥˧toŋ˧˧e˨˦tʰai˧˧tɔ˧˧kaʔ˨pʰaʔ˨pĩã˨˩e˨˦tsiŋ˥˥sin˨˦si˧˧tso˨˩laŋ˨˦siŋ˨˦koŋ˥˥e˨˦ki˥˥pun˥˧tiau˨˦kĩã˧˧
久病床前無孝子	ku˥˧tŋ˥˥penn,7bo˨˦hau˨˩tsu˥˧
乙等	it˨tiŋ˥˧
九芎樹	kiu˥˧kioŋ˥˥a˥˧tsʰa˨˦
乞丐要來要錢了	kʰit˨tsiaʔ˦beʔ˨lai˨˦pun˥˥tsĩ˨˦aʔ˨
乞丐許大願。比喻人明明沒有能力，卻好高騖遠	kʰit˨tsiaʔ˦he˧˧tua˧˧guan˧˧
也是學生	ia˧˧si˧˧hak˦siŋ˥˥
乾脆不要吃	kui˥˥kʰi˨˩mai˨˩tsiaʔ˦
乾脆去領養別人家的孩子	e˧˧sai˥˧kʰi˨˩pun˥˥pat˦laŋ˨˦e˨˦gin˥˧a˥˧lai˨˦tsʰi˧˧
乾脆折算現金給你	kui˥˥kʰi˨˩tã˥˧hian˧˧kim˥˥hɔ˧˧li˥˧
亂罵人是不好的事情	ɔ˥˥peʔ˦me˧˧laŋ˨˦si˧˧m˥˥ho˥˧e˨˦tai˧˧tsi˨˩
了解	liau˥˧kai˥˧
事先講明	tai˧˧siŋ˥˥biŋ˨˦hɔ˥˥biŋ˨˦tsʰiaŋ˨˩
事情	tai˧˧tsi˨˩
事情做不到一半	tai˧˧tsi˨˩tso˨˩iau˥˧bue˧˧tsit˦pũã˨˩
事情做到一半	tai˧˧tsi˨˩tso˨˩kau˨˩pũã˨˩tioŋ˥˥tsam˧˧
事情做到一半就逃跑了	tai˧˧tsi˨˩tso˨˩kaʔ˨pũã˨˩lɔ˧˧to˧˧laŋ˨˩kaŋ˥˧aʔ˨
事情就全完了	tai˧˧tsi˨˩to˧˧kʰi˨˩liau˥˧liau˥˧aʔ˨
事情就會成功	tai˧˧tsi˨˩to˧˧e˧˧siŋ˨˦koŋ˥˥
事情已經做了一半了	tai˧˧tsi˨˩i˥˧kiŋ˥˥tso˨˩tsit˦pũã˨˩aʔ˨
事情已經辦好了	tai˧˧tsi˨˩tso˨˩ho˥˧aʔ˨
事情能否成功	tai˧˧tsi˨˩e˧˧siŋ˨˦be˧˧siŋ˨˦
事情辦得很妥善	tai˧˧tsi˨˩tso˨˩liau˥˧tsin˥˥su˨˩si˧˧
事情這樣一直懸而未解也不是辦法	tai˧˧tsi˨˩an˥˧ne˥˥it˨tit˦tiau˨˩ti˧˧pũã˨˩kʰoŋ˥˥tioŋ˥˥ma˧˧m˥˥si˧˧pan˧˧huat˨
二來我沒興趣	dzi˧˧lai˨˦gua˥˧bo˨˦hiŋ˨˩tsʰu˨˩
二十一世紀	dziap˦it˨se˨˩ki˥˧
二十來歲正當年輕	dziap˦kui˥˧hue˨˩tŋ˥˥siau˨˩lian˨˦
二十四節氣之一，冬至過後十五天，因天候寒冷所以有這個名稱	siau˥˧han˨˦
二十多	dzi˧˧tsap˦tsʰut˨
五仁月餅	ŋɔ˥˧dzin˨˦gueʔ˦pĩã˥˧
五件衣服	gɔ˧˧nia˥˧sã˥˥
五光十色、各式各樣	gɔ˧˧hue˥˥tsap˦sik˨
五十多歲	gɔ˧˧tsap˦gua˧˧hue˨˩
五穀	ŋɔ˥˧kok˨
五香	ŋɔ˥˧hiaŋ˥˥
亡兄	boŋ˨˦hiŋ˥˥
亡國	boŋ˨˦kok˨
交付	kau˥˥hu˨˩
交朋友要小心	kau˥˥piŋ˨˦iu˥˧ai˨˩se˨˩dzi˧˧
人中長的人壽命比較長	dzin˨˦tioŋ˥˥tŋ˥˥e˨˦laŋ˨˦kʰaʔ˨tŋ˥˥hue˨˩siu˧˧
人事	dzin˨˦su˧˧
人只要肯努力	laŋ˨˦na˧˧kʰiŋ˥˧pʰaʔ˨pĩã˨˩
人在人際關係就在	dzin˨˦tsai˧˧dzin˨˦tsiŋ˨˦tsai˧˧
人在做，天在看。即舉頭三尺有神明，勸人不可做虧心事	laŋ˨˦teʔ˨tso,3tʰĩ˥˥teʔ˨kʰũã˨˩
人多嘴雜	tsap˦tsʰui˨˩kau˥˧kʰa˥˥tsʰŋ˥˥
人情	dzin˨˦tsiŋ˨˦
人情世故	dzin˨˦tsiŋ˨˦se˨˩su˧˧
人有七竅	laŋ˨˦u˧˧tsʰit˨kʰoŋ˥˧
人生在世要放開心胸	tso˨˩laŋ˨˦tioʔ˨ai˨˩sĩũ˧˧hɔ˧˧i˥˥kʰui˥˥
人生的開始。三字經的首句	dzin˨˦tsi˥˥tsʰɔ˥˥
人生苦短	dzin˨˦siŋ˥˥te˥˧te˥˧a˥˧
人的內臟是很重要的	laŋ˨˦e˨˦ŋɔ˥˧tsoŋ˧˧liok˨hu˥˧loŋ˥˧si˧˧tsin˥˥tioŋ˧˧iau˨˩e˨˦
人臉初生的細毛	kʰɔ˥˧mŋ˥˥a˥˧
人要是被比喻成畜牲就很不值了	laŋ˨˦na˧˧hɔ˧˧laŋ˨˦pi˥˧pʰiŋ˧˧tso˨˩tsiŋ˥˥sẽ˥˥to˧˧tsiok˨m˥˥tat˦aʔ˨
人造雨	dzin˨˦tso˧˧hɔ˧˧
人間的事很煩擾	se˨˩su˧˧luan˧˧hun˥˥hun˥˥
人類	dzin˨˦lui˧˧
什麼過分的事做不出來	sĩã˥˧miʔ˨iau˥˧siu˧˧tai˧˧tsi˨˩tso˨˩be˧˧tsʰut˨lai˨˦
仁者	dzin˨˦tsia˥˧
仇人	siu˨˦dzin˨˦
仇恨	uan˥˥siu˨˦
今天	kin˥˥a˥˧dzit˦
今天十六號	kin˥˥a˥˧dzit˦tsap˦lak˦
今天在西門町有一群黑道在火拼	kin˥˥a˥˧dzit˦ti˧˧se˥˥mŋ˥˥tiŋ˥˥u˧˧tsit˦tin˧˧hĩã˥˥ti˧˧teʔ˨tsʰia˥˥pĩã˨˩
今天在高速公路上發生一件翻車的意外	kin˥˥a˥˧dzit˦ti˧˧ko˥˥sok˨koŋ˥˥lɔ˧˧huat˨siŋ˥˥tsit˦kĩã˧˧piŋ˥˧tsʰia˥˥e˨˦i˨˩gua˧˧
今天天氣不好	kin˥˥a˥˧dzit˦tʰĩ˥˥kʰi˨˩bo˨˦ho˥˧
今天早上他來找你	e˥˥tsai˥˧a˥˧i˥˥u˧˧lai˨˦tsʰue˧˧li˥˧
今天早上溼氣真重	e˥˥tsai˥˧a˥˧tsui˥˧kʰi˨˩tsin˥˥taŋ˧˧
今天是好日子	kin˥˥a˥˧dzit˦si˧˧tua˧˧dzit˦
今天是我的生日	kin˥˥a˥˧dzit˦si˧˧gua˥˧e˨˦sẽ˥˥dzit˦
今天有一個和尚來這裡化緣	kin˥˥a˥˧dzit˦u˧˧tsit˦e˨˦hue˨˦sĩũ˧˧lai˨˦tsia˥˥hua˨˩ian˨˦
今天的太陽真大	kin˥˥a˥˧dzit˦e˨˦dzit˦tʰau˨˦tsin˥˥me˥˧
今天的會議由他來主持	kin˥˥a˥˧dzit˦e˨˦hue˧˧gi˧˧iu˨˦i˥˥lai˨˦tsu˥˧tsʰi˨˦
今年是壬午馬年	kin˥˥ni˨˦si˧˧dzim˨˦ŋɔ˥˧ni˨˦
今年的雨水很充足	kin˥˥ni˨˦e˨˦hɔ˧˧tsui˥˧tsin˥˥tsʰioŋ˥˥tsiok˨
今年第一期稻作稻穀很飽滿	kin˥˥ni˨˦lak˦gueʔ˦taŋ˥˥tiu˧˧a˥˧tsĩã˨˦pa˥˧sui˧˧
今晚月亮很亮	e˥˥hŋ˥˥am˨˩gueʔ˦niu˨˦tsin˥˥kŋ˥˥
今晚要來我們家作客嗎	e˥˥am˨˩beʔ˨lai˨˦guan˥˧tau˥˥hɔ˧˧guan˥˧tsʰĩã˥˧bo˨˦
仕途	su˧˧tɔ˨˦
他一上臺就忘了要唸旁白	i˥˥sui˨˦tsĩũ˧˧tai˨˦to˧˧be˧˧ki˨˩tit˨ai˨˩liam˧˧kʰau˥˧peʔ˦
他一星期至少要賣三百個	i˥˥tsit˦le˥˧pai˨˩tsi˨˩tsio˥˧ai˨˩be˧˧sã˥˥paʔ˨e˨˦
他一邊工作	i˥˥tsit˦bin˧˧tso˨˩kaŋ˥˥
他不久之後就學藝完成了	i˥˥liam˨˦mi˥˥to˧˧e˧˧tsʰut˨sai˥˥aʔ˨
他不但沒有記恨	i˥˥m˥˥na˧˧bo˨˦kʰioʔ˨hin˧˧
他不只捐錢	i˥˥m˥˥na˧˧kia˨˩hu˨˩tsĩ˨˦
他不只捐錢	i˥˥put˨tan˧˧kia˨˩hu˨˩tsĩ˨˦
他不定時有新作品出版	i˥˥sam˥˥put˨gɔ˧˧si˨˦e˧˧u˧˧sin˥˥tsok˨pʰin˥˧tsʰut˨pan˥˧
他不是故意的	i˥˥m˥˥si˧˧tʰiau˥˥i˨˩kɔ˨˩e˨˦
他不時來我們家串門子	i˥˥sam˥˥put˨gɔ˧˧si˨˦to˧˧lai˨˦guan˥˧tau˥˥kĩã˨˦taʔ˦
他不會理睬你	i˥˥be˧˧tsʰap˨li˥˧
他不識字	i˥˥m˥˥bat˨dzi˧˧
他不過是個半吊子罷了	i˥˥tsi˥˧put˨ko˨˩si˧˧tsit˦e˨˦pũã˨˩tʰaŋ˥˧sai˥˧nia˧˧nia˧˧
他不願意幫你	i˥˥m˥˥guan˧˧ka˧˧li˥˧tau˨˩sã˥˥kaŋ˧˧
他也不會怎樣	i˥˥ma˧˧be˧˧an˥˧tsũã˥˧
他今天的穿著很得體，有大家的風範	i˥˥kin˥˥a˥˧dzit˦e˨˦tsʰiŋ˧˧tsʰaʔ˨tsin˥˥tai˧˧hoŋ˥˥
他今年十歲	i˥˥kin˥˥ni˨˦tsap˦hue˨˩
他代表公司來開會	i˥˥tai˧˧piau˥˧koŋ˥˥si˥˥lai˨˦kʰui˥˥hue˧˧
他來一下子就回去了	i˥˥lai˨˦tsit˦tiap˨a˥˧ku˥˧to˧˧tńg1kʰi˨˩aʔ˨
他做什麼生意都賠錢	i˥˥tso˨˩sĩã˥˧miʔ˨siŋ˥˥li˥˧loŋ˥˧liau˥˧tsĩ˨˦
他做這一行	i˥˥tso˨˩tsit˨tɔ˨˦
他先打我	i˥˥siŋ˥˥ka˧˧gua˥˧pʰaʔ˨
他全身都是病痛	i˥˥kui˥˥sin˥˥kʰu˥˥tsuan˨˦mɔ˨˦pẽ˧˧
他出手很慷慨	i˥˥tsʰut˨tsʰiu˥˧tsin˥˥tai˧˧hoŋ˥˥
他刻這顆印章花很多時間	i˥˥kʰik˨tsit˨liap˦in˨˩a˥˧tsin˥˥liau˥˧kaŋ˥˥
他剛才從外頭回來	i˥˥tu˥˧tsiaʔ˨tui˨˩gua˧˧kʰau˥˧tńg1lai˨˦
他努力奮鬥的故事被刊登在報紙上面	i˥˥pʰaʔ˨pĩã˨˩e˨˦kɔ˨˩su˧˧u˧˧kʰan˥˥ti˧˧po˨˩tsua˥˧tiŋ˥˧tʰau˨˦
他升遷當主任了	i˥˥siŋ˥˥kʰi˥˧lai˨˦tso˨˩tsu˥˧dzim˧˧aʔ˨
他去年就去世了	i˥˥ku˧˧ni˨˦to˧˧kʰi˨˩aʔ˨
他又來了	i˥˥iu˧˧koʔ˨lai˨˦aʔ˨
他可是行家	i˥˥si˧˧lai˧˧haŋ˨˦e˨˦
他可能不會來了	i˥˥kʰo˥˧liŋ˨˦be˧˧lai˨˦aʔ˨
他吃一點點飯而已	i˥˥tsiaʔ˦tsit˦sut˨a˥˧pŋ˥˥nia˧˧nia˧˧
他吃最多	i˥˥tsiaʔ˦sioŋ˧˧tse˧˧
他吃飯時間不固定	i˥˥tsiaʔ˨pŋ˥˥loŋ˥˧bo˨˦it˨tiŋ˧˧e˨˦si˨˦kan˥˥
他和阿仁本來感情很好	i˥˥kaʔ˨a˥˥dzin˨˦guan˨˦pun˥˧kam˥˧tsiŋ˨˦tsĩã˨˦ho˥˧
他和黑道勾結	i˥˥kaʔ˨ɔ˥˥to˧˧kau˥˥kiat˨
他哭得眼淚直流	i˥˥kʰau˨˩kaʔ˨bak˦sai˥˧si˨˩lam˨˦sui˨˦
他嚇得半死	i˥˥kĩã˥˥tsit˦e˧˧pũã˨˩sio˥˧si˥˧
他四十多歲了	i˥˥siap˨gua˧˧hue˨˩aʔ˨
他因為身體不舒服	i˥˥sin˥˥tʰe˥˧kʰiam˨˩an˥˥
他在那間銀行有一個帳戶	i˥˥ti˧˧hit˨kiŋ˥˥gin˨˦haŋ˨˦u˧˧tsit˦e˨˦kʰau˥˧tso˧˧
他在鄉鎮市公所工作	i˥˥ti˧˧koŋ˥˥sɔ˥˧tsiaʔ˦tʰau˨˦lɔ˧˧
他在醫院處理文書工作	i˥˥ti˧˧pẽ˧˧ĩ˧˧tso˨˩bun˨˦su˥˥
他在騙你	i˥˥teʔ˨pʰian˨˩li˥˧
他多找我五十塊錢	i˥˥ke˥˥tsau˧˧gua˥˧gɔ˧˧tsap˦kʰɔ˥˥
他天生就比較粗魯、率直	i˥˥sẽ˥˥pun˥˧kʰaʔ˨tʰɔ˥˧siŋ˨˩
他太胖了	i˥˥sĩũ˥˥tua˧˧kʰɔ˥˥aʔ˨
他好比是隻被人關在籠子裡面的小鳥	i˥˥kʰo˥˧pi˥˧tsit˦tsiaʔ˨hɔ˧˧laŋ˨˦kũãĩ˥˥ti˧˧laŋ˨˦a˥˧lai˧˧e˨˦tsiau˥˧a˥˧
他專門在背後說人家的壞話	i˥˥tsuan˥˥bun˨˦ti˧˧au˧˧piaʔ˨koŋ˥˧laŋ˨˦e˨˦pʰãĩ˥˧ue˧˧
他對他的學生一律都很嚴格	i˥˥tui˨˩i˥˥e˨˦hak˦siŋ˥˥it˨lut˦loŋ˥˧tsin˥˥giam˨˦keʔ˨
他對語言方面很有興趣	i˥˥tui˨˩gi˥˧gian˨˦hoŋ˥˥bin˧˧tsin˥˥u˧˧hiŋ˨˩tsʰu˨˩
他就像公司的外交部長	i˥˥kʰo˥˧pi˥˧si˧˧koŋ˥˥si˥˥e˨˦gua˧˧kau˥˥pɔ˧˧tĩũ˥˧
他就像牛螕一樣	i˥˥kã˥˧na˥˧gu˨˦pi˥˥leʔ˨
他就是心腸不好	i˥˥to˧˧si˧˧pʰãĩ˥˧sim˥˥hiŋ˧˧
他就醒了	i˥˥to˧˧tsʰẽ˥˧aʔ˨
他常常打我發洩怨氣	i˥˥tĩã˧˧tĩã˧˧pʰaʔ˨gua˥˧tsʰut˨kʰui˨˩
他常常被老闆斥責	i˥˥put˨si˨˦hɔ˧˧tʰau˨˦ke˥˥tiŋ˨˩
他待人很好	i˥˥laŋ˨˦tsin˥˥ho˥˧
他很不孝順	i˥˥tsin˥˥put˨hau˨˩
他很喜歡說自以為是的話	i˥˥tsiok˨ai˨˩koŋ˥˧tua˧˧sĩã˥˥ue˧˧
他很堅強、上進	i˥˥tsin˥˥pa˥˥kiat˨
他很愛偷竊	i˥˥tsin˥˥pʰãĩ˥˧tsʰiu˥˧dziau˥˧
他很挑嘴	i˥˥tsin˥˥pʰãĩ˥˧tsʰui˨˩tau˥˧
他很有人緣	i˥˥tsin˥˥u˧˧laŋ˨˦ian˨˦
他很有內涵	i˥˥tsiok˨u˧˧lai˧˧tsai˨˦e˨˦
他很有名氣	i˥˥tsin˥˥u˧˧dzin˨˦boŋ˧˧
他很有年紀了吧	i˥˥m˥˥tsin˥˥tse˧˧hue˨˩aʔ˨
他很有本事	i˥˥tsin˥˥u˧˧tsai˨˦tiau˧˧
他很聰明	i˥˥tsiok˨kʰiau˥˧e˨˦
他很詼諧	i˥˥tsin˥˥ŋɔ˥˧dzin˨˦
他從南部上來臺北工作	i˥˥tui˨˩e˧˧kaŋ˥˧kʰi˥˧lai˨˦tai˨˦pak˨tsiaʔ˦tʰau˨˦lɔ˧˧
他怎麼這麼不要臉	i˥˥na˥˧e˧˧tsiaʔ˨put˨su˥˧kui˥˧
他怎麼那麼有才華	i˥˥na˥˧e˧˧hiaʔ˨tsai˨˦tsiŋ˨˦
他怕搭車會來不及	i˥˥kĩã˥˥kĩ˨˩hu˨˩be˧˧tioʔ˨tsʰia˥˥paŋ˥˥
他想買一刀紙	i˥˥beʔ˨be˥˧tsit˦to˥˥tsua˥˧
他懂得很多種做瓷器的專門技術	i˥˥bat˨tsiok˨tse˧˧tsioŋ˥˧tso˨˩hui˨˦a˥˧e˨˦tsʰiu˥˧lɔ˧˧
他懷孕挺了個大肚子	i˥˥pʰãĩ˧˧tsit˦e˨˦tua˧˧tɔ˧˧kui˥˥
他所說的和事實很不一致	i˥˥sɔ˥˧koŋ˥˧e˨˦kaʔ˨su˧˧sit˦u˧˧tsin˥˥tua˧˧e˨˦tsʰut˨dzip˦
他才十七歲而已	i˥˥tsiaʔ˨tsap˦tsʰit˨hue˨˩nia˧˧nia˧˧
他才會記得	i˥˥tsiaʔ˨e˧˧ki˨˩tit˨
他才退伍沒多久	i˥˥tsiaʔ˨tʰe˨˩ŋɔ˥˧bo˨˦gua˧˧ku˥˧
他打得太用力	i˥˥pʰaʔ˨tsit˦e˧˧sĩũ˥˥tua˧˧e˧˧
他打球打到喘不過氣來	i˥˥pʰaʔ˨kiu˨˦pʰaʔ˨kaʔ˨tua˧˧sim˥˥kʰui˨˩
他把他的私人花園公開展覽	i˥˥koŋ˥˥kʰai˥˥tian˥˧lam˥˧i˥˥e˨˦su˥˥dzin˨˦hue˥˥hŋ˥˥
他把所有的事情都說出來了	i˥˥ka˧˧sɔ˥˧u˧˧e˨˦tai˧˧tsi˨˩loŋ˥˧koŋ˥˧tsʰut˨lai˨˦aʔ˨
他把西瓜切成四塊	i˥˥ka˧˧si˥˥kue˥˥tsʰiat˨tso˨˩si˨˩te˨˩
他排行老大	i˥˥si˧˧tua˧˧han˨˩e˨˦
他故意這麼說要惹你生氣	i˥˥tiau˥˥kɔ˨˩i˨˩beʔ˨koŋ˥˧hɔ˧˧li˥˧kʰi˨˩
他明天要就職了	i˥˥bin˨˦a˥˧tsai˨˩beʔ˨tsĩũ˧˧dzim˧˧aʔ˨
他昨天三更半夜才回來	i˥˥tsa˥˥hŋ˥˥sã˥˥kẽ˥˥pũã˨˩me˨˦tsiaʔ˨tńg1lai˨˦
他昨晚住院	i˥˥tsa˥˥am˨˩dzip˦ĩ˧˧
他昨晚被人砍了好幾刀	i˥˥tsa˥˥me˨˦kʰi˨˩hɔ˧˧laŋ˨˦tʰai˨˦kui˥˧na˧˧to˥˥
他昨晚酒醉漚吐	i˥˥tsa˥˥am˨˩tsʰut˨tsiu˥˧
他是一個半吊子	i˥˥si˧˧tsit˦e˨˦pũã˨˩lɔ˧˧sai˥˥
他是一個沒良心的人	i˥˥si˧˧tsit˦e˨˦bo˨˦tʰian˥˥lioŋ˨˦e˨˦laŋ˨˦
他是一個粗人	i˥˥si˧˧tsit˦e˨˦tʰɔ˥˧laŋ˨˦
他是一個老實人	i˥˥si˧˧tsit˦e˨˦kɔ˥˧i˨˩laŋ˨˦
他是助手	i˥˥si˧˧dzi˧˧tsʰiu˥˧
他是我哥哥	i˥˥si˧˧guan˥˧hĩã˥˥ko˥˥
他是我妹妹	i˥˥si˧˧guan˥˧sio˥˧mue˧˧
他是我嫂嫂	i˥˥si˧˧guan˥˧hĩã˥˥so˥˧
他是我遇過最難相處的人	i˥˥si˧˧gua˥˧tu˥˧kue˨˩sioŋ˧˧pʰãĩ˥˧tʰi˨˩tʰau˨˦e˨˦laŋ˨˦
他是收養的	i˥˥si˧˧pun˥˥e˨˦
他是故意要和我作對的	i˥˥si˧˧tiau˥˥ti˨˦beʔ˨kaʔ˨gua˥˧tso˨˩tui˨˩e˨˦
他是有錢人	i˥˥si˧˧ho˥˧giaʔ˦laŋ˨˦
他是本尊	i˥˥si˧˧pun˥˧tsun˥˥
他是水電工啦	i˥˥si˧˧tso˨˩tsui˥˧tian˧˧e˨˦laʔ˨
他是老師	i˥˥si˧˧lau˧˧su˥˥
他是耳根軟的人	i˥˥si˧˧tsit˦e˨˦tua˧˧hĩ˧˧ti˥˥
他是製作家具的木工	i˥˥si˧˧tso˨˩sio˥˧bak˦e˨˦
他是這個歌仔劇團裡的小旦	i˥˥si˧˧tsit˨e˨˦kua˥˥a˥˧hi˨˩pan˥˥e˨˦sio˥˧tũã˨˩
他時常在這地方與人吵架、鬥毆	i˥˥tĩã˧˧tĩã˧˧ti˧˧tsit˨kʰɔ˥˥ui˨˦a˥˧kaʔ˨laŋ˨˦uan˥˥ke˥˥sio˥˥pʰaʔ˨
他最喜歡出風頭	i˥˥sioŋ˧˧ai˨˩tsʰut˨hoŋ˥˥tʰau˨˦
他最喜歡拿望遠鏡看稀奇的鳥類	i˥˥sioŋ˧˧ai˨˩tʰeʔ˦tsʰian˥˥li˥˧kĩã˨˩kʰũã˨˩hi˥˥han˥˧e˨˦tsiau˥˧a˥˧
他最近看起來很舒爽	i˥˥tsue˨˩kin˧˧kʰũã˨˩kʰi˥˧lai˨˦tsĩã˨˦sim˥˥soŋ˥˧
他會不會有惡疾	i˥˥kam˥˧e˧˧sẽ˥˥pʰãĩ˥˧miʔ˦
他會害羞	i˥˥e˧˧pʰãĩ˥˧se˨˩
他有一個很大的肚子	i˥˥u˧˧tsit˦e˨˦tua˧˧tɔ˧˧kui˥˥
他有一筆呆帳	i˥˥u˧˧tsit˦pit˨pʰã˨˩siau˨˩
他死的時候很痛苦	i˥˥si˥˧e˨˦si˨˦tsun˧˧tsin˥˥pʰãĩ˥˧si˥˧
他比較不會那麼累	i˥˥kʰaʔ˨be˧˧hiaʔ˨tʰiam˥˧
他決定要公開所有的事情	i˥˥kuat˨tiŋ˧˧beʔ˨koŋ˥˥kʰai˥˥sɔ˥˧u˧˧e˨˦tai˧˧tsi˨˩
他活著的時候做了很多好事	i˥˥tsai˧˧sẽ˥˥e˨˦si˨˦tsun˧˧tso˨˩tsin˥˥tse˧˧ho˥˧tai˧˧
他為了自己的利益出賣朋友	i˥˥ui˧˧tioʔ˨ka˥˥ki˧˧e˨˦li˧˧ik˨tsʰut˨be˧˧piŋ˨˦iu˥˧
他為人忠厚老實	i˥˥tso˨˩laŋ˨˦tsĩã˨˦kɔ˥˧i˨˩
他煮的東西很難吃	i˥˥tsu˥˧e˨˦miʔ˦kĩã˧˧tsin˥˥pʰãĩ˥˧tsiaʔ˦
他用錢很大方	i˥˥ioŋ˧˧tsĩ˨˦tsin˥˥pʰã˨˩tsʰiu˥˧
他白天都不在家裡	i˥˥dzit˦si˨˦loŋ˥˧bo˨˦ti˧˧tsʰu˨˩li˥˧
他的一句話使得我的心裡一片雜亂	i˥˥e˨˦tsit˦ku˨˩ue˧˧hɔ˧˧gua˥˧kui˥˥e˨˦sim˥˥tʰau˨˦dzu˨˦ka˥˧ka˥˧
他的人個性比較直率	i˥˥e˨˦laŋ˨˦kʰaʔ˨tʰɔ˥˧tit˦
他的人緣還算不錯	i˥˥koʔ˨put˨tsi˥˧a˥˧u˧˧dzin˨˦kʰi˨˩
他的人脈很廣	i˥˥e˨˦laŋ˨˦bin˧˧tsin˥˥kʰuaʔ˨
他的個性就是那麼粗魯	i˥˥to˧˧si˧˧hit˨kʰuan˥˧tʰɔ˥˧koŋ˥˥a˥˧siŋ˨˩
他的個性較老土	i˥˥e˨˦laŋ˨˦kʰaʔ˨tʰɔ˥˧
他的動作真快	i˥˥kʰa˥˥tsʰiu˥˧tsin˥˥kin˥˧
他的口氣很大	i˥˥e˨˦kʰau˥˧kʰi˨˩tsin˥˥tua˧˧
他的壞習慣一大堆	i˥˥e˨˦pʰãĩ˥˧pʰiaʔ˨tsit˦tua˧˧tui˥˥
他的大名	i˥˥e˨˦tua˧˧mia˨˦
他的大拇指被小刀割到了	i˥˥e˨˦tua˧˧tʰau˨˦bu˥˧hɔ˧˧to˥˥a˥˧kuaʔ˨tioʔ˨aʔ˨
他的手工很細緻	i˥˥e˨˦tsʰiu˥˧kaŋ˥˥tsin˥˥iu˨˩
他的病怎麼好得那麼快	i˥˥e˨˦pẽ˧˧na˥˧e˧˧ho˥˧kaʔ˨hiaʔ˨ni˧˧a˥˧kin˥˧
他的脾氣很壞	i˥˥tsin˥˥pʰãĩ˥˧siŋ˨˩te˧˧
他的膿瘡流膿了	i˥˥e˨˦liap˦a˥˧tsʰut˨laŋ˨˦aʔ˨
他的英文說得很流利	i˥˥iŋ˥˥gi˥˧koŋ˥˧kaʔ˨siaʔ˨siaʔ˨kio˨˩
他的行為舉止真令人懷疑	i˥˥e˨˦toŋ˧˧tsok˨tsin˥˥kʰo˥˧gi˨˦
他的身世聽著讓人覺得很傷心	i˥˥e˨˦sin˥˥se˨˩hɔ˧˧laŋ˨˦tʰĩã˥˥tioʔ˨kam˥˧kak˨tsĩã˨˦sim˥˥sŋ˥˥
他的食量真的很大	i˥˥tsʰin˥˥tsʰĩũ˧˧tua˧˧tɔ˧˧kui˥˥
他相隔很久才來一次	i˥˥ku˥˧ku˥˧tsiaʔ˨lai˨˦tsit˦pai˥˧
他看到人總是微微笑著	i˥˥kʰũã˨˩tioʔ˨laŋ˨˦loŋ˥˧bun˨˦bun˨˦a˥˧tsʰio˨˩
他看起來年輕多了	i˥˥kʰũã˨˩kʰi˥˧lai˨˦ke˥˥kʰaʔ˨siau˨˩lian˨˦
他真小氣	i˥˥tsin˥˥taŋ˨˩sŋ˥˥
他眼睛翻白眼	i˥˥bak˦tsiu˥˥piŋ˥˧peʔ˦kãĩ˨˦
他瞧不起別人	i˥˥kʰũã˨˩pat˦laŋ˨˦bo˨˦tsĩũ˧˧bak˦
他竟然敢動手打我	i˥˥kiŋ˨˩dzian˨˦kã˥˧tsʰut˨tsʰiu˥˧pʰaʔ˨gua˥˧
他經商成功主要的原因就是認真努力	i˥˥tso˨˩siŋ˥˥li˥˧e˧˧taŋ˨˩siŋ˨˦koŋ˥˥tsu˥˧iau˨˩e˨˦guan˨˦in˥˥to˧˧si˧˧dzin˧˧tsin˥˥pʰaʔ˨pĩã˨˩
他經常在讀書	i˥˥put˨si˨˦ma˧˧teʔ˨tʰak˦tsʰeʔ˨
他總共生了六個兒子	i˥˥loŋ˥˧tsoŋ˥˧sẽ˥˥lak˦e˨˦hau˧˧sẽ˥˥
他美得像仙女	i˥˥sui˥˧kaʔ˨na˥˧sian˥˥li˥˧
他花錢很大方	i˥˥tsʰut˨tsʰiu˥˧tsin˥˥tai˧˧hoŋ˥˥
他花錢很大方	i˥˥tsin˥˥pʰã˨˩tsʰiu˥˧
他被人比喻成菩薩	i˥˥hɔ˧˧laŋ˨˦pi˥˧dzu˧˧tso˨˩pʰɔ˨˦sat˨
他被警察叫去問口供	i˥˥kʰi˨˩hɔ˧˧kiŋ˥˧tsʰat˨tiau˨˩kʰi˨˩mŋ˥˥kʰau˥˧kiŋ˥˥
他被車子撞得不醒人事	i˥˥hɔ˧˧tsʰia˥˥loŋ˨˩tsit˦e˧˧m˥˥tsai˥˥laŋ˨˦
他被那個不肖之徒氣個半死	i˥˥kʰi˨˩hɔ˧˧hit˨e˨˦m˥˥tsĩã˨˦laŋ˨˦kʰi˨˩kaʔ˨beʔ˨si˥˧
他要送給別人的東西都會包裝得很漂亮	i˥˥beʔ˨saŋ˨˩hɔ˧˧laŋ˨˦e˨˦miʔ˦kĩã˧˧loŋ˥˧pau˥˥tsoŋ˥˥kaʔ˨tsin˥˥sui˥˧
他說他大後天會回來	i˥˥koŋ˥˧i˥˥tua˧˧au˧˧dzit˦e˧˧to˨˩tńg1lai˨˦
他說你是一朵花	i˥˥koŋ˥˧li˥˧si˧˧tsit˦lui˥˧hue˥˥
他說要中立	i˥˥koŋ˥˧beʔ˨tioŋ˥˥lip˦
他說要請我吃好料耶	i˥˥koŋ˥˧beʔ˨tsʰĩã˥˧gua˥˧tsiaʔ˦ho˥˧liau˧˧e˨˦
他說話不留口德	i˥˥koŋ˥˧ue˧˧tsin˥˥pʰãĩ˥˧tsʰui˨˩tau˥˧
他說話口氣很粗暴	i˥˥koŋ˥˧ue˧˧tsĩã˨˦pʰãĩ˥˧sĩã˥˥sau˨˩
他說話用語很文雅	i˥˥koŋ˥˧ue˧˧tsin˥˥bun˨˦
他講話很文雅	i˥˥koŋ˥˧ue˧˧tsin˥˥bun˨˦ŋa˥˧
他講話總是這樣翻來覆去	i˥˥koŋ˥˧ue˧˧an˥˧ne˥˥piŋ˥˧lai˨˦piŋ˥˧kʰi˨˩
他越是故意和你唱反調	i˥˥dzu˥˧tʰiau˥˥kaŋ˥˥
他跌得整個人撲倒在地	i˥˥puaʔ˦tsit˦e˧˧kui˥˥e˨˦laŋ˨˦pʰak˨loʔ˨kʰi˨˩
他跌落山谷	i˥˥puaʔ˦loʔ˨kʰi˨˩sũã˥˥kau˥˥
他跟我的看法並不一致	i˥˥kaʔ˨gua˥˧e˨˦kʰũã˨˩huat˨piŋ˧˧bo˨˦it˨ti˨˩
他車子開得太快	i˥˥tsʰia˥˥sai˥˧sĩũ˥˥kin˥˧
他這人不做善事積陰德	i˥˥tsit˨e˨˦laŋ˨˦pʰãĩ˥˧tsik˨tik˨
他這個人很有趣	i˥˥laŋ˨˦u˧˧kau˨˩sim˥˥sik˨
他這樣的做事手法太過粗魯了	i˥˥tsit˨kʰuan˥˧tso˨˩huat˨tsʰiu˥˧lɔ˧˧sĩũ˥˥tsʰɔ˥˥laʔ˨
他這樣說	i˥˥an˥˧ne˥˥koŋ˥˧
他這次出國	i˥˥tsit˨kue˨˩tsʰut˨kok˨
他這麼認真練習	i˥˥tsiaʔ˨dzin˧˧tsin˥˥lian˧˧sip˦
他連一點機會都不給我	i˥˥lian˨˦tsit˦tiam˥˧a˥˧ki˥˥hue˧˧to˥˥m˥˥hɔ˧˧gua˥˧
他還是聽不進去	i˥˥ia˧˧si˧˧tʰĩã˥˥be˧˧dzip˦ni˥˧
他還要一個多月才會回來	i˥˥ai˨˩koʔ˨gueʔ˦gua˧˧dzit˦tsiaʔ˨e˧˧tńg1lai˨˦
他那個人不太可靠	i˥˥hit˨e˨˦laŋ˨˦bo˨˦sĩã˥˧kʰo˥˧kʰo˨˩
他那幅畫有沒有入選	i˥˥hit˨pak˨tɔ˨˦u˧˧dzip˦suan˥˧bo˨˦
他都要等到下半夜才睡得熟	i˥˥loŋ˥˧ai˨˩tan˥˧kaʔ˨e˧˧pũã˨˩me˨˦tsiaʔ˨kʰun˨˩e˧˧loʔ˨bin˨˦
他都跑在最前頭	i˥˥loŋ˥˧tsau˥˧tai˧˧siŋ˥˥
他長得很高大	i˥˥sẽ˥˥tso˨˩tsiok˨tua˧˧han˨˩
他長得真可愛	i˥˥sẽ˥˥tso˨˩tsin˥˥kɔ˥˧tsui˥˥
他離開很久了	i˥˥li˧˧kʰui˥˥tsin˥˥ku˥˧aʔ˨
他食量很小	i˥˥tsin˥˥sio˥˧kʰau˥˧
付錢	hu˨˩tsĩ˨˦
仙人打鼓也會有差錯	sian˥˥dzin˨˦pʰaʔ˨kɔ˥˧iu˥˧si˨˦tsʰo˨˩
仙女下凡	sian˥˥li˥˧ha˧˧huan˧˧
令堂	liŋ˧˧toŋ˨˦
令尊	liŋ˧˧tsun˥˥
以你的經驗來看	i˥˧li˥˧e˨˦kiŋ˥˥giam˧˧lai˨˦kʰũã˨˩
以免欲速則不達	m˥˥tʰaŋ˥˥tsiaʔ˦kin˥˧loŋ˨˩pʰua˨˩ũã˥˧
以前人覺得生男孩子是福氣	kʰaʔ˨tsa˥˧e˨˦laŋ˨˦kam˥˧kak˨tsʰut˨tiŋ˥˥si˧˧hok˨kʰi˨˩
以前有很多山賊在這裡出沒	kʰaʔ˨tsa˥˧u˧˧tsin˥˥tse˧˧sũã˥˥tsʰat˦ti˧˧tsia˥˥tsʰut˨dzip˦
以後不得善終	au˧˧pai˥˧bo˨˦ho˥˧bue˥˧
以後我再告訴你	au˧˧pai˥˧gua˥˧tsiaʔ˨ka˧˧li˥˧koŋ˥˧
以後才不會不認帳	tsiaʔ˨be˧˧au˧˧dzit˦a˥˧m˥˥dzin˧˧siau˨˩
以後才有成就	dzit˦au˧˧tsiaʔ˨u˧˧tsʰut˨tʰuat˨
以過量餵養的方式，把豬隻的體型在短時間之內撐得更大，通常在即將販售或競賽之前進行	kiŋ˥˥tua˧˧ti˥˥
仲介者	tioŋ˥˥laŋ˨˦
但他認真努力	m˥˥koʔ˨i˥˥dzin˧˧tsin˥˥pʰaʔ˨pĩã˨˩
但是也有副作用	m˥˥koʔ˨ma˧˧u˧˧hu˨˩tsok˨ioŋ˧˧
位於苗栗縣內	koŋ˥˥kuan˥˧hioŋ˥˥
低音	ke˧˧im˥˥
住在深山裡的男性，又指老實的莊稼人	lai˧˧sũã˥˥hĩã˥˥ko˥˥
何況凡人？比喻誰能無過	kʰa˥˥pɔ˧˧taʔ˦tsʰa˥˥sĩã˥˧laŋ˨˦bo˨˦
你一個月賺多少錢	li˥˧tsit˦gueʔ˦dzit˦tʰan˨˩gua˧˧tse˧˧tsĩ˨˦
你不可以來我家	li˥˧be˧˧sai˥˧lai˨˦guan˥˧tau˥˥
你不可以到處晃蕩	li˥˧m˥˥tʰaŋ˥˥si˨˩ke˨˩so˨˦
你不會寫的題目先打勾作記號	li˥˧be˧˧hiau˥˧sia˥˧e˨˦te˨˦bok˨to˧˧siŋ˥˥kau˥˥kʰi˥˧lai˨˦
你不用來了	li˥˧m˥˥bian˥˧lai˨˦aʔ˨
你不能中途就反悔不做	li˥˧be˧˧taŋ˨˩ti˧˧tioŋ˥˥tɔ˨˦huan˥˧hue˥˧m˥˥tso˨˩
你不要一天到晚四處亂跑	li˥˧m˥˥ho˥˧tsit˦dzit˦kau˨˩am˨˩pʰa˥˥pʰa˥˥tsau˥˧
你不要和他計較	li˥˧mai˨˩kaʔ˨i˥˥ke˨˩kau˨˩
你不要打得那麼用力	li˥˧m˥˥tʰaŋ˥˥ka˧˧pʰaʔ˨kaʔ˨hiaʔ˨ni˧˧a˥˧tua˧˧lat˦
你不要捉弄他了	li˥˧mai˨˩ka˧˧i˥˥tsʰoŋ˨˩ti˧˧laʔ˨
你不要放蕩過一生	li˥˧m˥˥tʰaŋ˥˥hoŋ˨˩toŋ˧˧kue˨˩it˨siŋ˥˥
你不要浪費精神了	li˥˧mai˨˩oŋ˥˧hui˨˩sim˥˥sin˨˦aʔ˨
你不要為難他	li˥˧mai˨˩ka˧˧i˥˥tiau˥˥kɔ˥˧toŋ˥˧
你不要落入圈套	li˥˧m˥˥tʰaŋ˥˥tioŋ˨˩ke˨˩
你不要跟他計較	li˥˧m˥˥tʰaŋ˥˥kaʔ˨i˥˥ke˨˩kau˨˩
你不要這麼三八	li˥˧m˥˥tʰaŋ˥˥hiaʔ˨pat˨tin˥˥
你不過是個學徒	li˥˧tsi˥˧put˨ko˨˩si˧˧tsit˦e˨˦pũã˨˩tʰaŋ˥˧sai˥˥a˥˧
你也不能亂來	li˥˧ma˧˧be˧˧iŋ˧˧tit˨ɔ˥˥peʔ˦lai˨˦
你以為裝得漠不關心就沒事了是嗎	li˥˧sĩũ˧˧koŋ˥˧kik˨gua˧˧gua˧˧to˧˧bo˨˦tai˧˧tsi˨˩aʔ˨si˧˧bo˨˦
你何時要搬入新家	li˥˧taŋ˥˥si˨˦beʔ˨dzip˦tsʰu˨˩
你們倆就別再爭吵了	lin˥˧to˧˧mai˨˩koʔ˨uan˥˥aʔ˨laʔ˨
你們這些年輕小伙子不要太衝動莽撞	lin˥˧tsia˥˥e˨˦siau˨˩lian˨˦ke˥˥m˥˥tʰaŋ˥˥sĩũ˥˥tsʰoŋ˥˧poŋ˧˧
你偏要	li˥˧kan˥˥kan˥˥a˥˧beʔ˨
你做事情不要猶豫不決	li˥˧tso˨˩tai˧˧tsi˨˩m˥˥tʰaŋ˥˥sam˥˥sim˥˥lioŋ˥˧i˨˩
你做得這麼辛苦還讓人嫌棄	li˥˧tso˨˩kaʔ˨hiaʔ˨sin˥˥kʰɔ˥˧koʔ˨hɔ˧˧laŋ˨˦hiam˨˦
你做這樣就可以了	li˥˧tso˨˩an˥˧ne˥˥to˧˧e˧˧sai˥˧aʔ˨
你先去吃一塊餅充飢	li˥˧siŋ˥˥kʰi˨˩tsiaʔ˦tsit˦te˨˩pĩã˥˧tsi˥˧iau˥˥
你先點菜	li˥˧siŋ˥˥kio˨˩tsʰai˨˩
你再怎麼說	li˥˧koʔ˨an˥˧tsũã˥˧koŋ˥˧
你出去之後	li˥˧tsʰut˨mŋ˥˥liau˥˧au˧˧
你出門在外	li˥˧tsʰut˨mŋ˥˥tsai˧˧gua˧˧
你出門的時候要記得帶雨衣	li˥˧tsʰut˨mŋ˥˥e˨˦si˨˦ai˨˩e˧˧ki˨˩tit˨tsaʔ˨hɔ˧˧mua˥˥
你別去釣魚	li˥˧m˥˥tʰaŋ˥˥kʰi˨˩tio˨˩hi˨˦
你別太晚回來	li˥˧m˥˥tʰaŋ˥˥sĩũ˥˥ũã˨˩tńg1lai˨˦
你別想騙他	li˥˧bian˥˧sĩũ˧˧beʔ˨kuai˥˧i˥˥
你別老說一些不三不四的話	li˥˧mai˨˩kian˨˩koŋ˥˧loŋ˥˧si˧˧tsit˦kua˥˧put˨tap˨put˨tsʰit˨e˨˦ue˧˧
你千萬不要再做壞事	li˥˧tsʰian˥˥ban˧˧m˥˥tʰaŋ˥˥koʔ˨kĩã˨˦pʰãĩ˥˧lɔ˧˧
你去叫他出來	li˥˧kʰi˨˩kio˨˩i˥˥tsʰut˨lai˨˦
你去問別人	li˥˧kʰi˨˩mŋ˥˥pat˦laŋ˨˦
你去將掉在床底下的東西勾出來	li˥˧kʰi˨˩ka˧˧ka˥˥lauʔ˦ti˧˧bin˨˦tsʰŋ˥˥kʰa˥˥e˨˦miʔ˦kĩã˧˧kau˥˥tsʰut˨lai˨˦
你去幫我買一個裝酒的小容器	li˥˧kʰi˨˩ka˧˧gua˥˧be˥˧tsit˦e˨˦tsiu˥˧tau˥˧a˥˧
你去看是誰	li˥˧kʰi˨˩kʰũã˨˩si˧˧sĩã˥˧miʔ˨laŋ˨˦
你去買一些零食來吃吃	li˥˧kʰi˨˩be˥˧tsit˦kua˥˧si˨˩siu˨˩a˥˧lai˨˦tam˧˧sam˥˧tsit˦e˧˧
你叫什麼名字	li˥˧kio˨˩sĩã˥˧miʔ˨mia˨˦
你吃飽了沒有	li˥˧tsiaʔ˦pa˥˧bue˧˧
你問我的事我都不知道	li˥˧mŋ˥˥gua˥˧e˨˦tai˧˧tsi˨˩gua˥˧loŋ˥˧m˥˥tsai˥˥
你四周去找找看	li˥˧kʰi˨˩si˨˩kʰɔ˥˥lian˨˩tńg1tsʰue˧˧kʰũã˨˩mai˧˧
你多少吃一點	li˥˧ai˨˩ke˥˥kiam˥˧tsiaʔ˦tsit˦kua˥˧
你太主動啦	li˥˧sĩũ˥˥kue˨˩tsu˥˧toŋ˧˧laʔ˨
你如果安靜不出聲	li˥˧na˧˧tiam˧˧tiam˧˧mai˨˩tsʰut˨sĩã˥˥
你如果想要做衣服	li˥˧na˧˧beʔ˨tso˨˩sã˥˥
你如果把錢借給我	li˥˧na˧˧ka˧˧tsĩ˨˦tsioʔ˨gua˥˧
你如果有何不測	li˥˧na˧˧si˧˧u˧˧sĩã˥˧miʔ˨sã˥˥tŋ˥˥nŋ˥˥te˥˧
你如果有心要做	li˥˧na˧˧si˧˧u˧˧sim˥˥beʔ˨tso˨˩
你如果有需要什麼	li˥˧na˧˧kʰiam˨˩kʰueʔ˨sĩãʔ˨
你如果要買房子	i˥˥teʔ˨tso˨˩tioŋ˥˥laŋ˨˦
你媳婦人人稱讚	lin˥˧sin˥˥pu˧˧laŋ˨˦laŋ˨˦o˥˥lo˥˧
你對這件事情有什麼看法	li˥˧tui˨˩tsit˨kĩã˧˧tai˧˧tsi˨˩u˧˧sĩã˥˧miʔ˨tsu˥˧tĩũ˥˥
你就安心去做	li˥˧to˧˧hoŋ˨˩sim˥˥kʰi˨˩tso˨˩
你就快點走	li˥˧to˧˧kin˥˧tsau˥˧
你就想休息	li˥˧to˧˧sĩũ˧˧beʔ˨hioʔ˨kʰun˨˩
你就找別人嘛	li˥˧to˧˧tsʰue˧˧pat˦laŋ˨˦maʔ˨
你工作要好好地做	li˥˧kʰaŋ˥˥kʰue˨˩tioʔ˨ai˨˩ho˥˧ho˥˧a˥˧tso˨˩
你帶頭	li˥˧tso˨˩tai˧˧siŋ˥˥
你幾公分高呢	li˥˧u˧˧kui˥˧koŋ˥˥hun˥˥kuan˨˦
你幾點要出門	li˥˧kui˥˧tiam˥˧beʔ˨tsʰut˨mŋ˥˥
你弟弟今年幾歲了	lin˥˧sio˥˧ti˧˧kin˥˥ni˨˦kui˥˧hue˨˩aʔ˨
你往這個方向直走就到了	li˥˧tui˨˩tsit˨e˨˦hoŋ˥˥hioŋ˨˩tit˦tit˦kĩã˨˦to˧˧kau˨˩aʔ˨
你很明顯地是在騙我	li˥˧hun˥˥biŋ˨˦si˧˧teʔ˨pʰian˨˩gua˥˧
你得收下	li˥˧to˧˧siu˥˥kʰi˥˧lai˨˦
你心裡在想什麼我清楚得很	li˥˧sim˥˥kũã˥˥teʔ˨sĩũ˧˧sĩã˥˧miʔ˨gua˥˧tsai˥˥tsai˥˥
你怎麼可以拿趕牛鞭打小孩呢	li˥˧na˥˧e˧˧sai˥˧giaʔ˦gu˨˦sut˨a˥˧teʔ˨sut˨gin˥˧a˥˧
你怎麼白天就在睡覺	li˥˧na˥˧e˧˧dzit˦si˨˦a˥˧to˧˧teʔ˨kʰun˨˩
你想要定我的罪	li˥˧sĩũ˧˧beʔ˨pʰũã˨˩gua˥˧e˨˦tsue˧˧
你應該開朗大方一點	li˥˧tioʔ˨kʰaʔ˨tua˧˧lɔ˧˧leʔ˨
你才五十歲而已	li˥˧tã˥˥a˥˧gɔ˧˧tsap˦hue˨˩nia˧˧nia˧˧
你才吃一點點東西怎麼會飽	li˥˧tsiaʔ˨tsiaʔ˦tsit˦tiam˥˧a˥˧miʔ˦kĩã˧˧na˥˧e˧˧pa˥˧
你把女兒嫁給他絕對不會錯	lin˥˧ka˧˧tsa˥˥bɔ˥˧kĩã˥˧ke˨˩i˥˥to˧˧bo˨˦m˥˥tioʔ˨laʔ˨
你是不是在外面欠別人錢	li˥˧si˧˧m˥˥si˧˧ti˧˧gua˧˧kʰau˥˧u˧˧kʰiam˨˩laŋ˨˦tsĩ˨˦
你是不是這樣說	li˥˧koŋ˥˧an˥˧ne˥˥si˧˧m˥˥
你是我們家的長孫	li˥˧si˧˧lan˥˧tau˥˥e˨˦tua˧˧sun˥˥
你會借嗎	li˥˧kã˥˧e˧˧tsioʔ˨i˥˥
你會放心將工作交給他做嗎	li˥˧kam˥˧hoŋ˨˩sim˥˥ka˧˧kʰaŋ˥˥kʰue˨˩kau˥˥hɔ˧˧i˥˥tso˨˩
你會有這種心理	li˥˧e˧˧u˧˧tsit˨kʰuan˥˧sim˥˥li˥˧
你有什麼不滿	li˥˧u˧˧sĩã˥˧miʔ˨put˨buan˥˧
你有沒有吃午餐	li˥˧kam˥˧u˧˧tsiaʔ˦tioŋ˥˥tau˨˩tǹg1
你沒事兇我幹嘛	li˥˧bo˨˦tai˧˧bo˨˦tsi˨˩pʰãĩ˥˧gua˥˧tsʰoŋ˨˩sĩãʔ˨
你準備手電筒了嗎	li˥˧kam˥˧u˧˧tsʰuan˨˦tsʰiu˥˧tian˧˧a˥˧
你現在正火冒三丈	li˥˧tsit˨ma˥˧tŋ˥˥teʔ˨sim˥˥koŋ˨˦hue˥˧toʔ˨
你的女兒長得很漂亮	lin˥˧tsit˨ui˧˧tsʰian˥˥kim˥˥sẽ˥˥tso˨˩tsin˥˥sui˥˧
你的存摺簿應該要換了	li˥˧e˨˦tsʰiu˥˧tsiʔ˨pʰɔ˧˧a˥˧ho˥˧ũã˧˧aʔ˨
你的年紀比我大	li˥˧e˨˦ni˨˦hue˨˩pi˥˧gua˥˧kʰaʔ˨tse˧˧
你的意見真多	tsuan˨˦li˥˧e˨˦i˨˩kian˨˩liau˥˧liau˥˧
你的戶籍所在地在哪裡	li˥˧hɔ˧˧kʰau˥˧ti˧˧to˥˧ui˧˧
你看起來怎麼會那麼沒有精神呢	li˥˧kʰũã˨˩tioʔ˨na˥˧e˧˧hiaʔ˨ni˧˧a˥˧bo˨˦guan˨˦kʰi˨˩
你真的很不中用	li˥˧tsin˥˥tsĩã˨˩u˧˧kau˨˩ke˧˧lɔ˧˧
你知道他的身世背景嗎	li˥˧kam˥˧tsai˥˥ĩã˥˧i˥˥e˨˦tsʰut˨sin˥˥
你穿這件衣服相當漂亮	li˥˧tsʰiŋ˧˧tsit˨nia˥˧sã˥˥koʔ˨put˨tsi˥˧a˥˧sui˥˧
你缺錢用就來告訴我	li˥˧u˧˧kʰiam˨˩iŋ˧˧to˧˧lai˨˦ka˧˧gua˥˧koŋ˥˧
你若不出手將來一定會反悔	tsioŋ˥˥lai˨˦it˨tiŋ˧˧e˧˧huan˥˧hue˥˧
你若要就趕快拿去	li˥˧na˧˧beʔ˨ai˨˩kin˥˧tʰeʔ˦kʰi˨˩
你處事不公	li˥˧kʰũã˨˩laŋ˨˦tua˧˧se˨˩bak˦
你要再稍微叮嚀他一下	li˥˧ai˨˩koʔ˨ka˧˧i˥˥sio˥˧tiŋ˥˥tsit˦e˧˧
你要叫他姑姑	li˥˧ai˨˩kio˨˩i˥˥a˥˥kɔ˥˥
你要嗎	li˥˧beʔ˨bo˨˦
你要多穿一件外衣	li˥˧ai˨˩ke˥˥tʰaʔ˦tsit˦nia˥˧gua˧˧sã˥˥
你要好好努力	li˥˧tioʔ˨ho˥˧ho˥˧a˥˧pʰaʔ˨pĩã˨˩
你要小心	li˥˧tioʔ˨se˨˩dzi˧˧
你要小心點	li˥˧tioʔ˨ai˨˩kʰaʔ˨se˨˩dzi˧˧leʔ˨
你要帶雨傘去	li˥˧tioʔ˨ai˨˩tsaʔ˨hɔ˧˧sũã˨˩kʰi˨˩
你要慢慢來	li˥˧tioʔ˨un˨˦a˥˧si˧˧
你要慢慢地走	li˥˧tioʔ˨un˨˦un˨˦a˥˧kĩã˨˦
你要拿好	li˥˧ai˨˩tʰeʔ˦hɔ˧˧i˥˥ho˥˧
你要是不努力一點	li˥˧na˧˧m˥˥kʰaʔ˨pʰaʔ˨pĩã˨˩leʔ˨
你要是說了不該說的話	li˥˧na˧˧si˧˧ke˥˥koŋ˥˧ue˧˧
你要更努力一點	li˥˧tioʔ˨kʰaʔ˨pʰaʔ˨pĩã˨˩leʔ˨
你要注意一點	li˥˧ai˨˩kʰaʔ˨tsu˨˩i˨˩leʔ˨
你要記得戴手套	li˥˧ai˨˩e˧˧ki˨˩tit˨kua˨˩tsʰiu˥˧lok˨a˥˧
你要認真努力	li˥˧ai˨˩dzin˧˧tsin˥˥pʰaʔ˨pĩã˨˩
你要認真努力	li˥˧tioʔ˨ai˨˩dzin˧˧tsin˥˥pʰaʔ˨pĩã˨˩
你要騎腳踏車	li˥˧beʔ˨kʰia˨˦kʰa˥˥taʔ˦tsʰia˥˥
你該起來上學了	li˥˧ho˥˧kʰi˥˧lai˨˦tʰak˦tsʰeʔ˨aʔ˨
你說	li˥˧koŋ˥˧
你說再多他也聽不進去	li˥˧koŋ˥˧koʔ˨kʰaʔ˨tse˧˧i˥˥ma˧˧tʰĩã˥˥be˧˧dzip˦ni˥˧
你說起話來像老母雞一樣	li˥˧koŋ˥˧ue˧˧na˥˧hue˥˧ke˥˥bo˥˧leʔ˨
你說過的話一定要記得	li˥˧koŋ˥˧kue˨˩e˨˦ue,7it˨tiŋ˧˧ai˨˩e˧˧ki˨˩tit˨
你講話不要那麼大聲	li˥˧koŋ˥˧ue˧˧m˥˥ho˥˧hiaʔ˨tua˧˧sĩã˥˥
你讓我考慮一下	li˥˧hɔ˧˧gua˥˧kʰo˥˧li˧˧tsit˦e˧˧
你買這幹嘛	li˥˧be˥˧tse˥˥beʔ˨tsʰoŋ˨˩sĩãʔ˨
你走慢一些我才跟得上	li˥˧kĩã˨˦kʰaʔ˨ban˧˧leʔ˨gua˥˧m˥˥tsiaʔ˨tue˨˩e˧˧tioʔ˨
你越說	li˥˧dzu˥˧koŋ˥˧
你趕快去勸阻一下	li˥˧kin˥˧kʰi˨˩ka˧˧tsiam˨˩
你這個可憐的小孩子	li˥˧tsit˨e˨˦kʰo˥˧lian˨˦e˨˦gin˥˧a˥˧
你這個短命鬼	li˥˧tsit˨e˨˦iau˥˧siu˧˧te˥˧mia˧˧e˨˦
你這個臭小子	li˥˧tsit˨e˨˦tsʰau˨˩sio˥˧kĩã˥˧
你這樣做不怕會短命	li˥˧an˥˧ne˥˥tso˨˩m˥˥kĩã˥˥e˧˧iau˥˧siu˧˧
你這種人	li˥˧tsit˨kʰuan˥˧laŋ˨˦
你這種粗魯的個性要改一改	li˥˧tsit˨kʰuan˥˧tʰɔ˥˧koŋ˥˥a˥˧siŋ˨˩tioʔ˨ai˨˩kai˥˧laʔ˨
你還不知死活	li˥˧koʔ˨m˥˥tsai˥˥si˥˧
你還會見風轉舵	li˥˧koʔ˨e˧˧hiau˥˧si˥˥kue˥˥ua˥˧tua˧˧piŋ˨˦
你還要買	li˥˧koʔ˨beʔ˨be˥˧
你都不可以說	li˥˧loŋ˥˧be˧˧sai˥˧koŋ˥˧
你難道不怕看到鬼嗎	li˥˧kam˥˧m˥˥kĩã˥˥kʰi˨˩kʰũã˨˩tioʔ˨pʰãĩ˥˧miʔ˨a˥˧
使勁地打下去	tsʰut˨lat˦ka˧˧pʰaʔ˨loʔ˨kʰi˨˩
來來來	lai˨˦lai˨˦lai˨˦
來我們店裡捧場的人比較少	lai˨˦guan˥˧tiam˨˩kau˥˥kuan˥˥e˨˦laŋ˨˦kʰeʔ˨u˧˧kʰaʔ˨tsio˥˧
依照北斗七星排列所設的陣式	tsʰit˨tsʰẽ˥˥tin˧˧
保證會贏	pau˥˥ĩã˨˦e˨˦
信心	sin˨˩sim˥˥
信用卡	sin˨˩ioŋ˧˧kʰaʔ˨
偏方	pʰian˥˥hŋ˥˥
做人得受生活的折磨	tso˨˩laŋ˨˦tioʔ˨bua˨˦
做人心腸不要那麼壞	tso˨˩laŋ˨˦m˥˥tʰaŋ˥˥hiaʔ˨pʰãĩ˥˧sim˥˥
做官	tsʰut˨su˧˧
做牛得要拖犁耕田	tso˨˩gu˨˦tioʔ˨tʰua˥˥
做生意要敢投入本錢	tso˨˩siŋ˥˥li˥˧ai˨˩kã˥˧he˧˧pun˥˧
做起任何事都很不方便	tso˨˩sĩã˥˧miʔ˨tai˧˧tsi˨˩loŋ˥˧tsin˥˥bo˨˦hoŋ˥˥pian˧˧
做長輩的人對待晚輩不可以偏心	tso˨˩si˧˧tua˧˧e˨˦laŋ˨˦tui˨˩tʰai˧˧gin˥˧a˥˧m˥˥tʰaŋ˥˥tua˧˧se˨˩sim˥˥
偶爾	ku˥˧ku˥˧a˥˧
偶爾	sam˥˥put˨gɔ˧˧si˨˦
傷者和死者	sioŋ˥˥boŋ˨˦
傻氣不正經的人	sam˥˥pat˨laŋ˨˦
像這種六月炎熱的天氣	lak˦gueʔ˦hue˥˧sio˥˥pɔ˥˥
像這麼冷的天氣裡	tsʰĩũ˧˧tsit˨kʰuan˥˧tua˧˧kũã˨˦e˨˦tʰĩ˥˥
價錢很合理	ke˨˩tsĩ˨˦tsin˥˥koŋ˥˥to˧˧
價錢這麼高	ke˨˩tsĩ˨˦tsiaʔ˨kuan˨˦li˥˧na˧˧m˥˥tsʰut˨tsʰiu˥˧
儘管說出來	tso˨˩li˥˧koŋ˥˧tsʰut˨lai˨˦
兄弟各分東西了	hĩã˥˥ti˧˧loŋ˥˧hun˥˥sũã˨˩liau˥˧liau˥˧aʔ˨
先下手為強	siŋ˥˥he˧˧tsʰiu˥˧ui˨˦kioŋ˨˦
免得調解間反而變成當事人	m˥˥tʰaŋ˥˥koŋ˥˥tsʰin˥˥pian˨˩su˧˧tsu˥˧
兒子如果長大	gin˥˧a˥˧na˧˧tua˧˧han˨˩
入土為安	dzip˦tʰɔ˥˧ui˨˦an˥˥
入帳	dzip˦siau˨˩
入殮。將屍體移入棺材	dzip˦bok˨
內外事物都是他在掌理	gua˧˧tʰau˨˦kaʔ˨lai˧˧tʰau˨˦loŋ˥˧i˥˥teʔ˨hũã˧˧
內容	lue˧˧ioŋ˨˦
內政	lue˧˧tsiŋ˨˩
內閣	lue˧˧koʔ˨
全完蛋了	kʰi˨˩liau˥˧liau˥˧aʔ˨
全身都充滿了活力	kʰui˨˩lat˦tsap˦tsiok˨
全部的家產都完蛋了	kui˥˥e˨˦ke˥˥hue˥˧loŋ˥˧kʰi˨˩liau˥˧liau˥˧aʔ˨
兩代以上的交誼	se˨˩kau˥˥
兩個人	nŋ˥˥e˨˦laŋ˨˦
兩邊都不參加	nŋ˥˥piŋ˨˦loŋ˥˧bo˨˦ai˨˩tsʰam˥˥ka˥˥
兩隊人馬在街道相遇	nŋ˥˥tui˧˧dzin˨˦ma˥˧ti˧˧ke˥˥a˥˧lɔ˧˧sio˥˥tu˥˧
八仙過海	pat˨sian˥˥kue˨˩hai˥˧
八個人	peʔ˨e˨˦laŋ˨˦
八道菜	peʔ˨tsʰut˨tsʰai˨˩
公事要照規矩做	koŋ˥˥su˧˧tioʔ˨ai˨˩tsiau˨˩kʰi˥˧kaŋ˥˥tso˨˩
公公	ta˥˥kũã˥˥
公共事務	koŋ˥˥ka˥˥tai˧˧tsi˨˩
公共場所	koŋ˥˥kioŋ˧˧tĩũ˨˦sɔ˥˧
公共電話	koŋ˥˥ioŋ˧˧tian˧˧ue˧˧
公務人員	koŋ˥˥bu˧˧dzin˨˦uan˨˦
公司的事情就麻煩你代理一下	koŋ˥˥si˥˥e˨˦tai˧˧tsi˨˩tsiaʔ˨lo˨˦huan˨˦li˥˧tai˧˧li˥˧tsit˦e˧˧
公家機關	koŋ˥˥ka˥˥ki˥˥kuan˥˥
公海	koŋ˥˥hai˥˧
公物	koŋ˥˥but˦
公的	kaŋ˥˥e˨˦
六年戊班	lak˦ni˨˦bɔ˧˧pan˥˥
兵力	piŋ˥˥lik˦
再等一下	koʔ˨tan˥˧tsit˦e˧˧laʔ˨
冒犯、侵犯	kan˥˥huan˧˧
冬天	taŋ˥˥tʰĩ˥˥
冬筍	taŋ˥˥sun˥˧
凌晨一點到三點	tʰiu˥˧si˨˦
凡事都要仔細小心地想清楚	tak˦haŋ˧˧tai˧˧tsi˨˩loŋ˥˧ai˨˩sĩũ˧˧hɔ˧˧i˥˥kʰaʔ˨tsim˥˥tsiok˨leʔ˨
凡人有很多事情看不開	se˨˩siok˨laŋ˨˦u˧˧tsĩã˨˦tse˧˧tai˧˧tsi˨˩kʰũã˨˩be˧˧kʰui˥˥
凡間	huan˧˧kan˥˥
凹下去	naʔ˨loʔ˨kʰi˨˩
出五百要跟他買	tsʰut˨gɔ˧˧paʔ˨beʔ˨ka˧˧i˥˥be˥˧
出入要小心	tsʰut˨dzip˦ai˨˩se˨˩dzi˧˧
出名	tsʰut˨mia˨˦
出國	tsʰut˨kok˨
出太陽	tsʰut˨dzit˦
出太陽	tsʰut˨dzit˦tʰau˨˦
出家人必須要看破世間瑣事	tsʰut˨ke˥˥laŋ˨˦tioʔ˨ai˨˩kʰũã˨˩pʰua˨˩se˨˩tsiŋ˨˦
出氣	tsʰut˨kʰui˨˩
出生	tsʰut˨si˨˩
出界	tsʰut˨kai˨˩
出社會	tsʰut˨sia˧˧hue˧˧
出菜	tsʰut˨tsʰai˨˩
出遠門自己要小心一點	tsʰut˨gua˧˧ka˥˥ki˧˧ai˨˩kʰaʔ˨se˨˩dzi˧˧leʔ˨
出錢	tsʰut˨tsĩ˨˦
出頭	tsʰut˨tʰau˨˦
分不平均	pun˥˥be˧˧pẽ˨˦
分你一半	tsit˦pũã˨˩pun˥˥li˥˧
刊物	kʰan˥˥but˦
划龍船	pe˨˦liŋ˨˦tsun˨˦
別不好意思啦	bian˥˧pʰãĩ˥˧se˨˩laʔ˨
別人比較不愛跟他相處	laŋ˨˦kʰaʔ˨bo˨˦ai˨˩kaʔ˨i˥˥tau˨˩tin˧˧
別人要來找你算帳了	laŋ˨˦beʔ˨lai˨˦tsʰue˧˧li˥˧sǹg1siau˨˩aʔ˨
別再出價了	mai˨˩koʔ˨tsʰut˨aʔ˨
別理他	mai˨˩tsʰap˨i˥˥
利尿	li˧˧sui˥˧
到此為止	kau˨˩tsia˥˥ui˨˦tsi˥˧
到現在二十四小時了	kau˨˩tã˥˥tsit˦tui˨˩si˨˦aʔ˨
到現在還在不舒服	kau˨˩tã˥˥iau˥˧teʔ˨kan˥˥kʰɔ˥˧
到現在還是收不回來	kau˨˩tã˥˥iau˥˧siu˥˥be˧˧tńg1lai˨˦
到處跑	si˨˩ke˨˩tsau˥˧
刷子	bin˥˧a˥˧
前後輩份	tiŋ˥˧e˧˧un˨˦
剛剛還出大太陽	tu˥˧tsiaʔ˨iau˥˧teʔ˨tsʰut˨dzit˦tʰau˨˦
剛好可以看到月亮	tu˥˧ho˥˧e˧˧taŋ˨˩kʰũã˨˩tioʔ˨gueʔ˦niu˨˦
剛才	tã˥˥tsiaʔ˨
剪刀	ka˥˥to˥˥
副本	hu˨˩pun˥˧
割包	kuaʔ˨pau˥˥
力氣	kʰui˨˩lat˦
力道真大	lat˦tʰau˨˦tsin˥˥pa˥˧
力量	lik˦lioŋ˧˧
功勞	koŋ˥˥lo˨˦
功效	koŋ˥˥hau˧˧
加倍	ka˥˥pue˧˧
加工	ka˥˥kaŋ˥˥
動不動就要罵人	kʰap˦be˧˧tioʔ˨to˧˧beʔ˨ka˧˧laŋ˨˦me˧˧
勞工	lo˨˦kaŋ˥˥
勸世歌是在勸人不可以做壞事的	kʰuan˨˩se˨˩kua˥˥si˧˧teʔ˨khǹg1laŋ˨˦m˥˥tʰaŋ˥˥tso˨˩pʰãĩ˥˧tai˧˧e˨˦
包伙食	pau˥˥hue˥˧sit˦
包機	pau˥˥ki˥˥
包水餃	pau˥˥tsui˥˧kiau˥˧
包裝書本	pau˥˥tsʰeʔ˨
化工	hua˨˩kaŋ˥˥
化除痰液	hua˨˩tʰam˨˦
北上，多指縱貫線火車上行	tsĩũ˧˧pak˨
北上的火車	tsĩũ˧˧pak˨e˨˦hue˥˧tsʰia˥˥
北邊	pak˨piŋ˨˦
十二點要吃午餐了	tsap˦dzi˧˧tiam˥˧beʔ˨tsiaʔ˦tioŋ˥˥tau˨˩aʔ˨
十五音	sip˦ŋɔ˥˧im˥˥
十個人	tsap˦e˨˦laŋ˨˦
十全十美	sip˦tsuan˨˦sip˦bi˥˧
十分的完美	sip˦tsuan˨˦sip˦bi˥˧
十字路口	sip˦dzi˧˧lɔ˧˧
千夫所指	tsʰian˥˥hu˥˥sɔ˥˧tsi˥˧
千萬不要做決定	tsʰian˥˥ban˧˧m˥˥tʰaŋ˥˥tso˨˩kuat˨tiŋ˧˧
千萬人	tsʰian˥˥ban˧˧laŋ˨˦
千辛萬苦	tsʰian˥˥sin˥˥ban˧˧kʰɔ˥˧
升天	siŋ˥˥tʰian˥˥
升官發財	siŋ˥˥kũã˥˥huat˨tsai˨˦
升斗	bi˥˧tsin˥˥
升旗	siŋ˥˥ki˨˦
午時	ŋɔ˥˧si˨˦
午飯吃飽了就該休息	tioŋ˥˥tau˨˩pŋ˥˥tsiaʔ˦pa˥˧to˧˧ho˥˧hioʔ˨kʰun˨˩
半夜跑到墓園去	sã˥˥kẽ˥˥pũã˨˩me˨˦tsau˥˧kʰi˨˩boŋ˧˧a˥˧pɔ˥˥
半數	puan˨˩sɔ˨˩
半路	pũã˨˩lɔ˧˧
半途	puan˨˩tɔ˨˦
半隻	pũã˨˩tsiaʔ˨
博士	pʰok˨su˧˧
占大多數	tsiam˨˩tai˧˧to˥˥sɔ˨˩
占據位子	tsiam˨˩ui˧˧
占有利的時機還不如占地理優勢	tʰian˥˥si˨˦put˨dzu˨˦te˧˧li˧˧
卻打我出氣	suaʔ˨pʰaʔ˨gua˥˧tsʰut˨tsui˥˧
原本	guan˨˦pun˥˧
去傷解鬱悶	kʰi˨˩sioŋ˥˥kai˥˧ut˨
去吃飯	kʰi˨˩tsiaʔ˦pŋ˥˥
去年這裡山林失火	ku˧˧ni˨˦tsia˥˥hue˥˧sio˥˥sũã˥˥
去日本	kʰi˨˩dzit˦pun˥˧
又何必故意為難他	ho˨˦mi˥˧kʰɔ˥˧ka˧˧i˥˥tʰiau˥˥lan˨˦
反倒來幫我們忙	huan˥˧to˨˩tńg1koʔ˨lai˨˦ka˧˧lan˥˧tau˨˩sã˥˥kaŋ˧˧
反對	huan˥˧tui˨˩
反對的人是少數	huan˥˧tui˨˩e˨˦laŋ˨˦si˧˧tsio˥˧sɔ˨˩
反應不好	huan˥˧iŋ˨˩bo˨˦ho˥˧
反而	huan˥˧to˨˩tńg1lai˨˦
受訓之後	siu˧˧hun˨˩liau˥˧au˧˧
古時候	kɔ˥˧tsa˥˧si˨˦tai˧˧
古時候對他人母親的尊稱	tʰai˨˩hu˥˥dzin˨˦
古時候有些老人家會自己買棺材	kɔ˥˧tsa˥˧u˧˧e˨˦lau˧˧tua˧˧laŋ˨˦e˧˧ka˥˥ki˧˧be˥˧tua˧˧tsʰu˨˩
只不過	tsi˥˧put˨ko˨˩
只剩這些菜而已	kan˥˥na˥˥tsʰun˥˥tsia˥˥e˨˦tsʰai˨˩nia˧˧nia˧˧
只好慢慢咀嚼	tsi˥˧ho˥˧tauʔ˦tauʔ˦a˥˧mauʔ˨
只好暫時去當臨時工	tsi˥˧ho˥˧tsiam˧˧si˨˦kʰi˨˩tso˨˩lim˨˦si˨˦kaŋ˥˥
只是一點點小意思而已	tsi˥˧si˧˧tsit˦sut˨a˥˧sio˥˧i˨˩su˨˩nia˧˧nia˧˧
只有	tsi˥˧u˧˧
只有鳥啼叫的聲音	kan˥˥na˥˥u˧˧tsiau˥˧a˥˧tʰi˨˦kio˨˩e˨˦sĩã˥˥
只知道顧自己的利益	kan˥˥na˥˥tsai˥˥ĩã˥˧kɔ˨˩ka˥˥ki˧˧e˨˦li˧˧ik˨
只要一想到這件事情	na˧˧sĩũ˧˧tioʔ˨tsit˨tsan˨˦tai˧˧tsi˨˩
只要存點錢	kian˨˩na˧˧kʰiam˧˧kua˥˧tsĩ˨˦
只要有你	tsi˥˧iau˨˩u˧˧li˥˧
只除去成本，未除去其他費用的利潤	mɔ˨˦li˧˧
叫你不要	kio˨˩li˥˧mai˨˩
叫我要怎麼活下去	kio˨˩gua˥˧beʔ˨an˥˧tsũã˥˧uaʔ˦loʔ˨kʰi˨˩
叫苦連天	kio˨˩kʰɔ˥˧lian˨˦tʰian˥˥
叫菜	kio˨˩tsʰai˨˩
叫車	kio˨˩tsʰia˥˥
召集令	tiau˨˩tsip˦liŋ˧˧
可以	kʰo˥˧i˥˧
可以施捨十塊錢給我嗎	tsap˦kʰɔ˥˥gin˨˦lai˨˦pun˥˥gua˥˧ho˥˧bo˨˦
可以看到成千上萬顆星星	e˧˧sai˥˧kʰũã˨˩tioʔ˨tsʰian˥˥tsʰian˥˥ban˧˧ban˧˧liap˦tsʰẽ˥˥
可能	kʰo˥˧liŋ˨˦
可見	kʰo˥˧kian˨˩
吃不多	tsiaʔ˦be˧˧tse˧˧
吃些熱食是最好的了	tsiaʔ˦tsit˦kua˥˧sio˥˥e˨˦sioŋ˧˧ho˥˧
吃又要吃	tsiaʔ˦iu˧˧beʔ˨tsiaʔ˦
吃得乾淨	tsiaʔ˦hɔ˧˧tsʰiŋ˥˥kʰi˨˩
吃藥必須喝溫開水	tsiaʔ˦ioʔ˨a˥˧ai˨˩pʰue˨˩pũã˨˩sio˥˥liŋ˥˧e˨˦kun˥˧tsui˥˧
吃藥能止痛	tsiaʔ˦ioʔ˨a˥˧e˧˧taŋ˨˩tsi˥˧tʰĩã˨˩
吃飯吃得這麼不情不願	tsiaʔ˦pŋ˥˥tsiaʔ˦kaʔ˨tsiaʔ˨ni˧˧a˥˧m˥˥tsiŋ˨˦guan˧˧
合人參、白朮、茯苓、甘草、熟地、白芍、當歸、川芎、黃茋、肉桂等十種藥材的補藥	sip˦tsuan˨˦tai˧˧pɔ˥˧tʰŋ˥˥
同樣	kaŋ˧˧kʰuan˥˧
名片	biŋ˨˦pʰĩ˨˩
向道士求討符咒	kʰit˨hu˨˦a˥˧
哲學入門	tiat˨hak˦dzip˦mŋ˥˥
商店門口	tiam˨˩mŋ˥˥kʰau˥˧
喜慶的時候不可以說不祥的話	lau˧˧dziat˦si˨˦a˥˧m˥˥tʰaŋ˥˥koŋ˥˧pʰãĩ˥˧ue˧˧
喜歡扯女孩的辮子	ai˨˩tsʰuaʔ˨tsa˥˥bɔ˥˧gin˥˧a˥˧e˨˦mŋ˥˥bue˥˧a˥˧
喝水止渴	lim˥˥tsui˥˧tsi˥˧tsʰui˨˩ta˥˥
單槍匹馬	tan˥˥tsʰioŋ˥˥pʰit˨ma˥˧
嗜酒的人	tsiu˥˧sian˥˥
嘴唇扁掉凹陷的樣子	tsʰui˨˩mauʔ˨mauʔ˨
嚇一跳	kĩã˥˥tsit˦e˧˧
囚禁	siu˨˦kim˨˩
四個人	si˨˩e˨˦laŋ˨˦
四周很安靜	si˨˩pĩ˥˥tiam˧˧tsiŋ˧˧
四方	su˨˩hoŋ˥˥
四書五經	su˨˩su˥˥ŋɔ˥˧kiŋ˥˥
四物雞湯	su˨˩but˦a˥˧ke˥˥
四肢無力	su˨˩ki˥˥bo˨˦lat˦
因為你沒來	to˧˧si˧˧li˥˧bo˨˦lai˨˦
國王	kok˨oŋ˨˦
國際救援組織	aŋ˨˦sip˦dzi˧˧hue˧˧
土匪	tʰɔ˥˧hui˥˧a˥˧
土地	tʰɔ˥˧te˧˧
土產	tʰɔ˥˧san˥˧
在不好的年頭，狂人奇事特別多。比喻怪事年年有，今年特別多	pʰãĩ˥˧ni˨˦taŋ˥˥kau˧˧siau˥˧laŋ˨˦
在天上天公最大，在人間舅公最大。這是來自閩南風俗的說法，指舅舅地位高，所以每逢婚嫁喜事，或有舅舅會出席的場合，多請他出面主持	tʰĩ˥˥tiŋ˥˧tʰĩ˥˥kong,1te˧˧e˧˧bu˥˧ku˧˧koŋ˥˥
在於你是否願意去做	kai˨˩tsai˧˧li˥˧beʔ˨tso˨˩m˥˥tso˨˩
在食物中放鹽	he˧˧iam˨˦
地勢比較低	sũã˥˥se˨˩kʰaʔ˨ke˧˧
地支前四位	tsu˥˧tʰiu˥˧in˨˦bau˥˧
地方	te˧˧hŋ˥˥
地板一兩次沒擦	tʰɔ˨˦kʰa˥˥tsit˦pũã˨˩pai˥˧a˥˧bo˨˦tsʰit˨
坐好	tse˧˧hɔ˧˧ho˥˧
執政者多少都有包袱	tsip˨tsiŋ˨˩tsia˥˧loŋ˥˧ke˥˥kiam˥˧u˧˧pau˥˥hok˨a˥˧
塊頭真大	tsin˥˥tua˧˧pʰiaŋ˧˧
增加	ka˥˥tʰiam˥˥
壞事、壞消息卻一直來糾纏。比喻壞事連連	pʰãĩ˥˧tai˧˧tit˦tit˦lai˨˦kau˥˥tĩ˨˦
壞事爭著來告知	pʰãĩ˥˧kʰaŋ˥˥e˨˦sio˥˥tsẽ˥˥po˨˩
壞心	pʰãĩ˥˧sim˥˥
士農工商	su˧˧loŋ˨˦kaŋ˥˥sioŋ˥˥
夏令時間	ha˧˧liŋ˧˧si˨˦kan˥˥
外交	gua˧˧kau˥˥
外國	gua˧˧kok˨
外祖母住在宜蘭	gua˧˧ma˥˧tua˨˩ti˧˧gi˨˦lan˨˦
外面很冷	gua˧˧kʰau˥˧tsin˥˥kũã˨˦
外頭	gua˧˧kʰau˥˧
多少吃一點	ke˥˥kiam˥˧tsiaʔ˦tsit˦kua˥˧
多少賺點外快來添補家用	ke˥˥kiam˥˧tʰan˨˩tsit˦kua˥˧a˥˧gua˧˧lɔ˧˧a˥˧lai˨˦sio˥˥tʰĩ˥˥sɔ˥˧hui˨˩
多數人皆知	tua˧˧pɔ˧˧hun˧˧e˨˦laŋ˨˦loŋ˥˧tsai˥˥
多花錢而已	ke˥˥liau˥˧tsĩ˨˦e˨˦
夢中	baŋ˧˧tioŋ˥˥
大事化小	tua˧˧su˧˧hua˨˩sio˥˧su˧˧
大事盡量化解成小事	tua˧˧su˧˧hua˨˩sio˥˧su˧˧
大人	tua˧˧laŋ˨˦
大人少吃一口，小孩子就可以吃得飽，甚至吃到膩了	tua˧˧laŋ˨˦kʰiam˧˧tsit˦tshui,3gin˥˧a˥˧tsiaʔ˦kaʔ˨ui˨˩
大伯父	tua˧˧peʔ˨
大前天	tua˧˧tsoʔ˨dzit˦
大哥	tua˧˧hĩã˥˥
大地震會讓人心驚膽顫	tua˧˧te˧˧taŋ˧˧e˧˧hɔ˧˧laŋ˨˦sim˥˥kĩã˥˥tã˥˧hĩãʔ˨
大型空心菜	tua˧˧pun˥˧iŋ˨˩tsʰai˨˩
大姊	tua˧˧tsi˥˧
大姊昨天食指被碎玻璃割到	tua˧˧tsi˥˧tsa˥˥hŋ˥˥dzi˧˧tsãĩ˥˧kʰi˨˩hɔ˧˧po˥˥le˨˦iu˨˩a˥˧kuaʔ˨tioʔ˨
大嫂疼小叔	tua˧˧so˥˧tʰĩã˨˩sio˥˧tsik˨
大學畢業之後	tai˧˧hak˦tsʰut˨giap˦liau˥˧au˧˧
大學畢業以後就要找工作做	tai˧˧hak˦pit˨giap˦liau˥˧au˧˧to˧˧ai˨˩tsʰue˧˧tʰau˨˦lɔ˧˧
大家一定會曬得很黑	tak˦ke˥˥it˨tiŋ˧˧e˧˧pʰak˦kaʔ˨ɔ˥˥so˨˦so˨˦
大家一起過來吃飯	tak˦ke˥˥tsĩũ˧˧toʔ˨tsiaʔ˦pŋ˥˥
大家幫他分擔一點	lan˥˧ka˧˧i˥˥tau˨˩pun˥˥pʰẽ˥˥tam˧˧poʔ˨a˥˧
大家會分發到不同單位	tak˦ke˥˥e˧˧hun˥˥huat˨kʰi˨˩bo˨˦kaŋ˧˧e˨˦tan˥˥ui˧˧
大家都不知道他跑到哪裡去了	tak˦ke˥˥loŋ˥˧m˥˥tsai˥˥ĩã˥˧i˥˥tsau˥˧kʰi˨˩to˥˧ui˧˧
大家都分配得到	tak˦ke˥˥loŋ˥˧u˧˧tʰaŋ˥˥pun˥˥pʰẽ˥˥
大家都各奔東西了	toŋ˨˦hak˦loŋ˥˧si˨˩sũã˨˩kʰi˨˩aʔ˨
大家都知道他的手腳不乾淨，即指有偷竊的惡習	tak˦ke˥˥loŋ˥˧tsai˥˥ĩã˥˧i˥˥pʰãĩ˥˧tsʰiu˥˧dziau˥˧
大富由天安排，命中註定，小富則靠自已努力累積。即勸人不要心存野心，但要勤奮努力	tua˧˧pu˨˩iu˨˦thinn,1sio˥˧pu˨˩iu˨˦dzin˨˦
大後天	tua˧˧au˧˧dzit˦
大德	tai˧˧tik˨
大掃除的時候	tua˧˧pĩã˨˩sau˨˩e˨˦si˨˦
大月	tua˧˧gueʔ˦
大河沒有覆蓋。這句話多用於罵人去跳河自殺算了	tua˧˧kaŋ˥˧bo˨˦kʰam˨˩kua˨˩
大眼睛的新娘沒看見爐灶。諷刺一個人對於近在眼前的大目標，居然看不見	tua˧˧bak˦sin˥˥niu˨˦tsʰue˧˧bo˨˦tsau˨˩
大聲喊叫	tua˧˧sĩã˥˥kio˨˩
大衣裡面還要再穿一件毛衣才不會冷	hiu˨˦a˥˧lai˧˧bin˧˧ai˨˩koʔ˨ke˥˥tsʰiŋ˧˧tsit˦nia˥˧pʰoŋ˨˩se˥˥sã˥˥tsiaʔ˨be˧˧kũã˨˦
大量	tai˧˧lioŋ˧˧
大量生產才划算	tai˧˧lioŋ˧˧siŋ˥˥san˥˧tsiaʔ˨sǹg1e˧˧ho˨˦
天上	tʰĩ˥˥tiŋ˥˧
天下太平	tʰian˥˥ha˧˧tʰai˨˩piŋ˨˦
天亮了	tʰĩ˥˥kŋ˥˥aʔ˨
天啊	hɔʔ˨
天地顛倒，引申為違反常理	tʰĩ˥˥te˧˧tian˥˥to˨˩piŋ˥˧
天堂	tʰian˥˥toŋ˨˦
天天醉	tʰian˥˥tʰian˥˥tsui˨˩
天底下	tʰĩ˥˥kʰa˥˥e˧˧
天性	tʰian˥˥siŋ˨˩
天氣很冷	tʰĩ˥˥kʰi˨˩tsin˥˥kũã˨˦
天河	tʰian˥˥ho˨˦
天災	tʰian˥˥tsai˥˥
天神	tʰian˥˥sin˨˦
天神也無法做到滿足所有人的願望	tso˨˩tʰĩ˥˥ma˧˧be˧˧tiŋ˨˩tsiŋ˨˩laŋ˨˦i˨˩
天花板也要清一清	tʰian˥˥poŋ˨˦ma˧˧tioʔ˨tsʰiŋ˥˥tsʰiŋ˥˥leʔ˨
天那麼黑	tʰĩ˥˥hiaʔ˨ni˧˧a˥˧ɔ˥˥
太多了	sĩũ˥˥tse˧˧
夫君	hu˥˥kun˥˥
夫妻	aŋ˥˥a˥˧bɔ˥˧
夫妻一定要同心	hu˥˥hu˧˧tioʔ˨ai˨˩kaŋ˧˧sim˥˥
夫妻半夜在吵架	aŋ˥˥a˥˧bɔ˥˧pũã˨˩me˨˦teʔ˨uan˥˥ke˥˥
失勢	sit˨se˨˩
失去貞操	sit˨sin˥˥
失學	sit˨hak˦
失守	sit˨siu˥˧
失敗	sit˨pai˧˧
失敬	sit˨kiŋ˨˩
失眠	sit˨bin˨˦
失算	sit˨sǹg1
失約	sit˨iok˨
失血	sit˨hueʔ˨
失言	sit˨gian˨˦
失陪	sit˨pue˨˦
奇巧	ki˨˦kʰa˥˧
奏本	tsau˨˩pun˥˧
女大十八變	tsa˥˥bɔ˥˧gin˥˧a˥˧tsap˦peʔ˨pian˨˩
女婿是半子	kĩã˥˧sai˨˩si˧˧puan˨˩tsu˥˧
女子	lu˥˧tsu˥˧
女權	lu˥˧kʰuan˨˦
奴婢	lɔ˨˦pi˧˧
奴才	lɔ˨˦tsai˨˦
奸巧	kan˥˥kʰiau˥˧
好久不見	kiu˥˧kian˨˩kiu˥˧kian˨˩
好久不見了	tsin˥˥ku˥˧bo˨˦kĩ˨˩bin˧˧aʔ˨
好事不來	ho˥˧kʰaŋ˥˥e˨˦m˥˥lai˨˦
好事、好消息不來報喜	ho˥˧tai˧˧m˥˥tʰoŋ˥˥ti˥˥
好人	ho˥˧laŋ˨˦
好大的膽子	ho˥˧tua˧˧tã˥˧
好心	ho˥˧sim˥˥
好心的老闆	ho˥˧sim˥˥e˨˦tʰau˨˦ke˥˥
好處多多	put˨tsi˥˧a˥˧ho˥˧kʰaŋ˥˥
如今全完蛋了	tã˥˥loŋ˥˧hai˧˧liau˥˧liau˥˧aʔ˨
如果你要做研究	li˥˧na˧˧beʔ˨tso˨˩gian˥˧kiu˨˩
妻子的哥哥	lue˧˧hiŋ˥˥
妻子的姊妹	i˨˦a˥˧
婆婆	ta˥˥ke˥˥
婦人稱夫兄	tua˧˧peʔ˨a˥˧
婦女	hu˧˧li˥˧
媽媽一死	lau˧˧bu˥˧tsit˦e˧˧si˥˧
媽媽正在天井裡曬被子	a˥˥bu˥˧tŋ˥˥teʔ˨tʰĩ˥˥tsẽ˥˧lai˧˧pʰak˦pʰue˧˧
嫂子	so˥˧a˥˧
嬰兒無六月天。意為嬰兒抵抗力弱，容易感冒，即使在六月大熱天也要保暖，不得疏忽	aŋ˨˦ẽ˥˥a˥˧bo˨˦lak˦gueʔ˦tʰĩ˥˥
子弟	tsu˥˧te˧˧
子彈	tsʰiŋ˨˩tsi˥˧
孔子	kʰoŋ˥˧tsu˥˧koŋ˥˥
孝順的兒子。也指父母死後，居喪守孝的兒子	hau˨˩tsu˥˧
孩子王	gin˥˧a˥˧oŋ˨˦
孩子還小	gin˥˧a˥˧iau˥˧koʔ˨se˨˩han˨˩
孩子長大離家以後你就輕鬆了	gin˥˧a˥˧li˧˧kʰa˥˥tsʰiu˥˧i˥˧au˧˧li˥˧to˧˧kʰin˥˥saŋ˥˥aʔ˨
學期中	hak˦ki˨˦tioŋ˥˥
學生們每天都要去學校讀書	hak˦siŋ˥˥gin˥˧a˥˧tak˦kaŋ˥˥loŋ˥˧ai˨˩kʰi˨˩hak˦hau˧˧sioŋ˧˧kʰo˨˩
學音樂	oʔ˨im˥˥gak˦
安份守己	an˥˥hun˧˧siu˥˧ki˥˧
安打	an˥˥tã˥˧
安裝有鏡子的底座	kĩã˨˩tai˨˦
宋代有名的清官	pau˥˥koŋ˥˥
客人才會想來	laŋ˨˦kʰeʔ˨tsiaʔ˨e˧˧ai˨˩lai˨˦
宣布命令	ha˧˧liŋ˧˧
家家戶戶	ke˥˥ke˥˥hɔ˧˧hɔ˧˧
家裡	tsʰu˨˩lai˧˧
家裡面大小事情都是他在處理	tsʰu˨˩lai˧˧tua˧˧se˨˩haŋ˧˧tai˧˧tsi˨˩loŋ˥˧si˧˧i˥˥teʔ˨huat˦loʔ˨
寄放東西則可能會被揩油	kia˨˩miʔ˦e˧˧kiam˥˧
實在太不值得了	sit˦tsai˧˧tsin˥˥m˥˥tat˦
實在很沒用	sit˦tsai˧˧bo˨˦lɔ˧˧iŋ˧˧
實在很難看	sit˦tsai˧˧tsin˥˥pʰãĩ˥˧kʰũã˨˩sĩũ˨˩
實在是很可憐	sit˦tsai˧˧si˧˧kʰo˥˧lian˨˦tai˧˧
實在枉然	u˧˧kau˨˩liau˥˧dzian˨˦
實在讓人想不到	sit˦tsai˧˧hɔ˧˧laŋ˨˦sĩũ˧˧be˧˧kau˨˩
封面	tsʰeʔ˨pʰue˨˦
將才	tsioŋ˨˩tsai˨˦
專業的事情外行的人做不來	tsuan˥˥giap˦e˨˦tai˧˧tsi˨˩gua˧˧haŋ˨˦e˨˦tso˨˩be˧˧lai˨˦
尊稱皇帝的母親	tʰai˨˩hio˧˧
對不對	tioʔ˨bo˨˦
對他人稱自己的妻子	lue˧˧dzin˨˦
小丑	sio˥˧tʰiu˥˧
小事化無。有息事寧人或避重就輕之意	sio˥˧su˧˧hua˨˩bo˨˦su˧˧
小事盡量化解成沒事	sio˥˧su˧˧hua˨˩bo˨˦su˧˧
小叔	sio˥˧tsik˨a˥˧
小叔叔明天晚上才會回來	ban˥˥tsik˨a˥˧bin˨˦a˥˧e˥˥hŋ˥˥tsiaʔ˨e˧˧tńg1lai˨˦
小妹謝謝大家對我的愛護	sio˥˧mue˧˧kam˥˧sia˧˧tak˦ke˥˥e˨˦tʰĩã˨˩sioʔ˨
小嬰兒哭得滿身大汗	aŋ˨˦ẽ˥˥a˥˧kʰau˨˩kaʔ˨tsit˦sin˥˥kʰu˥˥kũã˧˧
小孩子	gin˥˧a˥˧
小孩子不可以太頑皮	gin˥˧a˥˧laŋ˨˦m˥˥tʰaŋ˥˥sĩũ˥˥tsʰiu˥˧tsʰiŋ˨˩
小孩子不要坐在門檻上	gin˥˧a˥˧laŋ˨˦m˥˥tʰaŋ˥˥tse˧˧hɔ˧˧tiŋ˧˧
小孩子也看得懂	gin˥˧a˥˧laŋ˨˦ma˧˧kʰũã˨˩u˧˧
小孩子們正在玩陀螺	gin˥˧a˥˧tŋ˥˥teʔ˨pʰaʔ˨kan˥˥lok˨
小孩子吃飯不可以壞習慣	gin˥˧a˥˧laŋ˨˦tsiaʔ˦pŋ˥˥be˧˧sai˥˧pʰãĩ˥˧kʰuan˥˧
小孩子就大聲的哭	gin˥˧a˥˧to˧˧tua˧˧sĩã˥˥hau˥˧
小孩子拉的屎水水的	gin˥˧a˥˧paŋ˨˩e˨˦sai˥˧tsui˥˧tsui˥˧
小孩子會長大	gin˥˧a˥˧e˧˧tua˧˧
小孩子騎車要留意謹慎	gin˥˧a˥˧laŋ˨˦kʰia˨˦tsʰia˥˥ai˨˩sio˥˧sim˥˥
小提袋	ka˥˥tsi˨˩a˥˧
小旦	sio˥˧tũã˨˩
小浪	sio˥˧iŋ˥˧
少少的	tsio˥˧tsio˥˧a˥˧
就一定會成功	to˧˧it˨tiŋ˧˧e˧˧siŋ˨˦koŋ˥˥
就像要昏過去了	na˥˧tsʰĩũ˧˧beʔ˨hun˧˧kʰi˨˩aʔ˨
就先拿他的去用	siŋ˥˥tʰeʔ˦i˥˥e˨˦kʰi˨˩iŋ˧˧
就去找他當介紹人	li˥˧na˧˧beʔ˨be˥˧tsʰu˨˩to˧˧kʰi˨˩tsʰue˧˧i˥˥
就多方請人協助就業	to˧˧iaŋ˥˥sã˥˥tʰok˨si˨˩beʔ˨tsʰue˧˧tʰau˨˦lɔ˧˧
就是因為天氣太熱	to˧˧si˧˧tʰĩ˥˥kʰi˨˩sĩũ˥˥dzuaʔ˦
就是我姐姐	si˧˧guan˥˧tsi˥˧a˥˧
就會天下太平了	to˧˧tʰian˥˥ha˧˧tʰai˨˩piŋ˨˦aʔ˨
就會生病	laŋ˨˦to˧˧pʰua˨˩pẽ˧˧
就算你不滿意	to˧˧sǹg1koŋ˥˧li˥˧bo˨˦tiŋ˨˩i˨˩
就算是天下大亂	tsun˥˧tso˨˩tʰĩ˥˥huan˥˧te˧˧luan˧˧
就能讓他吃半輩子了	to˧˧tʰiŋ˨˩ho˥˧tsiaʔ˦pũã˨˩si˨˩laŋ˨˦aʔ˨
就要把把手扶好	tsʰiu˥˧hũã˧˧a˥˧tioʔ˨ai˨˩hũã˧˧hɔ˧˧i˥˥ho˥˧
屋主	tsʰu˨˩tsu˥˧
屏東高樹出產棗子	pin˨˦toŋ˥˥e˨˦ko˥˥tsʰiu˧˧tsʰut˨san˥˧tso˥˧a˥˧
山上沒有牽自來水線路	sũã˥˥tiŋ˥˧bo˨˦kʰan˥˥tsui˥˧to˧˧
山上的夜晚	sũã˥˥tiŋ˥˧e˨˦am˨˩me˨˦
山水	san˥˥sui˥˧
山裡的姑娘要出嫁了。流行歌曲名	lai˧˧sũã˥˥kɔ˥˥niu˨˦beʔ˨tsʰut˨ke˨˩
工人	kaŋ˥˥laŋ˨˦
工作一下子就做完了	sit˨tʰau˨˦tsit˦kʰun˨˩a˥˧to˧˧tso˨˩liau˥˧aʔ˨
工作又不肯做	sit˨iu˧˧m˥˥tso˨˩
工作才完成不了	kʰaŋ˥˥kʰue˨˩tsiaʔ˨e˧˧tso˨˩be˧˧uan˨˦
工作的開端和結尾都要照顧好才行	kaŋ˥˥tʰau˨˦kaŋ˥˥bue˥˧loŋ˥˧ai˨˩kɔ˨˩hɔ˧˧ho˥˧
工尺	koŋ˥˥tsʰe˥˥
工廠	kaŋ˥˥tĩũ˨˦
工業	kaŋ˥˥giap˦
工程	kaŋ˥˥tiŋ˨˦
左邊這個位子就讓給你坐	tua˧˧piŋ˨˦niu˧˧hɔ˧˧li˥˧tse˧˧
差多啦	tsʰa˥˥tse˧˧leʔ˨
巷口屋子起火	haŋ˧˧a˥˧kʰau˥˧hue˥˧sio˥˥tsʰu˨˩
巷底有人辦喪事在做法會	haŋ˧˧a˥˧te˥˧u˧˧laŋ˨˦pan˧˧soŋ˥˥su˧˧teʔ˨tso˨˩koŋ˥˥tik˨
布尺	pɔ˨˩tsʰioʔ˨
希望你不要反悔	hi˥˥baŋ˧˧li˥˧m˥˥tʰaŋ˥˥huan˥˧hiau˥˥
干支為甲子的年分	kaʔ˨tsu˥˧ni˨˦
干涉	kan˥˥siap˦
平仄	pĩã˨˦tseʔ˨
平常、不出色	piŋ˨˦huan˨˦
平手	pẽ˨˦tsʰiu˥˧
年老了就不像樣了	tsiaʔ˦lau˧˧m˥˥tsĩã˨˦ĩũ˧˧
年輕人不要去吸食毒品，不然會很嚴重	siau˨˩lian˨˦laŋ˨˦m˥˥tʰaŋ˥˥tsiaʔ˦tok,1na˧˧bo,5tai˧˧tsi˨˩e˧˧put˨tik˨liau˥˧
年輕的時候不會想	siau˨˩lian˨˦be˧˧hiau˥˧sĩũ˧˧
幸好有你出面，否則這件事情就做不成了	ho˥˧ka˥˥tsai˨˩u˧˧li˥˧tsʰut˨thau,5na˧˧bo,5tsit˨kĩã˧˧tai˧˧tsi˨˩to˧˧pan˧˧be˧˧siŋ˨˦aʔ˨
店裡顧客很多	tiam˨˩lai˧˧laŋ˨˦kʰeʔ˨tsin˥˥tse˧˧
廟公	bio˧˧koŋ˥˥
廢話少說	ke˥˥ue˧˧kiam˥˧koŋ˥˧kua˥˧
弓箭	kiŋ˥˥tsĩ˨˩
引導	in˥˧to˧˧
引誘	in˥˧iu˥˧
引誘小偷出來	in˥˧iu˥˧tsʰat˦a˥˧tsʰut˨lai˨˦
引起	in˥˧kʰi˥˧
引進新產品	kai˨˩siau˧˧sin˥˥san˥˧pʰin˥˧
弟子	te˧˧tsu˥˧
張大步伐快速走	tua˧˧pɔ˧˧kiŋ˥˥
強調很老	tsʰit˨lau˧˧peʔ˨lau˧˧
形容不留情面或者是不講情義	liok˨tsʰin˥˥put˨dzin˧˧
形容人多嘴雜	tsap˦tsʰui˨˩kau˥˧kʰa˥˥tsʰŋ˥˥
形形色色的人	tsap˦hue˥˥gɔ˧˧sik˨e˨˦laŋ˨˦
往南部去	lam˨˦ha˧˧
很便宜了	tsin˥˥siok˨aʔ˨
很多人圍觀	tsiok˨tse˧˧laŋ˨˦ui˨˦leʔ˨kʰũã˨˩
很多人嫁娶	tsin˥˥tse˧˧laŋ˨˦ke˨˩tsʰua˧˧
很難比較	tsin˥˥pʰãĩ˥˧pi˥˧kau˨˩
律師牌照一次就考到了	lut˦su˥˥pai˨˦tsit˦pai˥˧to˧˧kʰo˥˧kue˨˩
後代	au˧˧te˧˧
後天這裡要舉辦一場歌唱比賽	au˧˧dzit˦tsia˥˥beʔ˨ki˥˧hiŋ˨˦tsit˦tĩũ˨˦kua˥˥tsʰĩũ˨˩pi˥˧sai˨˩
得到這種頑症很難醫治	ti˨˩tioʔ˨tsit˨kʰuan˥˧pʰãĩ˥˧tsiŋ˨˩tʰau˨˦tsin˥˥pʰãĩ˥˧i˥˥
從井裡頭用水桶把水打上來	tsʰĩũ˧˧tsui˥˧
從前到現在、向來	tsiŋ˨˦kau˨˩tã˥˥
從天井看出去	tui˨˩tʰĩ˥˥tsẽ˥˧kʰũã˨˩tsʰut˨kʰi˨˩
從小父母就過世了	tsu˧˧se˨˩han˨˩pe˧˧bu˥˧to˧˧kue˨˩sin˥˥aʔ˨
從臺北坐高鐵到臺中最久是一個多小時	tui˨˩tai˨˦pak˨tse˧˧ko˥˥tʰiʔ˨kau˨˩tai˨˦tioŋ˥˥sioŋ˧˧ku˥˧si˧˧tsit˦tiam˥˧tʰoŋ˥˧tsiŋ˥˥
從這條大馬路一直走下去就到我家了	an˨˩tsit˨tiau˨˦tua˧˧lɔ˧˧tit˦tit˦kʰi˨˩to˧˧kau˨˩guan˥˧tau˥˥aʔ˨
心臟	sim˥˥tsoŋ˧˧
必須多吃一些比較營養的食物	tioʔ˨ai˨˩ke˥˥tsiaʔ˦tsit˦kua˥˧kʰaʔ˨iŋ˨˦ioŋ˥˧e˨˦miʔ˦kĩã˧˧
必須要有充分的證據	tioʔ˨ai˨˩u˧˧tsʰioŋ˥˥hun˥˥e˨˦tsiŋ˨˩ki˨˩
快要散掉了	kioŋ˧˧beʔ˨sũã˨˩kʰi˨˩
怎麼今天又惡化了呢	si˧˧an˥˧tsũã˥˧kin˥˥a˥˧dzit˦koʔ˨huan˥˧tsiŋ˨˩
怎麼可以反悔	na˥˧e˧˧sai˥˧huan˥˧hue˥˧
怎麼就將棺木買好備用了	na˥˧e˧˧bue˧˧tsiŋ˨˦bue˧˧to˧˧ka˧˧tua˧˧siu˧˧be˥˧ho˥˧aʔ˨
怎麼無緣無故就打人呢	na˥˧e˧˧bo˨˦tai˧˧bo˨˦tsi˨˩ka˧˧laŋ˨˦pʰaʔ˨
怎麼說都不肯聽	sian˥˥koŋ˥˧to˥˥m˥˥tʰĩã˥˥
想不到他會為了利益而背叛大家	sĩũ˧˧be˧˧kau˨˩i˥˥e˧˧ui˧˧tioʔ˨li˧˧ik˨lai˨˦huan˥˧pue˧˧tsiŋ˨˩laŋ˨˦
想法和我們以往不同	sĩũ˧˧huat˨kaʔ˨guan˥˧iŋ˥˧kue˨˩loŋ˥˧bo˨˦kaŋ˧˧
想要多買幾件新衣服	sĩũ˧˧beʔ˨ke˥˥be˥˧kui˥˧nia˥˧a˥˧sin˥˥sã˥˥
意指手臂被打斷了，痊癒之後反倒更強壯。比喻愈挫愈勇	pʰaʔ˨tŋ˥˥tsʰiu˥˧kut˨tian˥˥to˨˩ioŋ˥˧
意為天理昭彰，順天理而行，自有善報，何須風水庇蔭	tʰian˥˥li˥˧tsiau˥˥tsiau,1te˧˧li˥˧ho˨˦tsai˧˧
感謝主	kam˥˧sia˧˧tsu˥˧
懷古	huai˨˦kɔ˥˧
成熟母豬所生的第一胎小豬	tʰau˨˦tsui˥˧ti˥˥a˥˧
我一兩天沒去	gua˥˧tsit˦pũã˨˩dzit˦a˥˧bo˨˦kʰi˨˩
我一禮拜要上五天班	gua˥˧tsit˦le˥˧pai˨˩ai˨˩sioŋ˧˧pan˥˥gɔ˧˧kaŋ˥˥
我一輩子不曾做過對不起他人的事	gua˥˧tsit˦si˨˩laŋ˨˦m˥˥bat˨tso˨˩kue˨˩tui˨˩put˨kʰi˥˧pat˦laŋ˨˦e˨˦tai˧˧tsi˨˩
我丈夫	ŋɔ˥˧hu˥˥
我下次不敢了	gua˥˧e˧˧pai˥˧m˥˥kã˥˧aʔ˨
我不去	gua˥˧m˥˥kʰi˨˩
我不喜歡他做事情的方法	gua˥˧bo˨˦kaʔ˨i˨˩i˥˥tso˨˩tai˧˧tsi˨˩e˨˦hoŋ˥˥sik˨
我不小心把你們的玻璃杯打破了	gua˥˧bo˨˦tu˥˧ho˥˧suaʔ˨ka˧˧lin˥˧e˨˦po˥˥le˨˦pue˥˥a˥˧koŋ˨˩pʰua˨˩kʰi˨˩
我不是本地人	gua˥˧m˥˥si˧˧pun˥˧te˧˧laŋ˨˦
我不曾出過國	gua˥˧m˥˥bat˨tsʰut˨kok˨kue˨˩
我不曾欠別人帳	gua˥˧m˥˥bat˨teʔ˨ka˧˧laŋ˨˦kʰiam˨˩siau˨˩
我不會放過他	gua˥˧bo˨˦beʔ˨paŋ˨˩i˥˥kan˥˥hiu˥˥
我不管啦	laŋ˨˦m˥˥kuan˥˧laʔ˨
我不贊成你這種做法	gua˥˧huan˥˧tui˨˩li˥˧tsit˨kʰuan˥˧tso˨˩huat˨
我今天人不舒服	gua˥˧kin˥˥a˥˧dzit˦laŋ˨˦m˥˥tu˥˧ho˥˧
我今天很忙	gua˥˧kin˥˥a˥˧dzit˦bo˨˦iŋ˨˦
我今年就要入學去讀書了	gua˥˧kin˥˥ni˨˦to˧˧beʔ˨dzip˦oʔ˨kʰi˨˩tʰak˦tsʰeʔ˨aʔ˨
我今晚要去看電影	gua˥˧e˥˥hŋ˥˥beʔ˨kʰi˨˩kʰũã˨˩tian˧˧ĩã˥˧
我以為你要走了	gua˥˧kio˨˩si˧˧li˥˧beʔ˨tsau˥˧aʔ˨
我來分配你們大家的工作	gua˥˧lai˨˦hun˥˥pʰue˨˩lin˥˧tak˦ke˥˥e˨˦kʰaŋ˥˥kʰue˨˩
我來卜一下卦	gua˥˧lai˨˦pok˨tsit˦e˧˧a˥˧kua˨˩leʔ˨
我來引薦你們兩個認識	gua˥˧lai˨˦kai˨˩siau˧˧lin˥˧nŋ˥˥e˨˦sik˦sai˧˧
我來設法	gua˥˧lai˨˦sĩũ˧˧pan˧˧huat˨
我們也沒辦法	guan˥˧ma˧˧bo˨˦huat˨tɔ˧˧
我們人壞事不要做	lan˥˧laŋ˨˦pʰãĩ˥˧tai˧˧tsi˨˩m˥˥tʰaŋ˥˥tso˨˩
我們住的這一帶	lan˥˧tua˨˩tsit˨kak˨ui˨˦a˥˧
我們家多得很	lan˥˧tau˥˥tsio˥˧kʰueʔ˨
我們家有開席宴客	guan˥˧tau˥˥u˧˧pan˧˧toʔ˨tsʰĩã˥˧laŋ˨˦
我們家的冷氣昨晚壞了	guan˥˧tau˥˥e˨˦liŋ˥˧kʰi˨˩tsa˥˥me˨˦pʰãĩ˥˧kʰi˨˩aʔ˨
我們少主人對我們這些僕役下屬都很好	guan˥˧siau˨˩ia˨˦tui˨˩guan˥˧tsit˨kua˥˧e˧˧kʰa˥˥tsʰiu˥˧laŋ˨˦loŋ˥˧tsin˥˥ho˥˧
我們已經說好了	lan˥˧i˥˧kiŋ˥˥pʰin˥˧ho˥˧aʔ˨
我們整個村子裡頭總共有五百戶人家	lan˥˧kui˥˥tsŋ˥˥tʰau˨˦loŋ˥˧tsoŋ˥˧u˧˧gɔ˧˧paʔ˨hɔ˧˧
我們會在這裡相遇	lan˥˧e˧˧ti˧˧tsia˥˥sio˥˥tu˥˧
我們的國家元首叫做總統	lan˥˧kok˨ka˥˥e˨˦guan˨˦siu˥˧kio˨˩tso˨˩tsoŋ˥˧tʰoŋ˥˧
我們的工頭看起來還很年輕	guan˥˧e˨˦kaŋ˥˥tʰau˨˦kʰũã˨˩kʰi˥˧lai˨˦iau˥˧koʔ˨tsin˥˥siau˨˩lian˨˦
我們要包禮慶賀他入新家	lan˥˧ai˨˩pau˥˥le˥˧ka˧˧i˥˥dzip˦tsʰu˨˩
我們要好好招呼客人	lan˥˧ai˨˩ho˥˧ho˥˧a˥˧tsiau˥˥tʰai˧˧laŋ˨˦kʰeʔ˨
我們要跟得上社會的改變	lan˥˧tioʔ˨ai˨˩tue˨˩e˧˧tioʔ˨sia˧˧hue˧˧e˨˦kai˥˧pian˨˩
我們要靠自己的能力拚出自己的前途	lan˥˧ai˨˩kʰo˨˩ka˥˥ki˧˧e˨˦lik˦lioŋ˧˧pĩã˨˩tsʰut˨lan˥˧ka˥˥ki˧˧e˨˦tsian˨˦tɔ˨˦
我們這個單位的人數不足	guan˥˧tsit˨e˨˦tan˥˥ui˧˧e˨˦dzin˨˦uan˨˦bo˨˦kau˨˩
我們這個村莊的交通很不便利	guan˥˧tsit˨e˨˦tsŋ˥˥tʰau˨˦e˨˦kau˥˥tʰoŋ˥˥tsin˥˥bo˨˦hoŋ˥˥pian˧˧
我們這條巷子昨天又遭小偷了	guan˥˧tsit˨tiau˨˦haŋ˧˧a˥˧tsa˥˥hŋ˥˥iu˧˧koʔ˨tioʔ˨tsʰat˦tʰau˥˥aʔ˨
我們這群朋友已經認識十幾年了	guan˥˧tsit˨tin˧˧hĩã˥˥ti˧˧i˥˧kiŋ˥˥sik˦sai˧˧tsap˦kui˥˧taŋ˥˥aʔ˨
我們這裡只有做批發生意	guan˥˧tsia˥˥kan˥˥na˥˥tso˨˩tua˧˧be˧˧
我們都是彼此熟識的人	lan˥˧loŋ˥˧si˧˧sik˦sai˧˧laŋ˨˦
我做不完	gua˥˧tso˨˩be˧˧kʰi˨˩
我剛進門	gua˥˧tã˥˥a˥˧dzip˦mŋ˥˥
我半路遇到朋友很高興	gua˥˧pũã˨˩lɔ˧˧tu˥˧tioʔ˨piŋ˨˦iu,2tsin˥˥hũã˥˥hi˥˧
我去方便一下	gua˥˧lai˨˦kʰi˨˩hoŋ˥˥pian˧˧tsit˦e˧˧
我可以借你	gua˥˧e˧˧taŋ˨˩tsioʔ˨li˥˧
我在臺灣出生的	gua˥˧ti˧˧tai˨˦uan˨˦tsʰut˨si˨˩e˨˦
我大哥比我大三歲	guan˥˧tua˧˧hĩã˥˥tua˧˧gua˥˧sã˥˥hue˨˩
我奶奶很喜歡煮冬菜鴨肉	guan˥˧a˥˥ma˥˧tsĩã˨˦ai˨˩tsu˥˧taŋ˥˥tsʰai˨˩aʔ˨
我婆婆很疼我	guan˥˧ta˥˥ke˥˥tsĩã˨˦tʰĩã˨˩gua˥˧
我媽媽最喜歡用半肥半瘦的肉下去滷	guan˥˧a˥˥bu˥˧sioŋ˧˧ai˨˩iŋ˧˧pũã˨˩tsĩã˥˥peʔ˦e˨˦baʔ˨loʔ˨kʰi˨˩lɔ˥˧
我家魚缸裡的魚都死了	guan˥˧tau˥˥hi˨˦tu˨˦a˥˧e˨˦hi˨˦a˥˧loŋ˥˧piŋ˥˧tɔ˧˧aʔ˨
我實在沒辦法分身來處理別人的事情	gua˥˧sit˦tsai˧˧bo˨˦huat˨tɔ˧˧hun˥˥sin˥˥lai˨˦tsʰu˥˧li˥˧pat˦laŋ˨˦e˨˦tai˧˧tsi˨˩
我實在沒辦法辨別	gua˥˧sit˦tsai˧˧bo˨˦huat˨tɔ˧˧hun˥˥piat˦
我專程來看你	gua˥˧tʰiau˥˥kaŋ˥˥lai˨˦kʰũã˨˩li˥˧
我對車子很在行	gua˥˧tui˨˩kʰi˨˩tsʰia˥˥tsin˥˥lai˧˧haŋ˨˦
我就感到非常生氣	gua˥˧to˧˧hue˥˧tua˧˧
我已經支撐不住了	gua˥˧i˥˧kiŋ˥˥tsi˥˥tsʰi˨˦be˧˧tiau˨˦aʔ˨
我已經答應人家了	gua˥˧to˥˥in˥˧laŋ˨˦aʔ˨
我希望你們支持我	gua˥˧hi˥˥baŋ˧˧lin˥˧ka˧˧gua˥˧tsi˥˥tsʰi˨˦
我常常去圖書館查資料	gua˥˧su˨˩sioŋ˨˦kʰi˨˩tɔ˨˦su˥˥kuan˥˧tsʰa˨˦tsu˥˥liau˧˧
我弟弟最愛看丑角表演	guan˥˧sio˥˧ti˧˧sioŋ˧˧ai˨˩kʰũã˨˩tʰiu˥˧a˥˧piau˥˧ian˥˧
我很討厭別人干預我的事	gua˥˧tsin˥˥tʰo˥˧ia˨˩pat˦laŋ˨˦kan˥˥siap˦gua˥˧e˨˦tai˧˧tsi˨˩
我很高興來到貴寶地。這句話也是走江湖的開場白	sio˥˧ti˧˧tsin˥˥hũã˥˥hi˥˧lai˨˦kau˨˩kui˨˩po˥˧te˧˧
我忘了寫作業	gua˥˧be˧˧ki˨˩tit˨sia˥˧koŋ˥˥kʰo˨˩
我忽然覺得手腳痠軟	gua˥˧hioŋ˨˦hioŋ˨˦kam˥˧kak˨kʰa˥˥sŋ˥˥tsʰiu˥˧nńg1
我想要趕快將你娶進門	gua˥˧sĩũ˧˧beʔ˨kũã˥˧kin˥˧ka˧˧li˥˧tsʰua˧˧dzip˦mŋ˥˥
我手掌的握力不夠	gua˥˧tsʰiu˥˧bue˥˧lat˦bo˨˦kau˨˩
我才不相信你說的話	gua˥˧tsiaʔ˨bo˨˦beʔ˨sioŋ˥˥sin˨˩li˥˧koŋ˥˧e˨˦ue˧˧
我才剛剛入門	gua˥˧tu˥˧dzip˦mŋ˥˥
我才剛剛進門而已	gua˥˧tã˥˥a˥˧tsiaʔ˨dzip˦mŋ˥˥nia˧˧nia˧˧
我才會打他	gua˥˧tsiaʔ˨e˧˧ka˧˧i˥˥pʰaʔ˨
我挑選的人都是很優秀的	gua˥˧kiŋ˥˧e˨˦laŋ˨˦loŋ˥˧si˧˧dzin˨˦dzin˨˦dzin˨˦e˨˦
我放在桌上的文件是誰拿走了	gua˥˧khǹg1ti˧˧toʔ˨tiŋ˥˧e˨˦bun˨˦kĩã˧˧si˧˧sĩã˥˧laŋ˨˦tʰeʔ˦kʰi˨˩
我整晚翻來覆去睡不著	gua˥˧kui˥˥me˨˦piŋ˥˧lai˨˦piŋ˥˧kʰi˨˩kʰun˨˩be˧˧kʰi˨˩
我明天要請半天假	gua˥˧bin˨˦a˥˧tsai˨˩beʔ˨tsʰiŋ˥˧pũã˨˩kaŋ˥˥e˨˦ka˥˧
我是外地搬來的	gua˥˧si˧˧gua˧˧ui˧˧pũã˥˥lai˨˦e˨˦
我是特別來看你的	gua˥˧si˧˧tiau˥˥ti˨˦lai˨˦kʰũã˨˩li˥˧e˨˦
我會加倍還給你	gua˥˧e˧˧ka˥˥pue˧˧hiŋ˨˦li˥˧
我會很難過	gua˥˧e˧˧tsin˥˥m˥˥kam˥˥
我會這樣做都是不得已的	gua˥˧e˧˧an˥˧ne˥˥tso˨˩loŋ˥˧si˧˧put˨tik˨i˥˧e˨˦
我月初要繳房租	gua˥˧gueʔ˦tʰau˨˦ai˨˩lap˦tsʰu˨˩sue˨˩tsĩ˨˦
我有一雙蘿蔔腿	gua˥˧u˧˧tsit˦siaŋ˥˥tua˧˧kʰa˥˥taŋ˨˦
我沒時間去買禮物	gua˥˧bo˨˦si˨˦kan˥˥tʰaŋ˥˥kʰi˨˩be˥˧le˥˧but˦
我沒有多餘的時間跟你聊天	gua˥˧bo˨˦hit˨lo˧˧iŋ˨˦kaŋ˥˥kaʔ˨li˥˧kʰai˥˥kaŋ˥˧
我爺爺七十歲生日的時候	guan˥˧a˥˥koŋ˥˥tsʰit˨tsap˦hue˨˩tua˧˧siu˧˧e˨˦si˨˦tsun˧˧
我爺爺拿了耙子要去整理菜園	guan˥˧a˥˥koŋ˥˥giaʔ˦dziau˥˧a˥˧beʔ˨kʰi˨˩tsiŋ˥˧li˥˧tsʰai˨˩hŋ˥˥
我爺爺玩股票賠光了錢	guan˥˧a˥˥koŋ˥˥sńg1kɔ˥˧pʰio˨˩su˥˥liau˥˧liau˥˧
我爺爺的書房裡有很多古書	guan˥˧a˥˥koŋ˥˥e˨˦tsʰeʔ˨paŋ˨˦lai˧˧te˥˧u˧˧tsin˥˥tse˧˧kɔ˥˧tsʰeʔ˨
我用人格跟你保證	gua˥˧ioŋ˧˧dzin˨˦keʔ˨ka˧˧li˥˧po˥˧tsiŋ˨˩
我的妻子回娘家去了	guan˥˧bɔ˥˧tńg1kʰi˨˩gua˧˧ke˥˥aʔ˨
我的岳母明天要來	guan˥˧tĩũ˧˧ḿ1bin˨˦a˥˧tsai˨˩beʔ˨lai˨˦
我的岳父明天要北上到臺北	guan˥˧tĩũ˧˧laŋ˨˦bin˨˦a˥˧tsai˨˩beʔ˨kʰi˥˧lai˨˦tai˨˦pak˨
我的工作很多	gua˥˧e˨˦kʰaŋ˥˥kʰue˨˩tsiok˨tse˧˧e˨˦
我的心肝寶貝	gua˥˧sim˥˥kũã˥˥a˥˧kĩã˥˧e˨˦
我的胸口正在痛	gua˥˧e˨˦sim˥˥kũã˥˥kʰut˨a˥˧tŋ˥˥teʔ˨tʰĩã˨˩
我的腳底長一顆水泡	gua˥˧kʰa˥˥te˥˧sẽ˥˥tsit˦liap˦tsui˥˧pʰa˧˧
我的衣服最喜歡由他來縫製	gua˥˧e˨˦sã˥˥sioŋ˧˧ai˨˩hɔ˧˧i˥˥tso˨˩
我看他做的壞事不只這樣而已	gua˥˧kʰũã˨˩i˥˥tso˨˩e˨˦pʰãĩ˥˧tai˧˧tsi˨˩m˥˥na˧˧an˥˧ne˥˥nia˧˧nia˧˧
我看你去找其他人比較好	gua˥˧kʰũã˨˩li˥˧kʰi˨˩tsʰue˧˧pat˦laŋ˨˦kʰaʔ˨ho˥˧
我看你還是再找一個人跟你去好了	gua˥˧kʰũã˨˩li˥˧koʔ˨tsʰue˧˧tsit˦e˨˦laŋ˨˦kaʔ˨li˥˧kʰi˨˩ho˥˧aʔ˨
我真不甘心	gua˥˧tsĩã˨˦m˥˥guan˧˧
我等你老半天了	gua˥˧tan˥˧li˥˧kui˥˥pũã˨˩pɔ˥˥aʔ˨
我給你一個月的時間	gua˥˧han˧˧li˥˧tsit˦gueʔ˦dzit˦i˥˧lai˧˧
我給你一個面子	gua˥˧hɔ˧˧li˥˧tsit˦e˨˦bin˧˧tsu˥˧
我胃痛又發作了	gua˥˧ui˧˧tʰĩã˨˩koʔ˨gia˨˦kʰi˥˧lai˨˦aʔ˨
我若沒有提醒你	gua˥˧na˧˧bo˨˦tʰe˨˦tsʰẽ˥˧
我若緊張就會口吃	gua˥˧na˧˧kin˥˧tĩũ˥˥to˧˧e˧˧tua˧˧tsiʔ˦
我被蚊子叮到	gua˥˧hɔ˧˧baŋ˥˧a˥˧tiŋ˨˩tioʔ˨
我要去買一本小筆記本回來記帳	gua˥˧beʔ˨kʰi˨˩be˥˧tsit˦pun˥˧tsʰiu˥˧tsiʔ˨pʰɔ˧˧a˥˧tńg1lai˨˦ki˨˩siau˨˩
我要回去了	gua˥˧beʔ˨tńg1kʰi˨˩aʔ˨
我要往那個方向去才能找到這項物品	gua˥˧ai˨˩tui˨˩to˥˧tsit˦hoŋ˥˥bin˧˧kʰi˨˩tsiaʔ˨tsʰue˧˧e˧˧tioʔ˨tsit˨haŋ˧˧miʔ˦kĩã˧˧
我要準備下山了	gua˥˧beʔ˨tsun˥˧pi˧˧ha˧˧san˥˥aʔ˨
我要讓他難堪	gua˥˧beʔ˨hɔ˧˧i˥˥pʰãĩ˥˧kʰũã˨˩
我要走運了	gua˥˧beʔ˨tsʰut˨un˧˧aʔ˨
我覺得野豬肉比較好吃	gua˥˧kam˥˧kak˨sũã˥˥ti˥˥a˥˧baʔ˨kʰaʔ˨ho˥˧tsiaʔ˦
我認為我們應該堅持到底	gua˥˧tsu˥˧tĩũ˥˥lan˥˧ai˨˩kian˥˥tsʰi˨˦kau˨˩te˥˧
我走到半路就遇見他了	gua˥˧kĩã˨˦kau˨˩tioŋ˥˥tɔ˨˦to˧˧tu˥˧tioʔ˨i˥˥aʔ˨
我這件衣服的裡子破掉了	gua˥˧tsit˨nia˥˧sã˥˥e˨˦lai˧˧li˥˧pʰua˨˩kʰi˨˩aʔ˨
我這裡有一些古書可以借給你	gua˥˧tsia˥˥u˧˧tsit˦kua˥˧kɔ˥˧tsu˥˥e˧˧iŋ˧˧tit˨tsioʔ˨li˥˧
我還沒吃飯	gua˥˧iau˥˧bue˧˧tsiaʔ˦pŋ˥˥
我都可以看到五彩繽紛的燈光閃爍不停	gua˥˧loŋ˥˧u˧˧kʰũã˨˩tioʔ˨ŋɔ˥˧tsʰai˥˧e˨˦tiŋ˥˥hue˥˧siam˥˧siam˥˧siʔ˨siʔ˨
我馬上來	gua˥˧sui˨˦lai˨˦
戲院五點才能進場	hi˨˩hŋ˥˥gɔ˧˧tiam˥˧tsiaʔ˨e˧˧sai˥˧dzip˦tĩũ˨˦
房子是祖父遺留下來的	tsʰu˨˩si˧˧a˥˥koŋ˥˥e˨˦tsʰiu˥˧bue˥˧paŋ˨˩loʔ˨lai˨˦e˨˦
所以下午就請假回家	sɔ˥˧i˥˧e˧˧pɔ˥˥to˧˧tsʰiŋ˥˧ka˥˧tńg1kʰi˨˩
所以我沒有要參加	sɔ˥˧i˥˧gua˥˧bo˨˦beʔ˨tsʰam˥˥ka˥˥
所以才會被老師罵	m˥˥tsiaʔ˨e˧˧hɔ˧˧lau˧˧su˥˥me˧˧
所以才要請他來幫忙	m˥˥tsiaʔ˨ai˨˩tsʰĩã˥˧i˥˥lai˨˦tau˨˩sã˥˥kaŋ˧˧
所以比較容易得罪別人	m˥˥tsiaʔ˨kʰaʔ˨e˧˧kʰi˨˩tik˨sit˨laŋ˨˦
所以沒有到班	tsiaʔ˨e˧˧bo˨˦lai˨˦sioŋ˧˧pan˥˥
手勢不太對	tsʰiu˥˧se˨˩bo˨˦sĩã˥˧tioʔ˨
手工精緻	tsʰiu˥˧lɔ˧˧tsin˥˥iu˨˩
手帕	tsʰiu˥˧kin˥˥a˥˧
手毛	tsʰiu˥˧mɔ˨˦
手頭現金很多	tsʰiu˥˧bin˧˧tsin˥˥tua˧˧
手黑黑的去摸牆壁會有手印	tsʰiu˥˧ɔ˥˥ɔ˥˥kʰi˨˩boŋ˥˥piaʔ˨e˧˧u˧˧tsʰiu˥˧hun˨˦
才不會傳染給別人	tsiaʔ˨be˧˧kʰi˨˩ka˧˧laŋ˨˦ue˨˩tioʔ˨
才不會老是覺得煩悶	kʰaʔ˨be˧˧sim˥˥bun˧˧
才不會虧本	tsiaʔ˨be˧˧liau˥˧pun˥˧
才不會被火花噴到	m˥˥tʰaŋ˥˥kʰi˨˩hɔ˧˧hue˥˧tsʰẽ˥˥pʰun˨˩tioʔ˨
才幹，姿態	bin˧˧tsui˥˧
才會成功	tsiaʔ˨e˧˧siŋ˨˦koŋ˥˥
才會有出人頭地的一天	tsiaʔ˨u˧˧tsʰut˨tʰau˨˦e˨˦tsit˦dzit˦
才會有出人頭地的那一天	tsiaʔ˨e˧˧tsʰut˨tʰau˨˦tʰĩ˥˥
才會有出息	tsiaʔ˨e˧˧u˧˧tsʰut˨tʰuat˨
才會遭到報應	tsiaʔ˨e˧˧siu˧˧tioʔ˨po˨˩iŋ˨˩
才沒約你	m˥˥tsiaʔ˨bo˨˦ka˧˧li˥˧tsio˥˥
扒飯	pe˥˥pŋ˥˥
打三下	pʰaʔ˨sã˥˥e˧˧
打叉做記號	pʰaʔ˨tsʰe˥˥tso˨˩ki˨˩ho˧˧
打定主意	sim˥˥tʰau˨˦liaʔ˦hɔ˧˧i˥˥tĩã˧˧
打點滴、靜脈注射	tsu˨˩tua˧˧taŋ˨˦e˨˦
把你打到求饒	pʰaʔ˨kaʔ˨hɔ˧˧li˥˧kio˨˩m˥˥kã˥˧
把我的錢拿去賭博輸光光	ka˧˧gua˥˧e˨˦tsĩ˨˦tʰeʔ˦kʰi˨˩puaʔ˦kiau˥˧su˥˥liau˥˧liau˥˧
把欠的錢還完	ka˧˧kʰiam˨˩e˨˦tsĩ˨˦hiŋ˨˦liau˥˧
把被子裝進被套裡	dzip˦pʰue˧˧
把這塊田地承租下來耕作	ka˧˧tsit˨te˨˩tsʰan˨˦pau˥˥pak˦loʔ˨lai˨˦tsiŋ˨˩tsoʔ˨
把食物或其他東西端上桌	tsĩũ˧˧toʔ˨
抬貨	gia˨˦hue˨˩
抽屜卡住了	tʰuaʔ˨a˥˧kʰaʔ˦tiau˨˦leʔ˨
拜天地	pai˨˩tʰĩ˥˥te˧˧
拜託他就沒錯	pai˨˩tʰok˨i˥˥to˧˧bo˨˦m˥˥tioʔ˨
拜託別人代為寫信	iaŋ˥˥laŋ˨˦sia˥˧pʰue˥˥
指嘴巴大的人比較有口福	kʰuaʔ˨tsʰui˨˩tsiaʔ˦si˨˩hŋ˥˥
按預先講好的來做	tsiau˨˩pʰin˥˧tsiau˨˩kĩã˨˦
捨不得買來吃	be˧˧tsʰut˨tit˨be˥˧lai˨˦tsiaʔ˦
掌管各項漁業資源調查、開發、漁業養殖技術等業務的中央政府機關	tsui˥˧san˥˧tsʰi˨˩giam˧˧sɔ˥˧
掐別人的脖子	tsʰe˥˥laŋ˨˦e˨˦am˧˧kun˥˧
提不起來	kũã˧˧be˧˧kʰi˥˧lai˨˦
搶購熱烈	tsʰĩũ˥˧tsʰi˧˧
撐開他的嘴才能夠灌藥	tsʰui˨˩ka˧˧kiŋ˥˥kʰui˥˥tsiaʔ˨e˧˧taŋ˨˩kuan˨˩ioʔ˨a˥˧
擁有良田美地，不如養育上進乖巧的好子孫	ho˥˧tsʰan˨˦te˧˧put˨dzu˨˦ho˥˧tsu˥˧te˧˧
收入	siu˥˥dzip˦
改天我們再一起吃飯	liŋ˧˧dzit˦lan˥˧tsiaʔ˨tso˨˩hue˥˧tsiaʔ˦pŋ˥˥
攻打	koŋ˥˥tã˥˧
故意	tiau˥˥kaŋ˥˥
故意	tiau˥˥kɔ˨˩i˨˩
教子有方	kau˨˩tsu˥˧iu˥˧hoŋ˥˥
整個社會充滿了快樂的氣氛	kui˥˥e˨˦sia˧˧hue˧˧tsʰioŋ˥˥buan˥˧kʰuai˨˩lok˨e˨˦kʰi˨˩hun˥˥
整天忙得像陀螺	kui˥˥dzit˦bo˨˦iŋ˨˦kaʔ˨na˥˧kan˥˥lok˨leʔ˨
整間屋子靜悄悄的	kui˥˥kiŋ˥˥tsʰu˨˩tiam˧˧tiam˧˧bo˨˦sĩã˥˥
文化中心	bun˨˦hua˨˩tioŋ˥˥sim˥˥
文言與白話交雜	puan˨˩bun˨˦puan˨˩peʔ˦
新店溪以南	sin˥˥tiam˨˩kʰe˥˥i˥˧lam˨˦
新死者、剛過世的人	sin˥˥boŋ˨˦
新的一年剛剛開始	sin˥˥tsĩã˥˥ni˨˦tʰau˨˦
施放煙火的時候要小心	paŋ˨˩ian˥˥hue˥˧e˨˦si˨˦tsun˧˧ai˨˩tsu˨˩i˨˩
旁邊	pĩ˥˥a˥˧
日月	dzit˦guat˦
日月潭是一個很有名的風景區	dzit˦guat˦tʰam˨˦si˧˧tsit˦e˨˦tsin˥˥tsʰut˨mia˨˦e˨˦hoŋ˥˥kiŋ˥˧kʰu˥˥
日本人	a˥˥pun˥˧a˥˧
早上五點至七點	bau˥˧si˨˦
早上去比較不會熱	e˥˥tsai˥˧a˥˧kʰi˨˩kʰaʔ˨be˧˧dzuaʔ˦
早期在家裡	kʰaʔ˨tsa˥˧tiam˨˩tsʰu˨˩lai˧˧
旱地或指山很多的地區	sũã˥˥te˧˧
旱田	sũã˥˥hŋ˥˥
明天以前必須把事情處理好	bin˨˦a˥˧tsai˨˩i˥˧tsiŋ˨˦ai˨˩ka˧˧tai˧˧tsi˨˩tso˨˩hɔ˧˧i˥˥ho˥˧se˨˩
明天晚上會停電	bin˨˦a˥˧am˨˩e˧˧tʰiŋ˨˦tian˧˧
明明都說好了	biŋ˨˦biŋ˨˦to˥˥koŋ˥˧ho˥˧aʔ˨
星期日要大掃除	le˥˧pai˨˩beʔ˨tua˧˧pĩã˨˩sau˨˩
昨夜我很難入眠	tsa˥˥me˨˦gua˥˧tsin˥˥pʰãĩ˥˧kʰun˨˩
昨天他的病情明明有比較好了	i˥˥tsa˥˥hŋ˥˥to˥˥u˧˧kʰaʔ˨ho˥˧aʔ˨
是一萬還是一塊錢	tsit˦kʰɔ˥˥si˧˧tua˧˧kʰɔ˥˥iaʔ˦se˨˩kʰɔ˥˥
是你不嫌棄啦	si˧˧li˥˧m˥˥kam˥˥hiam˨˦laʔ˨
是誰答應你這件事情的	si˧˧sĩã˥˧laŋ˨˦in˥˧li˥˧tsit˨kĩã˧˧tai˧˧tsi˨˩e˨˦
時代	si˨˦tai˧˧
時令	si˨˦liŋ˧˧
時間一久你就會忘記了	li˥˧ku˥˧lai˨˦to˧˧e˧˧be˧˧ki˨˩tit˨aʔ˨
時間已經不早	tʰĩ˥˥sik˨i˥˧kiŋ˥˥bo˨˦tsa˥˧
時間過得真快	dzit˦tsi˥˧kue˨˩liau˥˧tsin˥˥kin˥˧
時間還很充足	si˨˦kan˥˥koʔ˨tsin˥˥lioŋ˧˧
時間還早	tsʰit˨tsa˥˧peʔ˨tsa˥˧
晚上十一點至第二天凌晨一點	tsu˥˧si˨˦
晚上坐在窗邊	am˨˩si˨˦tse˧˧ti˧˧tʰaŋ˥˥a˥˧mŋ˥˥pĩ˥˥
書店	tsʰeʔ˨tiam˨˩
書要用布巾包著	tsʰeʔ˨ai˨˩iŋ˧˧kin˥˥a˥˧pau˥˥leʔ˨
最好	sioŋ˧˧ho˥˧
最好	sioŋ˧˧kai˨˩ho˥˧
最漂亮	sioŋ˧˧kai˨˩sui˥˧
最近卻為了生意的事情不合	kin˧˧lai˨˦suaʔ˨ui˧˧tioʔ˨siŋ˥˥li˥˧e˨˦tai˧˧tsi˨˩huan˥˧bok˨
最近手頭比較寬裕	tsue˨˩kin˧˧tsʰiu˥˧tʰau˨˦kʰaʔ˨liŋ˧˧
最近都在忙些什麼	kin˧˧lai˨˦loŋ˥˧teʔ˨bo˨˦iŋ˨˦sĩãʔ˨
會很不光彩	e˧˧tsin˥˥pʰãĩ˥˧tʰĩã˥˥
月亮	gueʔ˦niu˨˦
月刊	gueʔ˦kʰan˥˥
月形如眉	gueʔ˦bai˨˦i˨˩
月琴	gueʔ˦kʰim˨˦
月餅	gueʔ˦pĩã˥˧
有一次	u˧˧tsit˦tau˥˧
有也好	u˧˧ia˧˧ho˥˧
有事情隨時都能來找我	u˧˧tai˧˧tsi˨˩put˨kuan˥˧si˨˦loŋ˥˧e˧˧sai˥˧lai˨˦tsʰue˧˧gua˥˧
有人在敲門	u˧˧laŋ˨˦teʔ˨kio˨˩mŋ˥˥
有人說會成為夫妻是因為上輩子互相欠債	laŋ˨˦koŋ˥˧e˧˧tso˨˩aŋ˥˥a˥˧bɔ˥˧si˧˧tiŋ˥˧si˨˩laŋ˨˦sio˥˥kʰiam˨˩tse˨˩
有什麼好囂張的	u˧˧sĩã˥˧miʔ˨ho˥˧hiau˥˥pai˥˥e˨˦
有其他人要來嗎	kam˥˧koʔ˨u˧˧liŋ˧˧gua˧˧e˨˦laŋ˨˦beʔ˨lai˨˦
有其父必有其子	iu˥˧ki˨˦hu˧˧pit˨iu˥˧ki˨˦tsu˥˧
有包內餡的是包子	u˧˧pau˥˥ã˧˧e˨˦si˧˧pau˥˥a˥˧
有去無回	u˧˧kʰi˨˩bo˨˦hue˨˦
有口無心	u˧˧tsʰui˨˩bo˨˦sim˥˥
有地位有名望的人	tua˧˧dzin˨˦but˦
有很多生意人備牲祭拜土地公和孤魂野鬼	u˧˧tsin˥˥tse˧˧siŋ˥˥li˥˧laŋ˨˦tso˨˩ge˨˦
有志氣而勇敢剛毅的男子	tai˧˧tioŋ˧˧hu˥˥
有押韻	u˧˧tau˨˩ku˨˩
有的沒有的事情	gɔ˧˧si˨˩sã˥˥
有空酒瓶或者用過的壞器具、紙張可以回收利用的東西要賣嗎？摘自民間歌謠	u˧˧tsiu˥˧kan,1tʰaŋ˥˥be˧˧bo,5pʰãĩ˥˧taŋ˨˦ku˧˧siaʔ˨pʰɔ˧˧a˥˧tsua˥˧tʰaŋ˥˥be˧˧bo˨˦
有緣份才可以成為夫妻	u˧˧ian˨˦tsiaʔ˨e˧˧taŋ˨˩tso˨˩hu˥˥tsʰe˥˥
有這種可能	u˧˧tsit˨kʰuan˥˧kʰo˥˧liŋ˨˦
朋友	piŋ˨˦iu˥˧
服務費包含在裡面	hok˨bu˧˧hui˨˩pau˥˥tsai˧˧lai˧˧
木匠	tso˨˩bak˦e˨˦
木字旁	bok˨dzi˧˧piŋ˨˦
木工	bak˦kaŋ˥˥
木本	bok˨pun˥˧
木材	bok˨tsai˨˦
未來社會會變怎樣	bi˧˧lai˨˦sia˧˧hue˧˧e˧˧pian˨˩an˥˧tsũã˥˧
未免	bi˧˧bian˥˧
未滿二十歲	bi˧˧buan˥˧dzi˧˧tsap˦hue˨˩
末梢	bue˥˧a˥˧
本事、能力	tsai˨˦tiau˧˧
本人	pun˥˧laŋ˨˦
本名	pun˥˧mia˨˦
本土	pun˥˧tʰɔ˥˧
本年度	pun˥˧ni˨˦tɔ˧˧
本錢	pun˥˧tsĩ˨˦
李兄	li˥˧hĩã˥˥
村莊裡頭請戲班子來演戲的錢都是大家一起分攤的	tsŋ˥˥tʰau˨˦tso˨˩hi˨˩e˨˦tsĩ˨˦loŋ˥˧si˧˧kui˥˥tsŋ˥˥tʰau˨˦koŋ˥˥kʰui˥˥e˨˦
東方	taŋ˥˥hoŋ˥˥
東西不要撒得滿地都是	miʔ˦kĩã˧˧m˥˥tʰaŋ˥˥ia˧˧kaʔ˨tsit˦si˨˩ke˨˩
東西攢在他手裡	miʔ˦kĩã˧˧lak˦ti˧˧i˥˥e˨˦tsʰiu˥˧te˥˧
東西收在抽屜下面	miʔ˦kĩã˧˧siu˥˥ti˧˧tʰuaʔ˨a˥˧e˧˧te˥˧
東西沒地方放	miʔ˦kĩã˧˧bo˨˦ui˧˧tʰaŋ˥˥he˧˧
東西買中古的比較便宜	miʔ˦kĩã˧˧be˥˧dzi˧˧tsʰiu˥˧e˨˦kʰaʔ˨siok˨
東西還好好的你就不要了	miʔ˦kĩã˧˧iau˥˧koʔ˨ho˥˧ho˥˧li˥˧to˧˧m˥˥tiʔ˦aʔ˨
東邊	taŋ˥˥piŋ˨˦
林宅	lim˨˦koŋ˥˥kuan˥˧
校長叫他去校長室	hau˧˧tĩũ˥˧kio˨˩i˥˥kʰi˨˩hau˧˧tĩũ˥˧sik˨
根本	kin˥˥pun˥˧
棋子	ki˨˦dzi˥˧
樹木	tsʰiu˧˧bak˦
樹木全部燒光了	tsʰiu˧˧a˥˧loŋ˥˧sio˥˥liau˥˧liau˥˧
機械修護工人	ɔ˥˥tsʰiu˥˧
歡樂的時光是很美好可貴的	tsʰun˥˥siau˥˥it˨kʰik˨tit˦tsʰian˥˥kim˥˥
止痛	tsi˥˧tʰĩã˨˩
死命地跑	he˧˧sẽ˨˩mia˧˧tsau˥˧
死後一定會上天堂	si˥˧liau˥˧au˧˧it˨tiŋ˧˧e˧˧tsĩũ˧˧tʰian˥˥toŋ˨˦
死心	si˥˧sim˥˥
死棋	oŋ˨˦kian˨˩oŋ˨˦
毀於一旦	hui˥˧i˨˦it˨tan˨˩
母親想念在當兵的兒子	lau˧˧bu˥˧sim˥˥bun˧˧teʔ˨tso˨˩piŋ˥˥e˨˦kĩã˥˧
每個人都很喜歡可愛的動物	tak˦e˨˦laŋ˨˦loŋ˥˧tsĩã˨˦kaʔ˨i˨˩kʰo˥˧ai˨˩e˨˦toŋ˧˧but˦
每個人都有自己的想法	kok˨laŋ˨˦u˧˧kok˨laŋ˨˦e˨˦sim˥˥i˨˩
每個字都寫得很端正	tak˦dzi˧˧to˥˥sia˥˧kaʔ˨tsin˥˥si˨˩tsĩã˨˩
每個小孩都是父母的心肝寶貝	tak˦e˨˦gin˥˧a˥˧loŋ˥˧si˧˧pe˧˧bu˥˧e˨˦sim˥˥kũã˥˥a˥˧po˥˧pue˨˩
每樣東西都要吃	tak˦haŋ˧˧miʔ˦kĩã˧˧loŋ˥˧ai˨˩tsiaʔ˦
比力氣	pi˥˧kʰui˨˩lat˦
比喻家喻戶曉	mia˨˦sĩã˥˥tʰaŋ˨˩su˨˩hai˥˧
比喻走霉運	un˧˧tɔ˨˦kĩã˨˦ti˧˧bau˥˧dzi˧˧
比喻頑固嘴硬的人	tʰiʔ˨kʰi˥˧taŋ˨˦ge˨˦tso˨˦
比才能	pi˥˧tsai˨˦liŋ˨˦
比數差這麼多	pi˥˧sɔ˨˩tsʰa˥˥hiaʔ˨tse˧˧
比方說他若跟你借錢	pi˥˧lun˧˧koŋ˥˧i˥˥na˧˧ka˧˧li˥˧tsioʔ˨tsĩ˨˦
比武招親是歌仔戲才有的把戲	pi˥˧bu˥˧tsio˥˥tsʰin˥˥si˧˧kua˥˥a˥˧hi˨˩tsiaʔ˨u˧˧e˨˦tsʰut˨tʰau˨˦
比賽有贏有輸沒有一個定數	pi˥˧sai˨˩e˧˧ĩã˨˦e˧˧su˥˥bo˨˦pau˥˥un˥˧e˨˦
毛巾	bin˧˧kin˥˥
毛毛雨	hɔ˧˧mŋ˥˥a˥˧
毛遂	mɔ˨˦sui˧˧
毛髮的邊際要修一修嗎	mŋ˥˥kʰa˥˥beʔ˨siu˥˥bo˨˦
氏族	si˧˧tsok˨
氣得說不出話來	kʰi˨˩tsit˦e˧˧be˧˧koŋ˥˧ue˧˧
氣虛	tan˥˥tian˨˦bo˨˦lat˦
氣象報告說今天會有大浪	kʰi˨˩sioŋ˧˧po˨˩ko˨˩koŋ˥˧kin˥˥a˥˧dzit˦u˧˧tua˧˧iŋ˥˧
水井	tsui˥˧tsẽ˥˧
水果	kue˥˧tsi˥˧
水桶咚的一聲就投進水井內了	kũã˧˧tʰaŋ˥˧a˥˧tom˨˦tsit˦sĩã˥˥to˧˧lak˨dzip˦kʰi˨˩kɔ˥˧tsẽ˥˧lai˧˧aʔ˨
水流量非常大	tsui˥˧tsiok˨tua˧˧kaŋ˥˧
水稻長得很飽滿	tiu˧˧a˥˧kiat˨liau˥˧tsĩã˨˦pa˥˧sui˧˧
水面上	tsui˥˧bin˧˧sioŋ˧˧
求仙	kiu˨˦sian˥˥
求雨	kʰit˨hɔ˧˧
沒得比	be˧˧pi˥˧tit˨
沒惡意	bo˨˦pʰãĩ˥˧i˨˩
沒拿到冠軍真不甘心	bo˨˦tʰeʔ˦tioʔ˨kuan˥˥kun˥˥tsin˥˥m˥˥kam˥˥guan˧˧
沒有也好	bo˨˦ia˧˧ho˥˧
沒有做零售	bo˨˦teʔ˨be˧˧lan˨˦san˥˥e˨˦
沒有力氣	bo˨˦lat˦
沒有幾戶人家住在那裡	tua˨˩bo˨˦kui˥˧kʰau˥˧tsau˨˩
沒有我的准許	bo˨˦gua˥˧e˨˦in˥˧tsun˥˧
沒有牙齒	bo˨˦tsʰui˨˩kʰi˥˧
沒有關係	bo˨˦iau˨˩kin˥˧
沒本事	bo˨˦tsai˨˦
油井	iu˨˦tsẽ˥˧
泉水湧出	tsʰut˨tsũã˨˦
洗得不乾淨	se˥˧liau˥˧bo˨˦tsʰiŋ˥˥kʰi˨˩
洗手腳	se˥˧tsʰiu˥˧bin˧˧
活到七老八十了	tsiaʔ˦kaʔ˨tsʰit˨lau˧˧peʔ˨lau˧˧aʔ˨
流亡	liu˨˦boŋ˨˦
深紅色	tua˧˧aŋ˨˦
清除髒汙	kʰi˨˩la˨˦sam˨˦
滿臉鬍子的人不仁厚	hɔ˨˦e˨˦put˨dzin˨˦
火化	hue˥˧hua˨˩
火氣大	hue˥˧kʰi˨˩tua˧˧
火熄滅了！也引申為表示「慘了、糟了、完蛋了」的感嘆詞	hue˥˧hua˥˥kʰi˨˩aʔ˨
火熄滅了啦。即指沒力了、沒勁了	hue˥˧hua˥˥kʰi˨˩aʔ˨
炸好的芋頭要吃之前得先過油再稍微炸一下	tsĩ˨˩ho˥˧e˨˦ɔ˧˧a˥˧tsĩ˨˩beʔ˨tsiaʔ˦tsin˨˩tsiŋ˨˦ai˨˩koʔ˨tsã˨˩tsit˦e˧˧
為人處事必須認真努力	tso˨˩laŋ˨˦ai˨˩dzin˧˧tsin˥˥pʰaʔ˨pĩã˨˩
為人要注重人格	tso˨˩laŋ˨˦ai˨˩tioŋ˧˧dzin˨˦keʔ˨
烏魚子	ɔ˥˥hi˨˦tsi˥˧
無聊的時候就找些消遣來做	bo˨˦liau˨˦e˨˦si˨˦tsun,7to˧˧lai˨˦pĩ˨˩kaŋ˥˥ge˧˧
無論什麼事情	huan˨˦su˧˧
無論如何都不要成為浪蕩子	sian˥˥to˥˥m˥˥tʰaŋ˥˥tso˨˩pʰãĩ˥˧kĩã˥˧
煉丹	lian˧˧tan˥˥
煎魚要會翻面	tsian˥˥hi˨˦a˥˧ai˨˩e˧˧hiau˥˧piŋ˥˧piŋ˨˦
爐丹	lɔ˨˦tan˥˥
爭當丐頭。其實做乞丐的所得有限，雖然乞丐頭可以過得比其他乞丐好一點，但終究無法和非乞丐相比。故此句有嘲諷或可憐人為小利而爭的意味	sio˥˥tsẽ˥˥tso˨˩kʰit˨tsiaʔ˦tʰau˨˦
父子	pe˧˧a˥˧kĩã˥˧
父母就輕鬆了	pe˧˧bu˥˧to˧˧kʰin˥˥saŋ˥˥aʔ˨
父老子幼	pe˧˧lau˧˧kĩã˥˧iu˨˩
爺爺、外公	a˥˥koŋ˥˥
爺爺的病嚴重到快要死了	a˥˥koŋ˥˥e˨˦pẽ˧˧taŋ˧˧kaʔ˨kioŋ˧˧kioŋ˧˧beʔ˨hua˥˥kʰi˨˩aʔ˨
牛奶	gu˨˦liŋ˥˥
牛軛	ka˥˥tsʰia˥˥
牛頭馬面	gu˨˦tʰau˨˦be˥˧bin˧˧
牽引亡魂、通靈。是傳統喪禮的一部分	kʰan˥˥boŋ˨˦hun˨˦
王昭君	oŋ˨˦tsiau˥˥kun˥˥
王氏	oŋ˨˦si˧˧
王牌	oŋ˨˦pai˨˦
現代	hian˧˧tai˧˧
現代人的嫁妝常常都折合現金	tsit˨ma˥˧e˨˦laŋ˨˦ke˨˩tsŋ˥˥tĩã˧˧tĩã˧˧loŋ˥˧tã˥˧hian˧˧kim˥˥
現代的水瓢多半是塑膠製的	hian˧˧tai˧˧e˨˦tsui˥˧kʰok˨a˥˧sok˨ka˥˥tso˨˩e˨˦kʰaʔ˨tse˧˧
現在	tsit˨ku˥˧
現在到處都是橘子	tsit˨ma˥˧kam˥˥a˥˧tua˧˧si˨˩ke˨˩
現在卻變天了	tsit˨ma˥˧suaʔ˨teʔ˨huan˥˧tʰĩ˥˥aʔ˨
現在外面天色已經暗了	tsit˨ma˥˧gua˧˧kʰau˥˧e˨˦tʰĩ˥˥sik˨i˥˧kiŋ˥˥am˨˩aʔ˨
現在小一輩的年輕人	tsit˨ma˥˧e˧˧un˨˦e˨˦siau˨˩lian˨˦laŋ˨˦
現在已經是大老闆了	tsit˨ma˥˧i˥˧kiŋ˥˥si˧˧tua˧˧tʰau˨˦ke˥˥aʔ˨
現在很流行練功夫	tsit˨ma˥˧lian˧˧kaŋ˥˥hu˥˥tsin˥˥si˨˦kĩã˨˦
現在我才知道他是騙我的	tsit˨ma˥˧gua˥˧tsiaʔ˨tsai˥˥ĩã˥˧i˥˥si˧˧pʰian˨˩gua˥˧e˨˦
現在比較少人用木炭燒火	tsit˨ma˥˧kʰaʔ˨tsio˥˧laŋ˨˦teʔ˨hĩã˨˦hue˥˧tʰũã˨˩
現在要反悔已經來不及了	tsit˨ma˥˧beʔ˨huan˥˧hue˥˧i˥˧kiŋ˥˥be˧˧hu˨˩aʔ˨
現在觀念進步	tsit˨ma˥˧kuan˥˥liam˧˧tsin˨˩pɔ˧˧
現在開始賺錢囉	tsit˨ma˥˧kʰai˥˥si˥˧beʔ˨tʰan˨˩tua˧˧tsĩ˨˦lɔʔ˨
環境很好	kʰuan˨˦kiŋ˥˧tsin˥˥ho˥˧
生氣	hue˥˧tua˧˧
生活真艱困	dzit˦tsi˥˧tsin˥˥pʰãĩ˥˧kue˨˩
生活較寬裕	siŋ˥˥uaʔ˦e˧˧kʰaʔ˨lioŋ˧˧sioŋ˧˧
生男孩子	tsʰut˨tiŋ˥˥
用九層塔煎蛋很好吃	ioŋ˧˧kau˥˧tsan˨˩tʰaʔ˨tsian˥˥nŋ˥˥tsin˥˥ho˥˧tsiaʔ˦
用小火慢煮	ioŋ˧˧un˨˦un˨˦a˥˧hue˥˧loʔ˨kʰi˨˩tsu˥˧
用手抓不到	tsʰiu˥˧pe˨˦be˧˧tioʔ˨
用手比較快些	ioŋ˧˧tsʰiu˥˧pi˥˧kʰaʔ˨kin˥˧
用抹刀抹牆壁，不但牆壁光滑，連抹刀也光滑。形容人很會做人，雙方面都能討好	tsit˦bin˧˧buaʔ˨piaʔ˨siaŋ˥˥bin˧˧kŋ˥˥
用禽類動物內臟煮成的湯	ha˧˧sui˥˧tʰŋ˥˥
用話頂撞別人	iŋ˧˧ue˧˧tsʰe˥˥laŋ˨˦
甲乙丙丁	kaʔ˨it˨pĩã˥˧tiŋ˥˥
甲乙丙丁戊己庚辛壬癸十天干	tʰian˥˥kan˥˥
男子	lam˨˦tsu˥˧
男子漢大丈夫	lam˨˦tsu˥˧han˨˩tai˧˧tioŋ˧˧hu˥˥
男性祖先	tsɔ˥˧koŋ˥˥
畏首畏尾	kiu˥˥kʰa˥˥kiu˥˥tsʰiu˥˧
畢業之後找不到工作	tsʰut˨giap˦tsʰue˧˧bo˨˦tʰau˨˦lɔ˧˧
當教授是我一生的願望	tso˨˩kau˨˩siu˧˧si˧˧gua˥˧it˨siŋ˥˥e˨˦guan˧˧boŋ˧˧
疏離	paŋ˨˩gua˧˧gua˧˧
疑問句	gi˨˦bun˧˧ku˨˩
病才會比較快痊癒	pẽ˧˧tsiaʔ˨e˧˧kʰaʔ˨kʰuai˨˩ho˥˧
登陸	kʰi˥˧sũã˥˥
發帖子	pun˥˥tʰiap˨a˥˧
發生事情	tsʰut˨tai˧˧tsi˨˩
發簿子	pun˥˥pʰɔ˧˧a˥˧
白費力氣	liau˥˧lat˦
白費功夫	liau˥˧kaŋ˥˥
白費工夫又賠錢。比喻賠了夫人又折兵	liau˥˧kaŋ˥˥koʔ˨siʔ˦pun˥˧
百分比	paʔ˨hun˥˥pi˥˧
盡人事聽天命	tsin˧˧dzin˨˦su˧˧sun˧˧tʰĩ˥˥i˨˩
目前剛好沒空	tsʰiu˥˧tʰau˨˦tu˥˧tu˥˧a˥˧ho˥˧bo˨˦iŋ˨˦
盾和矛，原指兵器，後多引申為戰爭	kan˥˥ko˥˥
看你敢還是不敢	kʰũã˨˩li˥˧kã˥˧iaʔ˦si˧˧m˥˥kã˥˧
看你還差多少	kʰũã˨˩li˥˧koʔ˨kʰiam˨˩kʰueʔ˨gua˧˧tse˧˧
看起來還是很年輕	kʰũã˨˩tioʔ˨iau˥˧tsin˥˥siau˨˩lian˨˦
看那個孩子躲到哪裡去了	kʰũã˨˩hit˨e˨˦gin˥˧a˥˧biʔ˨ti˧˧to˥˧ui˧˧
看面相時，男性要看額頭，女性要看下巴	lam˨˦tʰian˥˥ping,5li˥˧e˧˧kok˨
真不好意思	tsĩã˨˦pʰãĩ˥˧se˨˩
真可惜	tsĩã˨˦kʰo˥˧sioʔ˨
真是了不得	tsin˥˥tsĩã˨˩put˨tik˨liau˥˧
真是厲害	m˥˥tsĩã˨˦kau˨˦
真是賺到了	tsin˥˥tsĩã˨˩si˧˧bau˥˧si˥˧aʔ˨
真沒用	tsin˥˥ha˧˧siau˥˥
真的會熱死人	tsin˥˥tsĩã˨˩e˧˧dzuaʔ˦si˥˧laŋ˨˦
真糟糕	tsin˥˥hai˧˧
真難說	tsin˥˥pʰãĩ˥˧koŋ˥˧
眼睛掛著斗概，看到別人的東西就想要。因為斗概概入不概出，故有此比喻	bak˦tsiu˥˥kua˨˩tau˥˧kai,3kʰũã˨˩laŋ˨˦miʔ˦to˧˧ai˨˩
眼睛通透可以把人看穿的眼神	tsui˥˧tsĩ˥˥bak˦
眾人的意見他一概反對	tsiŋ˨˩laŋ˨˦e˨˦i˨˩kian˨˩i˥˥it˨kʰai˨˩huan˥˧tui˨˩
瞳孔	bak˦tsiu˥˥dzin˨˦
知道要跟著我們走	tsai˥˥ĩã˥˧beʔ˨tue˨˩guan˥˧kĩã˨˦
石磨的中央	tsioʔ˨bo˧˧a˥˧sim˥˥
石頭浸久了也會長青苔。比喻從事某一工作，時間久了也會有所成就	tsioʔ˨tʰau˨˦tsim˨˩ku˥˧ma˧˧e˧˧tsʰĩũ˧˧tsʰẽ˥˥tʰi˨˦
磕頭	kʰau˨˩tʰau˨˦
磨刀石拿來磨刀子	to˥˥tsioʔ˨tʰeʔ˦lai˨˦bua˨˦to˥˥a˥˧
祖母	lai˧˧ma˥˧
祖父	lai˧˧koŋ˥˥
祝福你們一路平安	tsiok˨lin˥˧tsit˦lɔ˧˧piŋ˨˦an˥˥
祭拜祖先	pai˨˩koŋ˥˥ma˥˧
禮尚往來的事情有夠多	dzin˨˦tsiŋ˨˦se˨˩su˧˧u˧˧kau˨˩tse˧˧
秀才	siu˨˩tsai˨˦
稍微、一點點	sio˥˧kʰua˥˧
稍微、一點點	sio˥˧kʰua˥˧a˥˧
稍微想一下	sio˥˧sĩũ˧˧tsit˦e˧˧
稍等一下	sio˥˧tan˥˧tsit˦e˧˧
稍等一會兒	sio˥˧tan˥˧tsit˦e˧˧
稱人子	koŋ˥˥tsu˥˧
稻子長得很大棵了	tiu˧˧a˥˧huat˨kaʔ˨tsĩã˨˦tua˧˧tsaŋ˨˦aʔ˨
穿內衣比較衛生	u˧˧tsʰiŋ˧˧lai˧˧sã˥˥ke˥˥kʰaʔ˨ue˧˧siŋ˥˥
竹枝竟然斷掉了	tsʰue˨˦a˥˧suaʔ˨tŋ˥˥kʰi˨˩
笑笑的	tsʰio˨˩tsʰio˨˩a˥˧
第一冊	te˧˧it˨tsʰeʔ˨
第一期稻作的收成季	lak˦gueʔ˦taŋ˥˥
第三代	te˧˧sã˥˥te˧˧
第二	te˧˧dzi˧˧
第二代	te˧˧dzi˧˧tai˧˧
等一下	tsʰĩã˥˧ban˧˧tsit˦e˧˧
等一下麻煩你發言幫我說些好話好嗎	tan˥˧tsit˦e˧˧ma˨˦huan˨˦li˥˧tsʰut˨tsʰui˨˩ka˧˧gua˥˧tau˨˩koŋ˥˧kua˥˧ho˥˧ue˧˧ho˥˧bo˨˦
等一會兒也許會下雨	tan˥˧leʔ˨huan˧˧se˨˩e˧˧loʔ˨hɔ˧˧
等一會兒看不對勁	tan˥˧tsit˦e˧˧kʰũã˨˩m˥˥si˧˧se˨˩
等了一小時了	tan˥˧tsit˦tiam˥˧tsiŋ˥˥ku˥˧aʔ˨
算命先生	sioŋ˨˩mia˧˧sian˥˥
算命的說	sǹg1mia˧˧e˨˦koŋ˥˧
算命的說他生來就是乞丐命	sǹg1mia˧˧e˨˦koŋ˥˧i˥˥sẽ˥˥lai˨˦si˧˧kʰit˨tsiaʔ˦mia˧˧
算盤的珠子	sǹg1pũã˨˦dzi˥˧
管理機關人員的辦公處所	dzin˨˦su˧˧sik˨
簡直就像個王爺	be˧˧su˥˥oŋ˨˦ia˨˦leʔ˨
米漿	bi˥˧liŋ˥˥
粗俗的人講粗俗的話	tʰɔ˥˧laŋ˨˦koŋ˥˧tʰɔ˥˧ue˧˧
約一公尺的長度	sã˥˥tsʰioʔ˨
紅仕	aŋ˨˦su˧˧
紅包隨便你多少好了。譏笑和尚在中元普渡時亂誦經	aŋ˨˦pau˥˥sui˨˦li˥˧saŋ˨˩
細毛	iu˨˩mŋ˥˥
給人領養當童養媳	pun˥˥laŋ˨˦tso˨˩sin˥˥pu˧˧a˥˧
給他一個人情	tso˨˩dzin˨˦tsiŋ˨˦hɔ˧˧i˥˥
絨布	dzioŋ˨˦a˥˧pɔ˨˩
繡有八仙的紅彩，在喜慶時掛在門楣上	pat˨sian˥˥tsʰai˥˧
繩子鬆掉了	soʔ˨a˥˧liŋ˧˧kʰi˨˩aʔ˨
纏著要錢	lo˥˥tsĩ˨˦
缺德	iau˥˧siu˧˧
羊毛	ĩũ˨˦mŋ˥˥
羊毛	ĩũ˨˦mɔ˨˦
翻字典	piŋ˥˧dzi˧˧tian˥˧
翻車	piŋ˥˧tsʰia˥˥
翻轉身體	piŋ˥˧sin˥˥
翻過來洗另外一邊	piŋ˥˧kue˨˩lai˨˦se˥˧liŋ˧˧gua˧˧tsit˦bin˧˧
老人沒牙齒嘴巴都會凹陷	lau˧˧laŋ˨˦bo˨˦tsʰui˨˩kʰi˥˧loŋ˥˧e˧˧mauʔ˨tsʰui˨˩
老天爺	tʰĩ˥˥koŋ˥˥
老天爺疼愛老實人	tʰĩ˥˥koŋ˥˥tʰĩã˨˩goŋ˧˧laŋ˨˦
老婆覺得竹筴魚太好吃了，連自己都捨不得分給老公吃。為一句臺灣俗諺	pa˥˥laŋ˥˥ho˥˧tsiaʔ˦m˥˥pun˥˥aŋ˥˥
老師在叫你	sian˥˥sĩ˥˥teʔ˨kio˨˩li˥˧
老師正在教室裡面授課	lau˧˧su˥˥tŋ˥˥teʔ˨kʰo˨˩tŋ˥˥sioŋ˧˧kʰo˨˩
老犯人欺負新犯人。比喻老手欺生手	ku˧˧siu˨˦tsiaʔ˦sin˥˥siu˨˦
老王後天要出殯	oŋ˨˦e˨˦au˧˧dzit˦beʔ˨tsʰut˨sũã˥˥
老闆	tʰau˨˦ke˥˥
老闆人真好	tʰau˨˦ke˥˥laŋ˨˦tsin˥˥ho˥˧
老闆端菜上桌	tʰau˨˦ke˥˥pʰaŋ˨˦tsʰai˨˩tsĩũ˧˧toʔ˨
老陳	tan˨˦e˨˦
老陳跟老王兩人在爭論	tan˨˦e˨˦kaʔ˨oŋ˨˦e˨˦teʔ˨ke˥˥ue˧˧
老鼠被貓抓光光了	niau˥˧tsʰi˥˧hɔ˧˧niau˥˥liaʔ˦liau˥˧liau˥˧aʔ˨
考上狀元	tioŋ˨˩tsioŋ˧˧guan˨˦
而不是背後的主使者	m˥˥si˧˧tsin˥˥tsĩã˨˩e˨˦tʰau˨˦ke˥˥
而且好吃懶做	iu˧˧koʔ˨beʔ˨tsiaʔ˦m˥˥tʰo˥˧tʰan˨˩
聖人	siŋ˨˩dzin˨˦
聽說這種藥可以止咳化痰以及保養氣管	tʰĩã˥˥koŋ˥˧tsit˨kʰuan˥˧ioʔ˨a˥˧e˧˧taŋ˨˩tsi˥˧sau˨˩hua˨˩tʰam˨˦kiam˥˥kɔ˨˩hi˨˩kńg1
聽說那間房子有凶物	tʰĩã˥˥koŋ˥˧hit˨kiŋ˥˥tsʰu˨˩u˧˧pʰãĩ˥˧miʔ˦
肉包	baʔ˨pau˥˥
肉末	baʔ˨iu˨˩a˥˧
肚子像水櫃一樣凸起	pak˨tɔ˥˧na˥˧tsui˥˧kui˧˧
肚子裡、內臟	pak˨lai˧˧
股票上市	kɔ˥˧pʰio˨˩tsĩũ˧˧tsʰi˧˧
背叛	huan˥˧pue˧˧
背脊癢	kʰa˥˥tsiaʔ˨pʰĩã˥˥tsĩũ˧˧
胳臂只會向內彎	tsʰiu˥˧kʰiau˥˥
胸前肋骨像樓梯一根根突現。形容人營養不良的模樣	hiŋ˥˥kʰam˥˧na˥˧lau˨˦tʰui˥˥
脾氣發作起來	siŋ˨˩te˧˧gia˨˦kʰi˥˧lai˨˦
腦充血	nau˥˧tsʰioŋ˥˥hiat˨
腳摔斷了	kʰa˥˥kut˨siak˨tŋ˥˥kʰi˨˩
臉部皮膚細嫩	bin˧˧baʔ˨iu˨˩
自己	tsu˧˧ki˥˧
自己千萬要小心	ka˥˥ki˧˧tsʰian˥˥ban˧˧ai˨˩sio˥˧sim˥˥
自己的女兒	siau˥˧lu˥˧
自己若是生不出孩子	ka˥˥ki˧˧na˧˧be˧˧sẽ˥˥
自然生成的材料最好	tʰian˥˥dzian˨˦e˨˦sɔ˨˩tsai˨˦sioŋ˧˧ho˥˧
臺北是一個四通八達的大城市	tai˨˦pak˨si˧˧tsit˦e˨˦su˨˩tʰoŋ˥˥pat˨tat˦e˨˦tua˧˧sĩã˨˦tsʰi˧˧
臺北車站裡面有各地來的人	tai˨˦pak˨tsʰia˥˥tʰau˨˦lai˧˧bin˧˧ŋɔ˥˧lɔ˧˧e˨˦laŋ˨˦loŋ˥˧u˧˧
臺灣現在的工資很貴	tai˨˦uan˨˦hian˧˧tsʰu˥˧si˨˦e˨˦laŋ˨˦kaŋ˥˥tsin˥˥kui˨˩
舅子	ku˧˧a˥˧
舅舅坐主位	bu˥˧ku˧˧tse˧˧tua˧˧ui˧˧
舊舊的	ku˧˧ku˧˧a˥˧
舞臺	bu˥˧tai˨˦
船要進港時會鳴汽笛	tsun˨˦beʔ˨dzip˦kaŋ˥˧e˨˦si˨˦e˧˧tan˨˦tsui˥˧le˨˦
芥菜正出產	kua˨˩tsʰai˨˩tŋ˥˥teʔ˨tsʰut˨
花旦	hue˥˥tũã˨˩
花是你送的對吧	hue˥˥si˧˧li˥˧saŋ˨˩e˨˦hõ˨
花言巧語	hua˥˥gian˨˦kʰa˥˧gi˥˧
若不是因為年少輕狂的痴傻舉動	siau˨˩lian˨˦na˧˧bo˨˦tsit˦pai˥˧goŋ˧˧
若你手頭方便	li˥˧tsʰiu˥˧tʰau˨˦na˧˧hoŋ˥˥pian˧˧
若是一個不湊巧	na˧˧si˧˧tsit˦e˨˦m˥˥ho˥˧se˨˩
若是每個人都能稍微忍耐一下	tak˦e˨˦laŋ˨˦na˧˧loŋ˥˧lun˥˧tsit˦e˧˧
苦主	kʰɔ˥˧tsu˥˧
茶包	te˨˦pau˥˥
草木	tsʰo˥˧bok˨
草本植物	tsʰau˥˧pun˥˧sit˦but˦
荒地才會起火燃燒	m˥˥tsiaʔ˨e˧˧hue˥˧sio˥˥pɔ˥˥
荒野路邊哪兒來那些祭拜無主冤魂的小廟呢	lɔ˧˧pĩ˥˥na˥˧u˧˧iu˥˧iŋ˨˩koŋ˥˥
菜價都上漲了	tsʰai˨˩ke˨˩loŋ˥˧gia˨˦kʰi˥˧lai˨˦
菜包	tsʰai˨˩pau˥˥
菜市場	tsʰai˨˩tsʰi˧˧a˥˧
菜很嫩	tsʰai˨˩tsin˥˥iu˨˩
菜心	tsʰai˨˩sim˥˥
菜種	tsʰai˨˩tsi˥˧
萬一下雨就用得到	m˥˥tu˥˧ho˥˧loʔ˨hɔ˧˧to˧˧iŋ˧˧e˧˧tioʔ˨
萬分感謝	tsap˦dzi˧˧hun˥˥e˨˦kam˥˧sia˧˧
薪水給他東扣西扣就所剩無幾了	sin˥˥sui˥˧hɔ˧˧i˥˥sã˥˥tu˨˦si˨˩kʰau˨˩to˧˧tsʰun˥˥bo˨˦gua˧˧tse˧˧aʔ˨
藥包	ioʔ˨pau˥˥
藥吃下	ioʔ˨a˥˧tsiaʔ˦loʔ˨kʰi˨˩
藥方	ioʔ˨hŋ˥˥
蘊育優秀的後代	tsʰut˨ho˥˧kĩã˥˧sun˥˥
虎牙	hɔ˥˧ge˨˦
蛋黃	nŋ˥˥dzin˨˦
蜂王	pʰaŋ˥˥oŋ˨˦
蝦仁	he˨˦dzin˨˦
血流不止	hueʔ˨lau˨˦be˧˧tsi˥˧
行善	tso˨˩koŋ˥˥tik˨
衣架	sã˥˥kiŋ˥˥a˥˧
表哥	piau˥˧hĩã˥˥
袋子內翻一些零錢出來	te˧˧a˥˧lai˧˧piŋ˥˧tsit˦kua˥˧gin˨˦kak˨a˥˧tsʰut˨lai˨˦
被他吃掉	hɔ˧˧i˥˥tsiaʔ˦kʰi˨˩
西瓜一斤多少錢	si˥˥kue˥˥tsit˦kin˥˥si˧˧gua˧˧tse˧˧tsĩ˨˦
要上坡了	beʔ˨tsĩũ˧˧kia˧˧aʔ˨
要先量身材尺寸	ai˨˩siŋ˥˥niu˨˦tsʰun˨˩tsʰioʔ˨
要叫他出錢是不可能的事情	beʔ˨kio˨˩i˥˥tsʰut˨tsĩ˨˦si˧˧bo˨˦kʰo˥˧liŋ˨˦e˨˦tai˧˧tsi˨˩
要大後年才會回來	tioʔ˨ai˨˩tua˧˧au˧˧ni˨˦tsiaʔ˨e˧˧taŋ˨˩to˨˩tńg1lai˨˦
要稱呼他公公	ai˨˩tsʰiŋ˥˥hɔ˥˥i˥˥ta˥˥kũã˥˥
要讓他看得上眼不簡單	beʔ˨hɔ˧˧i˥˥kʰũã˨˩e˧˧tsĩũ˧˧bak˦bo˨˦kan˥˧tan˥˥
要重綁	ai˨˩tiŋ˨˦pak˦
解除災難	kai˥˧eʔ˨
計算時一再折扣，自總數中盡量減除	tsʰit˨tu˨˦peʔ˨kʰau˨˩
試試大小合不合適	tsʰi˨˩kʰũã˨˩tua˧˧se˨˩e˧˧haʔ˦be˧˧
試試看囉	poʔ˨kʰũã˨˩mai˧˧leʔ˨
詩文	si˥˥bun˨˦
話都說不清楚	ue˧˧loŋ˥˧koŋ˥˧be˧˧tsʰiŋ˥˥tsʰo˥˧
語文	gi˥˧bun˨˦
說到種花他還有點能耐	koŋ˥˧tioʔ˨tsiŋ˨˩hue˥˥i˥˥koʔ˨u˧˧dzi˧˧pɔ˧˧tsʰit˨a˥˧
說到車子	na˧˧koŋ˥˧tioʔ˨tsʰia˥˥
說得很清楚	koŋ˥˧liau˥˧tsin˥˥tsʰiŋ˥˥tsʰo˥˧
說笑話、插科打諢	kik˨ŋɔ˥˧dzin˨˦
說話比較隨便	koŋ˥˧ue˧˧kʰaʔ˨tsʰin˨˩tsʰai˥˧
誰叫你擅作主張做這件事	sĩã˥˧laŋ˨˦kio˨˩li˥˧tua˧˧tsu˥˧tua˧˧i˨˩tso˨˩tsit˨kĩã˧˧tai˧˧tsi˨˩
課本	kʰo˨˩pun˥˧
請上蒼保佑我們臺灣能夠安定和富裕	tsʰĩã˥˧sioŋ˧˧tʰian˥˥po˥˧pi˨˩lan˥˧tai˨˦uan˨˦e˧˧taŋ˨˩an˥˥tiŋ˧˧kaʔ˨hu˨˩dzu˧˧
請人傳話會被加油添醋	kia˨˩ue˧˧e˧˧ke˥˥
請問你的大名是	tsʰĩã˥˧mŋ˥˥li˥˧e˨˦tua˧˧mia˨˦si˧˧
請問這位小兄弟怎麼稱呼	tsʰĩã˥˧mŋ˥˥tsit˨ui˧˧sio˥˧ti˧˧an˥˧tsũã˥˧tsʰiŋ˥˥hɔ˥˥
請朋友幫忙介紹工作	tsʰĩã˥˧piŋ˨˦iu˥˧tau˨˩in˥˧tʰau˨˦lɔ˧˧
講故事	koŋ˥˧kɔ˥˧
警察	kiŋ˥˧tsʰat˨a˥˧
警察大人	kiŋ˥˧tsʰat˨tai˧˧dzin˨˦
警察捉到的是人頭帳戶	kiŋ˥˧tsʰat˨liaʔ˦tioʔ˨e˨˦si˧˧laŋ˨˦tʰau˨˦
警察要保護大眾的安全	kiŋ˥˧tsʰat˨ai˨˩po˥˧hɔ˧˧koŋ˥˥tsioŋ˨˩e˨˦an˥˥tsuan˨˦
讀書人	tʰak˦tsʰeʔ˨laŋ˨˦
變種	huan˥˧tsiŋ˥˧
變顏色	huan˥˧sik˨
讓人聞起來簡直要反胃	hɔ˧˧laŋ˨˦pʰĩ˧˧tioʔ˨kioŋ˧˧beʔ˨piŋ˥˧pak˨
讓人聽了心裡不舒服	hɔ˧˧laŋ˨˦tʰĩã˥˥tioʔ˨sim˥˥kũã˥˥tʰau˨˦be˧˧soŋ˥˧kʰuai˨˩
讓他去啦	hɔ˧˧i˥˥kʰi˨˩laʔ˨
讓他賺了一筆	kʰi˨˩hɔ˧˧i˥˥tʰan˨˩tsit˦tsʰiu˥˧kʰi˨˩
讓別人瞧不起	hɔ˧˧laŋ˨˦kʰũã˨˩bo˨˦
讓客人方便	hɔ˧˧laŋ˨˦kʰeʔ˨hoŋ˥˥pian˧˧
讓您增加麻煩，多了許多事，真是不好意思	hɔ˧˧li˥˧ke˥˥bo˨˦ing,5tsin˥˥pʰãĩ˥˧se˨˩
豆漿	tau˧˧liŋ˥˥
象牙	tsʰĩũ˧˧ge˨˦
豬的胰臟	io˥˥tsʰioʔ˨
貓在椅子下睡覺	niau˥˥kʰun˨˩ti˧˧i˥˧a˥˧e˧˧kʰa˥˥
財力	tsai˨˦lik˦
貧窮	san˨˩hioŋ˥˥
買書	be˥˧tsʰeʔ˨
買水果的錢	be˥˧kue˥˧tsi˥˧e˨˦tsĩ˨˦
買這件衣服花費一千元	be˥˧tsit˨nia˥˧sã˥˥kʰi˨˩tiau˧˧tsit˦tsʰiŋ˥˥kʰɔ˥˥
賓主盡歡	pin˥˥tsu˥˧tsin˧˧huan˥˥
賠錢生意沒人做	liau˥˧tsĩ˨˦siŋ˥˥li˥˧bo˨˦laŋ˨˦tso˨˩
賣蚵仔麵線一定可以賺錢	be˧˧o˨˦a˥˧mi˧˧sũã˨˩pau˥˥nia˥˧li˥˧tʰan˨˩tsĩ˨˦
質地鬆軟的木柴	pʰã˨˩tsʰa˨˦
赤色	tan˥˥hoŋ˨˦
走江湖賣藝為生的人	oŋ˨˦lok˨a˥˧sian˥˥
超級甜	se˨˩kai˨˩tĩ˥˥
超級貴	se˨˩kai˨˩kui˨˩
越多人割稻就越快完工	kuaʔ˨tiu˧˧a˥˧e˨˦laŋ˨˦kaŋ˥˥dzu˥˧tse˧˧to˧˧dzu˥˧kin˥˧kuaʔ˨liau˥˧
跑得喘不過氣	tsau˥˧kaʔ˨tua˧˧kʰui˨˩tsʰuan˥˧be˧˧li˧˧
跑掉	tsau˥˧kʰi˨˩aʔ˨
跨大步向前走	tua˧˧pɔ˧˧hioŋ˨˩tsian˨˦kĩã˨˦
路見不平	lɔ˧˧kian˨˩put˨piŋ˨˦
踩水車	taʔ˦tsui˥˧tsʰia˥˥
身體不舒服	laŋ˨˦bo˨˦soŋ˥˧kʰuai˨˩
車伕	tsʰia˥˥hu˥˥
車站附近有很多會拉客的計程車	tsʰia˥˥tʰau˨˦hu˨˩kin˧˧u˧˧tsin˥˥tse˧˧kio˨˩kʰeʔ˨e˨˦ke˨˩tʰiŋ˨˦tsʰia˥˥
軍人	kun˥˥dzin˨˦
較低階的職位	kʰaʔ˨ke˧˧kip˨e˨˦tsit˨ui˧˧
轉角的房子來做店面最合適	sã˥˥kak˨tʰaŋ˥˥e˨˦tsʰu˨˩lai˨˦tso˨˩tiam˨˩bin˧˧sioŋ˧˧ho˥˧
辦手續	pan˧˧tsʰiu˥˧siok˨
農作物收成好的年份	ho˥˧ni˨˦taŋ˥˥
農夫們在六月的收穫季都會比較忙	tsoʔ˨sit˨laŋ˨˦ti˧˧lak˦gueʔ˦taŋ˥˥loŋ˥˧e˧˧kʰaʔ˨bo˨˦iŋ˨˦
農曆初三、初四	tsʰe˥˥sã˥˥si˨˩
農曆新年除夕晚上家家戶戶都在圍爐	dzi˧˧kau˥˧me˨˦ke˥˥ke˥˥hɔ˧˧hɔ˧˧loŋ˥˧teʔ˨ui˨˦lɔ˨˦
農曆正月初九是玉皇大帝的誕辰	ku˧˧lik˦tsĩã˥˥gueʔ˦tsʰe˥˥kau˥˧si˧˧tʰĩ˥˥koŋ˥˥sẽ˥˥
農曆的小月只有二十九天而已	ku˧˧lik˦e˨˦sio˥˧gueʔ˦kan˥˥na˥˥dzi˧˧tsap˦kau˥˧kaŋ˥˥nia˧˧nia˧˧
退火	tʰe˨˩hue˥˧
送日子。指男方通知女方結婚日	saŋ˨˩dzit˦tʰau˨˦
逃避戰亂	tsau˥˧huan˥˧
逆天者亡	gik˦tʰian˥˥tsia˥˧boŋ˨˦
這下你真的賺死了	tsit˨sĩã˥˥li˥˧tsin˥˥tsĩã˨˩bau˥˧si˥˧aʔ˨
這不是什麼大事情	tse˥˥m˥˥si˧˧sĩã˥˧miʔ˨tua˧˧tai˧˧tsi˨˩
這不是我的	tse˥˥m˥˥si˧˧gua˥˧e˨˦
這些剩菜全部都打包起來	tsia˥˥e˨˦tsʰai˨˩bue˥˧loŋ˥˧ka˧˧pau˥˥kʰi˥˧lai˨˦
這些加起來總共一百元	tsia˥˥e˨˦ka˥˥kʰi˥˧lai˨˦loŋ˥˧tsoŋ˥˧tsit˦paʔ˨kʰɔ˥˥
這些小額的金錢	tse˥˥sio˥˧sɔ˨˩tsĩ˨˦
這些工作都交給你來分派	tsia˥˥e˨˦kʰaŋ˥˥kʰue˨˩loŋ˥˧kau˥˥hɔ˧˧li˥˧lai˨˦hun˥˥pʰai˨˩
這些東西你如果有需要就拿去	tsia˥˥e˨˦miʔ˦kĩã˧˧li˥˧na˧˧u˧˧kʰiam˨˩iŋ˧˧to˧˧tʰeʔ˦kʰi˨˩
這些蔥是我跟別人要來的	tsia˥˥e˨˦tsʰaŋ˥˥a˥˧si˧˧gua˥˧ka˧˧laŋ˨˦pun˥˥e˨˦
這些零錢對他來說是微不足道的	tsia˥˥e˨˦lan˨˦san˥˥tsĩ˨˦tui˨˩i˥˥lai˨˦koŋ˥˧si˧˧m˥˥tsĩã˨˦miʔ˦
這些頂多兩百元	tsia˥˥e˨˦sioŋ˧˧ke˥˥si˧˧nŋ˥˥paʔ˨kʰɔ˥˥
這些餅乾讓你們兩個人平分	tsia˥˥e˨˦pĩã˥˧hɔ˧˧lin˥˧nŋ˥˥e˨˦laŋ˨˦koŋ˥˥pun˥˥
這件事件我不允許你這樣做	tsit˨kĩã˧˧tai˧˧tsi˨˩gua˥˧m˥˥tsun˥˧li˥˧an˥˧ne˥˥tso˨˩
這件事你要讓他知道	tsit˨kĩã˧˧tai˧˧tsi˨˩li˥˧ai˨˩koŋ˥˧hɔ˧˧i˥˥tsai˥˥
這件事就這樣算了	tsit˨kĩã˧˧tai˧˧tsi˨˩to˧˧tsun˥˧tu˥˧suaʔ˨
這件事情一說起來就生氣	tsit˨kĩã˧˧tai˧˧tsi˨˩koŋ˥˧kʰi˥˧lai˨˦to˧˧sim˥˥hue˥˧toʔ˨
這件事情不能說出去	tsit˨kĩã˧˧tai˧˧tsi˨˩m˥˥ho˥˧koŋ˥˧tsʰut˨kʰi˨˩
這件事情你可以請他代辦	tsit˨tsan˨˦tai˧˧tsi˨˩li˥˧e˧˧taŋ˨˩tsʰĩã˥˧i˥˥tai˧˧pan˧˧
這件事情你最好別管	tsit˨kĩã˧˧tai˧˧tsi˨˩li˥˧sioŋ˧˧ho˥˧si˧˧mai˨˩kuan˥˧
這件事情由你做主就可以了	tsit˨tsan˨˦tai˧˧tsi˨˩hɔ˧˧li˥˧tsu˥˧i˨˩to˧˧ho˥˧
這件事情要是傳出去	tsit˨kĩã˧˧tai˧˧tsi˨˩na˧˧si˧˧tʰuan˨˦tsʰut˨kʰi˨˩
這件事情錯的人是你	tsit˨kĩã˧˧tai˧˧tsi˨˩m˥˥tioʔ˨e˨˦laŋ˨˦si˧˧li˥˧
這件事是怎麼發生的	tsit˨kĩã˧˧tai˧˧tsi˨˩si˧˧an˥˧tsũã˥˧huat˨siŋ˥˥e˨˦
這件洋裝不只是五千元而已	tsit˨nia˥˧ĩũ˨˦tsoŋ˥˥put˨tsi˥˧gɔ˧˧tsʰiŋ˥˥kʰɔ˥˥
這件衣服洗過以後變得縮小了	tsit˨nia˥˧sã˥˥se˥˧liau˥˧kiu˥˥tsui˥˧kʰi˨˩aʔ˨
這位作家自少女時代就開始寫作	tsit˨e˨˦tsok˨ka˥˥tsu˧˧siau˨˩li˥˧si˨˦tai˧˧to˧˧kʰai˥˥si˥˧sia˥˧tsok˨
這位小嬸很尊重大伯	tsit˨e˨˦sio˥˧tsim˥˧tsĩã˨˦tsun˥˥tioŋ˧˧tua˧˧peʔ˨
這個不行	tsit˨e˨˦be˧˧sai˥˧
這個人真可惡	tsit˨e˨˦laŋ˨˦tsin˥˥kʰo˥˧õ˨˩
這個孩子只顧白食不肯賺錢	tsit˨e˨˦gin˥˧a˥˧beʔ˨tsiaʔ˦m˥˥tʰo˥˧tʰan˨˩
這個客戶很難搞	tsit˨e˨˦kʰeʔ˨hɔ˧˧tsin˥˥pʰãĩ˥˧liu˥˧lak˦
這個小孩子常說不該說的話	tsit˨e˨˦gin˥˧a˥˧tsin˥˥pʰãĩ˥˧tsʰui˨˩
這個小孩子很難扶養	tsit˨e˨˦gin˥˧a˥˧tsin˥˥pʰãĩ˥˧io˥˥tsʰi˧˧
這個小孩很慷慨大方	tsit˨e˨˦gin˥˧a˥˧tsĩã˨˦pun˥˥tĩũ˥˥
這個是奶奶	tsit˨e˨˦si˧˧lai˧˧ma˥˧
這個月是生意淡季	tsit˨ko˨˩gueʔ˦si˧˧sio˥˧gueʔ˦
這個月錢賺得多	tsit˨gueʔ˦dzit˦tʰan˨˩kʰaʔ˨u˧˧tsĩ˨˦
這個村子沒多大	tsit˨e˨˦tsŋ˥˥tʰau˨˦bo˨˦gua˧˧tua˧˧
這個東西可有可無，都沒關係	tsit˨haŋ˧˧miʔ˦kĩã˧˧u˧˧ia˧˧ho,2bo˨˦ia˧˧ho,2loŋ˥˧bo˨˦iau˨˩kin˥˧
這個東西已經有了	tsit˨lo˧˧miʔ˦kĩã˧˧to˥˥i˥˧kiŋ˥˥u˧˧aʔ˨
這個案件是人倫悲劇	tsit˨e˨˦an˨˩kĩã˧˧si˧˧dzin˨˦lun˨˦pi˥˥kiok˨
這個牛舍裡有幾隻公牛	tsit˨e˨˦gu˨˦tiau˨˦lai˧˧te˥˧u˧˧kui˥˧tsiaʔ˨gu˨˦kaŋ˥˧
這個老闆還很年輕	tsit˨e˨˦tʰau˨˦ke˥˥iau˥˧tsin˥˥siau˨˩lian˨˦
這個醫生所開的藥劑的份量比較重	tsit˨e˨˦i˥˥siŋ˥˥e˨˦tsʰiu˥˧tʰau˨˦u˧˧kʰaʔ˨taŋ˧˧
這個鼻子塌陷的洋娃娃很難看	tsit˨e˨˦naʔ˨pʰĩ˧˧e˨˦aŋ˥˥a˥˧tsĩã˨˦pʰãĩ˥˧kʰũã˨˩
這兩個皮包看起來一模一樣	tsit˨nŋ˥˥e˨˦pʰue˨˦pau˥˥a˥˧kʰũã˨˩tioʔ˨kaŋ˧˧kʰuan˥˧a˥˧kaŋ˧˧kʰuan˥˧
這兩個計畫性質差太多	tsit˨nŋ˥˥e˨˦ke˨˩ue˧˧siŋ˨˩tsit˨tsʰa˥˥sĩũ˥˥tse˧˧
這只皮箱裡面裝什麼東西	tsit˨kʰa˥˥pʰue˨˦sĩũ˥˥lai˧˧te˥˧te˥˧sĩã˥˧miʔ˨
這四周都是泥沙	tsia˥˥si˨˩kʰɔ˥˥ui˨˦a˥˧loŋ˥˧si˧˧tʰɔ˨˦sua˥˥
這塊蛋糕被叉一下，居然凹下去了	tsit˨te˨˩ke˥˥nŋ˥˥ko˥˥tsʰiam˥˧tsit˦e˧˧suaʔ˨naʔ˨loʔ˨kʰi˨˩
這家商店是按人數收錢的	tsit˨kiŋ˥˥tiam˨˩si˧˧sǹg1laŋ˨˦tʰau˨˦siu˥˥tsĩ˨˦e˨˦
這封信麻煩你幫我代寫一下	tsit˨tĩũ˥˥pʰue˥˥ma˨˦huan˨˦li˥˧tʰe˨˩gua˥˧tai˧˧pit˨tsit˦e˧˧
這對雙胞胎到底誰是誰	tsit˨tui˨˩siaŋ˥˥sẽ˥˥a˥˧tau˨˩te˥˧sĩã˥˧laŋ˨˦si˧˧sĩã˥˧laŋ˨˦
這帖藥可以解除血氣鬱結	tsit˨tʰiap˨ioʔ˨a˥˧e˧˧taŋ˨˩kʰi˨˩sioŋ˥˥kai˥˧ut˨
這幾天天氣都不好	tsit˨kui˥˧kaŋ˥˥loŋ˥˧si˧˧pʰãĩ˥˧tʰĩ˥˥
這座山崖很高	tsit˨e˨˦sũã˥˥kʰam˨˩tsĩã˨˦kuan˨˦
這把刀的刀口很鋒利	tsit˨ki˥˥to˥˥e˨˦to˥˥tsʰui˨˩tsin˥˥lai˧˧
這支螺絲的螺紋已經磨損了	tsit˨ki˥˥lɔ˨˦si˥˥e˨˦ga˨˦ui˥˥kʰi˨˩aʔ˨
這是一種比喻	tse˥˥si˧˧tsit˦e˨˦pi˥˧dzu˧˧
這是公司內部的問題	tse˥˥si˧˧koŋ˥˥si˥˥lue˧˧pɔ˧˧e˨˦bun˧˧te˨˦
這是我們這組的問題	tse˥˥si˧˧lan˥˧tsit˨tsɔ˥˥e˨˦bun˧˧te˨˦
這是我媽媽的拿手好菜	tse˥˥si˧˧guan˥˧a˥˥bu˥˧e˨˦tsʰiu˥˧lɔ˧˧tsʰai˨˩
這是手工做的麵線	tse˥˥si˧˧tsʰiu˥˧kaŋ˥˥e˨˦mi˧˧sũã˨˩
這是直系孫子	tsit˨e˨˦si˧˧lai˧˧sun˥˥
這是眾人的事	tse˥˥si˧˧tsiŋ˨˩laŋ˨˦e˨˦tai˧˧tsi˨˩
這是誰的意見	tse˥˥si˧˧sĩã˥˧laŋ˨˦e˨˦tsu˥˧i˨˩
這最快也要到後天才能完成	tse˥˥sioŋ˧˧kin˥˧ma˧˧tioʔ˨ai˨˩kau˨˩au˧˧dzit˦tsiaʔ˨e˧˧ho˥˧
這本書的內容很淺顯	tsit˨pun˥˧tsʰeʔ˨e˨˦lue˧˧ioŋ˨˦tsin˥˥tsʰian˥˧
這條小徑很難走	tsit˨tiau˨˦sio˥˧lɔ˧˧tsin˥˥pʰãĩ˥˧kĩã˨˦
這條手帕做得很細緻	tsit˨tiau˨˦tsʰiu˥˧kin˥˥a˥˧tso˨˩liau˥˧u˧˧kau˨˩kaŋ˥˥hu˥˥
這條水管破掉了	tsit˨tiau˨˦tsui˥˧koŋ˥˧pʰua˨˩kʰi˨˩aʔ˨
這條泉水的水很甘甜	tsit˨kaŋ˥˧tsui˥˧tsũã˨˦e˨˦tsui˥˧tsĩã˨˦kam˥˥
這條路就變得很難走	tsit˨tiau˨˦lɔ˧˧to˧˧pian˨˩kaʔ˨tsin˥˥pʰãĩ˥˧kĩã˨˦
這條路很難走	tsit˨tiau˨˦lɔ˧˧tsin˥˥pʰãĩ˥˧kĩã˨˦
這樣不覺得太浪費嗎	an˥˧ne˥˥kam˥˧be˧˧sĩũ˥˥tʰo˥˧tse˨˩
這次一定贏啦	tsit˨sĩã˥˥pau˥˥ĩã˨˦e˨˦
這次比賽一定會贏	tsit˨hue˨˦pi˥˧sai˨˩pau˥˥un˥˧e˧˧ĩã˨˦
這次比賽沒拿到第一名	tsit˨pai˥˧e˨˦pi˥˧sai˨˩bo˨˦tʰeʔ˦tioʔ˨kuan˥˥kun˥˥
這次為他開刀的醫生都是最好的	tsit˨pai˥˧beʔ˨tʰe˨˩i˥˥kʰui˥˥to˥˥e˨˦i˥˥siŋ˥˥loŋ˥˧si˧˧it˨liap˦it˨e˨˦
這次的工程很順利	tsit˨pai˥˧e˨˦kaŋ˥˥su˧˧tsin˥˥sun˧˧li˧˧
這次的水災很嚴重	tsit˨pai˥˧e˨˦tsui˥˧tsai˥˥tsin˥˥giam˨˦tioŋ˧˧
這次買的五花肉真好吃	tsit˨kue˨˩be˥˧e˨˦sam˥˥tsan˨˦baʔ˨tsin˥˥ho˥˧tsiaʔ˦
這片山坡地上種了很多茶樹	tsit˨pʰian˨˩sũã˥˥pʰĩã˨˦tsiŋ˨˩tsiok˨tse˧˧te˨˦tsaŋ˨˦
這片草皮很平	tsit˨pʰian˨˩tsʰau˥˧pɔ˥˥tsin˥˥pẽ˨˦
這瓶香水是比較低級的貨品	tsit˨kuan˨˩pʰaŋ˥˥tsui˥˧kʰaʔ˨ke˧˧kip˨
這盤雞肉半生不熟	tsit˨pũã˨˦ke˥˥baʔ˨pũã˨˩tsʰẽ˥˥sik˦
這種事你應該要趁早講	tsit˨tsioŋ˥˧tai˧˧tsi˨˩li˥˧m˥˥to˧˧lioŋ˧˧tsa˥˧koŋ˥˧
這種事情何必再問	tsit˨kʰuan˥˧tai˧˧tsi˨˩aʔ˦sai˥˧koʔ˨mŋ˥˥
這種工作你們斯文的人根本做不來	tsit˨kʰuan˥˧kʰaŋ˥˥kʰue˨˩lin˥˧bun˨˦sin˥˥e˨˦kin˥˥pun˥˧to˥˥tso˨˩be˧˧lai˨˦
這種木材一才多少錢	tsit˨kʰuan˥˧bok˨tsai˨˦tsit˦tsʰai˨˦gua˧˧tse˧˧
這種東西太爛了啦	tsit˨tsioŋ˥˧miʔ˦kĩã˧˧sĩũ˥˥kɔ˥˧laʔ˨
這種東西菜市場不少	tsit˨tsioŋ˥˧miʔ˦kĩã˧˧tsʰai˨˩tsʰi˧˧a˥˧tsio˥˧kʰueʔ˨
這種餅世代相傳已經幾百年了	tsit˨tsioŋ˥˧pĩã˥˧se˨˩tai˧˧sioŋ˥˥tʰuan˨˦i˥˧kiŋ˥˥kui˥˥paʔ˨ni˨˦aʔ˨
這筆生意如果讓他做成	tsit˨tʰũã˥˥siŋ˥˥li˥˧na˧˧hɔ˧˧tso˨˩e˧˧siŋ˨˦
這筆錢是大家一起出的	tsit˨tiau˨˦tsĩ˨˦si˧˧tak˦ke˥˥koŋ˥˥ke˥˥tsʰut˨e˨˦
這算不上什麼錢	tse˥˥m˥˥tsĩã˨˦tsĩ˨˦
這箱橘子給你們分配	tsit˨sĩũ˥˥kam˥˥a˥˧hɔ˧˧lin˥˧kʰi˨˩pun˥˥
這群人很大一群	tsit˨tin˧˧laŋ˨˦tsĩã˨˦tua˧˧tin˧˧
這裡出產柳丁	tsia˥˥tsʰut˨liu˥˧tiŋ˥˥
這裡四周圍都是山	tsia˥˥si˨˩bin˧˧loŋ˥˧si˧˧sũã˥˥
這裡的東西他一口氣把它吃完	tsia˥˥e˨˦miʔ˦kĩã˧˧i˥˥tso˨˩tsit˦kʰun˨˩a˥˧ka˧˧i˥˥tsiaʔ˦liau˥˧
這道菜很好吃	tsit˨tsʰut˨tsʰai˨˩tsin˥˥ho˥˧tsiaʔ˦
這邊	tsit˨piŋ˨˦
這陣子經濟狀況真是拮据	tsit˨tsam˧˧a˥˧tsʰiu˥˧tʰau˨˦tsin˥˥an˨˦
這頓飯的飯錢大家一起均攤	tsit˨tǹg1pŋ˥˥tak˦ke˥˥tso˨˩hue˥˧hun˥˥tʰũã˥˥
這顆木瓜非常甜	tsit˨liap˦bok˨kue˥˥iau˥˧siu˧˧tĩ˥˥
這顆花生很飽滿	tsit˨liap˦tʰɔ˨˦tau˧˧tsin˥˥dzin˨˦
這魚腥味很重	tse˥˥hi˨˦a˥˧tsin˥˥tsʰau˨˩tsʰo˥˥
這麼小父親就過世了	tsiaʔ˨ni˧˧se˨˩han˨˩lau˧˧pe˧˧to˧˧lai˨˦kue˨˩sin˥˥kʰi˨˩
造反	tso˧˧huan˥˧
連一點東西都捨不得給人	lian˨˦tsit˦sut˨a˥˧miʔ˦to˥˥m˥˥kam˥˥hɔ˧˧laŋ˨˦
連乞丐也會出人頭地	kʰit˨tsiaʔ˦ia˧˧e˧˧tsʰut˨tʰau˨˦tʰĩ˥˥
連半個人影都沒有	lian˨˦pũã˨˩e˨˦laŋ˨˦ĩã˥˧ma˧˧bo˨˦
連這種工作都不會做	lian˨˦tsit˨kʰuan˥˧kʰaŋ˥˥kʰue˨˩to˥˥be˧˧hiau˥˧tso˨˩
進來	dzip˦lai˨˦
進去	dzip˦kʰi˨˩
遇到危險	tu˥˧tioʔ˨gui˨˦hiam˥˧
遇到困難仍然不會放棄	tu˥˧tioʔ˨kan˥˥lan˨˦loŋ˥˧be˧˧hoŋ˨˩kʰi˨˩
運動會又遇到大晴天	un˧˧toŋ˧˧hue˧˧koʔ˨tu˥˧tioʔ˨tsʰut˨tua˧˧dzit˦
過年的時候他會用外國酒來做公關	kue˨˩ni˨˦si˨˦a˥˧i˥˥e˧˧iŋ˧˧gua˧˧kok˨tsiu˥˧lai˨˦tso˨˩dzin˨˦su˧˧
過年過節的時候	ni˨˦tseʔ˨si˨˦a˥˧
過年過節要準備祭品來祭拜神明	ni˨˦tseʔ˨si˨˦a˥˧ai˨˩tsʰuan˨˦sam˥˥siŋ˥˥lai˨˦pai˨˩pai˨˩
違反法律規範的人	put˨huat˨tsi˥˥tɔ˨˦
遲早得要離開	tsa˥˧ban˧˧si˧˧ai˨˩li˧˧kʰui˥˥
遲早會出事	tsa˥˧ban˧˧e˧˧tsʰut˨tai˧˧tsi˨˩
還不認老	iau˥˧koʔ˨m˥˥dzin˧˧lau˧˧
還去當義工	koʔ˨kʰi˨˩tso˨˩gi˧˧kaŋ˥˥
還是一樣四處跑	ma˧˧kaŋ˧˧kʰuan˥˧pʰa˥˥pʰa˥˥tsau˥˧
還會考第一名	koʔ˨e˧˧kʰo˥˧te˧˧it˨mia˨˦
還有一些東西沒整理	iau˥˧u˧˧tsit˦kua˥˧a˥˧miʔ˦kĩã˧˧bo˨˦tsiŋ˥˧li˥˧
還沒開始做就停止	bue˧˧tsiŋ˨˦tso˨˩to˧˧kiu˥˥tsʰiu˥˧
邊走邊吃東西	na˥˧kĩã˨˦na˥˧tsiaʔ˦miʔ˦kĩã˧˧
那些男孩手很賤	hia˥˥e˨˦tsa˥˥pɔ˥˥gin˥˧a˥˧tsʰiu˥˧tsin˥˥tsian˧˧
那件洋裝看起來很高雅，不會俗氣	hit˨nia˥˧ĩũ˨˦tsoŋ˥˥kʰũã˨˩tioʔ˨tsin˥˥tua˧˧pan˧˧
那件褲子拿來比一下	hit˨nia˥˧kʰɔ˨˩tʰeʔ˦lai˨˦pi˥˧tsit˦e˧˧
那個不可以	hit˨e˨˦m˥˥tʰaŋ˥˥
那個乞丐每天都去車站向人乞討	hit˨e˨˦kʰit˨tsiaʔ˦tak˦kaŋ˥˥loŋ˥˧kʰi˨˩tsʰia˥˥tʰau˨˦ka˧˧laŋ˨˦pun˥˥
那個人很壞	hit˨e˨˦laŋ˨˦tsin˥˥pʰãĩ˥˧si˥˧
那個人很沒有水準	hit˨e˨˦laŋ˨˦tsĩã˨˦bo˨˦tsui˥˧tsun˥˧
那個人才是壞人	hit˨e˨˦laŋ˨˦tsiaʔ˨si˧˧pʰãĩ˥˧laŋ˨˦
那個人臉皮真厚	hit˨e˨˦laŋ˨˦u˧˧kau˨˩tua˧˧bin˧˧sin˨˦
那個唱歌唱得最好的人	hit˨e˨˦tsʰĩũ˨˩kua˥˥tsʰĩũ˨˩liau˥˧sioŋ˧˧ho˥˧e˨˦laŋ˨˦
那個女孩子講話很大方、自然	hit˨e˨˦tsa˥˥bɔ˥˧gin˥˧a˥˧koŋ˥˧ue˧˧tsin˥˥tua˧˧pan˧˧
那個小生長得真英俊	hit˨e˨˦sio˥˧siŋ˥˥tsin˥˥ian˨˦tau˨˦
那個老闆像土匪一樣兇惡	hit˨e˨˦tʰau˨˦ke˥˥u˧˧kau˨˩tʰɔ˥˧hui˥˧
那兩個小孩在吵架	hit˨nŋ˥˥e˨˦gin˥˧a˥˧teʔ˨uan˥˥ke˥˥
那兩球黑黑的東西是什麼	hit˨nŋ˥˥uan˨˦ɔ˥˥ɔ˥˥e˨˦miʔ˦kĩã˧˧si˧˧sĩã˥˧miʔ˨
那口井還有人在取水嗎	hit˨kʰau˥˧tsẽ˥˧kam˥˧koʔ˨u˧˧teʔ˨tsʰĩũ˧˧tsui˥˧
那幅畫很難看	hit˨pak˨tɔ˨˦tsin˥˥pʰãĩ˥˧kʰũã˨˩
那幾片彩雲添加了黃昏的美麗	hit˨kui˥˧pʰĩ˨˩tsʰai˥˧hun˨˦ka˥˥tʰiam˥˥hoŋ˨˦hun˥˥e˨˦bi˥˧le˧˧
那時候	hit˨ku˥˧
那本故事書很好看	hit˨pun˥˧kɔ˥˧tsʰeʔ˨tsĩã˨˦ho˥˧kʰũã˨˩
那根木頭很粗	hit˨kʰɔ˥˥tsʰa˨˦tsin˥˥tua˧˧kʰɔ˥˥
那條路中央有一個坑	hit˨tiau˨˦lɔ˧˧tioŋ˥˥ŋ˥˥u˧˧tsit˦naʔ˨
那種壞人要給他教訓	hit˨lo˧˧pʰãĩ˥˧miʔ˦ai˨˩ka˧˧i˥˥ka˨˩si˧˧
那間房子就會倒	hit˨kiŋ˥˥tsʰu˨˩to˧˧e˧˧to˥˧
那間房子有鬼	hit˨kiŋ˥˥tsʰu˨˩tsĩã˨˦pʰãĩ˥˧kʰaŋ˥˥
那間房子的四周圍都是山	hit˨kiŋ˥˥tsʰu˨˩e˨˦si˨˩piŋ˨˦loŋ˥˧si˧˧sũã˥˥
那間書店的書很多	hit˨kiŋ˥˥tsʰeʔ˨tiam˨˩e˨˦tsʰeʔ˨tsin˥˥tse˧˧
那隻蝸牛的頭縮進殼裡面去了	hit˨tsiaʔ˨lɔ˧˧le˨˦e˨˦tʰau˨˦kiu˥˥dzip˦kʰi˨˩kʰak˨lai˧˧te˥˧aʔ˨
那隻貓的爪子很銳利	hit˨tsiaʔ˨niau˥˥a˥˧e˨˦dziau˥˧a˥˧tsin˥˥lai˧˧
那項技術他已熟練了	hit˨haŋ˧˧kaŋ˥˥hu˥˥i˥˥i˥˧kiŋ˥˥oʔ˨tsĩũ˧˧tsʰiu˥˧aʔ˨
那麼小就經歷父母雙亡	hiaʔ˨se˨˩han˨˩pe˧˧bu˥˧to˧˧kue˨˩sin˥˥
邱大老爺	kʰu˥˥a˥˧boŋ˥˧sia˨˩
郎中錢一騙到手就開溜了	pian˥˧sian˥˥a˥˧tsĩ˨˦pian˥˧tsĩũ˧˧tsʰiu˥˧to˧˧liu˥˥suan˥˥aʔ˨
都不會不好意思	loŋ˥˧m˥˥tsai˥˥ĩã˥˧tʰaŋ˥˥pʰãĩ˥˧se˨˩
都市	tɔ˥˥tsʰi˧˧
都是上天的安排	loŋ˥˧si˧˧tʰĩ˥˥i˨˩
都沒有休息	loŋ˥˧bo˨˦hioʔ˨kʰun˨˩
醫生說他貧血	i˥˥siŋ˥˥koŋ˥˧i˥˥kʰiam˨˩hueʔ˨
里長伯做人很公正	li˥˧tĩũ˥˧peʔ˨a˥˧tso˨˩laŋ˨˦tsin˥˥koŋ˥˥to˧˧
金水嬸的三個兒子都很有才華，不是經理就是董事長	kim˥˥tsui˥˧tsim˥˧a˥˧sã˥˥e˨˦hau˧˧sẽ˥˥loŋ˥˧tsĩã˨˦u˧˧tsai˨˦tsing,5m˥˥si˧˧kiŋ˥˥li,2to˧˧si˧˧taŋ˥˧su˧˧tĩũ˥˧
金錢	tsĩ˨˦tsui˥˧
錢要帶多一點	tsĩ˨˦ai˨˩tsaʔ˨kʰaʔ˨lioŋ˧˧leʔ˨
長子的責任比較重	tua˧˧kĩã˥˧e˨˦tsik˨dzim˧˧kʰaʔ˨taŋ˧˧
長水痘的人不要到處跑	tsʰut˨tsu˥˥e˨˦laŋ˨˦m˥˥tʰaŋ˥˥si˨˩ke˨˩tsau˥˧
長輩留給他的遺產不少	si˧˧tua˧˧paŋ˨˩hɔ˧˧i˥˥e˨˦tsʰiu˥˧te˥˧be˧˧tsio˥˧
長青苔	tsʰĩũ˧˧tsʰẽ˥˥tʰi˨˦
門戶	mŋ˥˥hɔ˧˧
開到整臺車都翻過來	sai˥˧kaʔ˨kui˥˥tai˨˦tsʰia˥˥piŋ˥˧lian˨˩tńg1
開叉	kʰui˥˥tsʰe˥˥
阿三那個沒有用的人，只會在自己家欺負家人，對外卻完全不敢吭聲	a˥˥sam˥˥a˥˧hit˨kʰɔ˥˥bo˨˦lɔ˧˧iŋ˧˧lang,5kan˥˥na˥˥e˧˧hiau˥˧ti˧˧gu˨˦tiau˨˦lai˧˧tak˨gu˨˦bo˥˧nia˧˧nia˧˧
阿姨不是外人	a˥˥i˨˦m˥˥si˧˧gua˧˧laŋ˨˦
阿明	biŋ˨˦a˥˧
阿明中午吃壞肚子	a˥˥biŋ˨˦tioŋ˥˥tau˨˩tsiaʔ˦pʰãĩ˥˧pak˨tɔ˥˧
阿月	a˥˥guat˦
阿美一直在掃地	a˥˥bi˥˧it˨tit˦teʔ˨sau˨˩tʰɔ˨˦kʰa˥˥
阿英和我是最要好的朋友	a˥˥iŋ˥˥kaʔ˨gua˥˧si˧˧it˨liap˦it˨e˨˦ho˥˧piŋ˨˦iu˥˧
阿英很苦命	a˥˥iŋ˥˥a˥˧tsĩã˨˦pʰãĩ˥˧mia˧˧
阿英運氣很差	a˥˥iŋ˥˥a˥˧u˧˧kau˨˩pʰãĩ˥˧un˧˧
阿里山	a˥˥li˥˧san˥˥
陰陽人也要受到尊重	pũã˨˩iam˥˥ĩũ˨˦a˥˧ma˧˧ai˨˩siu˧˧tioʔ˨tsun˥˥tioŋ˧˧
陳家二房的子孫都很老實	tan˨˦ka˥˥dzi˧˧paŋ˨˦e˨˦kĩã˥˧sun˥˥a˥˧loŋ˥˧tsin˥˥lau˥˧sit˦
陳家的少爺人品很好	tan˨˦ka˥˥e˨˦siau˨˩ia˨˦dzin˨˦pʰin˥˧tsin˥˥ho˥˧
隨便吃會肚子痛	ɔ˥˥peʔ˦tsiaʔ˦e˧˧pʰãĩ˥˧pak˨tɔ˥˧
雖然今天是颱風天	sui˥˥dzian˨˦kin˥˥a˥˧dzit˦si˧˧hoŋ˥˥tʰai˥˥tʰĩ˥˥
雙打	siaŋ˥˥tã˥˧
雞爪	ke˥˥kʰa˥˥dziau˥˧
難道是吃到仙丹	kam˥˧si˧˧kʰi˨˩tsiaʔ˦tioʔ˨sian˥˥tan˥˥
雨從天窗潑下來。比喻禍從天降	hɔ˧˧pʰuaʔ˨tui˨˩tʰĩ˥˥tʰaŋ˥˥loʔ˨lai˨˦
零售的價格一定比批發貴	sio˥˧be˧˧e˨˦ke˨˩siau˨˩it˨tiŋ˧˧pi˥˧tua˧˧be˧˧kʰaʔ˨kui˨˩
電影看完再去吃飯	tian˧˧ĩã˥˧kʰũã˨˩suaʔ˨tsiaʔ˨lai˨˦kʰi˨˩tsiaʔ˦pŋ˥˥
電燈	tian˧˧hue˥˧
電視臺	tian˧˧si˧˧tai˨˦
電話就來了	tian˧˧ue˧˧to˧˧lai˨˦aʔ˨
非常厲害	tʰai˨˩li˧˧hai˧˧
面子	bin˧˧tsu˥˧
頂多虧錢而已	sioŋ˧˧tse˧˧tsĩ˨˦liau˥˧kʰi˨˩nia˧˧nia˧˧
頂多被罵一罵而已	tai˧˧put˨liau˥˧hɔ˧˧laŋ˨˦me˧˧me˧˧leʔ˨nia˧˧nia˧˧
順天者存	sun˧˧tʰian˥˥tsia˥˧tsun˨˦
頭髮綁得太鬆	tʰau˨˦mŋ˥˥pak˦liau˥˧sĩũ˥˥liŋ˧˧
顏色	sik˨tsui˥˧
風勢很強	hoŋ˥˥tsiok˨tua˧˧kaŋ˥˧
風浪大才會翻船	hoŋ˥˥iŋ˥˧tua˧˧tsiaʔ˨e˧˧piŋ˥˧tsun˨˦
風浪比較小了	hoŋ˥˥iŋ˥˧kʰaʔ˨pẽ˨˦aʔ˨
風雨很快就會過去，言語不當，很難消除	hoŋ˥˥hɔ˧˧kʰuai˨˩kue,3gian˨˦gi˥˧oʔ˨hua˨˩
颱風過後	hoŋ˥˥tʰai˥˥kue˨˩liau˥˧au˧˧
飢荒之年	hioŋ˥˥ni˨˦
飯吃完再吃水果	pŋ˥˥tsiaʔ˦liau˥˧tsiaʔ˨tsiaʔ˦kue˥˧tsi˥˧
飯桶	pŋ˥˥tau˥˧
飯還沒煮好	pŋ˥˥iau˥˧bue˧˧tsu˥˧ho˥˧
香蕉	kiŋ˥˥tsio˥˥
馬上就比不上人家	liam˨˦mi˥˥to˧˧bo˨˦huat˨tɔ˧˧kaʔ˨laŋ˨˦pi˥˧pʰiŋ˧˧
馬上就要開船了	liam˨˦mi˥˥to˧˧beʔ˨tsʰut˨pʰaŋ˨˦aʔ˨
馬上會發生事情	liam˨˦mi˥˥to˧˧e˧˧tsʰut˨tai˧˧tsi˨˩
骨架小	iu˨˩kut˨
骰子	sip˦pat˨a˥˧
高低	kuan˨˦ke˧˧
高太太最近好嗎	ko˥˥hu˥˥dzin˨˦tsue˨˩kin˧˧ho˥˧bo˨˦
高山	kuan˨˦sũã˥˥
魚肉製成的小丸子	hi˨˦uan˨˦
鳳梨片	oŋ˨˦lai˨˦piŋ˨˦
鴛鴦水鴨	uan˥˥ĩũ˥˥tsui˥˧aʔ˨
鵝會追咬人	go˨˦a˥˧e˧˧ka˧˧laŋ˨˦lo˥˥
麻臉的人必奸	niau˥˥e˨˦kan˥˥sin˨˦
龍宮	tsui˥˧tsĩ˥˥kioŋ˥˥
