a	a
abat	abat
abaz	abaz
abazhur	abaʒuɾ
abazi	abazi
abdhellë	abðɛɫə
abdylaziz	abdylaziz
absidë	absidə
acaherë	atsaheɾə
acarohem	atsaɾɔhɛm
acaroj	atsaɾɔj
aferë	afeɾə
afrohem	afɾɔhɛm
afrohet	afɾɔhet
afroj	afɾɔj
aftë	aftə
aftësi	aftəsi
afër	afəɹ
afër	afəɾ
ag	ag
agull	aguɫ
ajazmë	ajaːzmə
ajdës	ajdəs
ajxhan	ajdʒan
ajër	ajər
akacie	akatsiɛ
akrep	akɾɛp
akrepi	akɾɛpi
akth	akθ
aktivizëm	aktivizəm
akull	akuɫ
akullore	akuɫoɾe
akulloreshitës	akuɫoɾeʃitəs
alarm	alaɾm
alarmim	alaɾmim
alarmohem	alaɾmɔhɛm
alarmoj	alaɾmɔj
allme	aɫmɛ
alpe	alpe
ame	amɛ
amerika	amɛɾika
amfib	amfib
amti	amti
amull	amuɫ
amulli	amuɫi
amzë	amzə
amë	aːm
amësht	aməʃt
andaj	andaj
andë	aːnd
ang	aŋg
angari	angaɾi
anglisht	angliʃt
angësht	aŋgəʃt
ani	ani
anita	anita
anitë	anitə
ankth	aŋkθ
anë	anə
ap	aːp
apologji	apɔlɔɟi
aq	ac
araki	aɾaki
aranit	aɾanit
araqe	arace
arashkë	aɾaːʃk
arbëreshë	aɾbəɾɛʃə
argjend	aɾɟend
ari	aɾi
arith	aɾiθ
arixhi	aɾidʒi
arkivol	aɹkivɔl
arkë	aɾkə
armë	aːɾm
arne	aɾnɛ
arnë	aːɾn
arqitë	aɾcitə
arratis	aratis
arritje	aritjɛ
arrç	artʃ
arrë	aːr
arrës	arəs
arsimoj	aɾsimɔj
arsyetoj	aɾsyɛtɔj
artan	aɾtan
arti	aɾti
arushan	aɾuʃan
arushë	aɾuːʃə
arë	aɾə
asgjë	asɟə
ashiqare	aʃicaɾe
ashpër	aʃpəɾ
asht	aʃt
asish	asiʃ
asnjanësoj	asɲanəsɔj
asosh	asoʃ
ata	ata
atdhe	adðe
athinë	aθinə
athje	aθjɛ
atje	atjɛ
atmosferë	atmɔsfɛɹə
ato	atɔ
atë	atə
atësi	atəsi
avash	avaʃ
avashtë	avaʃtə
avashëm	avaʃəm
avit	avit
avlli	avɫi
azgan	azgan
açugë	atʃugə
baba	baba
babai	babai
babanik	babanik
badifokë	badifokə
bafër	bafəɾ
bagolinë	bagɔliːn
bagëti	bagəti
bajram	bajɾam
bakall	bakaɫ
bakter	baktɛɹ
bakëm	bakəm
bakërt	bakəɾt
balenë	balɛnə
balkrocë	balːkɾɔts
ballgun	baɫgun
balluke	baɫuke
ballëbreshtëz	baɫəbɾɛʃtəz
balonë	balonə
bandill	bandiɫ
banjo	baɲo
banjë	baɲə
banoj	banoj
bar	baɾ
bardhak	baɾðak
bardhan	baɾðan
bardhanë	baɾðanə
bardhavel	baɾðavel
bardhec	baɾðets
bardhok	baɾðok
bardhë	baɾðə
bardhës	baɾðəs
bashkim	baʃkim
bashkohem	baʃkɔhɛm
bashkoj	baʃkɔj
bashkë	baʃkə
bashkëfajtor	baʃkfajtɔɹ
bashkëfajtor	baʃkəfajtɔɹ
bashkëjetesë	baʃkəjɛtɛsə
bashkëjetoj	baʃkjɛtɔj
bashkëjetoj	baʃkəjɛtɔj
bashkëndodhi	baʃkəndɔði
bashkëngjis	baʃkənɟʑis
bashkëpunim	baʃkəpunim
bashkëtingëllor	baʃkətingəɫoɾ
bashkëtingëllore	baʃkətingəɫoɾe
bashtinë	baʃtiːn
bastis	bastis
bathë	baθə
baticë	batitsə
bdek	bdɛk
beg	beg
bej	bej
bejkë	bɛːjk
bejleg	bɛlɛg
belbëzoj	bɛlbəzɔj
belot	bɛlɔt
belush	bɛluʃ
beqar	bɛcaɾ
besa	besa
beshtë	bɛːʃt
besim	bɛsim
besnik	bɛsnik
besnike	bɛsnikɛ
besoj	bɛsɔj
besë	besə
betohem	bɛtɔhɛm
betoj	bɛtɔj
betë	betə
bezdis	bezdis
bezgë	bɛːzg
bie	bie
bie	biɛ
bijë	bijə
bile	bilɛ
bilur	biluɾ
bilë	bilə
bilë	biʎə
binjakët	biɲakət
bioteknologji	bijɔtɛknɔlɔɟʑi
bir	biɾ
birrem	birem
birrem	birɛm
bis	bis
bisedë	bisɛːd
bishë	biʃə
bizele	bizɛlɛ
bizon	bizɔn
biçikletë	bitʃikletə
bjeshkë	bjɛʃkə
blej	blej
blej	blɛj
bleron	blɛɾɔn
bletë	bletə
bli	bli
blihem	blihem
blihem	blihɛm
blihem	bʎihem
blihem	bʎihɛm
bobo	bɔbɔ
bodrum	bɔdɾum
bojaxhi	bɔjadʒi
bokë	bɔːk
bolbë	bɔːlb
bonjë	bɔɲə
borigë	boɾiːg
boronicë	bɔɾɔniːts
borzilok	bɔɾzilɔk
boshtër	bɔʃtəɾ
bostan	bɔstan
botoj	bɔtɔj
botë	bɔtə
bozhure	bɔʒuɾɛ
boçëborë	bɔtʃəbɔːɾ
brazdë	bɾazdə
bredh	bɾɛð
breg	bɾeg
bregcë	bɾektsə
bregdet	bregdet
brehem	bɹɛhɛm
brehem	bɾehem
brehem	bɾɛhɛm
brengos	brɛngɔs
bri	bɹiː
bri	bɹĩː
bri	bɾi
bricjapi	bɾitsjapi
brinar	bɾinaɾ
brumë	brumə
brushtull	bɾuʃtuɫ
brëndës	bɾəndəs
budalla	budaɫa
budallallosem	budaɫaɫɔsɛm
buj	buj
bujar	bujaɾ
bujgër	bujgəɾ
bujk	bujk
bukur	bukuɾ
bukuri	bukuɾi
buli	buli
bulledër	buɫɛdəɾ
bunacë	bunatsə
bunar	bunaɾ
burrë	burə
bush	buʃ
busull	busuɫ
buxhak	budʒak
buxhetor	budʒɛtɔɹ
buzë	buzə
buzë	buːz
buzëmadh	buzəmað
buzëmadhe	buzəmaðe
buzëqesh	bʊzəcɛʃ
buzëqeshje	buzəcɛʃjɛ
buç	butʃ
buças	butʃas
byrek	byɾɛk
bythë	byθə
bythëkromë	byθəkɾɔːm
bytyntë	bytyntə
bâj	bɑj
bëj	bəj
bëllogxhi	bəɫɔ̯gdʒiː
bënj	bəɲ
bërcel	bəɾtsɛl
bërdhog	bəɾðɔg
bërllog	bəɾɫɔ̯g
bërllogxhi	bəɾɫɔgdʒi
bërryl	bəryl
bërshen	bəɾʃɛn
c	ts
cac	tsats
caran	tsaɾan
carangth	tsaɾaŋθ
cingali	tsingali
cinxami	tsindzami
cjap	tsjap
cule	tsule
cup	tsup
curril	tsuril
cyle	tsyle
cërmëdell	tsəɾmədɛɫ
cërr	tsər
cërre	tsəre
d	d
dac	dats
dafinë	dafinə
dajë	dajə
dan	dan
daniel	danjɛl
daniel	danjɛɫ
daniel	daɲɛl
daniel	daɲɛɫ
daniell	danjɛɫ
daniell	daɲɛɫ
danjell	daɲɛɫ
dardhëz	daɾðəz
dashi	daʃi
dashni	daʃni
dashurohem	daʃuɾɔhɛm
dashuroj	daʃuɾɔj
ded	dɛːd
ded	dɛːdə
dedë	dɛdə
dedë	dɛːd
degë	dɛgə
dehem	dɛhɛm
dembel	dɛmbɛl
demir	demiɾ
demiraj	demiraj
demokraci	dɛmɔkɾatsi
depërtoj	dɛpəɾtɔj
deri	dɛɾi
derman	deɾman
derr	dɛr
det	dɛt
dh	ð
dhallë	ðaːɫ
dhampir	ðampiɾ
dhe	ðe
dhen	ðɛn
dhi	ðiː
dhjatë	ðjatə
dhjetë	ðjetə
dhjetë	ðjɛtə
dhjetë	ðɛt
dhuratë	ðuɾatə
dhëndër	ðəndəɾ
dhëndërr	ðəndər
di	di
dihat	dihat
dihet	dihet
dihet	dihɛt
dijës	dijəs
diktoj	diktɔj
din	din
dinjitet	diɲitɛt
djall	djaɫ
djalë	djalə
djersij	djeɾsij
dobi	dɔbi
dod	dɔːd
dod	dɔːdə
dodaj	doːdaj
dodaj	doːdaɲ
dodaj	doːdaɲi
dodë	doːd
dodë	doːdə
dodë	dɔːd
dodë	dɔːdə
dolli	doɫi
domethënë	domeθənə
domosdoshëm	dɔmɔsdɔʃəm
donikë	dɔniːk
doracak	dɔratsaku
doracak	dɔratsaːku
doracak	dɔɾatsak
dorë	dɔɹ
dorë	dɔɾə
dorëzohem	dɔɹzɔhɛm
dorëzohem	dɔɹəzɔhɛm
dredhëz	dɾɛðəz
drejt	dɾɛjt
dreq	dɾɛcɕ
dreq	dɾɛtɕ
dridhem	dɾiðɛm
dritan	dɾitan
dritare	dɾitaɾɛ
drizë	dɾiːz
drokth	dɾɔkθ
duaj	duaj
duhan	duhan
duhet	duhet
duhi	duhi
dukshëm	dukʃəm
durrës	durəs
dush	duʃ
dushk	duʃk
dushkull	duʃkuɫ
dushman	duʃman
dy	dy
dygjuhësi	dyɟʑuhəsi
dymbëdhjetë	dymbəðjɛtə
dyrrah	dyrah
dyzet	dyzet
dyzetedy	dyzɛtɛdy
dyzetegjashtë	dyzɛtɛɟʑaʃtə
dyzetekatër	dyzɛtɛkatəɹ
dyzetenjë	dyzɛtɛɲə
dyzetenëntë	dyzɛtɛnəntə
dyzetepesë	dyzɛtɛpɛsə
dyzeteshtatë	dyzɛtɛʃtatə
dyzetetetë	dyzɛtɛtɛtə
dyzetetre	dyzɛtɛtɾɛ
dëfrej	dəfɾɛj
dëftohem	dəftɔhɛm
dëftor	dəftɔɹ
dëftor	dəftɔɾ
dëftore	dəftɔɹe
dëftore	dəftɔɾe
dëgjoj	dəɟoj
dëllinjë	dəɫiːɲ
dëmtoj	dəmtɔj
dërgoj	dəɾgɔj
dëshiror	dəʃiɹɔɹ
dëshiror	dəʃiɾɔɾ
dëshirore	dəʃiɹɔɹe
dëshirore	dəʃiɾɔɾe
dëshirë	dəʃiɾə
dëshmor	dəʃmɔːr
dështim	dəʃtim
eci	ɛtsi
ed'hem	ɛdhɛm
edhem	ɛdhɛm
edëhem	edəhɛm
ekologji	ɛkɔlɔɟʑi
elb	ɛlb
elion	ɛliɔn
eliona	ɛlioːna
elionë	ɛlioːnə
eljon	ɛljɔn
eljona	ɛljoːna
eljonë	ɛljoːnə
elokuencë	elokuentsə
emtë	ɛmtə
emër	ɛməɾ
en	ɛɲ
en	ɛɲi
energjik	ɛnɛɾɟik
engjëllike	ɛnɟəɫikɛ
epshor	ɛpʃɔɹ
epshëm	ɛpʃəm
ereksion	ɛɾɛksiɔn
erion	ɛɾiɔn
eriona	ɛɾioːna
erionë	ɛɾioːnə
erjon	ɛɾjɔn
erjona	ɛɾjoːna
erjonë	ɛɾjoːnə
erë	eɾə
erëjona	eɾəjoːna
erëjonë	eɾəjoːnə
eshtë	ɛʃtər
et'hem	ɛthɛm
ethe	hɛθɛ
ethe	ɛθɛ
ethem	ɛthɛm
etëhem	etəhɛm
fabrikë	fabɾikə
facoletë	fatsoletə
faculetë	fatsuletə
faj	faj
fajtor	fajtoɾ
fajësi	fajəsi
fakulltet	fakuɫtet
fal	fal
faleminderit	falemindeɾit
faleminderit	falemndeɾit
fall	faɫ
faltore	faltɔɾɛ
fanellë	faneɫə
fantazist	fantazist
faqe	face
fare	faɾɛ
farë	faɾə
fati	fati
fatime	fatimɛ
fatjon	fatjɔn
fatkeqësi	fatkɛcɕəsi
fatndjekës	fatndjekəs
fatos	fatɔs
fe	fɛ
femër	fɛməɹ
ferrëkuqe	ferəkuce
ferrëmanzë	fɛrəmanzə
fidhës	fiðəs
fil	fil
fill	fiɫ̪
filxhan	fildʒan
fistik	fistik
fizikë	fizikə
fjalë	fjalə
flamur	flamur
flamur	flamuɹ
flamurtar	flamuɾtaɾ
flas	flas
fletë	fletə
flihet	flihet
flihet	flihɛt
flihet	fʎihet
flihet	fʎihɛt
flihet	fʎəhɛt
flijohem	flijɔhem
flijoj	flijɔj
fllad	fɫad
fora	foɾa
forcë	fɔɾtsə
frashër	fɾaʃəɾ
frashërishtë	fɾaʃəɾiʃtə
frashërt	fraʃəɾt
frikë	fɾikə
fror	fɾɔɾ
fryfq	frʏftɕ
fryhem	fryhɛm
frymëmarrje	fɾyməmarjɛ
frymëzoj	fɾyməzɔj
fryt	fɾyt
fsheh	fʃeːh
fshihem	fʃihem
ftohtësi	ftɔhtəsi
ftua	ftua
fugë	fugə
fuqishëm	fuciʃəm
furçë	fuːɾtʃ
fushatë	fuʃatə
fustan	fustan
fyelltar	fyeɫtaɾ
fyt	fyt
fytyrë	fytyɹə
fëmijë	fəmijə
fërkoj	fəɾkɔj
gabzherr	gabʒɛr
gadishull	gadiʃuɫ
gajdhur	gajðuɾ
gajtan	gajtan
gajushë	gajuʃ
gak	gak
gakth	gakθ
galë	gaːl
ganec	ganɛts
garazh	gaɾaʒ
gardh	gaɾð
gatë	gatə
gaztor	gaztɔɾ
gdhendës	gðendəs
gdhendëse	gðendəsɛ
gegnishte	gɛgniʃte
gegnishte	gɛgəniʃte
gegërishte	gɛgəɾiʃte
genc	gents
gj	ɟ
gjanë	ɟanə
gjarpër	ɟaɾpəɾ
gjashtë	ɟaʃtə
gjashtëdhjetedy	ɟaʃtəðjɛtɛdy
gjashtëdhjetegjashtë	ɟaʃtəðjɛtɛɟaʃtə
gjashtëdhjetekatër	ɟʑaʃtəðjɛtɛkatəɹ
gjashtëdhjetenjë	ɟʑaʃtəðjɛtɛɲə
gjashtëdhjetenëntë	ɟʑaʃtəðjɛtɛnəntə
gjashtëdhjetepesë	ɟʑaʃtəðjɛtɛpɛsə
gjashtëdhjeteshtatë	ɟʑaʃtəðjɛtɛʃtatə
gjashtëdhjetetetë	ɟʑaʃtəðjɛtɛtɛtə
gjashtëdhjetetre	ɟʑaʃtəðjɛtɛtɾɛ
gjashtëdhjetë	ɟaʃtəðjɛtə
gjashtëkëndësh	ɟaʃtəkəndəʃ
gjashtëmbëdhjetë	ɟʑaʃtəmbəðjɛtə
gjej	ɟɛj
gjekë	ɟekə
gjelbër	ɟɛlbəɾ
gjenetikë	ɟenetikə
gjerdan	ɟeɾdan
gjerë	ɟɛɾə
gjeth	ɟeθ
gjezdis	ɟezdis
gjikë	ɟikə
gjilpërë	ɟilpəɾə
gjilpërë	ɟʑɪlpəɹ
gjini	ɟini
gjiriz	ɟiɾiz
gjirokastër	ɟʝiɾɔkastəɾ
gjitar	ɟʑitaɹ
gjithësi	ɟiθəsi
gjobë	ɟɔːb
gjoks	ɟɔks
gjokë	ɟokə
gjol	ɟol
gju	gjũː
gju	gjũˑnɪ
gju	gjʊ̃j
gju	ɟu
gjuha	ɟuha
gjuhe	ɟuhe
gjuhë	gjuhɘ
gjuhë	gljuxə
gjuhë	gʎuxə
gjuhë	ɟuhə
gjuhën	ɟuhən
gjuhës	ɟuhəs
gjuhësh	ɟuhəʃ
gjuhësi	ɟuhəsi
gjuhët	ɟuhət
gjuhëtar	ɟuhətaɾ
gjuhëve	ɟuhəve
gjuhëvet	ɟuhəvet
gjukë	ɟukə
gjumë	ɟumə
gjykatë	ɟykaːt
gjykoj	ɟykɔj
gjylpanë	ɟilpəɾə
gjylpanë	ɟɪlpəɹ
gjymtyrë	ɟymtyɾ
gjynaf	ɟynaf
gjynah	ɟynah
gjyq	ɟyc
gjysh	ɟyʃ
gjysmë	ɟysmə
gjysëm	ɟysəm
gjë	ɟə
gjëlpërë	ɟilpəɾə
gjëlpërë	ɟʑɪlpəɹ
gljuhë	gljuxə
gljuhë	gʎuxə
gljuhë	ɟuhə
gllog	gɫog
gobellë	gɔbɛːɫ
gojë	gojə
gomar	gɔmaɾ
gomë	gomə
gore	goɾe
goren	goɾen
gorricë	gɔritsə
gotë	gotə
gozhdë	gɔːʒd
gozhup	gɔʒup
grabit	gɾabit
grabofç	gɾabɔftʃ
grabë	grabə
gradencë	gɾadentsə
gradinar	gɾadinaɾ
gradinë	gɾadinə
grafik	gɹafik
grafulloj	gɾafuɫɔj
gramatikan	gɾamatikan
gramatikisht	gɾamatikiʃt
gramatikor	gɾamatikɔɹ
gramatikë	gɾamatikə
gresë	gɾɛːs
grevist	gɾevist
grevë	gɾevə
grigjë	gɾiːɟ
grikëll	gɾikəɫ
grimcoj	gɾimtsoj
grimcuar	gɾimtsuaɾ
grimcë	gɾimtsə
grimë	gɾimə
grumbulloj	gɾumbuɫoj
grurë	gɾuɾə
grushtoj	gɾuʃtoj
grûnë	gɹũnə
grûnë	gɾũnə
guf	guf
gufoj	gufoj
gzim	gzim
gëlltit	gəɫtit
gëlqere	gəlceɾe
gënjej	gəɲɛj
gërbellë	gəɾbɛːɫ
gërdit	gərdit
gërfyell	gəɾfyɛɫ
gërhas	gəɾhas
gërnetë	gəɾnɛːt
gërrec	gərɛts
gështenjë	gəʃtɛːɲə
gëzoj	gəzɔj
ha	ha
habit	habit
habitor	habitɔɹ
habitor	habitɔɾ
habitore	habitɔɹe
habitore	habitɔɾe
hajdar	hajdaɾ
hajdut	hajdut
hajgare	hajgaɾe
hajger	hajgeɾ
hajn	hajn
hajneshë	hajneʃə
hajni	hajni
hajnisht	hajniʃt
hajnjeri	hajɲeɾi
hall	haɫ
hallakat	haɫakat
hallë	haɫə
halë	haːl
hamam	hamam
harmoç	haɾmɔtʃ
harr	har
harroj	harɔj
harrueshëm	haruɛʃəm
hartinë	haɾtiːn
harxh	haɾdʒ
hatër	hatəɾ
havlli	hɑvɫi
heci	hetsi
heci	hɛtsi
hegjemon	heɟemon
helmoj	helmɔj
herdhe	hɛɾðɛ
herdhesh	hɛɾðɛʃ
herdhet	hɛɾðɛt
herdheve	hɛɾðɛvɛ
herr	hɛr
hesull	hesuɫ
hidajet	hidajɛt
hide	hidɛ
hidhërohem	hiðəɾɔhɛm
hir	hiːɾ
hirrë	hirə
historia	histoɾia
hithës	hiθəs
hiç	hitʃ
hjidhi	hjiði
hotel	hɔtɛl
hoxhë	hodʒə
hyj	hyj
hyjnor	hyjnɔɾ
hyllas	hyɫas
hyllos	hyɫɔs
iki	iki
ikur	ikuɾ
ilaç	ilatʃ
ilirolog	ilirolog
ilirologji	ilirolog
ilqe	ilcɛ
imagjinatë	imaɟʑinatə
imagjinueshëm	imaɟʑinuɛʃəm
imam	imam
imi	imi
incizim	intsizim
incizoj	intsizoj
institucion	institutsion
inteligjencë	intɛliɟɛntsə
inteligjent	intɛliɟɛnt
interes	intɛrɛs
inxhinier	indʒinjeɾ
isha	iʃa
ishe	iʃɛ
ishim	iʃim
ishin	iʃin
ishit	iʃit
ishte	iʃtɛ
izabetë	izabetə
jakup	jakup
jakupi	jakupi
jakë	jakə
jam	jam
jamarbër	jamaɾbəɾ
janë	janə
jap	jaːp
jargavan	jaɾgavan
jasemin	jasemin
jashtëzakonisht	jaʃtəzakɔniʃt
je	jɛ
jemi	jɛmi
jeni	jɛni
jenë	jɛnə
jerevi	jeɾevi
jermësinë	jɛɾməsiːn
jevg	jevg
jevgjit	jevɟit
ji	ji
jini	jini
jo	jɔ
jorgan	jɔɾgan
josef	joːsəf
josef	joːsɛf
joz	joːz
joz	joːzə
jozef	joːzəf
jozef	joːzɛf
jozë	joːz
jozë	joːzə
ju	ju
juaj	juaj
jud	jud
jugor	jugɔɾ
kacadre	katsadɾe
kacaturrë	katsaturə
kaci	katsi
kadife	kadife
kadër	kadəɾ
kafaz	kafaz
kafkë	kafkə
kafshatë	kafʃatə
kafshoj	kafʃɔj
kafshë	kafʃə
kala	kala
kalamend	kalamɛnd
kallamboq	kaɫamboc
kallcë	kaɫtsə
kallume	kaɫume
kallëzore	kaɫəzoɾe
kalë	kalə
kamatë	kamaːt
kanat	kanat
kanavacë	kanavaːts
kapak	kapak
kapardisem	kapaɾdisem
kapiten	kapiten
kaproll	kapɾɔɫ
kapter	kapteɾ
karabatak	kaɾabatak
karafil	kaɾafil
karficë	kaɾfitsə
karkalec	kaɾkalɛts
karpë	karpə
kasnec	kasnɛts
kastravec	kastɾavɛts
katër	katəɾ
katërmbëdhjetë	katəɾmbəðjɛtə
kazermë	kazeɾmə
kaçavidë	katʃavidə
kaçkavall	katʃkavaɫ
kaçubet	katʃubɛt
kaçubë	katʃuːb
kaçurrel	katʃurɛl
kaçërotë	käcɕəɹɔːtə
kaçërotë	käcəɹɔːtə
kaçërotë	kätɕəɹɔːt
kaçërotë	kätʃəɹɔːtə
kaçërotë	käɕəɹɔːtə
kaçërotë	käʃəɹɔːtə
kepa	keːpa
kepë	keːpə
keq	kec
keqardhje	kɛcɕaɾðjɛ
keqardhës	kɛcɕaɾðəs
keqe	kɛcɕɛ
keqkuptoj	kɛcɕkuptɔj
kic	kits
kica	kitsa
kij	kij
kikirik	kikiɾik
kikirrikë	kikirikə
kishë	kiːʃ
kjo	kjɔ
klm	kələmə
klumësht	kluməʃt
klumështi	kluməʃti
kob	kɔb
kodër	kodəɾ
koftor	koftoɾ
kok	kok
kollogjonë	koɫoɟonə
kolltuk	koɫtuk
kompjuter	kompjuteɾ
kompjuterik	kompjuteɾik
komunikoj	kɔmunikɔj
konopishtë	konopiʃtə
kopër	kɔpəɾ
korb	kɔɾb
kordhë	kɔːɾð
korit	kɔɾit
korp	kɔrp
kos	kɔs
kosë	kɔːs
krahasohem	kɾahasɔhɛm
krahasoj	kɾahasɔj
krejtësisht	kɾɛjtəsiʃt
krekë	kɾɛːk
kremte	kɾɛmtɛ
kreshmë	kɾɛʃmə
kreshnik	kɾɛʃnik
krifshë	kɾiːfʃ
krijoj	kɾiːjɔj
krimb	kɾimb
krisogajtan	kɾisogajtan
krushkamadh	kɾuʃkamað
krushkaparë	kɾuʃkapaɾə
krye	kɾyɛ
kryej	kɾyɛj
kryekapter	kɾyekapteɾ
kryetar	kɾyetaɾ
kryqëzatë	kɾycɕəzatə
kthehem	kθehem
kthej	kθej
kthetër	kθɛtɚ
kthinë	kθinə
kthjelloj	kθjɛɫɔj
kudër	kudəɾ
kudër	kuːdəɹ
kujdestar	kujdɛstaɾ
kujtim	kujtim
kujtoj	kujtɔj
kukudh	kukuð
kukumalkë	kukumalkə
kullumbri	kuɫumbɾi
kulturë	kultuɾə
kultër	kultəɾ
kunat	kunat
kundër	kundəɾ
kundërshtoj	kundəɾʃtɔj
kundërthem	kundəɾθɛm
kungatë	kungatə
kungoj	kuŋgɔj
kunupicë	kunupitsə
kuptim	kuptim
kurban	kuɾban
kurorë	kuɾoːɾə
kurriz	kuriz
kurvë	kuːɾv
kushtor	kuʃtɔɹ
kushtor	kuʃtɔɾ
kushtore	kuʃtɔɾe
kushtrim	kuʃtrim
kushtrim	kuʃtɾim
kut	kut
kuvend	kuvɛnd
kuçedër	kutʃɛdəɾ
ky	ky
kyç	kytʃ
këllk	kəɫk
këmbej	kəmbɛj
këmbë	kəmbə
këna	kəna
kënaq	kənacɕ
kënaqem	kənacɕɛm
kënaqësi	kənacəsi
këndoj	kəndɔj
këngë	kəngə
këpucë	kəputsə
këpus	kəpus
këpushë	kəpuʃə
këput	kəput
këputë	kəputə
këqij	kəcɕiɲ
këqija	kəcija
kërthi	kəɾθi
këtij	kətij
këtu	kətu
këtë	kətə
lacë	laːts
lafshë	lafʃə
lagë	lagə
lagësht	lagəʃt
lagët	lagət
lahutar	lahutaɾ
lahutë	lahutə
lajm	lajm
lajthi	lajθi
lajthit	lajθit
lakmi	lakmi
lakror	lakɾoɾ
lakuriqësi	lakuɾicəsi
lakër	lakəɾ
langua	languɛ
lar	laɾ
larg	laɾg
larva	laɹva
lashtë	laʃtə
lavd	lavd
lehtë	lehtə
lehtësoj	lɛhtəsɔj
lek	lek
leksikologji	lɛksikɔlɔɟʑi
lekë	lekə
letër	lɛtəɾ
lexim	lɛdzim
lexoj	lɛdzɔj
lexueshëm	lɛdzuɛʃəm
librari	libɾaɾi
libër	libəɾ
lidhje	liːðjɛ
lidhor	liːðɔɹ
lidhor	liːðɔɾ
lidhore	liːðɔɹe
lidhore	liːðɔɾe
lidhës	liːðəs
ligare	liɣaɾe
lindje	lindjɛ
lindor	lindɔɾ
linjë	liɲə
liqen	licɛn
lis	lis
litar	litaɾ
livadh	livað
ll	ɫ
llaf	ɫaf
llogore	ɫogoɾe
lloj	ɫɔj
llokum	ɫokum
llokume	ɫokume
lopatë	lɔpaːt
lopë	lɔpə
luadh	luað
luaj	luaj
lubi	lubi
luftoj	luftɔj
luftë	luftə
luginë	luginə
luleshitës	luleʃitəs
luleshqiponjë	luleʃcipoɲə
lumarak	lumaɾak
lumth	lumθ
lungë	luŋgə
lus	lus
lus	ʎut
lus	ʎʊs
lut	lus
lut	lut
lut	ʎut
lut	ʎʊs
lutjesore	lutjɛsoːrɛ
lyerës	lyːɛrəs
lyerëse	lyːɛrəsɛ
lylc	ʎyʎts
lylë	lylə
lyp	lyp
lëkurë	ləkuɾə
lëndim	ləndim
lëndinë	ləndiːn
lëpij	ləpij
mace	matsɛ
mace	mãːts
mace	mõːts
mackë	matskə
macë	matsə
macë	mãːts
macë	mõːts
madh	mað
madhe	ɛmaðɛ
madhësi	maðəsi
magjup	maɟup
magjyp	maɟyp
makinë	makinə
makth	makθ
mali	mali
malësor	maləsoɾ
malësore	maləsoɾe
manaferrë	manaferə
mang	mang
manxuranë	mandzuraːn
maqorr	macɔr
maqorr	macɕɔr
maqorr	matɕɔr
maqorr	matʃɔr
maraq	maɾacç
marenë	maɾenə
matematikë	matɛmatikə
mathe	maθɛ
matosh	matɔʃ
mauthia	mauθia
mazë	maːz
maç	matʃ
maçok	matʃɔk
mbahem	mbahem
mbahem	mbahɛm
mbaj	mbaj
mbajtje	mbajtje
mbajtës	mbajtəs
mbaroj	maɹɔj
mbaroj	mbaɾɔj
mbaroj	mɑɹɔj
mbaros	mbarɔs
mbart	mbaɾt
mbarë	mbaɾə
mbarë	mãːɹ
mbarë	mɑ̃ːɹ
mbasi	mbaːsi
mbikëqyr	mbikəcyɾ
mbledh	mbleð
mbledhës	mbleðəs
mbretvrasës	mbɾetvɾasəs
mbrothësi	mbrɔθəsi
mbulohem	mbulɔhɛm
mbuloj	mbulɔj
mburracak	mburatsak
mburrem	mburɛm
mbush	mbuʃ
mbushem	mbuʃɛm
mby	mbyː
melika	melika
mendim	mendim
mendjemadh	mendjemað
mendjemadhësi	mendjemaðəsi
mendoj	mɛndɔj
merimangë	mɛɾimaŋg
meritoj	mɛɾitɔj
merrem	merɛm
meta	meta
metë	metə
mexhidje	medʒidje
mexhite	medʒite
meçkë	metʃkə
micak	mitsak
mikologji	mikɔlɔɟʑi
milika	milika
milingonë	milingɔːn
miqësi	micɕəsi
miqësohem	micɕəsɔhɛm
miratoj	miɾatɔj
mirë	miɾə
mirëmëngjes	miɾəməɲɟes
mirësoj	miɾəsɔj
mish	miʃ
miush	miuʃ
mjalcë	mjaltsə
mjaltë	mjaltə
mjegull	mjɛguɫ
mjegullnajë	mjɛguɫnajə
mjek	mjɛk
mjekër	mjekəɾ
mjel	mjɛl
mjellmë	mjɛɫmə
mjeshtër	mjɛʃtəɾ
modest	mɔdɛst
modesti	mɔdɛsti
moh	mɔh
molekulë	molekulə
mollatartë	mɔɫɒtɒɾtə
mollë	mɔɫə
morfologji	mɔɹfɔlɔɟʑi
morr	mɔr
moshë	mɔʃə
mostër	mostəɾ
motiv	motiv
motivohem	motivɔhɛm
motivoj	motivɔj
mrikë	mɾikə
mund	mund
murdar	muɾdaɾ
muskul	muskul
muskulaturë	muskulatuɹə
muskulor	muskulɔɹ
muskuloz	muskulɔs
mut	mut
muzikë	muzikə
mëdha	təməða
mëdhenj	təməðɛɲ
mëgashtër	məgaʃtəɾ
mëkat	məkat
mërej	mərɛj
mëshirë	məʃiːɾ
mëshoj	məʃɔj
mësim	məsim
mësohem	məsɔhɛm
mësonjëtore	məsoɲətoɾe
mësysh	məsyʃ
nallban	naɫban
napolon	napɔlɔn
nauk	nauk
ndermir	ndɛrmir
ndih	ndih
ndihem	ndihɛm
ndoc	ndɔts
ndokë	ndokə
ndrekë	ndɾekə
ndrikull	ndɾikuɫ
ndriçoj	ndritʃɔj
ndërrjet	ndərjɛt
nerënxë	nɛɾəndzə
neve	nɛvɛ
nevojtore	nevojtoɾe
nevojë	nevojə
nexhat	nedʒat
nga	ŋga
ngirterrë	ɳgitɛɾa
ngirterrë	ɳgitɛɾə
ngjalë	ɲɟalə
ngjis	ɲɟis
ngjyej	ɲɟyɛj
nis	nis
nj	ɲ
njehsor	ɲehsoɾ
njer	ɲɛɾ
një	ɲə
njëkohësisht	ɲəkɔhəsiʃt
njëmbëdhjetë	ɲəmbəðjɛtə
njëzet	ɲəzɛt
njëzetedy	ɲəzɛtɛdy
njëzetegjashtë	ɲəzɛtɛɟʑaʃtə
njëzetekatër	ɲəzɛtɛkatəɹ
njëzetenjë	ɲəzɛtɛɲə
njëzetenëntë	ɲəzɛtɛnəntə
njëzetepesë	ɲəzɛtɛpɛsə
njëzeteshtatë	ɲəzɛtɛʃtatə
njëzetetetë	ɲəzɛtɛtɛtə
njëzetetre	ɲəzɛtɛtɾɛ
nouk	nɔuk
nuk	nuk
numër	numəɹ
nxehtësi	ndzehtəsi
nxjerr	ndzjɛr
nëntetar	nəntetaɾ
nëntoger	nəntogeɾ
nëntë	nəntə
nëntëmbëdhjetë	nəntəmbəðjɛtə
nënë	nənə
odokët	odokət
ofendoj	ɔfɛndɔj
ora	ɔɾa
orgji	ɔɹɟʑi
orë	ɔɾə
orëndreqës	oɾəndɾecəs
orëçuet	oɾətʃuet
paafruar	paːafɾuːaɾ
pabesueshëm	pabɛsuɛʃəm
pabesë	pabesə
padit	padit
padukshëm	padukʃəm
pafund	pafunt
pagëzoj	pagəzɔj
paharrueshëm	paharuɛʃəm
pajt	pajt
pajtoj	pajtɔj
papagall	papagaɫ
papat	papat
paqe	pacɕɛ
paqe	pacɛ
paqe	pakʲɛ
paqe	patɕɛ
paqe	patʃɛ
parapëlqej	paɾapəlcɛj
parashikues	paɾaʃikues
parasysh	paɾasyʃ
parë	paɾə
pasagjer	pasaɟeɾ
pasi	paːsi
pasur	pasuɹ
pasur	pasuɾ
pat	pat
patologji	patɔlɔɟʑi
patur	patuɹ
patur	patuɾ
patëllxhan	patəɫdʒan
pavdekshëm	pavdɛkʃəm
pelerinë	peleɾinə
peligorgë	peligoɾgə
pemë	pɛːm
peqin	pecin
perëndim	pɛɾəndim
peshohem	pɛʃɔhɛm
peshoj	pɛʃɔj
peshore	pɛʃɔɾɛ
peshova	pɛʃɔva
peshqit	pɛʃcit
peshqit	pɛʃtɕit
peshtamall	peʃtamaɫ
peshuar	pɛʃuaɾ
peshë	pɛʃə
pesë	pɛsə
pesëdhjetedy	pɛsəðjɛtɛdy
pesëdhjetegjashtë	pɛsəðjɛtɛɟʑaʃtə
pesëdhjetekatër	pɛsəðjɛtɛkatəɹ
pesëdhjetenjë	pɛsəðjɛtɛɲə
pesëdhjetenëntë	pɛsəðjɛtɛnəntə
pesëdhjetepesë	pɛsəðjɛtɛpɛsə
pesëdhjeteshtatë	pɛsəðjɛtɛʃtatə
pesëdhjetetetë	pɛsəðjɛtɛtɛtə
pesëdhjetetre	pɛsəðjɛtɛtɾɛ
pesëdhjetë	pɛsəðjɛtə
pesëmbëdhjetë	pɛsəmbəðjɛtə
pesëzet	pesəzet
piano	pianɔ
pijan	pijan
pijetore	pijetoːrɛ
pis	pis
pjepër	pjepəɾ
pjeshkë	pjɛːʃk
plak	plak
plaçkë	platʃkə
pllakos	pɫakos
plotësisht	plotəsiʃt
plotësoj	plotəsɔj
plug	plug
po	pɔ
pohim	pɔhim
polem	pɔlɛm
pornografi	pɔɹnɔgɾafi
porosit	pɔɾɔsit
portokall	pɔɾtɔkaɫ
portokalle	pɔɾtɔkaɫɛ
postel	pɔstɛl
potkua	potkua
prag	pɾag
pranga	pɾanga
prapanicë	pɾapanitsə
praqe	prace
prehër	pɾehəɾ
prekë	pɾekə
prift	pɾift
prëhër	pɾəhəɾ
pubis	pubis
punoj	punɔj
punonjës	punɔɲəs
punë	punə
punëdhënës	punəðənəs
punësi	punəsi
punësohem	punəsɔhɛm
punësoj	punəsɔj
punësuar	punəsuaɾ
punësuara	punəsuaɾa
punëtor	punətoɾ
pupëz	pupəz
pushoj	puʃɔj
pushtues	puʃtuːɛs
pusullë	pusuːɫ
putër	putə
pyetje	pyɛtjɛ
pykë	pyːk
pëlqej	pəlcɛj
përafrohem	pəɹafɹɔhɛm
përafrohem	pəɾafɾɔhɛm
përafroj	pəɹafɹɔj
përafroj	pəɾafɾɔj
përdëllej	pəɾdəɫej
përdëllesë	pəɾdəɫesə
përdëllyeshëm	pəɾdəɫyeʃəm
përgjithshëm	pɚɟʑiθʃəm
përgjithësim	pɚɟʑiθəsim
përgjithësisht	pɚɟʑiθəsiʃt
përgjithësoj	pɚɟʑiθəsɔj
përgjues	pəɾɟues
përhap	pəɾhap
përkavë	pəɾkavə
përkeq	pəɾkɛc
përmby	pərmbyː
përmirësoj	pəɹmiɹəsɔj
përmy	pərmyː
përparoj	pəɹpaɹɔj
përqesh	pəɾcɛʃ
përshëndetje	pəɾʃəndɛtjə
përsos	pɚsos
përsosur	pɚsosuɹ
përtoj	pəɾtɔj
përzë	pəɾzə
përçaj	pəɾtʃaj
pësoj	pəsɔj
q	c
qafë	cafə
qark	cɕaɾk
qartë	caɾtə
qefin	cefin
qefull	cefuɫ
qemë	cɕɛmə
qen	cɕɛn
qendër	cɛndəɾ
qenë	cenə
qepa	cepa
qepë	ceːpə
qepë	cçeːpə
qeras	ceɾas
qeros	ceɾos
qerpik	tɕɛɹpik
qerre	cɛrɛ
qese	cese
qesharak	cɕɛʃaɾak
qeshë	cçɛʃə
qeth	cɛθ
qeveri	cɛvɛɾi
qeveris	cɛvɛɾis
qiell	cçiɛɫ
qifsha	cifʃaː
qifsha	cɕifʃaː
qifsha	kʲifʃaː
qifsha	tɕifʃaː
qifsha	tʃifʃaː
qime	cimɛ
qindarka	cindaɾka
qindarkë	cindaɾkə
qira	ciɾa
qiri	cɕiɾi
qivur	tɕivuɹ
qofsh	cɕofʃ
qofsha	cɕofʃa
qofshim	cɕofʃim
qofshin	cɕofʃin
qofshit	cɕɔfʃit
qoftë	cɕoftə
qosarak	cosaɾak
qose	cose
quaj	cuːj
quaj	cɕuːj
quaj	kluːɲ
quaj	kʎuːɲ
quhem	cuhɛm
qup	cup
qupi	cupi
qurylyk	cuɾylyk
qye	cyː
qye	cɕyː
qye	tɕyː
qye	tʃyː
qylaxhi	cɕyladʒi
qymyrgur	cymyɾguɾ
qyqek	cycek
qyrek	cyɾek
qyrlek	cyɾlek
qyrlik	cyɾlik
qyrylyk	cyɾylyk
qytet	cytɛt
që	cɕə
që	cə
që	tɕə
që	tʃə
qëndroj	cɕəndɾɔj
rajon	ɾajɔn
raki	ɾaki
rakishitës	ɾakiʃitəs
ramush	ɾamuʃ
ramë	ɾamə
ranishte	ɾaniʃte
ranishtë	ɾaniʃtə
ranor	ɾanoɾ
re	ɾe
rehat	ɾehat
rem	ɾɛm
rend	ɾɛnd
restorant	ɾɛstɔɾant
rexha	ɾedʒa
rexhep	ɾedʒep
rexhë	ɾedʒə
rezultat	ɾɛzultat
rigë	ɾig
rini	ɾini
rosë	ɾosə
rr	r
rrafsh	rafʃ
rrah	rah
rrepë	rɛp
rrepë	rɛpə
rreshter	reʃteɾ
rreshtoj	rɛʃt
rreth	rɛθ
rreze	rɛzɛ
rrezik	rɛzik
rrezikoj	rɛzikɔj
rrezikshëm	rɛzikʃəm
rrikë	rik
rrikë	rikə
rritem	ritem
rritem	ritɛm
rrjedhje	rjɛðjɛ
rruaj	ruaj
rrudhë	ruːð
rrugë	rugə
rrëbyth	rəbyθ
rrëfyes	rəfyːəs
rrëmujaxhi	rəmujadʒi
rrënoj	rənɔj
rrëshqanor	rəʃcanɔɾ
ryshfet	ɾyʃfɛt
rërë	ɾəɾə
rërët	ɾəɾət
s'	s
s'	z
sahat	sahat
sahatçi	sahattʃi
sajoj	sajɔj
saksi	saksi
saktë	saktə
sallgam	saɫgam
saraç	saɾatʃ
se	sɛ
selit	selit
sfurk	sfuːrk
sh	ʃ
sha	ʃa
shag	ʃag
shakllaban	ʃakɫaban
shakull	ʃakuɫ
shalqi	ʃalci
shalë	ʃalə
shami	ʃami
shap	ʃap
sharapoll	ʃaɾapoɫ
shark	ʃaɾk
sharki	ʃaɾki
sharkë	ʃaɾkə
shart	ʃaɾt
shat	ʃat
shatërvan	ʃatəɾvan
shehu	ʃehu
shejtan	ʃɛjtan
shembull	ʃɛmbuɫ
shemër	ʃɛməɾ
sheqer	ʃɛcɕɛɾ
sherbelë	ʃɛɾbɛːl
shermend	ʃɛɾmɛnd
shesh	ʃeʃ
shfrej	ʃfɾɛj
shigjetar	ʃiɟɛtaɾ
shigjetari	ʃidʑɛtaɹi
shigjetari	ʃiɟɛtaɾi
shigjetë	ʃidʑɛtə
shigjetë	ʃiɟɛtə
shihem	ʃiːhem
shikoj	ʃikoj
shikojmë	ʃikojmə
shikon	ʃikon
shikonin	ʃikonin
shikrije	ʃikɾijɛ
shitoj	ʃitɔj
shitës	ʃitəs
shkak	ʃkak
shkal	ʃkal
shkath	ʃkaθ
shkathët	ʃkaθət
shkencë	ʃkɛntsə
shkencëtar	ʃkɛntsətaɾ
shkolla	ʃkɔɫa
shkruaj	ʃkɾuaj
shkurtohem	ʃkuɹtɔhɛm
shkurtohem	ʃkuɾtɔhɛm
shkëlqej	ʃkəlcɛj
shkëlqyeshëm	ʃkəlcyɛʃəm
shkëndijë	ʃkəndiːj
shlivovicë	ʃlivovitsə
shlivë	ʃlivə
shof	ʃɔf
shog	ʃog
shoku	ʃɔku
shokun	ʃɔkun
shokut	ʃɔkut
shokë	ʃɔkə
shokësh	ʃɔkəʃ
shokët	ʃɔkət
shokëve	ʃɔkvɛ
shokëve	ʃɔkəvɛ
shparg	ʃpaɾg
shpat	ʃpat
shpejtësi	ʃpɛjtəsi
shpellë	ʃpeːɫə
shpend	ʃpɛnd
shpie	ʃpie
shpif	ʃpif
shpifa	ʃpifa
shpifur	ʃpifur
shpirrë	ʃpiːr
shpirtkeq	ʃpiɾtkec
shpjegoj	ʃpjɛgɔj
shpotit	ʃpɔtit
shpreh	ʃpɾeh
shprehës	ʃpɾehəs
shpretkë	ʃpretkə
shputë	ʃputə
shqem	ʃceːm
shqip	ʃcip
shqip	ʃcɕip
shqip	ʃkʲip
shqipohem	ʃcipɔhɛm
shqipohet	ʃcipɔhɛt
shqipoj	ʃcipɔj
shqipon	ʃcipɔn
shqiponjë	ʃcipɔɲə
shqiptar	ʃciptaɾ
shqiptoj	skʲiptɔj
shqiptoj	ʃciptɔj
shqiptoj	ʃcɕiptɔj
shqiptoj	ʃkʲiptɔj
shqiptoj	ʃtɕiptɔj
shqiptoj	ʃtʃiptɔj
shqipëlloj	ʃcipəɫɔj
shqipëlloj	ʃcɕipəɫɔj
shqipëlloj	ʃtɕipəɫɔj
shqipëlloj	ʃtʃipəɫɔj
shqipëri	ʃcipni
shqipëri	ʃcipəni
shqipëri	ʃcipəɾi
shqipëri	ʃcɕipni
shqipëri	ʃcɕipəni
shqipëri	ʃcɕipəɾi
shqipëri	ʃkʲipəɾi
shqyptar	ʃcyptaɾ
shqyt	ʃcyt
shrafciger	ʃɾaftsigeɾ
shtatzënë	ʃtatzəːn
shtatë	ʃtatə
shtatëmbëdhjetë	ʃtatəmbəðjɛtə
shtazarak	ʃtazaɾak
shtet	ʃtɛt
shtetas	ʃtetas
shtohem	ʃtɔhɛm
shtoj	ʃtɔj
shtrat	ʃtɾat
shtreb	ʃtɾɛb
shtrep	ʃtɾɛp
shtrigë	ʃtɾiːg
shturë	ʃtuːɾ
shtyllë	ʃtyːɫ
shtëllungë	ʃtəɫuŋə
shtëpi	ʃtəpi
shtëpiak	ʃtəpiak
shtëpâ	ʃtəpã
shuguroj	ʃuguɾoj
shukrije	ʃukɾijɛ
shum	ʃum
shumë	ʃumə
shumëgjuhësh	ʃuməɟʑuhəʃ
shuplakë	ʃuplaːk
shurbë	ʃuːɾb
shurdh	ʃuɾð
shurdhuar	ʃuɾðuaɾ
shushunjë	ʃuʃuːɲə
shushuq	ʃuʃuc
shykrije	ʃykɾijɛ
shëlboj	ʃəlbɔj
shëllij	ʃəɫij
shëndoshë	ʃəndɔʃə
shërbej	ʃəɾbɛj
shëtit	ʃətit
simahor	simahor
sinonim	sinɔnim
sinqertë	siŋcɕɛɾtə
sirtar	siɾtaɾ
sistem	sɪstɛm
sjellje	sjɛɫjɛ
skelet	skɛlɛt
skipetar	ʃciptaɹ
skipetar	ʃciptaɾ
skipetar	ʃcɕiptaɹ
skipetar	ʃcɕiptaɾ
skipetar	ʃkʲiptaɾ
skllav	skɫav
smirë	smiɾə
sobë	sobə
sodit	sɔdit
sofika	sofikə
soj	sɔj
sopatë	sɔpatə
sorkadh	sorkað
sorkadhe	sorkaðe
sorrë	sɔrə
sos	sɔs
sotir	sotiɾ
sotira	sotiɾa
spec	spɛts
spermë	spɛɾmə
sqap	scɕap
sqarim	scɕaɹim
sqaroj	stɕaɹɔj
sqotë	scɕɔtə
stan	stan
sternë	sternə
sterrë	sterə
stihi	stihi
stinë	stinə
stërvis	stəɾvit
sulmoj	sulmoj
sundoj	sundɔj
sup	sup
sy	sy
sykullumbri	sykuɫumbɾi
sylesh	syleʃ
syzi	syzi
së	s
së	sə
së	səː
sëmurë	səmuɾə
sëpatë	səpaːt
tafa	tafa
tafë	tafə
tamël	tɑ̃məl
tamël	tɒməl
tanë	tɑ̃ːnə
taraf	taɾaf
tarogzë	taɾɔːgzə
tatuazh	tatuaʒ
tavë	tavə
teknologji	tɛknɔlɔɟʑi
tekst	tekst
tellall	teɫaɫ
tetar	tetaɾ
tetë	tɛtə
tetëmbëdhjetë	tɛtəmbəðjɛtə
teuta	teuta
teutë	teutə
tezgjah	tezɟah
th	θ
thashethemëxhi	θaʃɛθɛmdʒi
thashethemëxhi	θaʃɛθɛmədʒi
thelbësor	θɛlbəsoɹ
therës	θɛɾəs
thesar	θɛsaɾ
thi	θiː
thith	θiθ
thjeshtë	θjɛʃtə
thopërç	θopəɾtʃ
thupër	θupəɾ
thyej	θyɛj
thëngjillor	θənɟiɫoɾ
thëngjilltar	θənɟiɫtaɾ
thërrime	θərime
thërrmijë	θərmijə
thërrmoj	θərmoj
tigan	tigan
tjetër	tjetəɾ
tosknishte	toskniʃte
toskërishte	tɔskəɾiʃtɛ
totolesh	totoleʃ
trashëgoj	tɾaʃəgɔj
tre	tɾɛ
tregtar	tɾɛgtaɾ
trembëdhjetë	tɾɛmbəðjɛtə
tridhjetedy	tɾiðjɛtɛdy
tridhjetegjashtë	tɾiðjɛtɛɟʑaʃtə
tridhjetekatër	tɾiðjɛtɛkatəɹ
tridhjetenjë	tɾiðjɛtɛɲə
tridhjetenëntë	tɾiðjɛtɛnəntə
tridhjetepesë	tɾiðjɛtɛpesə
tridhjeteshtatë	tɾiðjɛtɛʃtatə
tridhjetetetë	tɾiðjɛtɛtɛtə
tridhjetetre	tɾiðjɛtɛtɾɛ
tridhjetë	tɾiðjetə
trileçe	tɾiletʃe
trime	tɾimɛ
trokas	tɾokas
trokitni	trokitni
trondit	tɾɔndit
tru	tɾũ
trup	tɾup
tullac	tuɫats
tung	tuŋg
turi	tuɾi
ty	ty
tym	tym
të	tə
tërë	təɾə
tërësi	təɾəsi
tërësisht	təɾəsiʃt
u	u
udhë	uðə
udhëheq	uðəhec
udhëhiqem	uðəhicɛm
udhëtar	uðətaɾ
udhëtoj	uðətɔj
udhëzim	uðəzim
udhëzoj	uðəzɔj
ugar	ugaɾ
ujdis	ujdis
ujka	uːjka
ujori	ujɔɾi
ujë	ujə
ukshin	ukʃin
ulban	ulban
ulem	ulɛm
umb	umb
uragan	uɾagan
urdhëror	uɹðəɹɔɹ
urdhëror	uɾðəɾɔɾ
urdhërore	uɹðəɹɔɹe
urdhërore	uɾðəɾɔɾe
uroj	uɾɔj
urrej	urɛj
urrejtje	urɛjtjɛ
ushqej	uʃcçɛj
ushqim	uʃtɕim
ushqim	uʃɕim
vaginë	vaginə
vagjinë	vaɟʑinə
vagëlloj	vagəɫɔj
vakëf	vakəf
valdet	valdɛt
valixhe	validʒɛ
vallë	vaɫə
vampir	vampiɾ
varfër	vaɾfəɾ
varrakat	varakat
vashë	vaʃə
vatër	vatəɾ
vdekje	vdɛkjɛ
vdekur	vdɛkuɾ
vdes	vdes
vegim	vɛgim
vegoj	vɛgɔj
vegsh	vɛgʃ
velet	velet
vendim	vɛndim
vendos	vɛndos
vendosje	vɛndosjɛ
veprim	vɛpɹim
verbër	vɛɾbəɾ
verdhullor	veɾðuɫoɾ
verdhë	veɾðə
veri	veɾi
veri	vɛɾi
veri	vɛɾiː
verior	vɛɾiɔɾ
verë	vɛɾə
vesë	vɛːs
vete	vete
veti	vɛti
vetvetishëm	vɛtvɛtiʃəm
vetëlëvizës	vetələvizəs
vetëm	vetəm
vetëvendosje	vɛtəvɛndosjɛ
veçanti	vɛtʃanti
veçantë	vɛtʃantə
vidër	vidəɾ
vihem	vihem
vihem	vihɛm
vindjak	vɪndjak
vinjak	d
vinjak	vɪnjak
virtyt	viɾtyt
visar	visaɾ
viç	vic
viç	vicɕ
viç	vitɕ
viç	vitʃ
vjedh	vjɛð
vjedhës	vjɛðəs
vjedhëse	vjɛðəsɛ
vjehrrë	vjɛhrə
vjehërr	vjɛhər
vjelës	vjeləs
vjershë	vjeːɾʃə
vjeshtë	vjɛʃtə
vlagë	vlaːg
vlefshëm	vlɛfʃəm
vlej	vlɛj
vneshtar	vnẽʃtaɾ
vobektë	vɔbɛkt
vogël	vɔgəl
vopë	vopə
votoj	votɔj
vozit	vozit
vrasës	vrasəs
vraç	vɾatʃ
vreshtar	vreʃtaɾ
vreshtari	vreʃtaɾi
vrimë	vɾimə
vuaj	vuaj
vulvë	vulvə
vulë	vulə
vurkollak	vuɾkoɫak
vërtetë	vəɹtɛtə
vërtetë	vəɾtɛtə
vërvit	vəɾvit
vështirë	vəʃtiɹə
x	dz
xh	dʒ
xhafa	dʒafa
xhafë	dʒafə
xhagajdur	dʒagajduɹ
xhak	dʒaːk
xhaketë	dʒaketə
xham	dʒam
xhaxha	dʒadʒa
xhehenem	dʒɛhɛnɛm
xhehnem	dʒɛhnɛm
xheloz	dʒeloz
xhelozi	dʒelozi
xhemat	dʒemat
xhenem	dʒɛnɛm
xhiro	dʒiɾo
xhura	dʒuɾa
xhuxh	dʒudʒ
xhuxhmaxhuxh	dʒudʒmadʒudʒ
xhybe	dʒybe
xitelë	dzitɛlə
xixë	dzidzə
xixëllonjë	dzidzəɫɔɲə
yjeplotë	yjɛplɔtə
yjor	yjɔɹ
yjësi	yjəsi
ylber	ylbɛɹ
yll	yɫ
yllplimje	yɫplimjɛ
ymër	yməɾ
ynë	ynə
ysht	yʃt
yt	yt
yzeir	yzeiɾ
yzengji	yzenɟi
z	z
zabel	zabɛl
zakon	zakɔn
zakonisht	zakɔniʃt
zallinë	zaɫinə
zallishtë	zaɫiʃtə
zanafillë	zanafiɫə
zanat	zanat
zanor	zanoɾ
zanore	zanoɾe
zarar	zaɾaɾ
zbaticë	zbatitsə
zbavis	zbavis
zbavitës	zbavitəs
zbukuroj	zbʊːkʊɾɔj
zbulim	zbulim
zbuloj	zbulɔj
zdrukth	zdɾukθ
zef	zɛf
zeher	zeheɾ
zeje	zeje
zemër	zɛməɾ
zemër	zɛ̃ːməɾ
zemërkeq	zeməɾkec
zeqo	zeco
zgjedhje	zɟɛðjɛ
zgjiç	zɟitʃ
zgjoj	zɟoj
zh	ʒ
zhak	ʒɑk
zhanër	ʒanəɾ
zharg	ʒaɾk
zhavorr	ʒavor
zhbllokohet	ʒbɫɔkɔhɛt
zhele	ʒele
zhgënjej	ʒgəɲɛj
zhubë	ʒuːb
zhubër	ʒubəɾ
zhur	ʒuɾ
zhurishtë	ʒuɾiʃtə
zhurmoj	ʒuɹmɔj
zhurmoj	ʒuɾmɔj
zhvesh	ʒvɛʃ
zhvishem	ʒviʃɛm
zi	zi
zili	zili
zjarr	zjar
zjarrfikës	zjarfikəse
zog	zɔg
zojz	zɔːjz
zonjë	zɔɲə
zonë	zɔnə
zot	zɔt
zota	zɔta
zotëni	zɔtəni
zotëri	zɔtəri
zvarranik	zvaranik
zvarrisem	zvarisɛm
zvicra	zvitsra
zvicra	zvitsɾa
zvicrra	zvitsra
zvicrra	zvitsɾa
zvicër	zvitsər
zvicër	zvitsəɾ
zvicërr	zvitsər
zvicërr	zvitsəɾ
zvogëloj	zvɔgəlɔj
zymbyl	zymbyl
zyshë	zyʃə
zëvendës	zəvɛndəs
ç	tʃ
ç'	tʃ
çadër	tʃadəɾ
çair	tʃaiɾ
çaj	tʃaj
çakall	tʃakaɫ
çantë	tʃantə
çarçaf	tʃaɾtʃaf
çast	tʃast
çdo	ʒdo
çelës	tʃɛləs
çerek	tʃeɾek
çerekje	tʃeɾekje
çerekshekull	tʃeɾekʃekuɫ
çetinë	tʃɛtiːn
çfarë	tʃfaɾə
çifligar	tʃifligaɾ
çifteli	tʃiftɛli
çifut	tʃifut
çliroj	tʃliɾɔj
çmend	tʃmɛnd
çudi	tʃudi
çukë	tʃukə
çun	cun
çun	tʃun
ë	ə
ëmbël	əmbəl
ëmbëlsi	əmbəlsi
ëngjëll	əndʑəɫ
ëngjëll	ənɟəɫ
është	əʃtə
