aa	àá
aa	áá
aadọrin	àádɔ́ꜜɾĩ̄
aadọta	àádɔ́ꜜtā
aafin	ààfĩ̄
aago	āāgō
aajin	ààdʒĩ̀
aajo	āádʒò
aakaragba	àákàɾàgbá
aake	àáké
aala	ààlà
aamu	àámṹ
aanu	àánṹ
aapọn	ààkpɔ̃̀
aarin	àáɾĩ́
aarinọla	àáɾínɔ̄lá
aaro	ààɾò
aarọ	ààɾɔ̀
aarọ	àáɾɔ̀
aasiki	āásìkí
aasikiriimu	áásìkīɾīìmù
aawẹ	ààwɛ̀
aaya	àájá
aayan	àájã́
aayan	āájã́
aayan	āájã̄
aaye	ààjè
aayo	ààjò
aba	àbá
aba	àbā
aba	ābà
aba	ābá
abajọ	ābádʒɔ̄
abakaliki	ābākālīkī
abakọọsi	ābákɔ́ɔ̀sì
abari	àbàɾí
abarịṣa	àbāɾɪ̀ʃà
abata	àbàtà
abatao	àbàtàó
abetiaja	ābētíādʒá
abi	àbí
abia	ábíá
abia	ābíá
abidi	ábídí
abidi	ābídí
abigbẹyin	àbígbɛ̀jĩ̀
abiikọ	àbíìkɔ́
abiku	àbíkú
abikẹ	àbíkɛ́
abilekọ	ābīlékɔ̄
abimbọla	ābíŋ̄bɔ́lá
abisinwin	àbísĩ́wĩ́
abiya	ābíjá
abiyamọ	ābījāmɔ̃̄
abiyẹ	ābìjɛ́
abiọdun	ābíɔ́dṹ
abiọna	ābíɔ́nã̀
aboadiyẹ	ābōādìjɛ̄
aboaguntan	ābōàgũ̀tã̀
aboaja	ābōādʒá
abobo	ābòbó
abolounjẹku	ābólóṹdʒɛ̄kú
aboorunyi	ābóòɾũ̀jí
aboyun	ābōjṹ
abuda	àbùdá
abuja	àbúdʒá
abuke	ābūké
abule	ābúlé
aburada	ābùɾādà
aburada	ābūɾādà
aburahamu	ábúɾáhámù
aburo	àbúɾò
abuubutan	àbùùbùtã́
abuubutanabuke	àbùùbùtã́ābūké
abẹ	ābɛ́
abẹ	ābɛ̄
abẹbi	àbɛ̀bí
abẹbẹ	ābɛ̀bɛ̀
abẹkẹ	àbɛ̀kɛ́
abẹla	àbɛ́là
abẹni	àbɛ̀nĩ́
abẹrẹ	ābɛ́ɾɛ́
abẹtẹ	ābɛ́tɛ̀
abẹtẹlẹ	àbɛ̀tɛ́lɛ̀
abọbaku	ābɔ́bākú
abọde	àbɔ̀dè
abọde	àbɔ̀dé
abọgibọpẹ	ābɔ̄gībɔ̀kpɛ̀
abọriṣa	ābɔ̀ɾìʃà
abọruabọyeabọṣiṣẹ	àbɔ̄ɾúàbɔ̄jèàbɔ̄ʃíʃɛ̄
abọsẹde	ābɔ́sɛ̀dé
achọ	ātʃɔ̄
ada	àdá
ada	ādà
adaba	àdàbà
adabalukofi	àdàbàlùkòfì
adado	àdádó
adagba	ādāgbā
adagun	ādágṹ
adahunṣe	ādáhũ̄ʃē
adamawa	ādámáwá
adan	àdã́
adanida	àdánĩ̄dá
adanida	ādánĩ̄dá
ade	ādé
adebayọ	ādébájɔ̀
adebọbajọ	ādébɔ́bādʒɔ̄
adediran	ādédìɾã̄
adedire	ādédīɾē
adedure	ādédūɾē
adedẹwẹ	ādédɛ̀wɛ́
adefunkẹ	ādéfṹkɛ́
adegbamigbe	ādégbàmĩ́gbé
adegbemibu	ādégbémĩ̄bú
adeikẹ	ādéìkɛ́
adekiitẹ	ādékìítɛ̀
adekugbe	ādékùgbé
adele	àdèlé
adenikẹ	ādénĩ́ꜜkɛ́
adenikẹẹ	ādénĩ́ꜜkɛ́
aderonkẹ	ādéɾóŋ̄kɛ́
adeyẹmi	ādéjɛ̄mĩ́
adeyẹmọ	ādéjɛ̄mɔ̃̄
adeṣina	ādéʃínã̀
adiitu	àdììtú
adikala	ādíkálà
adimọlẹ	àdìmɔ̃́lɛ̀
adin	àdĩ́
adinumasọrọ	ādīnũ̄másɔ̀ɾɔ̀
adio	àdìó
adiro	àdìɾò
adiro	àdìɾō
adiro	ādīɾō
adirẹsi	àdíɾɛ́sì
adisa	àdìsá
aditi	ādītí
adiyẹ	ādìjɛ̄
adiẹ	ādìɛ̄
ado	àdó
ado	ādó
adodo	àdòdó
adoekiti	ādóèkìtì
adogan	àdògã́
adua	àdúà
adubi	àdùbí
adugbo	àdúgbò
adumaadan	àdúmáādã́
adun	ādũ̀
adunmadẹẹkẹẹ	ādũ̀mádɛ̀ɛ́kɛ̀ɛ́
adunni	àdũ̀nĩ́
adunni	ādũ̀nĩ́
adupẹ	ādúkpɛ́
adura	àdúɾà
adẹrupọkọ	ādɛ́ɾùkpɔ̄kɔ̀
adịn	àdɪ̃̀
adọdọ	ādɔ̀dɔ́
aeregbe	āéɾégbé
afaa	àfáà
afadurajagun	āfàdúɾàdʒāgũ̄
afara	āfàɾà
afara	āfáɾá
afaraoyin	āfáɾáōjĩ̄
afayafa	āfàjàfà
afeimojo	àfèìmòdʒò
aferemọjo	àfèɾèmɔ̃̀dʒò
afikun	àfīkṹ
afinihan	āfīnĩ̄hã̀
afinju	āfĩ́dʒú
afirika	āfíɾíkà
afojudi	àfōdʒúdī
afojusun	àfōdʒúsũ̀
afomọ	àfòmɔ̃́
afomọaarin	àfòmɔ̃́àáɾĩ́
afomọibẹrẹ	àfòmɔ̃́ìbɛ̀ɾɛ̀
afomọipari	àfòmɔ̃́ìkpāɾí
afonifoji	àfōnĩ́fōdʒì
afoopina	àfòòkpīnã́
afopina	àfòkpīnã́
afẹfẹ	āfɛ́fɛ́
afẹmọjumọ	àfɛ̀mɔ̃́dʒúmɔ̃́
afẹẹri	àfɛ́ɛ̀ɾí
afọbajẹ	āfɔ̄bādʒɛ̄
afọmọlọmu	āfɔ́mɔ̃̄lɔ́mṹ
afọn	àfɔ̃̀
afọwọfa	àfɔ̄wɔ́fà
afọwọfaẹda	àfɔ̄wɔ́fàɛ̀dá
aga	àgā
aga	āgà
agabagebe	àgàbàgēbè
agabangebe	àgàbàŋ̀gēbè
agada	àgàdà
agada	āgàdà
agada	āgādā
agadagodo	àgádágōdō
agaga	àgàgà
agalamaṣa	àgálámàʃà
agalamọsa	àgálámɔ̃̀sà
agalẹ	āgālɛ̀
agan	àgã̀
aganju	āgã̄dʒú
aganjuṣọla	āgã̄dʒúʃɔ̄lá
aganran	āgã́ɾã́
aganrandi	àgã́ɾã́dì
agba	àgbà
agba	àgbá
agba	āgbā
agbaakin	àgbàākĩ̄
agbabọọlu	āgbábɔ́ɔ̀lù
agbada	āgbádá
agbada	āgbādā
agbadarigi	àgbádáɾìgì
agbado	àgbàdō
agbagba	àgbāgbà
agbajọ	àgbádʒɔ̄
agbako	àgbákò
agbakoroju	àgbàkòɾódʒú
agbala	àgbàlá
agbalaaye	àgbáláājé
agbalagba	àgbàlāgbà
agbalẹ	āgbálɛ̀
agbamurere	àgbámũ̀ɾéɾé
agban	àgbã̀
agban	āgbã̀
agbanilagbatan	āgbānĩ̄lágbàtã́
agbanrere	àgbáŋ̀ɾéɾé
agbara	àgbàɾà
agbara	àgbàɾá
agbara	āgbàɾà
agbara	āgbàɾá
agbara	āgbáɾā
agbari	āgbáɾí
agbawo	āgbáꜜwō
agbaye	àgbájé
agbayun	àgbájũ̄
agbayunkun	àgbájũ̄kṹ
agbe	āgbè
agbe	āgbē
agbebọ	àgbébɔ̀
agbegbe	āgbègbè
agbegbeakoko	āgbègbèàkókò
agbekẹ	àgbékɛ́
agbelebuu	àgbéléꜜbú
agbigbo	àgbìgbò
agbinrin	àgbĩ̀ɾĩ̀
agbo	àgbò
agbo	àgbó
agbo	àgbō
agbo	āgbō
agbojẹ	āgbódʒɛ̄
agbokotọya	āgbókōtɔ́jà
agbẹ	àgbɛ̀
agbẹdu	āgbɛ̀dū
agbẹdẹ	àgbɛ̀dɛ̄
agbẹdẹbaba	àgbɛ̀dɛ̄bàbà
agbẹdẹfadaka	àgbɛ̀dɛ̄fàdákà
agbẹdẹwura	àgbɛ̀dɛ̄wúɾà
agbẹdọ	àgbɛ̄dɔ̀
agbẹgilere	āgbɛ́gīléɾē
agbẹjọro	āgbɛ̄dʒɔ́ɾò
agbọn	àgbɔ̃̀
agbọn	àgbɔ̃̄
agbọn	āgbɔ̃̀
agbọn	āgbɔ̃́
agbọnmiregun	àgbɔ̃̄mĩ̀ɾègṹ
agbọnniregun	àgbɔ̃̄nĩ̀ɾègṹ
agbọnrin	àgbɔ̃̀ɾĩ́
agbọrin	àgbɔ̀ɾĩ́
age	àgé
agege	āgégē
agegi	āgégī
agele	àgèlè
aghan	àɣã̄
aghayo	āɣàjò
aghere	āɣéɾé
agho	āɣó
aghọ	āɣɔ̄
aghọfẹn	àɣɔ̀fɛ̃̄
agidi	āgídí
agidigbo	àgídìgbō
agilinti	āgílíŋ́tí
agiliti	āgílítí
agira	āgíɾá
agiriiki	àgíɾíìkì
agiyan	àgìjã̀
ago	àgò
ago	àgó
agodongbo	āgódóŋ́gbó
agogo	àgògō
agogo	àgógó
agogo	āgōgō
aguala	àgùàlà
aguda	àgùdà
agunfọn	àgũ̀fɔ̃̄
agunrẹn	àgũ̀ɾɛ̃̀
aguntan	àgũ̀tã̀
agura	āgùɾá
agutan	àgùtã̀
agutẹn	àgùtɛ̃̀
agẹmọ	āgɛ̄mɔ̃̄
agẹrẹ	àgɛ̀ɾɛ̀
agọ	àgɔ́
agọ	āgɔ̀
agọọlọpaa	àgɔ́ɔ̄lɔ́kpàá
agụta	àgʊ́tà
agụtọn	àgʊ̀tɔ̃̀
aha	āhá
ahaya	àhàjá
ahayaibọn	àhàjáìbɔ̃̄
ahere	āhéɾé
ahun	āhũ̀
ahun	āhũ̄
ahun	āhṹ
ahunṣọ	āhũ̄ʃɔ̄
ahọn	āhɔ̃́
aibikita	àìbìkítà
aifo	āífó
aigbagbọ	àìgbàgbɔ́
aigbe	àígbè
aighọ	àìɣɔ̀
aika	àìkà
aika	àìkā
aikaragba	àíkàɾàgbá
aike	àìkè
aike	àíké
ailee	àílèé
aina	àìnã́
ainisuuru	àìnĩ́sùúɾù
ainitẹẹlọrun	àìnĩ́ꜜtɛ́lɔ́ɾũ̀
ainọn	àínɔ̃́
aio	āīō
airi	àìɾí
airigbẹẹya	àìɾíꜜgbɛ́jà
airilegbe	àìɾílégbé
airiṣẹṣe	àìɾíʃɛ́ʃē
airo	āíɾō
airo	āīɾō
airoorunsun	àìɾóōɾũ̄sũ̀
airọmọbi	àìɾɔ́mɔ̃̄bí
aisan	àìsã̀
aisaya	āísájà
aisikiriimu	áísìkīɾīìmù
aja	àdʒà
aja	ādʒá
ajadi	àdʒàdí
ajaga	àdʒàgà
ajagbe	àdʒàgbé
ajaja	àdʒàdʒá
ajako	ādʒákō
ajala	àdʒàlá
ajalemogun	àdʒàlémògṹ
ajalọrun	àdʒàlɔ́ɾũ̄
ajanaka	ādʒānã̄ká
ajanaku	àdʒànã̀kú
ajani	àdʒànĩ́
ajao	àdʒàò
ajaoajọsọn	àdʒàòàdʒɔ̀sɔ̃́
ajaodidu	àdʒàòdídú
ajaopụpa	àdʒàòkpʊ̄kpā
ajaoro	ādʒáōɾò
ajaoṣupa	ādʒáòʃùkpá
ajapada	àdʒàkpādà
ajara	àdʒàɾà
ajari	àdʒàɾí
ajaṣẹ	àdʒàʃɛ́
aje	ādʒé
ajeji	àdʒèdʒì
ajereke	ādʒèɾèké
ajero	ādʒēɾò
ajewọle	ādʒéwɔ̄lé
ajibẹtẹ	ādʒíbɛ́tɛ́
ajijẹn	àdʒìdʒɛ̃̀
ajikẹ	àdʒíkɛ́
ajilẹ	ādʒílɛ̀
ajimẹfun	ādʒímɛ́fũ̄
ajinjin	àdʒĩ̀dʒĩ̀
ajo	àdʒò
ajo	àdʒó
ajogun	ādʒōgũ̄
ajoji	àdʒòdʒì
ajola	àdʒòlà
ajuleọrun	àdʒùléɔ̀ɾũ̄
ajẹ	àdʒɛ́
ajẹbu	ādʒɛ̀bú
ajẹbọ	ādʒɛ̄bɔ́
ajẹbọta	ādʒɛ̄bɔ́tà
ajẹku	àdʒɛ̄kù
ajẹlẹ	ādʒɛ́lɛ̀
ajẹntina	ādʒɛ̄ŋ̄tínà
ajẹpako	ādʒɛ̄kpákó
ajọ	àdʒɔ̄
ajọ	ādʒɔ̀
ajọagbaye	àdʒɔ̄àgbájé
ajọdi	àdʒɔ̄dì
ajọdun	àdʒɔ̀dṹ
ajọdẹ	àdʒɔ̄dɛ̄
ajọkẹ	àdʒɔ̄kɛ́
ajọpinnu	àdʒɔ̄kpĩ̄nũ̄
ajọpinya	àdʒɔ̄kpĩ́jà
ajọrin	àdʒɔ̄ɾĩ̀
ajọsọ	àdʒɔ̄sɔ̄
ajọyọ	àdʒɔ̄jɔ̀
ajọṣepọ	àdʒɔ̄ʃēkpɔ̀
aka	àká
aka	āká
aka	ākā
akaa	àkàà
akaba	àkàbà
akaka	àkàkà
akala	àkàlà
akalamọsa	àkálámɔ̃̀sà
akamara	àkámāɾà
akamuja	àkámũ̀dʒà
akan	ākã̀
akankẹ	àkã̀kɛ́
akanloede	àkã̀lòèdè
akanni	àkã̀nĩ́
akara	àkàɾà
akaraoyinbo	àkàɾàòjĩ̀bó
akarigbo	àkáɾìgbò
akasọ	àkàsɔ̀
akata	ākátá
akata	ākātā
akatanpo	àkàtàŋ̀kpó
akaya	àkàjà
akaye	àkàjé
akeekee	àkéēkèē
akeke	ākēkē
akekee	ākéēkèē
akere	àkèɾé
akerese	ākēɾēsē
akewi	ākéwì
akiika	àkíìkà
akika	ākīkā
akikaragba	àkíkàɾágbá
akike	àkíké
akin	ākĩ̄
akiniku	ākínĩ́kù
akinlẹyẹ	ākĩ́lɛ̀jɛ̄
akinlẹyẹ	ākĩ́lɛ́ꜜjɛ̄
akire	ākīɾè
akirun	ākìɾũ̄
akisa	àkísà
akiti	ākítì
akitẹṣọ	ákítɛ́ʃɔ̀
akoba	àkóbá
akojọ	àkódʒɔ̄
akoko	àkókò
akoko	àkókó
akoko	ākòkō
akokoro	ākōkōɾō
akolẹta	ākólɛ́tà
akoo	àkòó
akoro	àkòɾó
akoso	àkósō
akoto	ākōtō
akukọ	àkùkɔ̄
akunwọsilẹ	àkṹwɔ́sílɛ̀
akunyungba	ākũ̀jũ̀gbà
akurun	àkúɾũ̄
akurẹ	àkúɾɛ́
akurọ	àkùɾɔ̀
akuṣẹẹ	ākúʃɛ̀ɛ́
akwaibọm	ākwāíbɔ̄m
akẹ	àkɛ̀
akẹku	àkɛ̀kù
akẹkọọ	ākɛ́kɔ̀ɔ́
akẹn	ākɛ̃̄
akẹtẹ	àkɛ̄tɛ̀
akịka	ākɪ̄kā
akọ	àkɔ̀
akọ	ākɔ̄
akọbi	àkɔ́bí
akọbulọọgu	ākɔ̄búlɔ́ɔ̀gù
akọefu	ākɔ̄èfù
akọgirisi	àkɔ́gìɾìsì
akọigba	àkɔ́ìgbà
akọni	ākɔ́nĩ̄
akọni	ākɔ̄nĩ̄
akọsẹjaye	àkɔ̄sɛ̀dʒājé
akọtọ	àkɔ̄tɔ́
akọọlẹ	àkɔ̄ɔ́lɛ̀
ala	àlà
ala	àlá
alaaanu	āláꜜánṹ
alaadi	àlàádì
alaafia	àlàáfíà
alaafin	āláàfĩ̄
alaalẹ	ālāālɛ́
alaamu	àláàmũ̀
alaamu	āláàmũ̀
alaaye	ālààjè
alaba	àlàbá
alabaaṣiṣẹpọ	āláꜜbáʃīʃɛ́kpɔ̀
alabasita	ālābásítà
alabi	àlàbí
alade	àlàdé
alade	āládé
aladegbuji	āládégbùdʒì
aladejana	āládédʒánã̀
aladelusi	āládélúsì
alademọmi	āládémɔ̃̀mĩ́
aladije	ālàdídʒē
aladuugbo	āláꜜdúgbò
alafẹrẹ	āláfɛ̄ɾɛ́
alagabagebe	ālágàbàgēbè
alagabangebe	ālágàbàŋ̀gēbè
alagba	ālágbà
alagbadaina	ālágbádáīnã́
alagbeeka	āláꜜgbéká
alagbẹdẹ	ālágbɛ̀dɛ̄
alageere	āláꜜgéɾé
alagidi	ālágídí
alagoogo	ālágòógó
alailowaya	āláìlōwájà
alaini	āláìnĩ́
alainisuuru	āláìnĩ́sùúɾù
alakalaa	àlákáꜜlá
alakara	ālákàɾà
alake	āláké
alaketu	ālákétū
alakẹ	àlàkɛ́
alalupayida	ālálúkpàjídà
alalẹ	ālálɛ̀
alamisi	àlàmísì
alamọ	ālámɔ̃̀
alamọmọ	ālámɔ̃̀mɔ̃̀
alangba	āláŋ̀gbá
alantakun	āláŋ̀tākũ̀
alapa	àlákpà
alapa	ālákpá
alapaandẹdẹ	āláꜜkpáŋ̀dɛ̀dɛ̀
alapadupẹ	ālákpādúkpɛ́
alapata	āláꜜkpātà
alapinni	ālákpĩ̄nĩ̄
alara	āláɾá
alarabara	āláɾàbāɾà
alaruba	àlàɾùbā
alase	ālásè
alatagba	ālátāgbà
alatilẹyin	ālátìlɛ́jĩ̀
alawada	āláwàdà
alaye	àlàjé
alaye	ālájé
alaye	ālājé
alayerẹ	ālájèɾɛ́
alaṣẹrẹ	āláʃɛ̀ɾɛ́
ale	àlè
aleebu	àléébù
aleebuara	àléébùāɾā
aleefa	àlééfà
alegba	àlégbà
alegun	àlégũ̀
alejo	àlēdʒò
alepa	àlékpā
alepata	ālèkpātā
alere	àléɾé
alibenia	ālībéníà
alifabẹẹti	álífábɛ́ɛ̀tì
alikama	àlìkámà
alimi	álímĩ̀
alimoyi	àlìmójì
aliyu	àlíjù
aloe	álóè
aloju	àlòdʒù
aloko	àlòkò
aloku	àlòkù
alubarika	àlùbáɾíkà
alubasa	àlùbásà
alubọsa	àlùbɔ́sà
alubọsaelewe	àlùbɔ́sàēléwé
alufaa	àlùfáà
alugbagba	ālùgbàgbà
alujanna	àlùdʒã́nã̀
alujọnnu	àlùdʒɔ̃̀nṹ
alukawani	àlùkáwànĩ́
alukenbu	àlùkéŋ́bù
alukiamọ	àlùkìámɔ̃̀
aluko	àlùkò
alukunrin	àlùkũ̄ɾĩ́
alumọgaji	àlùmɔ̃́gàdʒí
alumọkọrọyi	àlùmɔ̃̀kɔ́ɾɔ́jí
alumọni	àlùmɔ̃́nĩ̀
alupayida	àlúkpàjídà
alupipi	ālūkpìkpì
alupupu	ālùkpùkpù
aluwala	àlùwàlá
alẹ	ālɛ̀
alẹ	ālɛ́
alẹde	ālɛ̀dē
alọ	àlɔ́
amala	àmàlà
amawomaro	āmāwōmáɾò
amenia	àméníà
ami	àmĩ̀
ami	àmĩ́
ami	āmĩ́
amiayo	àmĩ̀ājò
amifaagun	àmĩ̀fàágũ̀
amiohun	àmĩ̀ōhũ̀
amiohunaarin	àmĩ̀ōhũ̀àáɾĩ́
amiohunisalẹ	àmĩ̀ōhũ̀ìsàlɛ̀
amiohunoke	àmĩ̀ōhũ̀òkè
amiohunẹlẹyọọrodo	àmĩ̀ōhũ̀ɛ̄lɛ́ꜜjɔ́ɾōdò
amiohunẹlẹyọọroke	àmĩ̀ōhũ̀ɛ̄lɛ́ꜜjɔ́ɾòkè
amodi	àmódī
amofin	āmòfĩ̄
amubadọgba	āmṹbádɔ́gbā
amuga	àmũ̀gā
amuga	āmṹgā
amuku	àmũ̄kù
amulu	àmṹlù
amunisin	āmṹnĩ̄sĩ̀
amure	àmũ̀ɾè
amẹrika	āmɛ́ɾíkà
amọ	àmɔ̃́
amọ	āmɔ̃̀
amọkẹ	àmɔ̃̀kɛ́
amọtẹkun	àmɔ̃̀tɛ́kũ̀
an	ã́
an	ã̄
ana	ànã̀
ana	ànã́
ana	ànã̄
anabi	ànã́bì
anago	ànã̀gó
anamọ	ànã̀mɔ̃́
anbulansi	áŋ́búláŋ̀sì
andọra	àŋ̀dɔ́ɾà
anfaani	àŋ̀fàànĩ́
angola	àŋ̀gólà
aniani	ànĩ́ã̀nĩ́
anikangbiju	ānĩ̀kã̀gbīdʒù
anikẹ	ànĩ́kɛ́
aniyan	ànĩ́jã̀
ankali	áŋ́kàlí
ankuri	àŋ̀kúɾí
anlugbua	āŋ́lùgbūà
anta	àŋ̀tà
anti	àŋ̀tí
anupe	ànũ̀kpē
ao	àō
aogo	āāgō
aokindupẹaraẹni	āòkíŋ́dúkpɛ́āɾáɛ̄nĩ̄
aoolaye	āóòlájè
aoro	àòɾò
apa	àkpà
apa	àkpá
apa	ākpá
apaadi	àkpáàdì
apadidi	àkpádìdì
apala	àkpālá
apala	ākpálá
apala	ākpālà
apapa	àkpákpá
apari	ākpáɾí
aparo	àkpāɾò
apata	àkpátā
apatamaja	àkpátámàdʒà
apejẹ	àkpèdʒɛ́
apejẹ	àkpèdʒɛ̄
apekẹ	àkpèkɛ́
apere	àkpèɾè
apetumodu	àkpētūmōdù
apetunpe	àkpètṹkpè
apiiri	àkpíìɾì
apilẹkọ	àkpīlɛ̀kɔ̄
apo	àkpò
apo	ākpó
apola	àkpólà
apolo	àkpólò
apoogun	ākpòògũ̀
apoorooro	àkpòòɾóòɾō
apoowe	àkpòòwé
apopona	àkpókpónã̀
apoporo	ākpōkpōɾō
aporo	ākpōɾō
apoti	àkpótí
apoti	ākpòtí
apotọ	àkpòtɔ̀
apẹja	ākpɛ̄dʒā
apẹrẹ	ākpɛ̀ɾɛ̀
apẹtẹbi	ākpɛ̀tɛ̀bí
apẹẹrẹ	àkpɛ̄ɛ̄ɾɛ̄
apọn	àkpɔ̃́
apọnle	àkpɔ̃́lé
ara	àɾà
ara	àɾá
ara	āɾá
ara	āɾā
araalu	āɾáàlú
araarọ	àɾàáɾɔ̀
araba	àɾàbà
aragbayamuya	āɾágbājāmṹjā
aragberi	àɾágbēɾí
aragbiji	āɾágbìdʒí
aran	àɾã́
aranṣọ	āɾã́ʃɔ̄
are	àɾē
are	āɾé
arere	āɾèɾē
aridunnu	àɾídũ̀nṹ
arifin	àɾífĩ́
arigbo	āɾígbó
arikẹ	àɾíkɛ́
aringiya	āɾĩ̄gíjà
arinurode	āɾínṹɾóꜜdē
ariro	āɾíɾō
ariro	āɾīɾō
arisun	àɾìsũ̀
ariwa	àɾíwá
ariwo	āɾíwó
ariwo	āɾīwō
ariya	àɾíjá
ariyanjiyan	àɾíjã̀dʒījã̀
ariyọ	àɾíjɔ̀
aro	àɾó
aro	āɾò
aro	āɾó
aro	āɾō
arobo	āɾòbó
arojojoye	āɾódʒòdʒōjè
aroko	àɾōkò
arokọ	àɾòkɔ̄
arugbo	āɾúgbó
arugbọn	āɾūgbɔ̃̀
arun	àɾũ̀
arun	àɾṹ
arun	āɾũ̄
arunabẹgẹẹja	àɾũ̀ābɛ́ꜜgɛ́dʒà
arunamọ	àɾũ̀àmɔ̃́
arunawu	àɾũ̀āwú
arundinlaaadọta	àɾṹdĩ́láàádɔ́tā
arundinlogoji	àɾṹdĩ́lógódʒì
arundinlogun	àɾṹdĩ́lógṹ
arundinlọgbọn	àɾṹdĩ́lɔ́gbɔ̃̀
arundinlọgọta	àɾṹdĩ́lɔ́gɔ́tā
arungaga	àɾũ̀gágá
arungbajumọ	àɾũ̀gbādʒúmɔ̃̀
arungbo	āɾũ̄gbó
arungun	āɾũ̄gṹ
arunjakutẹ	àɾũ̀dʒàkùtɛ̀
arunkogboogun	àɾũ̀kògbóògũ̀
arunkorikori	àɾũ̀kòɾìkòɾì
arunmẹdọwu	àɾũ̀mɛ́dɔ̀wú
arunrọmọlaparọmọlẹsẹ	àɾũ̀ɾɔ̄mɔ̃̄lákpáɾɔ̄mɔ̃̄lɛ́sɛ̀
arẹmọ	àɾɛ̀mɔ̃̄
arịla	àɾɪ̀là
arọ	àɾɔ̀
arọ	àɾɔ̄
arọ	āɾɔ́
arọ	āɾɔ̄
arọko	àɾɔ̄kō
arọmọdọmọ	àɾɔ̄mɔ̃̄dɔ́mɔ̃̄
arọn	àɾɔ̃̀
arọni	àɾɔ̀nĩ̀
arọọrọda	àɾɔ̀ɔ̀ɾɔ̀dá
asabuta	àsàbùtā
ase	àsè
asia	àsíá
asiidi	ásíìdì
asiko	àsìkò
asin	āsĩ́
asinwin	āsĩ́wĩ́
asun	àsũ̄
asunta	āsũ̀tā
asẹn	āsɛ̃́
asẹyin	āsɛ́jĩ̀
asọsọ	āsɔ̄sɔ̄
ata	ātā
ataare	ātāāɾē
atabutọn	àtàbútɔ̃̀
ataju	ātādʒú
atalaata	àtàláátà
atalẹ	ātālɛ̀
atamatase	ātāmátàsé
atampako	àtàŋ̀kpàkò
atan	ātã̄
atanda	àtã̀dá
atannigbọnnini	ātã̄nĩ̄gbɔ̃́nĩ̄nĩ̄
atannẹyẹ	ātã́ꜜnɛ̃́jɛ̄
atanpako	àtàŋ̀kpàkò
atapari	àtàkpàɾí
atari	àtàɾí
atatataṣe	ātātàtàʃé
atawe	ātàwé
ataọja	àtáɔ́dʒā
ati	àtī
atiala	ātíálá
atibaba	àtíbàbà
atijọ	àtīdʒɔ́
atike	àtíkè
atileyin	ātìléjĩ̀
atilẹyin	àtìlɛ́jĩ̀
atimọle	àtìmɔ̃́lé
atini	àtìnĩ́
atinukẹ	ātīnṹkɛ́
atioro	ātíòɾō
atipo	àtìkpó
atorin	àtōɾĩ̀
atunkẹ	àtṹkɛ́
atunyẹwo	àtṹjɛ̀wò
atupa	àtùkpà
atẹgun	àtɛ̀gũ̀
atẹgun	ātɛ́gũ̀
atẹjiṣẹ	àtɛ̀dʒíʃɛ́
atẹlẹwọ	àtɛ́lɛ̄wɔ́
atẹlẹọ	àtɛ́lɛ̄ɔ́
atẹrigba	àtɛ́ɾígbà
atọ	àtɔ̀
atọ	ātɔ́
atọgbẹ	àtɔ̀gbɛ̄
atọka	ātɔ́ꜜkā
atọn	ātɔ̃̄
atọsi	àtɔ̀sí
atọsin	àtɔ̀sĩ́
atọtọ	ātɔ̄tɔ̄
atọọka	ātɔ́ɔ̀kā
atọọle	ātɔ̀ɔ́lé
audu	āúdù
awa	àwā
awada	àwàdà
awawa	àwàwà
awe	àwé
awere	āwèɾè
awerewere	àwèɾèwéɾé
awijare	àwídʒàɾē
awiṣẹ	àwíʃɛ̄
awo	àwō
awo	āwó
awo	āwō
awobuluyi	āwóbùlújì
awodi	àwòdì
awodiapẹja	àwòdìākpɛ̄dʒā
awodiran	āwódìɾã̄
awoko	àwòkō
awolọwọ	āwólɔ́wɔ̀
aworan	àwòɾã́
aworanafikereyọọnuya	àwòɾã́àfīkēɾējɔ́ɔ̀nũ̀jà
aworanafọwọya	àwòɾã́àfɔ̄wɔ́jà
awori	àwóɾì
aworo	àwòɾò
awoyale	āwójālé
awujalẹ	āwùdʒālɛ̀
awujẹ	àwùdʒɛ̀
awun	āwũ̄
awurọ	àwúɾɔ̀
awusa	āwùsá
awusa	āwúsá
awuyewuye	āwūjēwūjē
awẹn	àwɛ̃̀
awọ	àwɔ̀
awọ	āwɔ̀
awọ	āwɔ̄
awọfi	àwɔ̀fī
awọn	àwɔ̃̀
awọn	àwɔ̃̄
awọn	āwɔ̃́
awọsanma	àwɔ̀sã́mà
awọsanma	àwɔ̄sã́mà
aya	àjà
aya	àjá
aya	ājà
aya	ājā
ayaba	ājābā
ayafi	àjàfī
ayafọto	ājāfɔ́tò
ayalegbe	ājálégbé
ayan	àjã̀
ayandiran	àjã́dìɾã̄
ayanfẹ	àjã̀fɛ́
ayangalu	àjã̀gālú
ayangburẹn	àjã́gbùɾɛ̃̀
ayanmọ	àjã̀mɔ̃́
aye	àjè
aye	ājè
aye	ājé
ayeatijọ	ājéàtīdʒɔ́
ayederu	ājédèɾú
ayegbe	àjègbè
ayekootọ	ājékòótɔ́
ayelala	ājélálā
ayelujara	ājélūdʒáɾā
ayeraye	ājéɾājé
ayerẹ	ājèɾɛ́
ayikule	ājíkúlè
ayinrin	àjĩ̀ɾĩ́
ayinrin	ājĩ̀ɾĩ̀
ayiyọn	àjíjɔ̃̀
ayo	ājò
ayoayo	ājòājò
ayoọlọpọn	ājòɔ̄lɔ́kpɔ̃́
ayu	ājù
ayun	ājũ̀
ayẹyẹ	ājɛ̄jɛ̄
ayọ	ājɔ̀
ayọbamikalẹ	ājɔ̀bámĩ̄kālɛ́
ayọka	àjɔ̀ká
ayọpọrọ	ājɔ̀kpɔ̀ɾɔ́
aza	āzá
aṣa	àʃà
aṣa	àʃá
aṣadi	àʃádì
aṣakẹ	àʃàkɛ́
aṣalẹ	àʃálɛ́
aṣalẹ	āʃálɛ̀
aṣalẹ	āʃālɛ̀
aṣamu	àʃàmṹ
aṣanwewe	àʃáŋ̀wéwé
aṣanwewe	àʃáŋ́wēwé
aṣaro	àʃáɾó
aṣegbefabo	āʃègbèfábō
aṣigba	àʃígbà
aṣigbe	àʃígbè
aṣipa	āʃíkpā
aṣiri	àʃíɾí
aṣiwaju	āʃíwádʒú
aṣẹ	àʃɛ́
aṣẹ	àʃɛ̄
aṣẹ	āʃɛ̀
aṣẹwo	āʃɛ́wó
aṣẹṣe	àʃɛ̀ʃē
aṣẹṣẹ	àʃɛ̀ʃɛ́
aṣọ	āʃɔ̄
aṣọle	āʃɔ́lé
aṣọofi	āʃɔ̄òfì
aṣọoke	āʃɔ̄òkè
aṣọṣọ	āʃɔ́ʃɔ́
aọfịn	àɔ̀fɪ̃̄
aọn	àɔ̃̀
b	b
b	bí
ba	bà
baale	bāálé
baali	báálì
baaluu	bààlúù
baalẹ	bāálɛ̀
baara	bááɾà
baayanni	bāájã̀nĩ̀
babababa	bàbábàbá
babaganran	bàbàgã̄ɾã̄
babaiya	bàbáìjá
babalawo	bābāláwō
babiloni	bábílónì
baibai	bàìbàì
bairo	báíɾò
bajẹ	bàdʒɛ́
bakare	bákàɾè
bakiteria	bākītéɾíà
bakẹ	bàkɛ́
balaga	bàlágà
balogun	bālógũ̄
baluu	bàlúù
balẹ	bālɛ̀
banba	bàŋ̀bà
bandeeji	báŋ́déèdʒì
bandeeji	báŋ́déédʒì
bankẹ	bã́kɛ́
bantẹ	bàŋ̀tɛ́
bara	bàɾà
barafin	bāɾāfĩ́
barafo	bàɾàfò
barawo	bàɾáwò
bareke	báɾékè
bariba	bàɾìbá
barika	báɾíkà
basejẹ	bàsèdʒɛ́
bata	bàtà
bata	bàtá
bawo	báꜜwō
bawoni	báwōnĩ̄
bayii	báꜜjí
baṣọrun	bāʃɔ̀ɾũ̄
baẹsẹsọrọ	báɛ̄sɛ̀sɔ̀ɾɔ̀
baọlọji	bàɔ́lɔ́dʒì
beba	bébà
beere	bèèɾè
beere	béèɾè
beere	bééɾé
belu	bélú
berebere	béɾébéɾé
beru	bèɾù
bi	bì
bi	bí
bi	bī
bibeli	bíbélì
bijawarabiẹkun	bìdʒàwàɾàbíīɛ̄kũ̀
bikita	bìkítà
bilala	bílálà
bilisi	bìlísì
biliọnu	bílíɔ̀nù
birasili	bìɾàsílì
birikila	bíɾíkìlà
birọ	bíɾɔ̀
bisikiiti	bīsīkíìtì
bode	bōdè
bojuboju	bōdʒúbōdʒú
bolifia	bòlífíà
bora	bóɾā
bora	bōɾā
boya	bójá
buaya	bùájà
buba	bùbá
buburu	búbūɾú
buka	búkà
bukata	bùkátà
bukayọ	bùkájɔ̀
bulausi	búláùsì
bulọọgu	búlɔ́ɔ̀gù
bun	bũ̀
bura	búɾā
burundi	bùɾúŋ́dì
burẹdi	búɾɛ́dì
burẹwa	būɾɛ́wà
burọda	bùɾɔ̀dá
buuru	búúɾú
bẹ	bɛ̀
bẹ	bɛ́
bẹ	bɛ̄
bẹdunjẹ	bɛ́dũ̄dʒɛ̀
bẹlẹjẹ	bɛ̀lɛ̀dʒɛ́
bẹntiroo	bɛ̄ŋ̄tīɾóò
bẹnẹ	bɛ̀nɛ̃̀
bẹri	bɛ́ɾí
bẹru	bɛ̀ɾù
bẹrẹ	bɛ̀ɾɛ̀
bẹrẹ	bɛ̀ɾɛ́
bẹrẹ	bɛ́ɾɛ̀
bẹrẹ	bɛ̄ɾɛ̄
bẹẹ	bɛ́ɛ̀
bẹẹni	bɛ́ɛ̀nĩ̄
bẹẹrẹ	bɛ́ɛ́ɾɛ̀
bọ	bɔ̀
bọ	bɔ́
bọ	bɔ̄
bọbọ	bɔ̀bɔ́
bọdi	bɔ̀dí
bọdi	bɔ́dì
bọgeria	bɔ̀géɾíà
bọkinafaso	bɔ̀kínàfāsò
bọkọtọ	bɔ̀kɔ́tɔ̀
bọn	bɔ̃̄
bọno	bɔ́nò
bọsikọrọ	bɔ́síkɔ̀ɾɔ̀
bọsẹde	bɔ́sɛ̀dé
bọta	bɔ́tà
bọti	bɔ̀tí
bọọlu	bɔ́ɔ̀lù
d	d
d	dí
daadaa	dáādáā
dabaara	dàbáàɾà
dabira	dábíɾà
dada	dàdā
daduro	dádúɾó
dafa	dáfá
dagba	dàgbà
dagbure	dágbūɾē
dahọmi	dàhɔ̀mĩ̀
daji	dádʒì
daju	dádʒú
dakun	dákũ̄
damira	dāmĩ̄ɾā
damọ	dámɔ̃̀
dan	dã́
dan	dã̄
dana	dánã́
dandogo	dàŋ́dógó
dani	dánĩ́
dani	dānĩ̄
danpara	dáŋ̀kpáɾá
dansaaki	dàŋ́sáákì
danwo	dã́wò
danṣiki	dàŋ́ʃíkí
dapada	dákpādà
dara	dáɾà
dara	dáɾā
darandaran	dáɾã̀dáɾã̀
darandaran	dāɾã̄dāɾã̄
dawa	dáwà
dawati	dàwátì
dedere	dèdèɾé
deji	dédʒì
di	dì
di	dí
di	dī
dibo	dìbò
dide	dìdē
difa	dífá
digbolu	dìgbòlù
digbolugi	dìgbòlūgī
digi	dígí
digo	dígò
dilali	dìlálì
din	dĩ́
dindinrin	dĩ̀dĩ̀ɾĩ̀
dinku	dĩ́kù
dipẹta	díkpɛ̄tà
diragoni	díɾágónì
diran	dìɾã̄
dirodiro	dīɾōdīɾō
disai	dìsáì
disu	dísù
diutaronomi	dīūtāɾónómĩ̀
dodo	dòdò
dodo	dòdō
dodo	dódò
dodo	dōdò
dodo	dōdō
dokita	dókítà
dokitaeyin	dókítàējĩ́
dokitaiṣatuntoeyin	dókítàìʃàtṹtòējĩ́
dooje	dòòdʒé
dosunmu	dòsũ̀mṹ
du	dù
du	dú
du	dū
dubulẹ	dùbúlɛ̀
dudu	dúdú
dudubikoroiṣin	dúdúbíkóɾóīʃĩ̄
dukia	dúkìá
dumbu	dúŋ́bú
dun	dũ̀
dun	dṹ
dunaadura	dúꜜnã́dúɾà
dunbioyin	dũ̀bíōjĩ̄
dunbu	dúŋ́bú
dundun	dũ̀dṹ
duniyan	dúnĩ́jã̀
duo	dúó
duro	dúɾó
duuru	dùùɾù
duọọsi	dúɔ́ɔ̀sì
dẹ	dɛ̀
dẹ	dɛ̄
dẹdodẹdo	dɛ̄dòdɛ̄dò
dẹdẹrẹkun	dɛ̀dɛ̀ɾɛ́kʊ̃́
dẹdẹrẹkun	dɛ̀dɛ̀ɾɛ̄kʊ̃̀
dẹn	dɛ̃́
dọ	dɔ̀
dọ	dɔ́
dọbalẹ	dɔ̀bálɛ̀
dọla	dɔ́là
dọti	dɔ̀tí
dọtibiẹlẹdẹ	dɔ̀tíbíɛ̄lɛ́dɛ̀
e	e
e	é
ebibo	èbíbó
ebinpami	ēbīŋ́kpāmĩ́
ebiripo	èbìɾìkpò
ebute	èbúté
ede	èdè
ede	ēdè
ede	ēdé
edeaiyede	èdèàìjēdè
edekoyede	èdèkòjédè
edidu	èdídú
edidun	èdídṹ
edio	ēdīó
eebo	èèbó
eebu	èèbù
eebu	èébú
eedi	èèdì
eedi	éèdì
eedu	èédú
eefi	èéfí
eefin	èéfĩ́
eegbọn	ēégbɔ̃̄
eegunpaari	ēēgũ̄kpááɾì
eeje	ēéꜜdʒē
eeji	ēédʒì
eekan	èèkã̀
eekan	èékã́
eekanna	èékã́nã́
eeku	èèkù
eeku	èèkú
eeku	èēkù
eeku	ēēkū
eekun	ēékṹ
eekẹnna	èékɛ̃́nã́
eela	èélá
eepa	èèkpà
eepa	èékpá
eepa	éèkpà
eepinni	ēékpĩ̀nĩ̀
eera	èèɾà
eeru	èèɾù
eeru	èéɾú
eeru	ēéɾú
eeru	ēēɾū
eetu	èètù
eetu	èètú
eetu	èétú
eewo	ēéwō
eewọ	èèwɔ̀
eeyan	èèjã̀
eeyi	èéjī
efinrin	ēfĩ̄ɾĩ̄
efun	ēfũ̄
egbe	ègbè
egbe	ègbé
egbe	ēgbè
egbe	ēgbé
egbere	ēgbéɾē
egbi	ēgbī
egbigbo	ègbìgbò
egbin	ègbĩ̀
egbin	ègbĩ̄
egbin	ēgbĩ̄
egbodo	ègbōdò
egbogbo	ēgbògbò
egbojo	ègbōdʒò
egbona	ègbónã́
egboogi	ēgbòōgī
ege	ègé
egeirọlẹ	ègéìɾɔ̀lɛ́
eghe	èɣē
eghe	ēɣé
eghighọ	èɣìɣɔ̀
egho	ēɣó
eghoro	ēɣōɾō
egigun	ēgígṹ
egigun	ēgīgũ̄
egue	ēgūè
egun	ègũ̀
egungun	ēgũ̄gũ̄
egungun	ēgṹgṹ
egunyeye	ēgũ̄jējē
egure	ēgūɾè
eguru	ēgúɾù
ehihẹn	èhíhɛ̃́
ehikọ	ēhìkɔ́
ehoro	ēhōɾō
eighọ	èìɣɔ̀
eijẹ	ēídʒɛ̄
eje	èdʒē
eje	ēdʒé
eji	èdʒì
eji	èdʒí
eji	ēdʒī
ejide	èdʒìdé
ejidinlaaadọta	èdʒìdĩ́láꜜádɔ́tā
ejidinlogoji	èdʒìdĩ́lógódʒì
ejidinlogun	èdʒìdĩ́lógṹ
ejidinlọgbọn	èdʒìdĩ́lɔ́gbɔ̃̀
ejidinlọgọta	èdʒìdĩ́lɔ́gɔ́tā
ejigbo	èdʒìgbò
ejijẹ	ēdʒídʒɛ̄
ejika	èdʒìká
ejila	èdʒìlá
ejilelaaadọta	èdʒìléláàádɔ́tā
ejilelogoji	èdʒìlélógódʒì
ejilelogun	èdʒìlélógṹ
ejilelọgbọn	èdʒìlélɔ́gbɔ̃̀
ejiogbe	èdʒìōgbè
ejirẹ	èdʒìɾɛ́
ejitọn	èdʒítɔ̃́
ejo	èdʒó
ejo	ēdʒò
ejoabewerẹ	ēdʒòābéwéɾɛ́
ejoabiruṣoro	ēdʒòābìɾùʃōɾó
ejolọwọninu	ēdʒòlɔ́wɔ́nĩ́nṹ
ejomọnamọna	ēdʒòmɔ̃́nã́mɔ̃́nã́
ejoparamọlẹ	ēdʒòkpāɾāmɔ̃́lɛ̀
ejoṣebe	ēdʒòʃèbé
ejoọka	ēdʒòɔ̄ká
ejoọwun	ēdʒòɔ̀wũ̀
eke	èké
ekeegbe	èkéègbè
ekeji	èkēdʒì
ekikanna	èkíkã́nã́
ekiki	èkīkì
ekikun	ēkíkṹ
ekisa	èkísà
ekiti	èkìtì
ekitiudi	ēkītīùdí
eko	èkó
ekoidẹ	èkóídɛ̄
ekolo	ēkòló
eku	ēkū
ekulu	èkùlù
ekura	ēkūɾá
ekuru	èkūɾū
ekute	èkúté
ekutu	ēkùtù
eledemeji	ēlédèmédʒì
eledua	ēlédùà
eledumare	ēlédùmāɾè
eleduwa	ēlédùwà
elegbede	ēlégbèdè
elegede	ēlégédé
elegeeara	ēléꜜgéàɾà
elegosi	ēlégòsì
elejigbo	ēlédʒìgbò
elekiti	ēlékìtí
elemure	ēlémũ̀ɾé
eleredere	ēléɾēdèɾē
eleruku	ēléɾùkú
eleruuwa	ēléꜜɾúwà
eleuriu	ēléūɾíū
eleṣu	ēléʃù
elija	èlídʒà
elu	èlú
elu	ēlú
elubọ	èlùbɔ́
eluju	èlùdʒù
emi	èmĩ̄
emi	ēmĩ̄
emimi	èmĩ́mĩ́
emirin	ēmĩ́ɾĩ́
emurẹn	èmṹɾɛ̃̀
emurẹn	ēmũ̄ɾɛ̃́
emurẹn	ēmṹɾɛ̃́
eni	ènĩ̀
eni	ènĩ́
eni	ēnĩ́
enini	ènĩ̀nĩ́
enini	ēnĩ̄nĩ̄
eniyan	ènĩ̀jã̀
epe	èkpè
epipa	èkpíkpá
epiya	èkpìjà
epo	èkpò
epo	èkpō
epo	ēkpō
epopupa	ēkpōkpūkpā
eporọbi	ēkpōɾɔ̀bì
ere	èɾè
ere	èɾé
ere	èɾē
ere	ēɾè
ere	ēɾé
eree	ēɾèé
erekuṣu	ēɾékùʃù
erele	èɾèlé
erembo	ēɾèŋ̀bó
ereoriitage	ēɾéōɾíìtàgé
ereoṣupa	ēɾéòʃùkpá
erewun	ēɾéwũ̀
ereṣupa	ēɾéʃùkpá
erigi	èɾìgì
erigi	ēɾìgì
erikọ	ēɾíkɔ̄
erin	ēɾĩ́
erin	ēɾĩ̄
erinlẹ	ēɾĩ̄lɛ̀
erinmi	ēɾĩ̄mĩ̄
erinmilokun	ēɾĩ̄mĩ̄lókũ̄
eriru	ēɾíɾú
erirun	èɾíɾṹ
eriwoyaa	ēɾíwōjàà
ero	èɾó
eroja	èɾòdʒà
erongba	èɾòŋ̀gbà
erukuku	èɾūkùkù
erun	èɾṹ
ese	èsè
ese	èsē
ese	ēsè
ese	ēsé
esi	èsí
esi	ēsì
esi	ēsí
esibi	èsìbí
eso	èsō
esoajara	èsōàdʒàɾà
esuro	èsúɾó
esuru	èsúɾú
esuu	èsúú
ete	ètè
ete	ètē
eteeti	ētēētí
eti	ētí
etido	ētídò
etikun	ētíꜜkũ̄
etitan	ètìtã̀
etito	ètítò
etitu	ètítú
etosayedọkan	ètòsājédɔ̀kã̄
etu	ètú
etu	ētù
etu	ētū
etutu	ètùtù
eu	ēú
eurẹ	ēúɾɛ́
ewe	èwē
ewe	ēwè
ewe	ēwé
ewebẹ	ēwébɛ̀
ewedo	ēwédò
ewedu	ēwédú
eweko	ēwékō
ewelere	ēwéléɾè
ewi	èwí
ewi	ēwì
ewo	èwō
ewu	èwù
ewu	ēwú
ewu	ēwū
ewua	ēwùà
ewuju	ēwúdʒù
ewura	ēwùɾà
ewuro	ēwúꜜɾō
ewurẹ	ēwúɾɛ́
ewọriwọ	èwɔ̀ɾìwɔ̀
eye	èjé
eye	èjē
eyemọtẹ	èjémɔ̃̀tɛ́
eyeye	ējējē
eyi	èjí
eyin	ējĩ́
eyinerin	ējĩ́ēɾĩ̄
eyini	èjīnĩ̀
eyinjija	èjĩ̀dʒìdʒà
eyinọgan	ējĩ́ɔ̀gã̀
eṣi	èʃí
eṣia	éʃíà
eṣinṣin	ēʃĩ̄ʃĩ̄
eṣiṣilọọ	èʃìʃìlɔ́ɔ̀
eṣiṣilọọ	ēʃīʃīlɔ́ɔ̀
eṣu	èʃù
eṣu	ēʃú
eṣubiyii	èʃúbíꜜjí
eṣulaalu	èʃùláàlú
eṣuọdara	èʃùɔ̀dàɾà
f	f
f	fí
faaji	fàádʒì
faara	fááɾà
faari	fáàɾí
fada	fádà
fadaka	fàdákà
fadọrọlemi	fádɔ́ɾɔ̀lémĩ̄
fagunwa	fágṹwà
fajuro	fādʒúɾō
falala	fàlàlà
famu	fàmũ̄
fanadiọmu	fànã́díɔ́mũ̀
fanimọra	fānīmɔ́ɾā
faranse	fāɾāŋ̄sé
farao	fáɾáò
fasiti	fásítì
fawẹli	fáwɛ̀lì
fayawọ	fàjàwɔ́
feeli	féèlì
fere	fèɾè
feregede	fèɾègèdè
ferese	fèɾèsé
fi	fi
fi	fí
fidio	fídíò
fifu	fīfū
figagbaga	fīgāgbágā
fihan	fīhã̀
fiji	fídʒì
fiku	fíkù
fila	fìlà
filẹṣaṣọbora	fīlɛ̀ʃāʃɔ̄bōɾā
fiofio	fíōfíō
fipamunijagun	fīkpámṹnĩ̄dʒāgũ̄
fisiisi	físíìsì
fitami	fítámĩ̀
fitila	fìtílà
fitina	fìtínã̀
fo	fò
fonọlọji	fōnɔ́lɔ́dʒì
foonu	fóònũ̀
forigbalẹ	fōɾígbálɛ̀
forijaleagbọn	fōɾídʒáléāgbɔ̃́
forikori	fōɾíkōɾí
fu	fū
fuku	fùkù
fulani	fúlànĩ́
funfun	fũ̄fũ̄
funkẹ	fṹkɛ́
funsaari	fṹsááɾí
fura	fúɾá
fura	fūɾā
furọ	fùɾɔ̀
fuyẹ	fújɛ́
fẹ	fɛ̀
fẹ	fɛ́
fẹlifẹli	fɛ̄lífɛ̄lì
fẹlifẹli	fɛ̄līfɛ̄lī
fẹnẹsuela	fɛ̄nɛ̄súélà
fẹran	fɛ́ɾã̀
fọ	fɔ̀
fọ	fɔ́
fọfọ	fɔ́fɔ́
fọlawiyọ	fɔ̄láwījɔ́
fọleti	fɔ́létí
fọn	fɔ̃̀
fọn	fɔ̃́
fọn	fɔ̃̄
fọnfọn	fɔ̃̄fɔ̃̄
fọntọnfọntọn	fɔ̃́tɔ̃́fɔ̃́tɔ̃́
fọrọwalẹnuwo	fɔ̀ɾɔ̀wálɛ́nũ̄wò
fọrọwaọrọwolẹnu	fɔ̀ɾɔ̀wáɔ̀ɾɔ̀wòlɛ́nũ̄
fọto	fɔ́tò
fọtosintẹsi	fɔ̄tōsíŋ́tɛ̄sì
g	g
g	gí
ga	gà
ga	gá
ga	gā
gaari	gàáɾì
gaasi	gáàsì
gabasi	gàbāsì
gabiomiran	gābíòmĩ̀ɾã́
gabiọpẹ	gābíɔ̀kpɛ̄
gadagbagadagba	gàdàgbàgādāgbā
gafara	gáfáɾà
gaga	gágà
gambari	gàŋ̀bàɾí
gambia	gáŋ́bíà
gan	gã̀
gan	gã́
gan	gã̄
gana	gánà
ganbia	gáŋ́bíà
gangan	gã́gã̄
ganiyu	gànĩ́jù
garawa	gāɾāwā
gari	gàɾí
gasikia	gàsíkíá
gb	gb
gb	gbì
gba	gbà
gba	gbá
gbaatuu	gbáàtúù
gbaawẹ	gbààwɛ̀
gbadun	gbádũ̀
gbadura	gbàdúɾà
gbagbe	gbàgbé
gbagbọ	gbàgbɔ́
gbagungbagun	gbágũ̄gbàgũ̄
gbagura	gbágùɾá
gbaguuda	gbágùúdá
gbajumọ	gbádʒúmɔ̃́
gbajumọ	gbādʒúmɔ̃̀
gbalaja	gbālādʒā
gbalẹ	gbálɛ̀
gbalẹgbalẹ	gbálɛ̀gbálɛ̀
gbanajẹ	gbānã́dʒɛ̄
gbangba	gbāŋ̄gbā
gbanjo	gbàŋ̀dʒō
gbaradi	gbáɾādì
gbaradi	gbāɾādì
gbaragogo	gbáɾágōgō
gbau	gbàù
gbau	gbáú
gbe	gbè
gbe	gbé
gbeborun	gbébōɾũ̀
gbede	gbédè
gbedegbeyọ	gbédègbéjɔ̀
gbeegun	gbéégṹ
gbeegun	gbéēgũ̄
gbeja	gbèdʒà
gbekurujẹlọwọẹbọra	gbèkūɾūdʒɛ̄lɔ́wɔ́ɛ̄bɔ̄ɾā
gbera	gbéɾā
gberaga	gbéɾāgā
gbese	gbèsè
gbi	gbì
gbigba	gbígbà
gbigba	gbígbá
gbin	gbĩ̀
gbin	gbĩ̄
gbingbin	gbĩ́gbĩ̀
gbingbin	gbĩ́gbĩ̄
gbingbin	gbĩ̄gbĩ̄
gbiyanju	gbìjã̀dʒú
gbo	gbò
gbo	gbó
gbo	gbō
gbogbo	gbōgbō
gboju	gbódʒú
gbolohun	gbólóhũ̀
gbona	gbónã́
gbongbo	gbòŋ̀gbò
gbongbodu	gbōŋ́gbōdú
gborigbo	gbòɾìgbò
gborigbo	gbòɾígbò
gborin	gbóɾĩ́
gborogi	gbòɾògì
gbẹ	gbɛ̀
gbẹ	gbɛ́
gbẹ	gbɛ̄
gbẹdu	gbɛ̀dū
gbẹdẹ	gbɛ̄dɛ̄
gbẹfẹ	gbɛ̀fɛ́
gbẹgbẹrẹ	gbɛ̀gbɛ̀ɾɛ̀
gbẹgiri	gbɛ̀gìɾì
gbẹn	gbɛ̃̀
gbẹnagbẹna	gbɛ́nã̀gbɛ́nã̀
gbẹrun	gbɛ́ɾũ̄
gbẹrẹbi	gbɛ̀ɾɛ̀bí
gbẹrẹfuutu	gbɛ̄ɾɛ̄fúùtù
gbẹsẹle	gbɛ́sɛ̀lé
gbọ	gbɔ́
gbọdọ	gbɔ̄dɔ̀
gbọfungbọfun	gbɔ̀fũ̄gbɔ̀fũ̄
gbọgbẹ	gbɔ̄gbɛ́
gbọkanle	gbɔ́kã̀lé
gbọmọgbọmọ	gbɔ́mɔ̃̄gbɔ́mɔ̃̄
gbọn	gbɔ̃̀
gbọn	gbɔ̃́
gbọngan	gbɔ̃̀gã̀
gbọnmire	gbɔ̃̀mĩ́ɾè
gbọnre	gbɔ̃̀ɾè
gbọrọ	gbɔ̀ɾɔ̀
gbọunjẹ	gbɔ́ṹdʒɛ̄
ge	gé
gede	gēdē
gedegede	gédégédé
geere	gēēɾē
gege	gègé
gele	gèlè
ghan	ɣã́
ghan	ɣã̄
gho	ɣò
ghẹngwa	ɣɛ̃̄gʷà
ghọn	ɣɔ̃̀
ghọn	ɣɔ̃́
ghọn	ɣɔ̃̄
gi	gí
gigisẹ	gìgísɛ̀
giloobu	gílóòbù
gin	gĩ̄
gini	gínì
giraamu	gíɾáàmù
giriisi	gíɾíìsì
girimọkai	gíɾímɔ̃́káì
girimọkayi	gíɾímɔ̃́kájì
gisanrin	gísã̄ɾĩ́
giẹsi	gíɛ́sì
go	gò
go	gō
gogongo	gògòŋ́gò
gogoro	gōgōɾō
goje	gòdʒé
goli	gōlí
golofun	gòlòfũ̄
gomina	gómĩ̀nã̀
gongo	góŋ́gó
goobe	gòòbē
gudugudu	gúdúgúdú
guguru	gúgúɾú
gulegule	gúlēgúlē
gulukoosi	gúlúkóòsì
gun	gũ̀
gun	gũ̄
gun	gṹ
gunugun	gúnũ̄gṹ
gure	gúɾē
guusu	gúúsù
guusuafirika	gúúsùáfíɾíkà
gwẹ	gʷɛ̀
gẹ	gɛ̀
gẹ	gɛ̄
gẹdu	gɛ̄dú
gẹẹsi	gɛ̀ɛ́sì
gọ	gɔ̀
gọ	gɔ̄
gọbi	gɔ̀bì
gọdọgbodo	gɔ̀dɔ̀gbódò
gọgọ	gɔ̀gɔ̀
gọlugọ	gɔ̀lúgɔ̀
gọlọmiṣọ	gɔ̀lɔ̀mĩ̀ʃɔ̀
gọlọmiṣọ	gɔ́lɔ́mĩ́ʃɔ́
gọlọmiṣọ	gɔ̄lɔ̄mĩ̄ʃɔ̄
gọmbọ	gɔ̀ŋ̀bɔ́
gọn	gɔ̃́
gọn	gɔ̃̄
gọnko	gɔ̃́kō
gọta	gɔ́tà
h	h
h	hí
ha	hà
ha	há
ha	hā
habakuku	hábákúkù
halaka	hàlákà
han	hã̀
han	hã́
han	hã̄
hanturu	hã̀túɾú
harafi	háɾàfí
haramu	hàɾámù
haya	hájà
he	hè
he	hē
hewu	hēwú
hi	hí
hilahilo	hílàhílò
ho	hó
horo	hòɾò
horo	hóɾó
horo	hōɾó
horo	hōɾō
horoẹjẹpupa	hóɾóɛ̀dʒɛ̀kpūkpā
hun	hũ̀
hunwa	hũ̄wà
hẹbẹhẹbẹ	hɛ́bɛ́hɛ́bɛ́
hẹlẹhẹlẹ	hɛ̄lɛ̄hɛ̄lɛ̄
hẹngwa	hɛ̃̄gʷà
hẹrimọ	hɛ̀ɾìmɔ̃̀
họ	hɔ̀
họ	hɔ́
họ	hɔ̄
i	i
i	í
iaye	īájé
iba	ìbà
iba	ìbá
iba	ìbā
iba	ībà
iba	ībá
iba	ībā
ibaada	ìbáádà
ibaaka	ìbàákà
ibaaka	ìbáákà
ibaaka	ìbāākā
ibaba	ībābā
ibadan	ìbàdã̀
ibadi	ìbàdí
ibakasiẹ	ìbákāsíɛ̄
ibakasiẹ	ìbākāsíɛ̄
ibale	ìbálé
ibaluwẹ	ībālùwɛ̀
ibantẹ	ìbàŋ̀tɛ́
ibanujẹ	ìbànṹdʒɛ́
ibarapa	ìbàɾàkpá
ibatiyan	ìbàtíjã̀
ibeere	ìbèèɾè
ibeere	ìbéèɾè
ibeji	ìbēdʒì
ibi	ìbì
ibi	ìbí
ibi	ìbī
ibi	ībí
ibi	ībī
ibidun	ìbídũ̀
ibidunmoye	ìbídũ̀mójè
ibikibi	ībīkíbī
ibilẹ	ìbílɛ̀
ibinu	ìbínṹ
ibo	ìbò
ibo	ìbó
iboji	ībòdʒī
iboji	ībódʒì
iboji	ībōdʒì
ibomii	ībòmĩ́ĩ̀
ibomiran	ībòmĩ́ɾã̀
ibuji	ìbūdʒì
ibukun	ìbùkṹ
ibunu	ìbùnṹ
ibusun	ībùsũ̀
ibẹpẹ	ìbɛ́kpɛ̄
ibẹrẹ	ìbɛ̀ɾɛ̀
ibọlọ	ìbɔ̀lɔ́
ibọn	ìbɔ̃̄
ibọn	ībɔ̃́
ibọnagba	ìbɔ̃̄àgbá
ibọnagbelejika	ìbɔ̃̄àgbélédʒìká
ibọnjagamu	ìbɔ̃̄dʒāgāmũ̀
ibọnyin	ìbɔ̃́jĩ̀
ibọsẹ	ìbɔ̀sɛ̀
ibọwọ	ìbɔ̀wɔ̀
ibọwọ	ìbɔ̀wɔ́
ida	ìdá
ida	ìdā
ida	īdà
idaaṣa	īdàáʃà
idae	ìdàé
idagbaroke	ìdàgbàɾókè
idagbasoke	ìdàgbàsókè
idahun	ìdáhũ̀
idaji	ìdádʒí
idaji	ìdādʒì
idalẹ	ìdálɛ̀
idameje	ìdáméꜜdʒē
idamẹfa	ìdámɛ́fà
idamẹjọ	ìdámɛ́ꜜdʒɔ̄
idamẹwaa	ìdámɛ́ꜜwá
idanilẹkọọ	ìdánĩ̄lɛ́ꜜkɔ́
idanimọ	ìdánĩ̄mɔ̃̀
idanre	ìdã̀ɾè
idanwo	ìdã́wò
idarin	ìdāꜜɾĩ̄
idata	ìdāꜜtā
ideegbe	ìdéègbè
ideregbe	ìdéɾègbè
idi	ìdì
idi	ìdí
idi	īdì
idi	īdí
idigbo	īdígbó
idije	ìdíꜜdʒē
idiku	ìdīkù
idile	ìdílé
idimu	ìdīmṹ
idimulẹ	īdìmṹlɛ̀
idimulẹawujọ	ìdìmṹlɛ̀àwùdʒɔ̄
idiofoonu	īdíófóònù
idodo	īdōdō
idogbe	ìdògbé
idoha	ìdòhá
idowu	ìdòwú
idunaadura	ìdúnã̀ã́dúɾà
idẹ	īdɛ̄
idẹjọ	ìdɛ̀dʒɔ̄
idọbalẹ	ìdɔ̀bálɛ̀
idọti	ìdɔ̀tí
iere	īèɾè
ifa	ìfà
ifa	īfá
ifa	ɪ̄fá
ifaara	ìfááɾà
ifabunmi	īfábũ̀mĩ̄
ifadiran	īfádìɾã̄
ifadọrọlemi	ɪ̄fádɔ́ɾɔ̀lémĩ̄
ifajẹmileyin	īfádʒɛ́mĩ̄léjĩ̀
ifalaye	īfáàlájè
ifalọọrọ	īfálɔ̀ɔ́ɾɔ̀
ifalọọọrọ	īfálɔ́ɔ̀ɔ́ɾɔ̀
ifamakinde	īfámákĩ̄dé
ifamimikomi	īfámĩ́mĩ́kòmĩ́
ifamugbẹẹ	īfámũ̀gbàɛ́
ifasiti	īfásītì
ifatumikẹ	ɪ́fátúmĩ̄kɛ́
ifayẹmi	īfájɛ̄mĩ̄
ife	īfē
ifirosinroojẹ	ìfìɾósĩ́ɾòódʒɛ̄
ifiwawẹda	ìfìwàwɛ̀dá
ifo	ìfò
ifo	īfō
ifohunpeniyan	ìfōhũ̄kpènĩ̀jã̀
iforiti	ìfōɾítì
ifun	ìfũ̄
ifura	ìfūɾā
ifẹ	ìfɛ́
ifẹ	īfɛ̀
ifẹhonuhan	ìfɛ̀hónṹhã̀
ifẹyinti	ìfɛ̀jĩ̀tì
ifọ	īfɔ̀
ifọn	īfɔ̃́
ifọrọdara	ìfɔ̀ɾɔ̀dáɾà
ifọrọwanilẹnuwo	ìfɔ̀ɾɔ̀wánĩ̄lɛ́nũ̄wò
ifọrọwero	ìfɔ̀ɾɔ̀wéɾò
ifọwọsowọpọ	ìfɔ̄wɔ́sōwɔ́kpɔ̀
iga	ìgà
igake	ìgàkè
igake	ìgákè
igala	ìgálà
igala	ìgālà
igala	īgálà
igangan	ìgã́gã́
iganna	ìgã̀nã́
igara	ìgáɾá
igba	ìgbà
igba	ìgbá
igba	īgbà
igba	īgbá
igba	īgbā
igbabọọlu	ìgbábɔ́ɔ̀lù
igbado	ìgbàdō
igbadun	ìgbádũ̀
igbafẹ	ìgbāfɛ́
igbagba	ìgbàgbá
igbagbọ	ìgbàgbɔ́
igbala	ìgbàlà
igbalẹ	ìgbàlɛ̀
igbalẹ	ìgbálɛ̀
igbaradi	ìgbáɾādì
igbaroko	ìgbāɾòkó
igbaweremẹsin	ìgbàwèɾèmɛ́sĩ̀
igbayẹkẹtẹ	ìgbájɛ̀kɛ̀tɛ̀
igbe	ìgbé
igbe	īgbē
igbegbeleju	ìgbègbèlédʒú
igbekun	ìgbèkũ̀
igbelarugẹ	ìgbéláɾūgɛ̄
igberaga	ìgbéɾāgā
igberiko	ìgbèɾíkō
igbese	īgbèsè
igbesẹ	ìgbésɛ̀
igbeyawo	ìgbéjàwó
igbi	ìgbì
igbin	ìgbĩ̀
igbin	ìgbĩ́
igbio	īgbīó
igbiwo	īgbīwó
igbo	ìgbò
igbo	ìgbó
igbo	īgbó
igbo	īgbō
igbokijikiji	īgbókìdʒīkìdʒī
igbomina	ìgbómĩ̀nã̀
igboya	ìgbójà
igbẹ	ìgbɛ́
igbọnwọ	ìgbɔ̃̀wɔ́
igbọnwọ	ìgbɔ̃̄wɔ́
ige	ìgè
igede	ìgèdè
igere	ìgèɾè
ighaghe	ìɣáɣè
igi	īgī
igiiwe	īgīìwé
igisanrin	īgísã̄ɾĩ́
igo	ìgò
igodan	ìgòdã̄
igun	īgṹ
igunpa	ìgṹkpá
igọ	ìgɔ̀
igọ	ìgɔ́
igọ	ìgɔ̄
igọ	īgɔ̀
igọn	īgɔ̃́
ihinrere	ìhĩ̀ɾēɾē
iho	īhò
ihoho	ìhòhò
ija	ìdʒā
ijabẹ	ìdʒábɛ̀
ijaka	ìdʒàká
ijakadi	ìdʒàkādì
ijakariwọ	ìdʒàkáɾìwɔ̀
ijakumọ	ìdʒàkùmɔ̃̀
ijala	ìdʒálá
ijalọ	ìdʒàlɔ̄
ijanu	ìdʒánũ̄
ijapa	ìdʒàkpá
ijapaokun	ìdʒàkpáòkũ̄
ijaye	ìdʒàjè
ijibiti	ídʒíbítì
ijimere	ìdʒímèɾè
ijinlẹ	ìdʒĩ̀lɛ̀
ijinlẹ	ìdʒĩ̄lɛ̀
ijiroro	ìdʒíɾòɾò
ijo	īdʒó
ijokoo	ìdʒókòó
iju	ìdʒū
iju	īdʒù
ijumu	ìdʒùmṹ
ijẹbu	ìdʒɛ̀bú
ijẹgun	ìdʒɛ̄gṹ
ijẹlu	ìdʒɛ̀lú
ijẹrẹ	ìdʒɛ́ɾɛ́
ijẹta	ìdʒɛ́tā
ijẹta	ìdʒɛ̄tā
ijẹṣa	ìdʒɛ̀ʃà
ijẹṣu	ìdʒɛ̄ʃū
ijọ	ìdʒɔ̄
ijọ	īdʒɔ́
ijọba	ìdʒɔ̄bā
ijọbaalagbada	ìdʒɔ̄bāālágbádá
ijọbaamunisin	ìdʒɔ̄bāāmṹnĩ̄sĩ̀
ijọbaibilẹ	ìdʒɔ̄bāìbílɛ̀
ika	ìkà
ika	ìká
ika	ìkā
ikaifabẹla	ìkāìfábɛ̀lá
ikalẹ	ìkálɛ̀
ikan	īkã́
ikaniyan	ìkànĩ̀jã̀
ikara	ɪ̀kàɾà
ikarahun	ìkāɾāhũ̄
ikarawun	ìkāɾāwũ̄
ikasẹ	ìkāsɛ̀
ikata	īkàtà
ike	ìké
ike	īké
ike	īkē
ikebe	ìkébè
ikede	ìkéꜜdē
iki	īkì
ikin	īkĩ́
ikin	īkĩ̄
ikiribojo	ìkìɾìbòdʒò
ikoidẹ	ìkóídɛ̄
ikoko	ìkòkò
ikolẹ	ìkólɛ̀
ikooko	ìkōōkò
ikoriko	ìkòɾīkò
ikorodu	ìkòɾòdú
iku	īkú
ikun	ìkũ̀
ikun	ìkṹ
ikun	īkũ̀
ikun	īkũ̄
ikun	īkṹ
ikunlẹ	ìkṹlɛ̀
ikuukuu	ìkùūkùū
ikuukuu	ìkúūkùū
ikẹgan	ìkɛ́gã̀
ikẹja	ìkɛ̄dʒà
ikẹnnẹ	ìkɛ̃́nɛ́
ikọ	īkɔ̀
ikọ	īkɔ́
ikọkọrẹ	ìkɔ́kɔ̄ɾɛ́
ikọla	ìkɔ̄là
ikọta	ìkɔ̄tā
ila	ìlà
ila	īlá
ilaburu	ìlábùɾù
ilajẹ	ìlàdʒɛ̄
ilakaka	ìlàkàkà
ilakọṣẹ	ìlákɔ̀ʃɛ̄
ilara	ìláɾá
ilari	ìlàɾí
ile	īlé
ileawoṣifila	īléàwòʃífìlà
ileaye	īléājé
ileelẹ	īléēlɛ̀
ileeṣẹ	īléēʃɛ́
ilegogoro	īlégōgōɾō
ileifowopamọ	īléìfōwókpāmɔ̃́
ileikawe	īléìkàwé
ileiwosan	īléìwòsã̀
ilekewu	īlékéwú
ilekikọ	īlékíkɔ́
ilekile	īlékílé
ileoyin	īléōjĩ̄
ilera	ìlēɾā
ileri	ìléɾí
ileya	īléjá
ileṣa	īléʃà
ileẹjọ	īléɛ̄dʒɔ́
ileẹjọkotẹmilọrun	īléɛ̄dʒɔ́kòtɛ́mĩ̄lɔ́ɾũ̀
ileẹkọ	īléɛ̀kɔ́
ileẹyẹ	īléɛ̄jɛ̄
ileọba	īléɔ̄bā
ileọkọ	īléɔ̄kɔ̄
ileọmọ	īléɔ̄mɔ̃̄
ilomiafẹfẹ	ìlómĩ̄āfɛ́fɛ́
iloro	ìlōɾō
ilu	ìlù
ilu	ìlú
ilumoye	ìlúmōjè
ilumọọka	ìlúmɔ̃̀ɔ̃́ká
ilẹ	īlɛ̀
ilẹadulawọ	īlɛ̀ādúláwɔ̀
ilẹaye	īlɛ̀ājé
ilẹkun	ìlɛ̀kũ̀
ilẹkun	īlɛ̀kũ̀
ilẹkẹ	ìlɛ̀kɛ̀
ilọri	ìlɔ̀ɾí
ilọrin	ìlɔ̄ɾĩ̄
ilọsiwaju	ìlɔ̄síwádʒú
ilọwọọrọ	ìlɔ́wɔ́ɔ́ɾɔ́
imado	ìmàdò
imale	ìmàlē
imeeli	ímēèlì
imi	ìmĩ̀
imi	ìmĩ́
imi	īmĩ́
imisi	ìmĩ́sí
imo	ímò
imu	īmṹ
imọ	ìmɔ̃̀
imọ	īmɔ̃̀
imọajakalẹarun	ìmɔ̃̀àdʒàkálɛ̀àɾũ̀
imọaruneweko	ìmɔ̃̀àɾũ̀ēwékō
imọijinlẹ	ìmɔ̃̀ìdʒĩ̀lɛ̀
imọiṣegun	ìmɔ̃̀ìʃègũ̀
imọiṣiro	ìmɔ̃̀ìʃīɾò
imọiṣẹẹrọ	ìmɔ̃̀īʃɛ́ɛ̀ɾɔ̄
imọlara	ìmɔ̃̀láɾā
imọle	ìmɔ̃̀lē
imọlẹ	ìmɔ̃́lɛ̀
imọlẹ	īmɔ̃̄lɛ̀
imọnipaẹdaeniyan	ìmɔ̃̀nĩ́kpāɛ̀dáènĩ̀jã̀
imọran	ìmɔ̃̀ɾã̀
imọsayẹnsi	ìmɔ̃̀sájɛ́ŋ̀sì
imọẹrọ	ìmɔ̃̀ɛ̀ɾɔ̄
ina	ìnã̀
ina	ìnã́
ina	ìnã̄
ina	īnã́
inagijẹ	ìnã̄gīdʒɛ̄
inaki	ìnã̀kí
indomi	íŋ́dómì
indoneṣia	īŋ̄dōnéʃíà
innsi	ĩ́ŋ̀sì
innsi	ĩ́ŋ́sì
intanẹẹti	íŋ́tánɛ́ɛ̀tì
intanẹẹti	ĩ́tánɛ́ɛ̀tì
inu	īnṹ
inṣere	ĩ̄ʃēɾē
inọki	ìnɔ̀kí
io	īó
io	īɣó
iorio	ìòɾìò
ipade	ìkpàdé
ipagborun	ìkpāgbóɾũ̄
ipakoto	ìkpákòtò
ipakọ	ìkpàkɔ́
ipalara	ìkpāláɾā
ipapoda	ìkpākpòdà
ipata	ìkpátá
ipatẹwọ	ìkpàtɛ́wɔ́
ipebi	ìkpèbí
ipekere	ìkpékēɾé
ipenija	ìkpènĩ́dʒà
ipenpeju	ìkpéŋ̀kpédʒú
ipilẹṣẹ	ìkpīlɛ̀ʃɛ̀
ipin	ìkpĩ́
ipinlẹ	ìkpĩ́lɛ̀
ipinnu	ìkpĩ̄nũ̄
ipinya	ìkpĩ́jà
ipinṣa	ìkpĩ̄ʃà
ipogun	ìkpōgũ̄
ipolongo	ìkpōlōŋ̄gō
ipolowo	ìkpōlówó
ipẹ	ìkpɛ́
ipẹjalapaju	ìkpɛ̄dʒāláꜜkpādʒù
ipẹta	ìkpɛ̀tā
ipẹta	ìkpɛ̄tà
ipẹyarun	ìkpɛ̀jàɾũ̄
ipọn	ìkpɔ̃̄
ipọn	īkpɔ̃̄
ipọnju	ìkpɔ̃́dʒú
ira	ìɾà
ira	ìɾá
ira	ìɾā
ira	īɾà
ira	īɾá
iraaki	ìɾáàkì
iraani	ìɾáànì
iragbiji	ìɾágbìdʒí
iragbiji	ìɾágbìdʒī
irakunnugba	ìɾákũ̀nũ̀gbá
iranlọwọ	ìɾã̀lɔ́wɔ́
iranti	ìɾã́tí
irawọ	ìɾàwɔ̀
irawọoniru	ìɾàwɔ̀ōnĩ́ɾù
ire	ìɾè
ire	ìɾé
ire	ìɾē
ire	īɾè
ire	īɾé
ire	īɾē
ireke	ìɾèké
irekọja	ìɾékɔ̄dʒá
iremọje	ìɾèmɔ̃̀dʒé
irere	ìɾèɾé
ireti	ìɾètí
iri	ìɾì
iri	ìꜜɾí
irin	ìɾĩ̀
irin	īɾĩ̄
irinajo	ìɾĩ̀àdʒò
irinkerindo	ìɾĩ̀kèɾĩ̄dò
irinwo	īɾĩ̄wó
irinṣẹ	īɾĩ̄ʃɛ́
iro	ìɾò
iro	ìɾó
iro	ìɾō
iro	īɾò
iro	īɾō
iroko	ìɾókò
ironupiwada	ìɾònṹkpìwàdà
irosun	ìɾòsũ̀
irosun	ìɾōsũ̀
iroyin	ìɾòjĩ̀
iroyinogunkiitan	ìɾòjĩ̀ōgũ̄kìítã́
iroyinẹlẹjẹ	ìɾòjĩ̀ɛ̄lɛ́dʒɛ̀
iru	ìɾù
iru	ìɾú
iru	īɾù
iru	īɾú
irukẹrẹ	ìɾùkɛ̀ɾɛ̀
irun	ìɾũ̄
irun	īɾũ̄
irungbọn	īɾũ̀gbɔ̃̀
irunkirun	īɾũ̄kíɾũ̄
irunmarugbo	ìɾũ̀màɾúgbó
irunmọlẹ	īɾṹmɔ̃̄lɛ̀
irunoju	īɾũ̄ōdʒú
irẹ	ìɾɛ̀
irẹlẹ	ìɾɛ̀lɛ̀
irẹpọ	ìɾɛ́kpɔ̀
irẹsi	ìɾɛ̄sì
irẹtẹ	ìɾɛ̀tɛ̀
irẹtẹ	ìɾɛ̄tɛ̀
irọ	īɾɔ́
irọkẹ	ìɾɔ́kɛ́
irọlẹ	ìɾɔ̀lɛ́
irọri	ìɾɔ̀ɾí
isa	īsà
isaaro	ìsààɾó
isaba	ìsābà
isalẹ	ìsàlɛ̀
isansa	ìsáŋ̀sá
isi	ìsí
isiaka	īsíákà
isiisan	īsīīsã́
isikiẹli	ìsíkíɛ́lì
isinku	ìsĩ̀kú
isinmi	ìsĩ̄mĩ̄
isirẹli	ísíɾɛ́lì
isobo	ìsòbò
isu	īsū
isẹ	īsɛ̀
isẹse	ìsɛ̀sē
isọ	ìsɔ̀
isọ	ìsɔ́
isọ	ìsɔ̄
ita	ìtā
ita	ītā
itadogun	ìtàdógṹ
itagbe	ìtágbè
itage	ìtàgé
itali	ítálì
itan	ìtã̀
itan	ìtã̄
itan	ītã̄
itanna	ìtã̀nã́
itanna	ìtã̄nã́
itawe	ìtàwé
iti	ìtì
itiopia	ìtíókpíà
itori	ìtōɾī
itosi	ìtòsí
itẹjade	ìtɛ̀dʒádē
itẹle	ìtɛ̀lé
itẹlọrun	ìtɛ́lɔ́ɾũ̀
itọ	ìtɔ̀
itọ	ītɔ́
itọṣuga	ìtɔ̀ʃúgà
iwa	ìwà
iwaju	īwádʒú
iwan	īwã́
iwarẹ	ìwàɾɛ̄
iwarẹfa	ìwàɾɛ̀fà
iwe	ìwé
iwe	īwē
iweagberoyinjade	ìwéāgbéɾòjĩ̀dʒádē
iweiroyin	ìwéìɾòjĩ̀
iwere	īwèɾè
iwewee	ìwéwèé
iwi	īwì
iwin	īwĩ́
iwin	īwĩ̄
iwo	ìwō
iwori	ìwòɾì
iworiwo	ìwòɾìwò
iwoyi	ìwòꜜjí
iwu	īwú
iwure	ìwúɾē
iwuri	ìwúɾí
iwuye	ìwújè
iwẹ	ìwɛ̀
iwẹ	ìwɛ́
iwẹfa	ìwɛ̀fà
iwọ	ìwɔ́
iwọ	ìwɔ̄
iwọ	īwɔ̀
iwọ	īwɔ̄
iwọde	ìwɔ́ꜜdē
iwọntunwọnsi	ìwɔ̃̀tṹwɔ̃̀sì
iwọpopo	ìwɔ̄kpókpó
iwọriwọ	ìwɔ̀ɾìwɔ̀
iwọrọku	ìwɔ́ɾɔ́kù
iya	ìjà
iya	ìjá
iyaalu	ìjáàlù
iyadudu	ìjàdúdú
iyagba	ìjàgbà
iyaloriṣa	ìjálóɾìʃà
iyalẹnu	ìjàlɛ́nũ̄
iyalẹta	ìjálɛ̀tā
iyamioṣoronga	ìjàmĩ̄òʃòɾòŋ̀gà
iyamioṣoronga	ìjámĩ̄òʃòɾòŋ̀gà
iyamọpọ	ìjámɔ̃̀kpɔ́
iyan	ìjã̀
iyan	ījã̀
iyan	ījã́
iyanda	ìjã̀dá
iyanga	ìjã̀gā
iyanifa	ìjánĩ́fá
iyanrin	ījã̄ɾĩ̀
iyara	ījàɾá
iyawo	ìjàwó
iye	ìjè
iye	ījè
iye	ījē
iyekan	ījèkã̄
iyemeji	ījèmédʒì
iyeye	ījējē
iyooku	ìjòókù
iyun	ījũ̀
iyẹ	ìjɛ́
iyẹfun	ìjɛ̀fũ̄
iyẹn	ìjɛ̃̀
iyẹn	ìjɛ̃̄
iyẹrosun	ìjɛ̀ɾòsũ̀
iyẹrẹifa	ìjɛ̀ɾɛ̀īfá
iyẹwu	ìjɛ̀wù
iyọ	ìjɔ̄
iyọ	ījɔ̀
iyọba	ījɔ̄bā
iyọnda	ìjɔ̀ŋ̀dā
iyọoyinbo	ījɔ̀òjĩ̀bó
iṣa	ìʃà
iṣakọlẹ	ìʃákɔ́lɛ̀
iṣan	īʃã̄
iṣana	īʃánã́
iṣapa	ìʃákpá
iṣarun	ìʃàɾũ̄
iṣasun	ìʃāsũ̀
iṣatunto	ìʃàtṹtò
iṣawuru	ìʃáwùɾú
iṣe	ìʃē
iṣegbefabo	ìʃègbèfábō
iṣelu	ìʃèlú
iṣikanrin	ìʃíkã̄ɾĩ́
iṣikinrin	ìʃíkĩ̄ɾĩ́
iṣile	ìʃílé
iṣin	īʃĩ̄
iṣirun	ìʃíɾũ̄
iṣo	ìʃó
iṣoro	ìʃòɾō
iṣu	īʃū
iṣupo	ìʃúkpó
iṣura	ìʃúɾā
iṣẹ	ìʃɛ̀
iṣẹ	ìʃɛ́
iṣẹ	īʃɛ́
iṣẹamurele	īʃɛ́àmṹɾēlé
iṣẹda	ìʃɛ̀dà
iṣẹda	ìʃɛ̀dá
iṣẹju	ìʃɛ́dʒú
iṣẹkulumọ	ìʃɛ́kùlùmɔ̃́
iṣẹlẹ	ìʃɛ̀lɛ̀
iṣẹnbaye	ìʃɛ̀ŋ̀bájé
iṣẹtọfabo	ìʃɛ̀tɔ́fábō
iṣẹṣe	ìʃɛ̀ʃē
iṣọla	ìʃɔ̀lá
iẹsi	ìɛ̄sì
j	dʒ
j	dʒí
ja	dʒà
ja	dʒá
jaa	dʒáà
jade	dʒáꜜdē
jadelaye	dʒádēlájé
jaguda	dʒàgùdà
jagunjagun	dʒāgũ̄dʒāgũ̄
jalumi	dʒálūmĩ̄
jamani	dʒámánĩ̀
jamba	dʒàŋ̀bá
jameika	dʒàméíkà
jan	dʒã̀
jangiroba	dʒāŋ̄gīɾóbà
janjan	dʒã̄dʒã̄
jankariwọ	dʒàŋ̀káɾìwɔ̀
janmọọ	dʒã̀mɔ̃́ɔ̃̀
japa	dʒákpā
jawojawo	dʒáwódʒáwó
jaye	dʒājé
jeburẹawoolugbẹbẹ	dʒèbùɾɛ́àwōōlùgbɛ́bɛ̀
jepaani	dʒèkpáànĩ̀
jere	dʒèɾè
jero	dʒéɾó
jesu	dʒésù
ji	dʒì
ji	dʒí
ji	dʒī
jibiti	dʒìbìtì
jiga	dʒìgá
jiga	dʒígà
jigijigi	dʒìgìdʒìgì
jijẹ	dʒídʒɛ̄
jimọ	dʒímɔ̃̀
jimọh	dʒímɔ̃̀
jin	dʒĩ̀
jinki	dʒíŋ̀kí
jinna	dʒĩ̀nã̀
jiroro	dʒíɾòɾò
jiya	dʒìjà
jiyan	dʒījã̀
jiyan	dʒījã́
jo	dʒò
jo	dʒó
jobiokoto	dʒóbíòkòtó
joko	dʒòkó
jokoo	dʒóꜜkó
jokujoku	dʒòkúdʒòkú
jomijoke	dʒōmĩ̄dʒòkè
joṣua	dʒóʃúà
ju	dʒù
juba	dʒúbà
jubaehoro	dʒúbàēhōɾō
jẹ	dʒɛ́
jẹ	dʒɛ̄
jẹagbọnrineṣilọbẹ	dʒɛ̄àgbɔ̃̀ɾĩ́èʃílɔ́bɛ̀
jẹbutu	dʒɛ̀bùtù
jẹgun	dʒɛ̄gũ̄
jẹjẹrẹ	dʒɛ̄dʒɛ̄ɾɛ̄
jẹleosinmi	dʒɛ́léósĩ̄mĩ̄
jẹlesinmi	dʒɛ́lésĩ̄mĩ̄
jẹn	dʒɛ̃̀
jẹnnọ	dʒɛ̃̀nɔ̀
jẹnẹretọ	dʒɛ̄nɛ̄ɾétɔ̀
jẹnẹsisi	dʒɛ́nɛ́sísì
jẹrun	dʒɛ̄ɾũ̄
jẹun	dʒɛ̄ũ̄
jẹunsapo	dʒɛ̄ũ̄sákpò
jẹunsoke	dʒɛ̄ũ̄sókè
jẹwọ	dʒɛ̀wɔ̀
jẹwọ	dʒɛ́wɔ́
jẹwọ	dʒɛ̄wɔ̀
jọ	dʒɔ̀
jọ	dʒɔ̄
jọdani	dʒɔ́dánì
jọjia	dʒɔ́dʒíà
k	k
k	kí
ka	kà
ka	ká
kaa	káà
kaaarọ	káꜜáɾɔ̀
kaaba	káàbá
kaabọ	káàbɔ̀
kaadi	káàdì
kaadiiranti	káàdììɾã́tí
kaadipupa	káàdìkpūkpā
kaakiri	káàkīɾī
kaalẹ	káālɛ́
kaasan	káꜜsã́
kaaya	káájá
kabaamọ	kábàámɔ̃̀
kabeeji	kábéèdʒì
kabiyesi	kábíjèsí
kabukabu	kābúkābú
kadara	kádàɾá
kaduna	kàdúnã́
kafeeni	kāféènì
kaibi	kàíbī
kaju	kādʒú
kaka	kàkà
kakaki	kàkàkí
kakanda	kàkàŋ̀dá
kakiri	kákīɾī
kakulọọsi	kákúlɔ́ɔ̀sì
kalaba	kàlàbā
kalamu	kálàmũ̀
kalolo	kálòlò
kalori	kálóɾì
kamẹra	kámɛ́ɾà
kamẹruunu	kāmɛ̄ɾúùnũ̀
kan	kã̀
kan	kã́
kan	ꜜkã̄
kanada	kánádà
kanafuru	kànã́fùɾù
kanbodia	kàŋ̀bódíà
kanga	kã̀gā
kanka	kàŋ̀kà
kankere	kã̄kéɾé
kannafuru	kã̀nã́fùɾù
kannago	kã̀nã̀gó
kannakanna	kã̄nã̄kã́nã́
kannango	kã̀nã̀ŋ̀gó
kano	kánò
kanwun	kã́wṹ
karakata	káɾàkátà
karaole	káɾāólē
kare	káɾē
kari	kàɾí
karibi	kàɾíbī
karibikuọtia	kàɾíbīkúɔ̄tīā
karuwa	káɾùwà
karịgbị	kàrɪ̀gbɪ̀
karọọti	káɾɔ́ɔ̀tì
kasimu	kàsímũ̀
katakata	kātākātā
katidira	kàtídíɾà
kayeefi	kàjééfì
ke	kè
ke	ké
kede	kéꜜdē
kedere	kēdēɾē
keeki	kéèkì
keferi	kèfèɾí
keje	kēdʒē
keji	kēdʒì
kekere	kékēɾé
kere	kéɾé
keresimesi	kéɾésìmēsì
kereyọọnu	kēɾējɔ́ɔ̀nũ̀
kete	kētē
ketu	kétū
kewu	kéwú
ki	kì
ki	kí
ki	kī
kii	kíì
kiini	ꜜkínĩ́
kiini	ꜜkĩ́nĩ́
kijipa	kídʒìkpá
kilaasi	kíláàsì
kilogiraamu	kìlógíɾáàmù
kilomita	kìlómítà
kilorofi	kīlōɾōfí
kilọ	kìlɔ̀
kindinrin	kĩ́dĩ̀ɾĩ́
kini	kínĩ̄
kiniun	kìnĩ̀ṹ
kinkinrinmiyin	kĩ̀kĩ̀ɾĩ́mĩ̄jĩ́
kinniun	kĩ̀nĩ̀ṹ
kiribati	kīɾībátì
kirisẹndọmu	kīɾīsɛ́ŋ́dɔ̀mũ̀
kita	kítà
kitipa	kítíkpā
kitipi	kītīkpī
kiweje	kíwēdʒē
ko	kò
ko	kó
ko	kō
koda	kódà
kofoworọla	kòfōwóɾɔ̄lá
kogbawọle	kógbáwɔ̄lé
kogi	kōgí
kokeeni	kōkéènì
koko	kòkò
koko	kòkó
koko	kókò
koko	kókó
kokodia	kòkódìà
kokondo	kòkòŋ̀dó
kokoro	kòkòɾò
kokoro	kókóɾó
kokoroarun	kòkòɾòàɾũ̀
kokoye	kōkōjé
kolekole	kólékólé
kolekole	kólēkólē
kolo	kóló
kololo	kólòlò
kolonbia	kòlóŋ́bíà
kolẹ	kólɛ̀
kolẹkolẹ	kólɛ̀kólɛ̀
komookun	kòmóòkũ̄
kondo	kóŋ́dó
konkoto	kóŋ̀kótō
koo	kóò
kooki	kóòkì
kooko	kōókō
kori	kóɾì
koriko	kòɾīkò
koriko	kōɾíkō
korikoto	kóɾìkótō
koro	kòɾó
koro	kóɾó
koro	kōɾò
koroba	kōɾōbá
korobiewuro	kōɾòbíēwúꜜɾō
korona	kòɾónà
koso	kòsō
kosofo	kòsófò
kosofo	kósófò
kotọpẹ	kòtɔ́kpɛ́
kowee	kōwéè
ku	kù
ku	kú
kuba	kúbà
kuewuọmọ	kúēwūɔ̄mɔ̃̄
kuki	kúkì
kukunduku	kúkúŋ̀dùkú
kulikuli	kúlíkúlí
kulusọ	kúlúsɔ̄
kumọ	kùmɔ̃̀
kuna	kùnã̀
kunle	kṹlé
kunlekunle	kũ̄lékũ̄lé
kunlẹ	kṹlɛ̀
kunrungbịngbịn	kũ̀ɾũ̀gbɪ̃́gbɪ̃́
kura	kùɾà
kura	kúɾà
kura	kúɾá
kura	kúɾā
kurekure	kúɾékùɾé
kuro	kúɾò
kuromiọmu	kúɾómĩ́ɔ̃̀mũ̀
kuru	kúɾú
kurubikukute	kúɾúbíkùkùté
kurukuru	kùɾūkùɾū
kusa	kùsà
kuti	kútì
kutukutu	kùtùkùtù
kutọnu	kútɔ̄nũ̄
kuudaro	kúùdáɾò
kuujokoo	kúùdʒókòó
kuukalẹ	kúùkàlɛ̀
kuukunra	kúùkṹɾā
kuule	kúūlé
kuurọju	kúùɾɔ́dʒú
kuurọlẹ	kúùɾɔ̀lɛ́
kuuyalẹta	kúùjálɛ̀tā
kuuṣẹ	kúūʃɛ́
kuwara	kúwáɾà
kuẹrụbọ	kúɛ̀ɾʊ̀bɔ̀
kuọdunkeresimesi	kúɔ̄dṹkéɾésìmēsì
kuọduntuntun	kúɔ̄dṹtũ̄tũ̄
kuọjọmẹta	kúɔ̄dʒɔ́mɛ́tā
kẹfa	kɛ̄fà
kẹhinde	kɛ́jĩ̀dé
kẹhinde	kɛ́ĩ̀dé
kẹjọ	kɛ̄dʒɔ̄
kẹkẹ	kɛ̀kɛ̀
kẹkẹ	kɛ̀kɛ́
kẹkẹ	kɛ́kɛ́
kẹkẹ	kɛ̄kɛ̄
kẹkọọ	kɛ́ꜜkɔ́
kẹmisiri	kɛ́mĩ́síɾì
kẹnya	kɛ́ŋ́jà
kẹrin	kɛ̄ɾĩ̄
kẹsẹ	kɛ́sɛ́
kẹta	kɛ̄tā
kẹturu	kɛ́tùɾù
kẹtẹkẹtẹ	kɛ́tɛ́kɛ́tɛ́
kẹwaa	kɛ̄ꜜwá
kẹyinde	kɛ́jĩ̀dé
kẹyinde	kɛ́ĩ̀dé
kọ	kɔ̀
kọ	kɔ́
kọ	kɔ̄
kọbọ	kɔ́bɔ̀
kọfi	kɔ̄fí
kọja	kɔ̄dʒá
kọjọda	kɔ́dʒɔ́dā
kọkọrọ	kɔ́kɔ́ɾɔ́
kọlade	kɔ́ládé
kọlawọle	kɔ́láwɔ̄lé
kọlekọle	kɔ́lékɔ́lé
kọlifilawa	kɔ́lífīlāwà
kọlikọli	kɔ́líkɔ́lí
kọlọfin	kɔ́lɔ́fĩ́
kọlọkọlọ	kɔ̀lɔ̀kɔ̀lɔ̀
kọlọkọlọ	kɔ́lɔ̄kɔ̀lɔ̄
kọma	kɔ́mã̄
kọmputa	kɔ̀ŋ̀kpútà
kọnfu	kɔ̃̄fú
kọngila	kɔ̄ŋ̄gílá
kọngọ	kɔ̀ŋ̀gɔ́
kọngọ	kɔ́ŋ́gɔ́
kọnkere	kɔ̃̄kéɾé
kọnkọ	kɔ̀ŋ̀kɔ̀
kọnputa	kɔ̀ŋ̀kpútà
kọnsonanti	kɔ́ŋ́sónáŋ̀tì
kọraa	kɔ̀ɾáà
kọrin	kɔ̄ɾĩ̄
kọrinkọrin	kɔ̄ɾĩ̄kɔ̄ɾĩ̄
kọsẹ	kɔ̀sɛ̀
l	l
l	lí
la	là
la	lá
laaarin	láꜜáɾĩ́
laada	láádá
laakaye	làákàjè
laali	làálì
laanọ	ꜜlánɔ̃́
laaroye	láàɾójè
laasigbo	làásìgbò
laba	làbà
labaa	láꜜbá
labalaba	lābālábá
labankada	lábàŋ̀kádà
labari	làbáɾì
labidun	làbídũ̀
labirikanna	lábíɾíkã́nã́
labule	lábúlé
labẹ	lábɛ́
ladugbo	ládūgbó
laefi	láèfí
lafikun	láfīkṹ
lafun	láfṹ
lagbedemeji	lágbēdēmédʒì
lagunna	lágũ̀nã̀
lagọlagọ	lāgɔ̀lāgɔ̀
laiberia	làìbéɾíà
laibiri	láíbìɾì
lailopin	láìlóꜜkpĩ̄
lailọọnu	láílɔ́ɔ̀nũ̀
laini	láìnĩ́
laipẹ	láìkpɛ́
laisi	láìsí
laiwowe	láìwòwé
lakuregbe	làkúɾègbé
lalaalẹ	lálāālɛ́
laluuri	làlúúɾí
lameyitọ	lámèjítɔ́
lamidi	lámídì
lamilami	lámĩ̄lámĩ̄
lanaa	láꜜnã́
lapaipa	lákpàīkpà
lapalapa	làkpálàkpá
laraarọ	láɾàáɾɔ̀
larubawa	láɾúbáwá
lasisi	làsísì
lati	láꜜtī
lawani	láwànĩ́
layeatijọ	lájéàtīdʒɔ́
le	lè
le	lé
le	lē
ledumae	lédùmāè
lefitiku	léfítíkù
legbelegbe	légbélègbé
lekeleke	lékēlékē
lekokobiojuẹja	lēkōkōbíōdʒúɛ̄dʒā
lemọmu	lèmɔ̃́mũ̀
lenii	léꜜnĩ́
lesi	lèsí
lesoto	lèsótò
leṣii	léꜜʃí
li	lí
libia	líbíà
ligbẹ	lígbɛ̀
liigi	líìgì
liigi	líígì
liili	líìlí
linguisiiki	lìŋ̀gúísíìkì
lita	lítà
litireṣọ	lítíɾéʃɔ̀
lo	lò
lo	ló
lodeoni	lóꜜdēònĩ́
logbo	lógbò
logboṣẹẹ	lógbòʃɛ́ɛ́
logunẹdẹ	lógũ̄ɛ̀dɛ̄
logunọfẹ	lógũ̄ɔ̄fɛ̄
lojiji	lódʒīdʒì
lojoojumọ	lódʒōōdʒúmɔ̃́
lojukoju	lódʒúkōdʒú
loke	lókè
lokili	lókílì
lonii	lóꜜnĩ́
looni	ꜜlónĩ́
loorekoore	lóòɾèkóòɾè
lori	lóɾí
lowobiṣẹkẹrẹ	lówóbíʃɛ̀kɛ̀ɾɛ̀
loṣoo	lóʃòó
loṣooṣu	lóʃōōʃù
lubiaṣọofi	lùbíāʃɔ̄òfì
lubulubu	lúbúlúbú
lukaluka	lúkàlúkà
luko	lūkō
lukudi	lùkúdì
lukuluku	lùkúlùkú
lẹ	lɛ̀
lẹ	lɛ́
lẹ	lɛ̄
lẹbanoni	lɛ́bánónì
lẹgbẹẹ	lɛ́ꜜgbɛ́
lẹhin	lɛ́hĩ̀
lẹsẹkẹsẹ	lɛ́sɛ̀kɛ́sɛ̀
lẹsẹkẹsẹ	lɛ́sɛ̀kɛ̄sɛ̀
lẹta	lɛ́tà
lẹyin	lɛ́jĩ̀
lọ	lɔ̀
lọ	lɔ́
lọ	lɔ̄
lọbalọba	lɔ́bālɔ́bā
lọdọọdun	lɔ́dɔ̄ɔ̄dṹ
lọfinnda	lɔ́fĩ́ŋ́dà
lọjọiwaju	lɔ́dʒɔ́īwádʒú
lọla	lɔ́ꜜlā
lọpọlọpọ	lɔ́kpɔ̀lɔ́kpɔ̀
lọrunlọrun	lɔ́ɾũ̀lɔ́ɾũ̀
lọsọọsan	lɔ́sɔ̀ɔ̀sã́
lọsọọsẹ	lɔ́sɔ̀ɔ̀sɛ̀
lọwọọwọ	lɔ́wɔ́ɔ́wɔ́
lọya	lɔ́jà
lọọle	lɔ̄ɔ̄lé
lụka	lʊ́kà
lụkalụka	lʊ́kàlʊ́kà
m	m
m	mĩ́
m	ŋ
m	ŋ́
m	ŋ̄
maa	màá
maa	máā
maa	māā
maapu	máàkpù
maasi	máàsì
madaamidofo	mádàámĩ̄dófò
madaarikan	mádàáɾíkã̀
madagasika	mādāgásíkà
magi	māgí
maginẹsiọ	màgìnɛ́síɔ̀
magun	mágũ̀
maigho	màìɣò
majala	màdʒàlà
majata	mádʒātā
majele	mádʒèlé
majẹmu	mádʒɛ̀mũ̄
majẹmu	mádʒɛ̀mṹ
makaruku	màkàɾúkù
makaruru	màkàɾúɾù
makirofoonu	mākīɾōfóònũ̀
makoko	mākòkō
malaagunjinna	málàágũ̀dʒĩ̀nã̀
malawi	màláwì
maleka	màlékà
maleṣia	màléʃíà
mali	málì
malita	málítà
malughu	màlúɣù
maluu	màlúù
malọmọ	málɔ̄mɔ̃́
mama	màmá
mangoro	máŋ́gòɾò
maraarun	máɾààɾṹ
maria	màɾíà
mariwo	màɾìwò
masẹdoniaariwa	māsɛ̄dóníààɾíwá
matiu	mátíù
meje	méꜜdʒē
mejeeje	médʒèèdʒē
mejeeji	médʒèèdʒì
mejemeje	méꜜdʒēméꜜdʒē
meji	médʒì
mejimeji	médʒìmédʒì
meloo	méꜜló
meriiiri	méꜜɾíꜜíɾí
mi	mĩ̀
mi	mĩ́
mi	mĩ̄
midinmiidin	mĩ̄dĩ̄mĩ́ĩ̀dĩ̀
mii	ꜜmĩ́ĩ̀
miiran	ꜜmĩ́ɾã̀
miligiraamu	mílígíɾáàmù
miliiki	mílíìkì
miliikigbẹrẹfu	mĩ́líìkìgbɛ̄ɾɛ̄fū
mililita	mìlílítà
milimita	mìlímítà
miliọnu	mílíɔ̀nù
miringindin	mĩ̀ɾĩ̀gĩ̀dĩ̀
mita	mítà
moji	mōdʒí
momi	mōmĩ̄
mongolia	mòŋ̀gólíà
mooluẹ	móòlūɛ̀
mooru	móōɾū
moroko	mòɾókò
mosanbiiki	mòsáŋ́bíìkì
motunrayọ	mōtṹɾájɔ̀
mu	mũ̀
mu	mũ̄
mu	mṹ
mudunmudun	mũ̀dũ̀mṹdũ̀
mugbo	mũ̄gbó
mugwẹmugwẹ	mũ̀gʷɛ̀mũ̀gʷɛ̀
mulọmulọ	mṹlɔ́mṹlɔ́
mumi	mũ̄mĩ̄
muraina	mṹɾáínã̀
murainọ	mṹɾáínɔ̀
musiiba	mùsííbà
musiọmu	mũ̀síɔ̀mũ̀
muso	mṹsò
musu	mṹsù
musulumi	mũ̀sùlùmĩ́
muwe	mũ̀wé
muyiiwa	mṹꜜjíwá
muyiwa	mṹjìwá
muṣin	mũ̄ʃĩ̄
m̀	m̩̀
m̂	m̩̂
m̄	m̩̄
m̌	m̩̌
mẹfa	mɛ́fà
mẹfamẹfa	mɛ́fàmɛ́fà
mẹfẹẹfa	mɛ́fɛ̀ɛ̀fà
mẹjẹẹjọ	mɛ́dʒɛ̀ɛ̀dʒɔ̄
mẹjọ	mɛ́ꜜdʒɔ̄
mẹjọmẹjọ	mɛ́ꜜdʒɔ̄mɛ́ꜜdʒɔ̄
mẹkunnu	mɛ̀kṹnũ̀
mẹkunu	mɛ̀kúnũ̀
mẹrin	mɛ́ꜜɾĩ̄
mẹrinmẹrin	mɛ́ꜜɾĩ̄mɛ́ꜜɾĩ̄
mẹrẹẹrin	mɛ́ɾɛ̀ɛ̀ɾĩ̄
mẹsiko	mɛ́síkò
mẹta	mɛ́ꜜtā
mẹtamẹta	mɛ́ꜜtāmɛ́ꜜtā
mẹtẹẹta	mɛ́tɛ̀ɛ̀tā
mẹwaa	mɛ́ꜜwá
mẹwaamẹwaa	mɛ́ꜜwámɛ́ꜜwá
mẹwaanṣẹlẹ	mɛ́ꜜwáŋ́ʃɛ̄lɛ̀
mẹwẹẹwaa	mɛ́wɛ̀ɛ̀wàá
mọ	mɔ̃̀
mọ	mɔ̃́
mọ	mɔ̃̄
mọdakẹkẹ	mɔ̃̄dákɛ́kɛ́
mọdẹmọdẹ	mɔ̃̀dɛ̀mɔ̃̀dɛ̀
mọgaa	mɔ̃̀gáà
mọgaji	mɔ̃́gàdʒí
mọgala	mɔ̃́gálà
mọgba	mɔ̃̄gbà
mọinmọin	mɔ̃́ĩ́mɔ̃́ĩ́
mọjesin	mɔ̃̀dʒèsĩ́
mọlẹbi	mɔ̃̀lɛ́bí
mọmi	mɔ̃́mĩ̀
mọmọ	mɔ̃̀mɔ̃́
mọmọdu	mɔ̃́mɔ̃́dù
mọnafiki	mɔ̃̀nã́fìkí
mọnamọna	mɔ̃̀nã̀mɔ̃́nã́
mọnamọna	mɔ̃́nã́mɔ̃́nã́
mọremi	mɔ̃́ɾēmĩ́
mọremi	mɔ̃̄ɾèmĩ̄
mọremiajaṣoro	mɔ̃́ɾēmĩ́àdʒàʃōɾò
mọremiajaṣoro	mɔ̃̄ɾèmĩ̄àdʒàʃōɾò
mọriwo	mɔ̃̀ɾìwò
mọriọ	mɔ̃̀ɾìò
mọsalasi	mɔ̃́sálásí
mọto	mɔ̃́tò
mọwe	mɔ̃̀wé
mọṣalaṣi	mɔ̃́ʃáláʃí
mọṣi	mɔ̃́ʃì
n	n
n	nĩ́
n	ŋ
n	ŋ́
n	ŋ̄
n	̃
naa	nã́ã̀
naija	nàìdʒá
naija	náídʒà
naijiria	nàìdʒíɾíà
naira	náíɾà
nama	nã́mà
namibia	nàmíbíà
nanaburukuu	nã̀nã́bùɾùkú
narun	nã́ɾũ̄
nasia	nã̀síà
neghi	nèɣí
nian	nĩ́ꜜã̄
niasẹyinwaasẹyinbọ	nĩ́àsɛ̀jĩ̀wáàsɛ̀jĩ̀bɔ̀
nijẹrin	nĩ́ꜜdʒɛ̄ɾĩ̄
nijẹta	nĩ́ꜜdʒɛ̄tā
nikan	nĩ̀kã̄
nikaragua	nīkāɾágúà
nile	nĩ́lé
ninu	nĩ́nṹ
nipasẹ	nĩ́kpāsɛ̀
nipọn	nĩ́kpɔ̃̄
niran	nĩ́ꜜɾã̄
nirọn	nĩ́ꜜɾɔ̃̄
nisin	nĩ́sĩ̄
nita	nĩ́ꜜtā
nitori	nĩ́ꜜtōɾí
niturojini	nĩ́túɾódʒínĩ̀
niwaju	nĩ́ꜜwádʒú
niyinlokikiafiyesi	nĩ́jĩ̀lókìkíàfījèsí
niṣo	nĩ̀ʃó
njẹ	ŋ̀dʒɛ́
njẹta	ŋ́dʒɛ̄tā
nkọ	ŋ́kɔ́
nkọ	ŋ̄kɔ́
nla	ŋ́lá
nle	ŋ́lé
nnkan	ŋ̄ŋ̀kã̄
nnkankan	ŋ̄ŋ̀kã̄kã̄
nnu	ŋ́nṹ
nta	ŋ́tā
ntori	ŋ́tōɾí
nukan	nũ̀kã̄
nunu	nṹnũ̀
nwaju	ŋ́wádʒú
n̂	n̩̂
nẹ	nɛ̀
nẹ	nɛ́
nẹẹ	nɛ́ɛ̀
nẹẹn	nɛ̀ɛ́
nẹẹn	nɛ̀ɛ̃́
nị	nɪ̃̀
nọmba	nɔ́ŋ́bà
nọmbaagbabọọlu	nɔ́ŋ́bàāgbábɔ́ɔ̀lù
nọwe	nɔ́wè
o	o
o	ó
obeje	òbèdʒé
obeje	òbédʒé
obele	òbèlè
oberemoye	òbèɾèmójè
obi	òbí
obi	ōbì
obinrin	ōbĩ̀ɾĩ̄
obira	ōbīɾā
obirikiti	òbìɾìkìtì
obitọn	ōbītɔ̃̄
obiṣuari	òbíʃúáɾì
obo	òbò
obukọ	òbúkɔ̄
odabọ	ódàbɔ̀
ode	òdē
odi	òdì
odi	òdí
odi	ōdì
odi	ōdī
odidi	ōdīdī
odidẹrẹ	ōdídɛ̄ɾɛ́
odigbooṣe	ódìgbòóʃē
odindi	ōdĩ̄dī
odindi	ōdīŋ̄dī
odio	òdíō
odo	òdō
odo	ōdò
odo	ōdó
odo	ōdō
ododo	òdòdó
ododo	òdōdō
ododo	ōdódō
odoilu	ōdóìlù
odu	òdù
odu	òdú
odu	òdū
odu	ōdù
oduduwa	ōdùdūwà
oduifa	ōdùīfá
oduwa	ōdūwā
ofefee	òféfèé
ofi	òfì
ofin	òfĩ̄
ofinagbaye	òfĩ̄àgbájé
ofio	òfìò
ofofo	òfófó
ofu	òfú
ofun	òfṹ
ofurufu	òfūɾūfú
ofuurufu	òfūūɾūfú
ogbe	ōgbè
ogbe	ōgbē
ogbebara	ōgbèbàɾà
ogbedi	ōgbèdí
ogbefun	ōgbèfṹ
ogbegunda	ōgbègṹdá
ogbeka	ōgbèká
ogbekanran	ōgbèkã̀ɾã̀
ogbere	ògbèɾè
ogbere	ògbéɾè
ogberekoo	ògbèɾèkóò
ogberosun	ōgbèɾōsũ̀
ogberẹtẹ	ōgbèɾɛ̀tɛ̀
ogberẹtẹ	ōgbèɾɛ̄tɛ̀
ogbesa	ōgbèsá
ogbesẹ	ōgbèsɛ́
ogbetura	ōgbètúɾá
ogbeturupọn	ōgbètúɾúkpɔ̃̀
ogbewori	ōgbèwòɾì
ogbewọnrin	ōgbèwɔ̃́ɾĩ́
ogbeyẹku	ōgbèjɛ̀kú
ogboatọasureiworiwofun	ōgbóātɔ́àsúɾēìwòɾìwòfṹ
ogbogbo	ògbògbō
ogbomọṣọ	ògbómɔ̃̀ʃɔ́
ogboni	ògbónĩ̄
ogboo	ògbòó
ogbufọ	ògbūfɔ̀
ogbugbu	ògbùgbú
ogburo	ògbùɾó
oge	ògé
oge	ōgē
ogede	ògèdè
ogede	ògèdē
ogede	ògédé
ogho	ōɣó
oghun	òɣũ̄
oghun	ōɣũ̄
ogidan	ògìdã́
ogidigbo	ògìdìgbó
ogido	ògìdō
ogio	ōgìō
ogiri	ògìɾì
ogiri	ògīɾī
ogirigbamila	ògīɾīgbàmĩ́là
ogiriṣakọ	ògìɾìʃákɔ́
ogiyan	ògìjã́
ogo	ògò
ogo	ògó
ogo	ògō
ogoga	ògògà
ogogoro	ògógóɾó
ogoji	ōgódʒì
ogolomaṣu	ògòlòmàʃú
ogolomọṣi	ògòlòmɔ̃̀ʃí
ogongo	ògòŋ̀gò
ogooroẹyin	ògóóɾóɛ̀jĩ̀
ogooroẹyin	ògōōɾōɛ̀jĩ̀
ogu	ògù
ogu	ōgú
ogu	ōgū
ogulutu	ògúlùtū
ogun	ògũ̀
ogun	ògṹ
ogun	ōgũ̄
ogun	ōgṹ
ogunabẹle	ōgũ̄ābɛ́lé
ogunbiyi	ògṹbíꜜjí
ogunbiyii	ògṹbíꜜjí
ogunda	ògṹdá
ogundabẹdẹ	ògṹdábɛ̀dɛ́
ogundare	ògṹdáɾē
ogunde	ògṹŋ̀dé
ogundele	ògṹdélé
ogundepo	ògṹdékpò
ogundiran	ògṹdìɾã̄
ogungun	ōgũ̄gũ̄
ogunlende	ōgṹléŋ̄dé
ogunlẹyẹ	ògṹlɛ́ꜜjɛ̄
ogunmoriyele	ògṹmōɾíjèlé
ogunmọdẹde	ògṹmɔ̃̄dɛ̄dé
ogunna	ògṹnã́
ogunoye	ògṹōjè
oguntuyi	ògṹtújì
ogunyẹmi	ògṹjɛ̄mĩ́
ogunyọlade	ògṹjɔ̀ládé
ogunṣuyi	ògṹʃūjì
ogurọ	ògùɾɔ̀
ogurọ	ògúɾɔ́
ogwigwi	ògʷìgʷí
ogẹsinlẹṣin	ògɛ̄ʃĩ̄lɛ́ʃĩ̄
ohihun	ōhìhũ̀
ohun	ōhũ̀
ohun	ōhũ̄
ohunkohun	ōhũ̄kóhũ̄
oi	ōī
oibaa	ōíbàà
oigho	ōíɣō
oii	ōīī
oiie	ōíīē
oje	òdʒé
oje	ōdʒē
oji	ōdʒì
ojia	òdʒíá
ojibata	òdʒíbàtà
ojido	ōdʒìdó
ojigan	òdʒìgã̄
ojiji	òdʒìdʒī
ojiji	òdʒídʒí
ojiji	òdʒīdʒì
ojiya	òdʒíjá
ojo	òdʒò
ojo	òdʒó
ojo	ōdʒō
ojojo	òdʒòdʒò
ojola	òdʒòlá
ojoojumọ	ōdʒōōdʒúmɔ̃́
ojora	ōdʒōɾā
ojoro	òdʒóɾó
oju	ōdʒú
ojubọ	ōdʒúꜜbɔ̄
ojude	ōdʒúꜜdē
ojugun	ōdʒúgũ̄
ojuju	ōdʒūdʒū
ojukoju	ōdʒúkōdʒú
ojukokoro	ōdʒúkòkòɾò
ojule	ōdʒúlé
ojulowo	ōdʒúlówó
ojulumọ	ōdʒúlùmɔ̃̀
ojumọ	ōdʒúmɔ̃́
ojuodu	ōdʒúōdù
ojuologbo	ōdʒúōlógbò
ojusanma	ōdʒúsɔ̃́mɔ̃̀
ojuti	ōdʒútì
ojuọjọ	ōdʒúɔ̄dʒɔ́
ojuọrun	ōdʒúɔ̀ɾũ
oke	òkè
okeere	òkèèɾè
okeokun	òkèòkũ̄
okete	òkété
okiki	òkìkí
okinẹ	ōkīnɛ̄
okiti	òkìtì
oko	òkò
oko	ōkó
oko	ōkō
okobo	òkóbó
okoto	òkòtó
okotorobo	òkótòɾóbó
oku	òkù
oku	òkú
oku	ōkù
okudi	ōkūdì
okudu	òkúdū
okule	ōkùlè
okun	òkũ̄
okun	ōkũ̀
okun	ōkũ̄
okunfa	ōkũ̀fà
okunilẹ	ōkũ̀īlɛ̀
okunkun	òkũ̀kũ̀
okunrun	òkũ̀ɾũ̀
okuru	òkúɾù
okuta	òkúta
ole	òꜜlé
ole	ōlè
olele	ōlēlē
olikaluku	ōlíkálùkù
olila	ōlílá
olilu	òlìlù
olio	ōlíó
olisa	ōlísà
olodo	ōlódó
olodo	ōlóꜜdō
olodongboro	ōlódòŋ̀gbōɾō
olodumare	ōlóꜜdùmāɾè
olofoofo	ōlóꜜfófó
ologbo	ōlógbò
ologboṣẹrẹ	ōlógbòʃɛ́ɾɛ́
ologeeṣa	ōlógèéʃà
ologho	ōlóɣó
ologiiriṣẹṣẹ	ōlógìíɾìʃɛ̀ʃɛ̀
ologinni	ōlógĩ̀nĩ́
ologoṣẹ	ōlógōʃɛ́
ologun	ōlógũ̄
olojo	òlōdʒò
olokili	ōlókílì
olokoṣẹ	ōlókōʃɛ́
olokun	ōlóꜜkũ̄
ololufẹ	ōlólùfɛ́
olomele	ōlómēlē
olongbo	ōlóŋ́gbò
olongo	ōlōŋ̄gō
oloo	ōlóó
oloofeere	ōlóòféèɾé
oloogunebi	ōlóògũ̀ēbī
olooorun	ōlóòóɾũ̀
olori	ōlōɾì
oloriṣa	ōlóɾìʃà
olorogbo	ōlóɾógbó
olorogu	ōlóɾógū
olowo	ōlówò
olowo	ōlówó
oloye	ōlójè
oloyin	ōlójĩ̄
oloṣelu	ōlóʃèlú
olu	òlú
olu	ōlú
olubadan	ōlúbàdã̀
olubọde	ōlúbɔ̀dé
olufẹ	ōlùfɛ́
olugbe	ōlùgbé
olugbeja	ōlùgbèdʒà
olugbodi	ōlúgbódī
olugbongbo	òlùgbóŋ́gbó
olukarẹ	ōlúkàɾɛ́
olukondo	ōlúkòŋ̀dó
oluku	ōlùkù
olukurumusi	ōlúkúɾúmũ̀sì
olukọ	ōlùkɔ́
olule	ōlúlé
oluli	ōlúlí
olulu	òlúlú
oluorogbo	ōlúōɾógbó
oluorogbo	ōlúōɾōgbō
oluoroke	ōlúōɾókè
oluranṣẹ	ōlùɾã́ʃɛ́
olurun	ōlúɾũ̄
oluwa	ōlúwā
oluwafunkẹ	ōlúwāfṹkɛ́
oluwongaga	ōlúwōŋ̄gāgā
oluwoo	ōlúwòó
omele	ōmēlē
omi	ōmĩ̄
omidan	ōmĩ̄dã̄
omidiran	ōmĩ́dìɾã̄
omii	òmĩ́ĩ̀
ominira	òmĩ̀nĩ̄ɾā
ominu	ōmĩ̄nṹ
omira	ōmĩ́ɾā
omiran	òmĩ̀ɾã́
omiran	òmĩ́ɾã̀
omiro	ōmĩ̄ɾó
omitoro	ōmĩ̄tōɾō
omiye	ōmĩ̄jē
omudẹndẹnrẹn	ōmũ̀dɛ̃̄dɛ̃̄ɾɛ̃́
omugodogbo	ōmũ̀gòdògbò
omugwẹ	òmũ̀gʷɛ̀
omuka	ōmũ̀kā
omuwẹ	òmũ̀wɛ̀
ondo	òŋ̀dó
ondo	ōŋ̀dó
ondoajaja	ōŋ̀dóādʒādʒá
ongbẹ	òŋ̀gbɛ̄
ongbẹngbẹmi	òŋ̀gbɛ̄ŋ́gbɛ̄mĩ́
oni	ònĩ́
onibata	ōnĩ́bàtà
onibata	ōnĩ́bàtá
onibuka	ōnĩ́búkà
onidiri	ōnĩ́dìɾí
onifa	ōnĩ́fá
onigbagbọ	ōnĩ́gbàgbɔ́
onigbajamọ	ōnĩ́gbàdʒámɔ̃̀
onigbameji	ōnĩ́gbámédʒì
onikaluku	ōnĩ́kálùkù
onikaluku	ōnĩ́kálūkú
onikondo	ōnĩ́kòŋ̀dó
onila	ōnĩ́lá
onilegogoro	ōnĩ́légōgōɾō
onimọ	ōnĩ́mɔ̃̀
onimọijinlẹ	ōnĩ́mɔ̃̀ìdʒĩ̀lɛ̀
onipẹrẹnsẹ	ōnĩ́kpɛ́ɾɛ̀ŋ̀sɛ́
onire	ōnĩ́ɾè
onisuuru	ōnĩ́sùúɾù
onitumọ	ōnĩ́tūmɔ̃̀
oniwaasu	ōnĩ́wàásù
oniwaduwadu	ōnĩ́wàdùwàdù
oniṣango	ōnĩ́ʃã̀gó
oniṣegun	ōnĩ́ʃègũ̀
oniṣowo	ōnĩ́ʃòwò
oniṣẹṣe	ōnĩ́ʃɛ̀ʃē
onka	òŋ̀kà
onko	òŋ̀kò
oo	òò
oo	óō
oodo	ōóꜜdō
oogun	òógũ̀
oogun	ōògũ̀
oogunapakokoro	ōògũ̀ākpākòkòɾò
ooka	òòkā
ookan	ōóꜜkã̄
ookun	ōókṹ
oola	òólá
oolu	òòlù
oolẹ	ōòlɛ̀
oolẹ	ōólɛ̀
oore	òòɾè
oore	ōòɾè
oorun	òóɾũ̀
oorun	ōòɾũ̀
oorun	ōōɾũ̄
oorẹ	òòɾɛ̀
oorọ	òóɾɔ̀
ootọ	òótɔ́
oowo	ōówō
ooya	òòjà
ooṣa	òòʃà
ooṣaala	òòʃàálá
ooṣanla	òòʃàŋ́lá
opin	òkpĩ̄
opitan	òkpìtã̀
opo	òkpó
opo	ōkpó
opomulero	òkpómṹléɾó
oponu	òkpònṹ
opopona	òkpókpónã̀
oposo	òkpòsò
ore	òɾé
ore	ōōɾē
ori	òɾì
ori	òɾí
ori	ōɾí
ori	ōɾī
origho	ōɾíɣō
origun	ōɾígũ̄
orikadun	ōɾíkádṹ
oriki	ōɾíkì
orilẹ	ōɾílɛ̀
orimolusi	ōɾímōlúsì
orin	ōɾĩ́
orin	ōɾĩ̄
oriri	ōɾīɾī
orirun	òɾíɾũ̀
orirun	ōɾíɾũ̄
orisun	ōɾíꜜsũ̄
orita	ōɾíꜜtā
orita	ōɾītā
oriṣa	òɾìʃà
oriṣaala	òɾìʃàálá
oriṣabinu	òɾìʃábínṹ
oriṣakire	òɾìʃàkīɾè
oriṣanla	òɾìʃàŋ́lá
oriṣaoko	òɾìʃàōkō
oro	òɾò
oro	òɾó
oro	òɾō
oro	ōɾò
oro	ōɾó
oro	ōɾō
orofo	òɾófó
orofo	òɾōfó
orogbo	ōɾógbó
orogun	ōɾógũ̀
orogun	ōɾōgṹ
oroguniya	ōɾōgṹìjá
oroka	òɾòkā
orokun	ōɾókṹ
orombo	òɾōŋ̀bó
oromọdiyẹ	òɾòmɔ̃̄dìjɛ̄
orooro	òɾóòɾō
ororo	òɾóɾó
ororo	òɾōɾò
oru	òɾū
oru	ōɾù
oruka	òɾùkā
orukun	ōɾúkṹ
orukọ	òɾúkɔ̄
orukọ	ōɾúkɔ̄
orukọabiku	ōɾúkɔ̄àbíkú
orukọamutọrunwa	ōɾúkɔ̄àmṹtɔ̀ɾũ̄wá
orukọkorukọ	ōɾúkɔ̄kóɾúkɔ̄
orule	òɾùlé
orunkun	ōɾṹkṹ
orupo	òɾúkpò
orupo	ōɾúkpò
oruwo	ōɾúwō
ose	ōsè
osi	òsì
osilo	òsìlò
osun	ōsũ̀
osun	ōsũ̄
otente	òtéŋ́té
oti	ōtī
otili	òtílí
otita	òtìtà
otitọ	òtítɔ́
oto	òtò
otolo	òtòlò
otu	òtù
otua	òtúá
otupa	òtùkpà
otura	òtúɾá
otuurupọn	òtúúɾúkpɔ̃̀
oukọ	ōúkɔ̄
oun	òũ̄
ounjẹ	ōṹdʒɛ̄
ounjẹaarọ	ōṹdʒɛ̄àáɾɔ̀
ounjẹalẹ	ōṹdʒɛ̄ālɛ́
ounjẹalẹoluwa	ōṹdʒɛ̄ālɛ́ōlúwā
ounjẹọsan	ōṹdʒɛ̄ɔ̀sã́
oupo	ōúkpò
owe	òwè
owe	òwē
owe	ōwé
owewe	òwéwē
owiwi	òwìwí
owo	òwò
owo	ōwó
owoagbaye	òwòàgbájé
owoifẹyinti	ōwóìfɛ̀jĩ̀tì
owoomi	ōwóōmĩ̄
owoori	ōwóōɾí
owooṣu	ōwóōʃù
owoẹyọ	ōwóɛ̄jɔ̄
owu	òwù
owu	òwú
owu	òwū
owu	ōwú
owun	òwũ̄
owurọ	òwúɾɔ̀
owusuwusu	òwúsúwūsù
owuọ	òwúɔ̀
oye	òjē
oye	ōjè
oye	ōjē
oyi	òjì
oyin	ōjĩ̄
oyinado	ōjĩ̄àdò
oyinbo	òjĩ̀bó
oyinigan	ōjĩ̄ìgã̀
oyiya	òjìjà
oyo	òjō
oyun	ōjṹ
ozu	ōzú
oṣe	òʃé
oṣe	ōʃè
oṣe	ōʃé
oṣelu	òʃèlú
oṣemawe	òʃēmàwé
oṣere	òʃèɾé
oṣeun	ōʃēũ̄
oṣibata	òʃíbàtà
oṣie	òʃìé
oṣiṣẹ	òʃìʃɛ́
oṣo	òʃó
oṣo	ōʃó
oṣogbo	òʃōgbō
oṣomaalo	òʃómàáló
oṣooṣu	ōʃōōʃù
oṣu	ōʃù
oṣuagẹmọ	ōʃùāgɛ̄mɔ̃̄
oṣubelu	ōʃùbélú
oṣuerele	ōʃùèɾèlé
oṣuigbe	ōʃùìgbé
oṣuigbe	ōʃùīgbē
oṣumare	òʃùmàɾè
oṣuogun	ōʃùògṹ
oṣuokudu	ōʃùòkúdū
oṣuowewe	ōʃùòwéwē
oṣupa	òʃùkpá
oṣupa	ōʃùkpá
oṣupaaranmọju	òʃùkpáàɾã̀mɔ̃́dʒú
oṣupadẹjẹ	òʃùkpádɛ̀dʒɛ̀
oṣuṣẹrẹ	ōʃùʃɛ̀ɾɛ́
oṣuẹbibi	ōʃùɛ̀bìbì
oṣuẹrẹna	ōʃùɛ̀ɾɛ̀nã̀
oṣuọpẹ	ōʃùɔ̀kpɛ̀
oṣuọpẹ	ōʃùɔ̀kpɛ̄
oṣuọwara	ōʃùɔ̀wàɾà
p	kp
p	kpí
pa	kpá
pa	kpā
paaki	kpáàkì
paari	kpááɾì
paayan	kpààjã̀
pabanbari	kpābāŋ̄bāɾì
pada	kpādà
padanu	kpàdánũ̀
pade	kpàdé
pade	kpādé
pagidende	kpāgīdèŋ̀dé
pagọ	kpàgɔ́
pai	kpāí
pajapaja	kpādʒákpādʒá
pajawiri	kpàdʒáwìɾì
paka	kpākà
pakala	kpàkálà
pakanleke	kpákáŋ̀lēkē
paki	kpákí
pakisitani	kpākísítánì
pako	kpàkō
pako	kpákò
pako	kpákó
pako	kpākó
pako	kpākō
pakute	kpàkúté
palaka	kpālākā
palarun	kpáláɾũ̄
palẹsini	kpālɛ́sìnì
palọ	kpàlɔ́
pana	kpānã́
panakata	kpānã̄kàtá
panapana	kpānã́kpānã́
panda	kpáŋ́dā
pankeeki	kpāŋ̄kéèkì
pankuru	kpáŋ́kùɾù
panti	kpàŋ̀tí
papakọofuurufu	kpákpákɔ̀òfūūɾūfú
papalanto	kpákpáláŋ́tó
papamilolo	kpākpāmĩ̀lòlò
papayẹkẹ	kpákpájɛ̄kɛ̄
papoda	kpākpòdà
parada	kpāɾādà
paradise	kpáɾádísè
parakaṣaka	kpàɾàkáʃàká
parakoyi	kpàɾàkòjí
paranta	kpáɾáŋ́tà
parapandu	kpāɾākpã̄dù
pari	kpáɾí
pari	kpāɾí
pariwo	kpāɾīwō
paroko	kpàɾōkò
parọ	kpāɾɔ́
parọwa	kpàɾɔ̄wà
pata	kpátá
pataki	kpàtàkì
patako	kpátákó
patapata	kpátákpátá
patiyẹ	kpātījɛ̄
patẹwọ	kpàtɛ́wɔ́
paṣan	kpàʃã́
paṣipaarọ	kpàʃíkpààɾɔ̀
paṣẹ	kpàʃɛ̄
pe	kpè
pe	kpé
pejupesẹ	kpédʒúkpésɛ̀
pere	kpèɾé
pere	kpéɾé
peregun	kpèɾègṹ
pete	kpètē
pi	kpí
pidan	kpīdã́
pidanpidan	kpīdã́kpīdã́
pin	kpĩ́
pin	kpĩ̄
pinnu	kpĩ̄nũ̄
pipiri	kpíkpíɾì
pirọrọbiẹjaojiji	kpīɾɔ̄ɾɔ̄bíɛ̄dʒāòdʒídʒí
pitan	kpìtã̀
po	kpò
po	kpó
pogede	kpògèdè
pokunso	kpōkũ̀sō
polongo	kpōlōŋ̄gō
polowo	kpōlówó
polukurumuṣu	kpōlúkúɾúmũ̄ʃū
pomegiraneti	kpómégíɾánétì
poo	kpóò
popo	kpókpó
popondo	kpòkpòŋ̀dó
poporo	kpòkpóɾò
popotọn	kpókpótɔ̃̄
posi	kpósí
potogi	kpōtōgí
powe	kpòwē
poṣe	kpòʃé
pu	kpū
pubu	kpūbú
pupa	kpūkpā
pupuru	kpūkpūɾū
pupọ	kpúkpɔ̀
purofaili	kpúɾófáìlì
puromo	kpúɾómò
purotosua	kpùɾótósúà
puruntu	kpúɾúŋ̀tù
pẹ	kpɛ́
pẹja	kpɛ̄dʒā
pẹjapẹja	kpɛ̄dʒākpɛ̄dʒā
pẹkirẹki	kpɛ̀kíɾɛ̀kí
pẹkulẹ	kpɛ̄kūlɛ̄
pẹlu	kpɛ̀lú
pẹlẹ	kpɛ̀lɛ́
pẹlẹbẹ	kpɛ̄lɛ̄bɛ̄
pẹna	kpɛ̄ná
pẹnaiti	kpɛ̄nã́ĩ́tì
pẹnariti	kpɛ̄nã́ɾítì
pẹnsu	kpɛ́ŋ́sù
pẹpusi	kpɛ̄kpūsí
pẹpẹ	kpɛ̄kpɛ̄
pẹpẹyẹ	kpɛ́kpɛ́jɛ̄
pẹrẹsẹ	kpɛ̄ɾɛ̄sɛ̄
pẹtẹpẹtẹ	kpɛ̀tɛ̀kpɛ̀tɛ̀
pẹtẹpẹtẹ	kpɛ̀tɛ̀kpɛ́tɛ̀
pẹtẹpẹtẹ	kpɛ̄tɛ̄kpɛ́tɛ́
pẹtẹpẹtẹ	kpɛ̄tɛ̄kpɛ̄tɛ̄
pẹtẹẹsi	kpɛ̀tɛ́ɛ̀sì
pẹẹlẹpẹ	kpɛ̄ɛ̄lɛ̀kpɛ́
pẹẹni	kpɛ́ɛ̀nì
pọ	kpɔ̀
pọ	kpɔ́
pọbiiyanrin	kpɔ̀bíījã̄ɾĩ̀
pọfọ	kpɔ̄fɔ̀
pọkanpọ	kpɔ̄kã̀kpɔ̀
pọn	kpɔ̃̀
pọn	kpɔ̃́
pọn	kpɔ̃̄
pọnmọ	kpɔ̃̀mɔ̃́
pọnmọ	kpɔ̃̄mɔ̃̄
pọnpọndọn	kpɔ̃̄kpɔ̃̄dɔ̃́
pọnun	kpɔ̃́ũ̀
pọpọṣinṣin	kpɔ̀kpɔ̀ʃĩ̀ʃĩ̀
pọsii	kpɔ̀síī
pọtimanto	kpɔ̄tīmáŋ́tò
pọtuga	kpɔ́túgà
pọtọpọtọ	kpɔ̀tɔ̀kpɔ́tɔ̀
r	ɾ
r	ɾí
ra	ɾà
ra	ɾá
ra	ɾā
rago	ɾàgó
ragoliisi	ɾágólíìsì
raisi	ɾáìsì
rakunmi	ɾàkũ̄mĩ́
rakunmi	ɾàkṹmĩ́
ramuramu	ɾāmṹɾāmũ̀
ranlọwọ	ɾã̀lɔ́wɔ́
ranti	ɾã́tí
ranṣẹ	ɾã́ʃɛ́
rara	ɾáɾà
rara	ɾáɾá
raun	ɾáũ̀
raye	ɾájè
raye	ɾājè
raye	ɾājē
re	ɾè
re	ɾé
rege	ɾégè
rekọja	ɾékɔ̄dʒá
reluwee	ɾélùwéè
ri	ɾì
ri	ɾí
ri	ɾī
ria	ɾīā
riba	ɾìbá
rii	ɾìí
rikiṣi	ɾìkíʃí
rin	ɾĩ̀
rin	ɾĩ́
rin	ɾĩ̄
rinniigake	ɾĩ̀nĩ́ìgàkè
riran	ɾíꜜɾã̄
risiiti	ɾìsíìtì
risinkin	ɾísĩ̄kĩ̄
ro	ɾò
ro	ɾó
ro	ɾō
roboto	ɾóbótó
roboto	ɾōbōtō
rogbodiyan	ɾògbòdìjã̀
roguro	ɾógùɾò
roju	ɾódʒú
roju	ɾōdʒú
romania	ɾòmáníà
ronupiwada	ɾōnṹkpìwàdà
roro	ɾōɾò
rorẹ	ɾōɾɛ́
rotimi	ɾótìmĩ́
run	ɾũ̀
run	ɾũ̄
run	ɾṹ
ruuru	ɾúùɾù
ruwanda	ɾùwáŋ́dà
rẹ	ɾɛ̀
rẹ	ɾɛ̄
rẹfiri	ɾɛ̄fīɾí
rẹjẹ	ɾɛ́dʒɛ̄
rẹkorẹko	ɾɛ́kóɾɛ́kó
rẹmọ	ɾɛ́mɔ̃̄
rẹn	ɾɛ̃̀
rẹn	ɾɛ̃́
rẹn	ɾɛ̃̄
rẹnfẹnrẹnfẹn	ɾɛ̃̄fɛ̃́ɾɛ̃̄fɛ̃́
rẹwa	ɾɛ̄wà
rẹwabiegbin	ɾɛ̄wàbíēgbĩ̄
rọ	ɾɔ̀
rọ	ɾɔ̄
rọbi	ɾɔ̄bí
rọn	ɾɔ̃̄
rọnlọọ	ɾɔ̃̀lɔ́ɔ́
rọparọsẹ	ɾɔ̄kpáɾɔ̄sɛ̀
rọra	ɾɔ̄ɾā
rọṣia	ɾɔ́ʃíà
s	s
s	sí
saa	sáà
saafula	sáàfúlà
saaki	sáákì
saari	sààɾì
saba	sábà
sababi	sábàbí
sabiganna	sābīgã̀nã́
sadankata	sàdáŋ́kátà
safuroni	sáfúɾónĩ̀
sakaani	sàkáánĩ́
sakara	sákáɾà
salakọ	sàlàkɔ́
salubata	sálúbàtà
samaani	sàmáánĩ̀
samu	sàmũ̀
san	sã̀
san	sã́
san	sã̄
sanbia	sáŋ́bíà
sango	sã̀gó
sanma	sã́mà
sanmọni	sã̀mɔ̃́nĩ̀
sanra	sã̄ɾā
sanyan	sã́jã́
sao	sàò
sapa	sākpá
saraa	sàɾáà
saraki	sàɾàkí
sare	sáɾé
saree	sàɾéè
saro	sàɾó
sarootu	sàɾōōtù
satani	sátánì
sayẹnsi	sájɛ́ŋ̀sì
saṣẹrẹ	sàʃɛ́ɾɛ́
se	sè
se	sé
sefanaya	sēfānã́jà
segesege	ségēsègē
sekaraya	sēkāɾájà
si	sí
sibi	sìbí
siga	sìgá
silebu	sílébù
simẹsimẹ	sìmɛ̀sìmɛ̀
sin	sĩ̀
sin	sĩ́
sin	sĩ̄
sinamoni	sínã́mónĩ̀
sinbabuwe	sìŋ̀bábúwè
singbọnlẹ	sĩ́gbɔ̃̄lɛ̀
sinima	sīnīmá
sinki	síŋ́kì
sinmi	sĩ̄mĩ̄
sinu	sínṹ
sinwin	sĩ́wĩ́
sipeeni	síkpéènì
siria	síɾíà
sirialoonu	sīɾīālóònù
sirilanka	sīɾīláŋ́kà
sisi	sísì
sisi	sīsí
sita	síꜜtā
sitefanu	sítéfánù
sobiya	sòbìjà
sogundogoji	sōgṹdōgódʒì
soke	sókè
sokoto	sókótó
somalia	sòmálíà
sori	sóɾí
sose	sòsé
sudaani	sùdáànì
sufee	súfèé
suke	súkè
suna	súnã̀
suna	súnã́
sunami	sùnámì
sunkanmi	sṹkã̀mĩ́
sunkun	sũ̄kṹ
sunmọ	sṹmɔ̃́
sunta	sũ̀tā
sunwọn	sũ̄wɔ̃̀
suura	súúɾà
suuru	sùúɾù
suurulere	sùúɾùléɾè
suya	sújà
sẹ	sɛ̀
sẹ	sɛ́
sẹloteepu	sɛ̄lōtéèkpù
sẹlẹmọ	sɛ́lɛ̄mɔ̃̄
sẹlẹru	sɛ́lɛ̀ɾú
sẹn	sɛ̃̀
sẹn	sɛ̃́
sẹngwa	sɛ̃̄gʷà
sẹntimita	sɛ̀ŋ̀tímítà
sẹnẹga	sɛ̀nɛ̀gà
sẹriya	sɛ̀ɾíjà
sọ	sɔ̄
sọgbodilesọgbẹdigboro	sɔ̄gbódīlésɔ̀gbɛ́dìgbōɾō
sọmọdọbọ	sɔ̄mɔ̃̄dɔ̀bɔ̄
sọrọ	sɔ̀ɾɔ̀
sọrọsoke	sɔ̀ɾɔ̀sókè
sọrọsọrọ	sɔ̀ɾɔ̀sɔ̀ɾɔ̀
sọwedowo	sɔ̀wédōwó
sụọn	sʊ̄ɔ̃̀
t	t
t	tí
ta	tà
ta	tā
taaba	táábà
taara	tààɾà
taara	tāàɾá
taba	tábà
tabi	tàbí
tabili	tábìlì
tadawa	tàdáwà
tafatafa	tāfàtāfà
tailandi	táíláŋ̀dì
taiwo	táíwò
tajutaju	tādʒútādʒú
taka	tàkā
takada	tákàdá
takasufee	tàkāsúfèé
takele	tàkèlè
takele	tākèlè
takete	tākété
takisi	tākīsí
talabi	tàlàbí
talaka	tálákà
talika	tálíkà
tanapoṣo	tānã́kpōʃó
tanganran	tã́gã̄ɾã̄
tanjẹ	tã̀dʒɛ̄
tanmọọ	tã̀mɔ̃́ɔ̃̀
tannatanna	tã̄nã́tã̄nã́
tansania	tàŋ̀sáníà
tapa	tákpà
tata	tātā
tatapupu	tātākpùkpù
tatase	tàtàsé
tautau	táútáú
tawe	tàwé
taye	tájé
tayelolu	tájélōlú
telọ	télɔ̀
tete	tētē
ti	tì
ti	tí
ti	tī
tii	tíì
tilẹyin	tìlɛ́jĩ̀
timi	tìmĩ̀
timitimi	tìmĩ̀tìmĩ̀
timutimu	tìmũ̀tìmũ̀
tin	tĩ̄
tiree	tíɾéè
tirela	tíɾélà
tiro	tīɾō
tiroo	tìɾóò
titi	títì
titi	títí
titun	tītũ̄
tiṣa	tíʃà
tiọri	tíɔ́ɾì
to	tò
to	tó
tobi	tòbí
tobi	tóbī
togo	tógò
tolotolo	tòlótòló
tomati	tòmátì
tomatielejo	tòmátìēlédʒò
too	tóò
toro	tòɾò
tufalu	túfálù
tufulu	túfúlù
tuka	túká
tulasi	túlàsì
tulẹtulẹ	túlɛ̀túlɛ̀
tunba	túŋ́bá
tunisia	tùnísíà
tuntun	tũ̄tũ̄
turari	tùɾàɾí
tutu	tūtù
tuuba	túúbá
tuubu	túùbù
tuubu	túúbú
tuulu	túúlū
tẹ	tɛ̀
tẹ	tɛ́
tẹba	tɛ̀bà
tẹjade	tɛ̀dʒádē
tẹjumalejo	tɛ̄dʒúmáꜜlēdʒò
tẹli	tɛ́lì
tẹlifiṣọn	tɛ̄līfíʃɔ̃̀
tẹlẹ	tɛ́lɛ̀
tẹnanti	tɛ́nã́ŋ̀tì
tẹnbẹlẹkun	tɛ̀ŋ̀bɛ̀lɛ̀kũ̄
tẹpamọṣẹ	tɛ̄kpámɔ̃́ʃɛ́
tọ	tɔ̀
tọ	tɔ́
tọ	tɔ̄
tọju	tɔ́dʒú
tọki	tɔ́kì
tọrọ	tɔ́ɾɔ́
tọrọ	tɔ̄ɾɔ̄
tọọrọ	tɔ́ɔ́ɾɔ́
tọọrọagbọn	tɔ́ɔ́ɾɔ́àgbɔ̃̀
u	u
u	ú
ubirọ	ùbíɾɔ̀
ubisi	ūbīsí
ubo	ūbō
ubosi	ūbōsí
ubu	ùbú
ubu	ūbú
ubujẹ	ūbùdʒɛ̄
ubujẹrun	ūbùdʒɛ̄ɾũ̄
ubusu	ūbùsù
uda	ūdà
udako	ūdàkó
udangho	ùdã́ɣò
udano	ʊ̀dã́ò
udaun	ùdáũ̀
uderegbe	ùdéɾègbè
udi	ùdí
udimdi	ūdīŋ̄dī
udiroko	ùdìɾókò
udodo	ūdōdō
udẹ	ùdɛ̀
udẹ	ūdɛ̄
udẹn	ùdɛ̃́
ufẹ	ūfɛ̀
ufẹ	ʊ̄fɛ̀
uga	ùgà
uga	ūgā
ugba	ùgbà
ugba	ūgbá
ugba	ʊ̀gbà
ugba	ʊ̄gbá
ugbafẹ	ùgbāfɛ́
ugbin	ùgbĩ́
ugbogbo	ùgbógbó
ugbẹn	ùgbɛ̃́
ugha	ùɣà
ughaghe	ùɣáɣè
ughogho	ùɣòɣò
ughogho	ūɣòɣò
ughọ	ùɣɔ́
ugwẹ	ùgʷɛ̀
ugwọ	ùgʷɔ̄
uhin	ùhĩ̀
ujaamẹṣẹ	ùdʒāāmɛ̀ʃɛ̀
uji	ūdʒì
ukeke	ùkēkē
ukere	ūkèɾè
uko	ùkó
ukoko	ùkòkò
ukoko	ūkōkō
ukoti	ùkótí
ukoto	ùkòtó
ukoto	ùkótó
uku	ūkù
uku	ūkú
ukọ	ūkɔ̀
ulaa	ùláá
ule	ūlé
uleya	ūléjá
uli	ūlí
ulikuli	ūlíkúlí
ulooyinbo	ùlōòjĩ̀bó
ulu	ùlù
ulu	ùlú
ulẹ	ùlɛ̀
ulẹ	ūlɛ̀
ulọta	ùlɔ̄tā
un	ũ̄
un	ṹ
unagho	ùnã́ɣó
ununmu	ũ̄ũ̄mũ̄
uogbo	ūógbó
uparo	ùkpāɾò
uparo	ʊ̀kpāɾò
upe	ùkpè
upepe	ūkpèkpé
upole	ùkpólé
upuu	ūkpúù
upẹn	ùkpɛ̃̀
upẹn	ùkpɛ̃́
upẹrun	ùkpɛ̄ɾũ̄
uranlọọ	ʊ̀ɾɔ̃̀lɔ́ɔ́
ure	ūɾè
urere	ùɾèɾé
uroko	ùɾókò
urumu	ūɾūmũ̄
urun	ūɾũ̄
urunkurun	ūɾũ̄kúɾũ̄
urunmu	ūɾũ̄mũ̄
urẹn	ùɾɛ̃̀
usi	ùsì
usobo	ùsòbò
usẹ	ūsɛ́
usọkusọ	ùsɔ̄kúꜜsɔ̄
uta	ūtā
uta	ʊ̄tā
uwa	ùwà
uwe	ùwé
uwe	ūwē
uwowo	ūwòwò
uwẹ	ʊ̀wɛ̄
uwọ	ùwɔ̄
uwọn	ùwɔ̃̀
uwọn	ūwɔ̃̀
uwọn	ūwɔ̃́
uya	ùjà
uya	ùjá
uyanẹrun	ùjànɛ́ɾũ̄
uyi	ūjì
uza	ùzà
uṣu	ūʃū
uṣẹ	ūʃɛ́
uṣẹṣe	ùʃɛ̀ʃē
w	w
w	wí
wa	wà
wa	wá
wa	wā
waa	wàá
waapa	wáákpá
waasu	wàásù
wadowado	wádòwádò
waduwadu	wàdùwàdù
wahala	wàhálà
waja	wàdʒà
waja	wádʒà
waka	wákà
wakati	wákàtí
walahi	wàláhì
wara	wàɾà
warakaṣi	wàɾàkàʃì
warapa	wáɾákpá
warawara	wàɾàwàɾà
waye	wájé
wee	wèé
wele	wélē
were	wèɾè
werepe	wèɾèkpè
wi	wì
wi	wí
wi	wī
win	wĩ̀
win	wĩ́
wo	wò
wo	ꜜwō
wolewole	wōléwōlé
wolii	wòlíì
worawọ	wòɾàwɔ̀
worobo	wóɾóbō
wowo	wówó
wowo	wówō
woṣere	wōʃēɾē
wu	wù
wu	wú
wu	wū
wukuwuku	wùkúwùkú
wundia	wúŋ́díá
wunrẹn	wṹɾɛ̃̀
wunrẹnidanwo	wṹɾɛ̃̀ìdã́wò
wura	wúɾà
wuraọla	wúɾàɔ̄lá
wure	wúɾē
wuruwuru	wúɾūwùɾū
wuwo	wúwō
wẹ	wɛ̀
wẹ	wɛ́
wẹ	wɛ̄
wẹdo	wɛ̄dò
wọ	wɔ̀
wọ	wɔ́
wọde	wɔ̀dē
wọde	wɔ́ꜜdē
wọle	wɔ̄lé
wọn	wɔ̃̀
wọn	wɔ̃́
wọnwe	wɔ̃̀wé
wọnyi	wɔ̃̀jí
wọnyẹn	wɔ̃̀jɛ̃̀
wọnyẹn	wɔ̃̀jɛ̃̄
y	j
y	jí
ya	jà
ya	já
ya	jā
yaarawa	jàāɾāwā
yagba	jàgbà
yala	jálà
yalẹnu	jàlɛ́nũ̄
yama	jámà
yanana	jànã̀nã́
yangan	jã̄gã̄
yangi	jã̄gí
yanju	jã̄dʒú
yannana	jã̀nã̀nã́
yanpọnyanrin	jã́kpɔ̃̄jã́ɾĩ̄
yanyan	jã́jã̀
yara	jàɾá
yariini	jāɾíìnĩ̀
yauyauu	jàújàúù
ye	jè
ye	jé
yee	jéè
yekeyeke	jékéjéké
yemowo	jémòwó
yemowo	jēmòwó
yemọja	jēmɔ̃̄dʒā
yere	jèɾè
yesi	jèsí
yewa	jēwā
yeye	jèjé
yeye	jéjē
yeyemuye	jéjémũ̀jé
yi	jí
yi	jī
yigi	jìgì
yii	ꜜjí
yimiyimi	jímĩ́jímĩ́
yin	jĩ́
yinki	jíŋ̀kì
yinnu	jĩ̀nũ̀
yinrunyinrun	jĩ́ɾũ̀jĩ́ɾũ̀
yinyin	jĩ̀jĩ́
yio	jíò
yio	jíó
yisa	jísá
yo	jó
yonbo	jòŋ̀bó
yoo	jóò
yoo	jóó
yooku	jòókù
yoruba	jōɾùbá
yu	jú
yubẹ	júbɛ̀
yugọọti	júgɔ́ɔ̀tì
yukireeni	jūkíɾéènì
yun	jũ̀
yun	j̃ṹ
yungba	jũ̀gbà
yunifasiti	jūnĩ̄fásítì
yureniọ	jūɾénĩ́ɔ̃̀
yuro	júɾò
yuroopu	júɾóòkpù
yẹi	jɛ̀ì
yẹn	jɛ̃̀
yẹn	jɛ̃́
yẹn	ꜜjɛ̃̄
yẹpẹrẹ	jɛ̄kpɛ̄ɾɛ̄
yẹra	jɛ̄ɾā
yẹri	jɛ̀ɾì
yẹti	jɛ̄tí
yẹukẹ	jɛ́úkɛ́
yọ	jɔ̀
yọ	jɔ́
yọ	jɔ̄
yọn	jɔ̃̀
yọnda	jɔ̀ŋ̀dā
yọyinyọyin	jɔ̄jĩ́jɔ̄jĩ́
yụn	jʊ̃̀
zokoo	zóꜜkó
zẹ	zɛ̄
ɔ̀	ɔ̀
ɔ́	ɔ́
ɔ̂	ɔ̂
ɔ̄	ɔ̄
ɔ̌	ɔ̌
ɛ̀	ɛ̀
ɛ́	ɛ́
ɛ̂	ɛ̂
ɛ̄	ɛ̄
ɛ̌	ɛ̌
ḿ	ḿ̩
ṣ	ʃ
ṣ	ʃí
ṣaadi	ʃáàdì
ṣaanu	ʃàánṹ
ṣaata	ʃáátá
ṣabẹẹ	ʃábɛ̀ɛ́
ṣafikun	ʃàfīkṹ
ṣagidi	ʃāgídí
ṣago	ʃágō
ṣaina	ʃáínà
ṣainọn	ʃàínɔ̃́
ṣakabula	ʃākābùlà
ṣakaṣaka	ʃàkàʃàkà
ṣakaṣaka	ʃákāʃàkā
ṣaki	ʃàkì
ṣakoso	ʃàkósō
ṣalaisi	ʃāláìsí
ṣalanga	ʃáláŋ́gá
ṣalaye	ʃàlàjé
ṣango	ʃã̀gó
ṣanpọnna	ʃã̀kpɔ̃̀nã́
ṣatunto	ʃàtṹtò
ṣatunṣe	ʃàtṹʃē
ṣawada	ʃàwàdà
ṣawari	ʃàwáɾí
ṣawawi	ʃàwáwí
ṣaworo	ʃàwòɾò
ṣaworo	ʃāwōɾō
ṣayẹwo	ʃàjɛ̀wò
ṣe	ʃé
ṣe	ʃē
ṣege	ʃégè
ṣegede	ʃēgēdē
ṣeleri	ʃèléɾí
ṣelu	ʃèlú
ṣenji	ʃéŋ́dʒì
ṣepinya	ʃèkpĩ́jà
ṣere	ʃēɾé
ṣeto	ʃètò
ṣewadii	ʃèwádìí
ṣi	ʃì
ṣi	ʃí
ṣi	ʃī
ṣibaṣibo	ʃìbáʃìbō
ṣibi	ʃíbí
ṣigidi	ʃìgìdì
ṣigidi	ʃígídí
ṣigidi	ʃīgīdī
ṣigun	ʃīgũ̄
ṣikago	ʃìkágò
ṣikiti	ʃìkìtì
ṣiko	ʃíkó
ṣile	ʃílè
ṣimi	ʃīmĩ́
ṣingọọmu	ʃĩ̄gɔ́ɔ̀mũ̀
ṣinko	ʃíŋ́kō
ṣiripake	ʃíɾíkpàkè
ṣiyemeji	ʃījèmédʒì
ṣiṣe	ʃíʃē
ṣiṣẹ	ʃīʃɛ́
ṣofofo	ʃòfófó
ṣojo	ʃōdʒō
ṣokoleeti	ʃōkōléètì
ṣokoto	ʃòkòtò
ṣokunfa	ʃōkũ̀fà
ṣoro	ʃòɾō
ṣoro	ʃōɾó
ṣoyinka	ʃójíŋ̄ká
ṣoṣo	ʃōʃō
ṣubu	ʃūbú
ṣuga	ʃúgà
ṣugbọn	ʃùgbɔ̃́
ṣukuu	ʃùkúù
ṣukuṣuku	ʃùkùʃùkù
ṣun	ʃṹ
ṣẹ	ʃɛ̀
ṣẹ	ʃɛ́
ṣẹ	ʃɛ̄
ṣẹda	ʃɛ̀dà
ṣẹda	ʃɛ̀dá
ṣẹgi	ʃɛ̀gī
ṣẹgilọla	ʃɛ̀gílɔ̄lá
ṣẹju	ʃɛ́dʒú
ṣẹkẹrẹ	ʃɛ̀kɛ̀ɾɛ̀
ṣẹkẹtẹ	ʃɛ̀kɛ̀tɛ́
ṣẹkẹṣẹkẹ	ʃɛ̄kɛ́ʃɛ̄kɛ̀
ṣẹlẹ	ʃɛ̄lɛ̀
ṣẹlẹru	ʃɛ́lɛ̀ɾú
ṣẹpuṣẹpu	ʃɛ́kpúʃɛ́kpú
ṣẹrẹ	ʃɛ̀ɾɛ́
ṣẹrẹ	ʃɛ̄ɾɛ̄
ṣẹẹti	ʃɛ́ɛ̀tì
ṣọbiri	ʃɔ́bìɾì
ṣọdẹ	ʃɔ̄dɛ̄
ṣọkọrọgbọdọ	ʃɔ̄kɔ̄ɾɔ̀gbɔ̀dɔ̀
ṣọkụrọ	ʃɔ́kʊ̀ɾɔ́
ṣọlagbade	ʃɔ̄lágbādé
ṣọnpọnnọ	ʃɔ̃̀kpɔ̃̀nɔ́
ṣọun	ʃɔ̀ṹ
ṣọwọn	ʃɔ̀wɔ̃́
ṣọọbu	ʃɔ́ɔ̀bù
ṣọọki	ʃɔ́ɔ̀kì
ṣọọn	ʃɔ̀ɔ̃́
ṣọọṣi	ʃɔ́ɔ̀ʃì
ṣụnṣụnwịnwịn	ʃʊ̃̀ʃʊ̃̀wɪ̃̄wɪ̃̄
ẹ	ɛ
ẹ	ɛ̀
ẹ	ɛ́
ẹ	ɛ́ɛ̀
ẹ	ɛ̄
ẹba	ɛ̀bà
ẹba	ɛ̀bá
ẹbafin	ɛ̄báfĩ́
ẹbi	ɛ̀bí
ẹbi	ɛ̀bī
ẹbi	ɛ̄bí
ẹbibi	ɛ̀bìbì
ẹbinẹyin	ɛ̀bínɛ́jĩ̀
ẹbiti	ɛ̀bìtì
ẹbu	ɛ̄bū
ẹbun	ɛ̀bũ̀
ẹburu	ɛ̀bùɾú
ẹburumbu	ɛ̀bùɾúŋ̀bú
ẹbẹkọn	ɛ̀bɛ́kɔ̃̀
ẹbọ	ɛ̄bɔ̄
ẹbọgu	ɛ̀bɔ́gù
ẹbọnyi	ɛ̀bɔ̃́jì
ẹbọra	ɛ̄bɔ̄ɾā
ẹda	ɛ̀dà
ẹda	ɛ̀dá
ẹda	ɛ̄dá
ẹdinwo	ɛ̀dĩ́wó
ẹdiyẹ	ɛ̄dìjɛ̄
ẹdo	ɛ̄dó
ẹdun	ɛ̄dũ̀
ẹdun	ɛ̄dũ̄
ẹdunarinlẹ	ɛ̄dũ̄āɾĩ̄lɛ̀
ẹduwẹ	ɛ̄dùwɛ̄
ẹdọ	ɛ̀dɔ̀
ẹdọforo	ɛ̀dɔ̀fóɾó
ẹdọn	ɛ̄dɔ̃̀
ẹdọn	ɛ̄dɔ̃̄
ẹfa	ɛ̀fà
ẹfun	ɛ̄fũ̄
ẹfunikunwe	ɛ̄fũ̄ìkũ̀wé
ẹfunpọroye	ɛ̄fṹkpɔ̀ɾójè
ẹfunṣetan	ɛ̄fṹʃētã́
ẹfuufu	ɛ̀fúùfù
ẹfịnfịn	ɛ̄fɪ̃̄fɪ̃̄
ẹfọ	ɛ̀fɔ́
ẹfọn	ɛ̀fɔ̃́
ẹfọn	ɛ̀fɔ̃̄
ẹfọn	ɛ̄fɔ̃̀
ẹfọn	ɛ̄fɔ̃́
ẹfọnha	ɛ̄fɔ̃́hà
ẹga	ɛ̀gà
ẹga	ɛ̀gā
ẹgba	ɛ̀gbà
ẹgba	ɛ̀gbá
ẹgba	ɛ̄gbā
ẹgbaa	ɛ̄gbàá
ẹgbado	ɛ̀gbádò
ẹgbin	ɛ̀gbĩ̀
ẹgbin	ɛ̀gbĩ̄
ẹgbẹ	ɛ̀gbɛ́
ẹgbẹ	ɛ̀gbɛ̄
ẹgbẹ	ɛ̄gbɛ́
ẹgbẹn	ɛ̀gbɛ̃̄
ẹgbẹnọ	ɛ̀gbɛ́nɔ̀
ẹgbẹrun	ɛ̄gbɛ̀ɾṹ
ẹgbẹẹgbẹ	ɛ̀gbɛ̀ɛ̀gbɛ́
ẹgbọn	ɛ̀gbɔ̃́
ẹghẹn	ɛɣɛ̃̄
ẹghẹn	ɛ̀ɣɛ̃̄
ẹghẹnghẹn	ɛ̄ɣɛ̃̀ɣɛ̃́
ẹgin	ɛ̀gĩ̄
ẹgunjẹ	ɛ̀gṹdʒɛ̄
ẹgunsi	ɛ̀gṹsí
ẹgusi	ɛ̀gúsí
ẹgwa	ɛ̀gʷà
ẹgwa	ɛ̀gʷá
ẹgwa	ɛ̄gʷà
ẹgẹ	ɛ̀gɛ́
ẹgẹdẹ	ɛ̀gɛ̀dɛ̀
ẹhin	ɛ̀hĩ̀
ẹja	ɛ̄dʒá
ẹja	ɛ̄dʒā
ẹjaapatamaja	àkpátámàdʒà
ẹjaarọ	ɛ̄dʒāàɾɔ̀
ẹjaonida	ɛ̄dʒāōnĩ́dà
ẹjaonirungbọn	ɛ̄dʒāōnĩ́ɾũ̀gbɔ̃̀
ẹjaṣawa	ɛ̄dʒāāʃáwá
ẹjaọsan	ɛ̄dʒāɔ̄sã̀
ẹjoji	ɛ̀dʒòdʒì
ẹjẹ	ɛ̀dʒɛ̀
ẹjẹriru	ɛ̀dʒɛ̀ɾíɾū
ẹjọ	ɛ̀dʒɔ̄
ẹjọ	ɛ̄dʒɔ́
ẹka	ɛ̀kà
ẹka	ɛ̀kā
ẹka	ɛ̄kà
ẹkaede	ɛ̀kāèdè
ẹkiri	ɛ̀kìɾì
ẹkisodu	ɛ́kísódù
ẹku	ɛ̀kú
ẹkun	ɛ̀kṹ
ẹkun	ɛ̄kũ̀
ẹkun	ɛ̄kṹ
ẹkunijọbaibilẹ	ɛ̄kũ̀ìdʒɔ̄bāìbílɛ̀
ẹkurẹ	ɛ̀kùɾɛ́
ẹkuẹ	ɛ̀kùɛ́
ẹkẹ	ɛ̄kɛ́
ẹkẹ	ɛ̄kɛ̄
ẹkịkọnnọ	ɛ̀kɪ́kɔ̃́nɔ́
ẹkịkụn	ɛ̄kɪ́kʊ̃́
ẹkọ	ɛ̀kɔ́
ẹkọ	ɛ̀kɔ̄
ẹkọifọwọyaworan	ɛ̀kɔ́ìfɔ̄wɔ́jàwòɾã́
ẹkọile	ɛ̀kɔ́īlé
ẹkụrẹ	ɛ̀kʊ̀ɾɛ́
ẹla	ɛ̀là
ẹla	ɛ̄lá
ẹliri	ɛ̀líɾí
ẹlomii	ɛ̄lòmĩ́ĩ̀
ẹlomiran	ɛ̄lòmĩ́ɾã̀
ẹlu	ɛ̀lú
ẹlulu	ɛ̀lúlú
ẹlẹdaa	ɛ̄lɛ́ꜜdá
ẹlẹdẹ	ɛ̄lɛ́dɛ̀
ẹlẹgungun	ɛ̄lɛ́gũ̄gũ̀
ẹlẹha	ɛ̄lɛ́hà
ẹlẹja	ɛ̄lɛ́dʒā
ẹlẹkọle	ɛ̄lɛ́kɔ̀lé
ẹlẹluu	ɛ̄lɛ́ꜜlú
ẹlẹmu	ɛ̄lɛ́mũ̄
ẹlẹnuiru	ɛ̄lɛ́nũ̄īɾú
ẹlẹpa	ɛ̄lɛ́kpà
ẹlẹrindodo	ɛ̄lɛ́ɾĩ̀dòdò
ẹlẹsinjẹ	ɛ̄lɛ́sĩ̀dʒɛ́
ẹlẹwọn	ɛ̄lɛ́wɔ̃̀
ẹlẹyamẹya	ɛ̄lɛ́jàmɛ̀jà
ẹlẹyinjuaanu	ɛ̄lɛ́jĩ̄dʒúàánṹ
ẹlịla	ɛ̄lɪ̄lá
ẹmi	ɛ̀mĩ́
ẹmilalẹ	ɛ̀mɪ̃̀lālɛ̀
ẹmu	ɛ̄mũ̄
ẹmudo	ɛ̀mṹdó
ẹmọ	ɛ̄mɔ̃́
ẹmọ	ɛ̄mɔ̃̄
ẹmụẹ	ɛ̀mʊ̃̀ɛ̃̀
ẹn	ɛ̃̀
ẹn	ɛ̃̄
ẹna	ɛ̄nã̀
ẹni	ɛ̄nĩ́
ẹni	ɛ̄nĩ̄
ẹnikẹni	ɛ̄nĩ̄kɛ́nĩ̄
ẹnitiọkanmiyan	ɛ̄nĩ̄tíɔ̄kã̀mĩ̄jã̀
ẹnjinia	ɛ̄ŋ̄dʒīníà
ẹnu	ɛ̄nũ̄
ẹnugu	ɛ̄nṹgū
ẹnịnụ	ɛ̀nɪ̃́nʊ̃́
ẹpa	ɛ̀kpà
ẹparoro	ɛ̀kpàɾòɾō
ẹpiya	ɛ̀pìjà
ẹpẹ	ɛ̀kpɛ́
ẹpẹyọ	ɛ̀kpɛ̀jɔ̀
ẹpọn	ɛ̀kpɔ̃́
ẹpọn	ɛ̄kpɔ̃̀
ẹpọn	ɛ̄kpɔ̃́
ẹran	ɛ̄ɾã̄
ẹranko	ɛ̄ɾã̄kō
ẹrankoayasẹ	ɛ̄ɾã̄kōājāsɛ̀
ẹranmi	ɛ̄ɾã̄mĩ̄
ẹri	ɛ̀ɾí
ẹri	ɛ̄ɾī
ẹrin	ɛ̀ɾĩ́
ẹrin	ɛ̀ɾĩ̄
ẹrindinlaaadọta	ɛ̀ɾĩ̀dĩ́láàádɔ́tā
ẹrindinlogoji	ɛ̀ɾĩ̀dĩ́lógódʒì
ẹrindinlogun	ɛ̀ɾĩ̀dĩ́lógṹ
ẹrindinlọgbọn	ɛ̀ɾĩ̀dĩ́lɔ́gbɔ̃̀
ẹrindinlọgọta	ɛ̀ɾĩ̀dĩ́lɔ́gɔ́tā
ẹrinkeekee	ɛ̀ɾĩ́kèékèé
ẹrinkk	ɛ̀ɾĩ́kèékèé
ẹrinkk	ɛ̀ɾĩ́kɛ̀ɛ́kɛ̀ɛ́
ẹrinkẹẹkẹẹ	ɛ̀ɾĩ́kɛ̀ɛ́kɛ̀ɛ́
ẹrinla	ɛ̀rĩ̀lá
ẹrinlelaaadọta	ɛ̀ɾĩ̀léláàádɔ́tā
ẹrinlelogoji	ɛ̀ɾĩ̀lélógódʒì
ẹrinlelogun	ɛ̀ɾĩ̀lélógṹ
ẹrinlelọgbọn	ɛ̀ɾĩ̀lélɔ́gbɔ̃̀
ẹru	ɛ̀ɾù
ẹru	ɛ̀ɾú
ẹru	ɛ̄ɾù
ẹru	ɛ̄ɾú
ẹrun	ɛ̄ɾũ̄
ẹrẹja	ɛ̄ɾɛ́dʒà
ẹrẹkẹ	ɛ̀ɾɛ̀kɛ́
ẹrẹna	ɛ̀ɾɛ̀nã̀
ẹrẹna	ɛ̄ɾɛ̀nã̀
ẹrẹna	ɛ̄ɾɛ́nã̀
ẹrẹwọn	ɛ̄ɾɛ̄wɔ̃̄
ẹrọ	ɛ̀ɾɔ̄
ẹrọagbaworanyọ	ɛ̀ɾɔ̄āmógbáwòɾã́jɔ̄
ẹrọagbeniroke	ɛ̀ɾɔ̄āgbénĩ̄ɾòkè
ẹrọamohunmaworan	ɛ̀ɾɔ̄āmóhũ̀máwòɾã́
ẹrọamohuntutu	ɛ̀ɾɔ̄āmóhũ̄tūtù
ẹrọamuletutu	ɛ̀ɾɔ̄āmṹlétūtù
ẹrọamunawa	ɛ̀ɾɔ̄āmṹnã́wá
ẹrọamunawaalẹfuufu	ɛ̀ɾɔ̄āmṹnã́wáālɛ̀fúùfù
ẹrọamunimi	ɛ̀ɾɔ̄āmṹnĩ̄mĩ́
ẹrọasọrọmagbesi	ɛ̀ɾɔ̄āsɔ̀ɾɔ̀mágbèsì
ẹrọayarabiaṣa	ɛ̀ɾɔ̄ājáɾābíàʃá
ẹrọayaworan	ɛ̀ɾɔ̄ājàwòɾã́
ẹrọayelujara	ɛ̀ɾɔ̄ājélūdʒáɾā
ẹrọgbohungbohun	ɛ̀ɾɔ̄gbōhũ̀gbōhũ̀
ẹrọibanisọrọ	ɛ̀ɾɔ̄ìbánĩ̄sɔ̀ɾɔ̀
ẹrọifọbọ	ɛ̀ɾɔ̄ìfɔ̄bɔ́
ẹrọifọṣọ	ɛ̀ɾɔ̄ìfɔ̄ʃɔ̄
ẹrọilọnkan	ɛ̀ɾɔ̄ìlɔ̄ŋ̀kã̄
ẹrọiranṣọ	ɛ̀ɾɔ̄ìɾã́ʃɔ̄
ẹrọitẹwe	ɛ̀ɾɔ̄ìtɛ̀wé
ẹrọiṣawari	ɛ̀ɾɔ̄ìʃàwáɾí
ẹrọiṣiro	ɛ̀ɾɔ̄ìʃíɾò
ẹrụn	ɛ̄ɾʊ̃̄
ẹsa	ɛ̀sà
ẹsan	ɛ̀sã̄
ẹsan	ɛ̀sɔ̃́
ẹsin	ɛ̀sĩ̀
ẹsin	ɛ̀sĩ́
ẹsin	ɛ̄sĩ̄
ẹsinadimula	ɛ̀sĩ̀àdìmṹlà
ẹsinmirin	ɛ̀sĩ̀mĩ̀ɾĩ̀
ẹsẹ	ɛ̄sɛ̀
ẹsẹ	ɛ̄sɛ̄
ẹsẹntaye	ɛ̄sɛ̀ŋ̀tájé
ẹsẹntaye	ɛ̄sɛ̀ŋ̄tájé
ẹta	ɛ̀tā
ẹta	ɛ̄tà
ẹtadinlaaadọta	ɛ̀tàdĩ́láꜜádɔ́tā
ẹtadinlogoji	ɛ̀tàdĩ́lógódʒì
ẹtadinlogun	ɛ̀tã̀dĩ́lógṹ
ẹtadinlọgbọn	ɛ̀tàdĩ́lɔ́gbɔ̃̀
ẹtadinlọgọta	ɛ̀tàdĩ́lɔ́gɔ́tā
ẹtala	ɛ̀tàlá
ẹtalelaaadọta	ɛ̀tàléláàádɔ́tā
ẹtalelogoji	ɛ̀tàlélógódʒì
ẹtalelogun	ɛ̀tàlélógṹ
ẹtalelọgbọn	ɛ̀tàlélɔ́gbɔ̃̀
ẹtaoko	ɛ̀tāòkò
ẹtu	ɛ̀tù
ẹtu	ɛ̄tù
ẹtu	ɛ̄tū
ẹtẹ	ɛ̀tɛ̀
ẹtẹ	ɛ̀tɛ́
ẹtịpa	ɛ̀tɪ̀kpá
ẹtọọmọniyan	ɛ̀tɔ́ɔ̄mɔ̃̄nĩ̀jã̀
ẹtụpa	ɛ̀tʊ̀kpá
ẹu	ɛ̄ù
ẹun	ɛ̄ũ̄
ẹurẹ	ɛ̄úɾɛ́
ẹwa	ɛ̀wà
ẹwa	ɛ̀wá
ẹwa	ɛ̄wà
ẹwadun	ɛ̀wádṹ
ẹwiri	ɛ̄wìɾì
ẹwu	ɛ̀wù
ẹwunrẹnkọn	ɛ̄wṹɾɛ̃̀kɔ̃̀
ẹwẹn	ɛ̀wɛ̃̄
ẹwẹn	ɛ̄wɛ̃̄
ẹwẹso	ɛ̀wɛ̀sō
ẹwọn	ɛ̀wɔ̃̀
ẹyawo	ɛ̀jáwó
ẹyin	ɛ̀jĩ̀
ẹyin	ɛ̀jĩ̄
ẹyin	ɛ̄jĩ̀
ẹyin	ɛ̄jĩ̄
ẹyinju	ɛ̄jĩ̄dʒú
ẹyun	ɛ̄jṹ
ẹyunbọ	ɛ̀jṹbɔ̀
ẹyẹ	ɛ̀jɛ̄
ẹyẹ	ɛ̄jɛ̄
ẹyẹaganran	ɛ̄jɛ̄āgã́ɾã́
ẹyẹakoko	ɛ̄jɛ̄àkókó
ẹyẹle	ɛ̄jɛ̄lé
ẹyẹṣango	ɛ̄jɛ̄ʃã̀gó
ẹyịnyịn	ɛ̄jɪ̃̀jɪ̃́
ẹyọ	ɛ̀jɔ̀
ẹyọ	ɛ̄jɔ̄
ẹyọlọ	ɛ̄jɔ́lɔ́
ẹ̀	ɛ̀
ẹ́	ɛ́
ẹ̄	ɛ̄
ẹ̌	ɛ̌
ẹṣe	ɛ̄ʃé
ẹṣeun	ɛ̄ʃēũ̄
ẹṣin	ɛ̄ʃĩ̄
ẹẹdogun	ɛ̀ɛ́dógṹ
ẹẹfa	ɛ̄ɛ́fà
ẹẹjọ	ɛ̄ɛ́ꜜdʒɔ̄
ẹẹkan	ɛ̀ɛ̀kã̄
ẹẹkẹ	ɛ̀ɛ̀kɛ́
ẹẹmeje	ɛ̀ɛ̀mēdʒē
ẹẹmeji	ɛ̀ɛ̀mēdʒì
ẹẹmẹfa	ɛ̀ɛ̀mɛ̄fà
ẹẹmẹjọ	ɛ̀ɛ̀mɛ̄dʒɔ̄
ẹẹmẹrin	ɛ̀ɛ̀mɛ̄ɾĩ̄
ẹẹmẹta	ɛ̀ɛ̀mɛ̄tā
ẹẹmẹwaa	ɛ̀ɛ̀mɛ̄ꜜwá
ẹẹra	ɛ̄ɛ́ɾà
ẹẹrin	ɛ̄ɛ́ꜜɾĩ̄
ẹẹta	ɛ̄ɛ́ꜜtā
ẹẹwaa	ɛ̄ɛ́ꜜwá
ẹẹyọ	ɛ̀ɛ̀jɔ̀
ẹẹọ	ɛ̀ɛ̀ɔ̀
ẹọn	ɛ̀ɔ̃̀
ẹụra	ɛ̄ʊ̀ɾà
ịarẹfa	ɪ̀àɾɛ̀fà
ịgbae	ʊ̄gbáè
ịgbẹ	ɪ̀gbɛ̀
ịgbị	ɪ̀gbɪ̀
ịja	ɪ̀dʒā
ịjakariọ	ɪ̀dʒàkáɾìɔ̀
ịjakịsa	ɪ̀dʒàkɪ́sà
ịn	ɪ̃́
ịpẹẹ	ɪ̀kpɛ́ɛ̀
ịra	ɪ̄ɾá
ịraọ	ɪ̀ɾàɔ̀
ịrọnyin	ɪ̄ɾɔ̃̄jĩ̀
ịta	ɪ̄tā
ịyara	ɪ̀jàɾà
ịyọ	ījɔ̀
ịyọnnịyọn	ɪ̀jɔ̃̀nɪ̃́jɔ̃̀
ọ	ɔ
ọ	ɔ́
ọ	ɔ̄
ọba	ɔ̄bà
ọba	ɔ̄bā
ọbaala	ɔ̄bāálá
ọbadio	ɔ̄bādìō
ọbakan	ɔ̄bàkã̄
ọbaluaye	ɔ̄bālúājé
ọbaluayesanya	ɔ̄bālúājésã̀jà
ọbalufọn	ɔ̄bàlùfɔ̃̀
ọbalufọn	ɔ̄bālùfɔ̃̀
ọbameri	ɔ̄bāmèɾì
ọbanla	ɔ̄bāŋ́lá
ọbanịfọn	ɔ̄bànɪ̃̀fɔ̃̀
ọbanịfọnṣae	ɔ̄bànɪ̃̀fɔ̃̀ʃāè
ọbaopojẹ	ɔ̄bāòkpódʒɛ̀
ọbara	ɔ̀bàɾà
ọbasanya	ɔ̄básã̀jà
ọbatala	ɔ̄bàtálá
ọbayejẹ	ɔ̀bàjédʒɛ́
ọbayejẹ	ɔ̀bājédʒɛ́
ọbu	ɔ̀bù
ọbun	ɔ̀bũ̀
ọbuntun	ɔ̄bũ̄tũ̄
ọbẹ	ɔ̀bɛ̄
ọbẹ	ɔ̄bɛ̀
ọbịnrịn	ɔ̄bɪ̃̀ɾɪ̃̄
ọbịtụn	ɔ̄bɪ̄tʊ̃̄
ọbọ	ɔ̀bɔ̀
ọbọ	ɔ̀bɔ̄
ọbọ	ɔ̄bɔ́
ọbọn	ɔ̀bɔ̃̀
ọbọnbọn	ɔ̀bɔ̃̀ũ̀bɔ̃̄ũ̀
ọbụtụn	ɔ̀bʊ́tʊ̃̀
ọda	ɔ̀dà
ọda	ɔ̀dá
ọdaju	ɔ̀dádʒú
ọdan	ɔ̀dã̀
ọdan	ɔ̄dã́
ọdun	ɔ̀dũ̀
ọdun	ɔ̄dṹ
ọdundun	ɔ̀dṹdṹ
ọdunedi	ɔ̄dṹēdì
ọdunigogo	ɔ̄dṹ
ọdunijẹṣu	ɔ̄dṹìdʒɛ̄ʃū
ọdunkun	ɔ̀dũ̀kṹ
ọdunọlọjọ	ɔ̄dṹɔ̄lɔ́dʒɔ́
ọdẹ	ɔ̀dɛ̀
ọdẹ	ɔ̄dɛ̄
ọdẹdiran	ɔ̄dɛ́dìɾã̄
ọdẹdẹ	ɔ̀dɛ̀dɛ̀
ọdẹgbami	ɔ̄dɛ́gbàmĩ́
ọdẹmọ	ɔ̄dɛ̄mɔ̃̄
ọdọ	ɔ̀dɔ̀
ọdọ	ɔ̀dɔ́
ọdọ	ɔ̀dɔ̄
ọdọfin	ɔ̀dɔ̀fĩ̄
ọdọn	ɔ̄dɔ̃́
ọdọọdun	ɔ̄dɔ̄ɔ̄dṹ
ọfa	ɔ̀fà
ọfa	ɔ̄fà
ọfafa	ɔ̀fàfà
ọfan	ɔ̀fã̄
ọfiisi	ɔ́fíìsì
ọfun	ɔ̀fũ̄
ọfọ	ɔ̄fɔ̀
ọfọn	ɔ̀fɔ̃̄
ọga	ɔ̀gà
ọga	ɔ̀gá
ọgan	ɔ̀gã̀
ọgan	ɔ̄gã́
ọganjọ	ɔ̀gã̀dʒɔ́
ọganwo	ɔ̀gã̀wó
ọgba	ɔ̀gbà
ọgba	ɔ̄gbà
ọgba	ɔ̄gbá
ọgba	ɔ̄gbā
ọgban	ɔ̀gbã́
ọgbara	ɔ̀gbàɾá
ọgbase	ɔ̀gbàsè
ọgbufọ	ɔ̀gbūfɔ̀
ọgbun	ɔ̀gbũ̄
ọgbun	ɔ̀gbṹ
ọgbẹni	ɔ̀gbɛ́nĩ̄
ọgbẹri	ɔ̀gbɛ̀ɾì
ọgbẹsẹ	ɔ̀gbɛ̀sɛ̀
ọgbọgbọ	ɔ̀gbɔ̀gbɔ̀
ọgbọmọdelasuru	ɔ̀gbɔ́mɔ̃̄délàsúɾú
ọgbọn	ɔ̀gbɔ̃́
ọgbọn	ɔ̄gbɔ̃̀
ọgbọn	ɔ̄gbɔ̃́
ọgbọnọ	ɔ̀gbɔ̀nɔ̀
ọgbọọgba	ɔ̄gbɔ̄ɔ̄gbā
ọghọn	ɔ̀ɣɔ̃̄
ọghọta	ɔ̀ɣɔ́tā
ọginnitin	ɔ̀gĩ̀nĩ̀tĩ̀
ọgẹdẹ	ɔ̀gɛ̀dɛ̀
ọgẹdẹagbagba	ɔ̀gɛ̀dɛ̀àgbāgbà
ọgẹnnẹtẹn	ɔ̀gɛ̃̀nɛ̀tɛ̃̀
ọgẹrẹ	ɔ̀gɛ́ɾɛ́
ọgọ	ɔ̀gɔ̀
ọgọdọ	ɔ̀gɔ̀dɔ̀
ọgọta	ɔ̄gɔ́ꜜtā
ọgụnrụn	ɔ̀gʊ̃̀ɾʊ̃̀
ọgụnrụnọọ	ɔ̀gʊ̃̀ɾʊ̃̀ɔ̄ɔ́
ọgụrọ	ɔ̀gʊ̀ɾɔ̀
ọhaha	ɔ̀hàhà
ọhẹ	ɔ̀hɛ̀
ọhọri	ɔ̀hɔ̀ɾí
ọja	ɔ̀dʒà
ọja	ɔ̀dʒá
ọja	ɔ̄dʒà
ọjaagbaye	ɔ̄dʒààgbájé
ọjaagbẹ	ɔ̄dʒààgbɛ̀
ọjẹ	ɔ̀dʒɛ̀
ọjẹdiran	ɔ̀dʒɛ́dìɾã̄
ọjẹlu	ɔ̀dʒɛ̀lú
ọjịjẹ	ɔ̀dʒɪ̀dʒɛ̀
ọjọ	ɔ̄dʒɔ́
ọjọabamẹta	ɔ̄dʒɔ́àbámɛ́tā
ọjọaiku	ɔ̄dʒɔ́àìkú
ọjọaje	ɔ̄dʒɔ́ādʒé
ọjọbọ	ɔ̄dʒɔ́bɔ̀
ọjọgbọn	ɔ̀dʒɔ̀gbɔ̃́
ọjọiya	ɔ̄dʒɔ́ìjá
ọjọiṣẹgun	ɔ̄dʒɔ́ìʃɛ́gũ̄
ọjọkanri	ɔ̄dʒɔ́kã̄ɾí
ọjọru	ɔ̄dʒɔ́ɾú
ọjọẹti	ɔ̄dʒɔ́ɛ̄tì
ọjọọbi	ɔ̄dʒɔ́ɔ̀bí
ọka	ɔ̄kà
ọka	ɔ̄ká
ọkada	ɔ̀kādà
ọkan	ɔ̀kã̄
ọkan	ɔ̄kã̀
ọkan	ɔ̄kã́
ọkan	ɔ̄kã̄
ọkandinlaaadọta	ɔ̀kã̀dĩ́láàádɔ́tā
ọkandinlogoji	ɔ̀kã̀dĩ́lógódʒì
ọkandinlogun	ɔ̀kã̀dĩ́lógṹ
ọkandinlọgbọn	ɔ̀kã̀dĩ́lɔ́gbɔ̃̀
ọkandinlọgọta	ɔ̀kã̀dĩ́lɔ́gɔ́tā
ọkanjuwa	ɔ̀kã́dʒúwà
ọkanla	ɔ̀kã̀lá
ọkanlelaaadọta	ɔ̀kã̀léláàádɔ́tā
ọkanlelogoji	ɔ̀kã̀lélógódʒì
ọkanlelogun	ɔ̀kã̀lélógṹ
ọkanlelọgbọn	ɔ̀kã̀lélɔ́gbɔ̃̀
ọkanran	ɔ̀kã̀ɾã̀
ọkaṣa	ɔ̀kàʃà
ọkin	ɔ̀kĩ́
ọkinni	ɔ̄kĩ̄nĩ̄
ọkun	ɔ̀kũ̀
ọkunmẹ	ɔ̀kũ̀mɛ̀
ọkunrin	ɔ̄kũ̀ɾĩ̄
ọkuta	òkútā
ọkẹ	ɔ̀kɛ́
ọkẹlẹjẹu	ɔ̀kɛ́lɛ́dʒɛ̀ú
ọkẹn	ɔ̀kɛ̃́
ọkẹrẹ	ɔ̀kɛ̀ɾɛ̀
ọkẹrẹ	ɔ̀kɛ́ɾɛ́
ọkẹrẹgba	ɔ̀kɛ́ɾɛ́gbà
ọkịka	ɔ̀kɪ̀kā
ọkọ	ɔ̀kɔ̀
ọkọ	ɔ̄kɔ̀
ọkọ	ɔ̄kɔ́
ọkọ	ɔ̄kɔ̄
ọkọayọkẹlẹ	ɔ̄kɔ̀ājɔ́kɛ́lɛ́
ọkọnrẹn	ɔ̀kɔ̃̄ɾɛ̃̀
ọkọnsi	ɔ̀kɔ̃̀sí
ọkọofuurufu	ɔ̄kɔ̀òfūūɾūfú
ọkọojuirin	ɔ̄kɔ̀ōdʒúīɾĩ̄
ọkọọkan	ɔ̀kɔ̀ɔ̀kɔ̃̄
ọkụta	ɔ̀kʊ́tā
ọla	ɔ̀lā
ọla	ɔ̄là
ọla	ɔ̄lá
ọlaifa	ɔ̄láīfá
ọlamiọbọ	ɔlámɪ̃́ɔ̀bɔ́
ọlatẹru	ɔ̄látɛ́ɾù
ọlayinminu	ɔ̄lájĩ̀mĩ́nũ̀
ọlayiwọla	ɔ̄lájíwɔ̄lá
ọlide	ɔ̄līdé
ọlẹ	ɔ̀lɛ̄
ọlẹ	ɔ̄lɛ̀
ọlẹdarun	ɔ̀lɛ́dàɾũ̀
ọlẹlẹ	ɔ̀lɛ̀lɛ̀
ọlọ	ɔ̄lɔ̄
ọlọbatala	ɔ̄bàtálá
ọlọfa	ɔ̄lɔ́fà
ọlọfin	ɔ̄lɔ́ꜜfĩ̄
ọlọfịn	ɔ̄lɔ́fɪ̃̄
ọlọfịn	ɔ̄lɔ́ꜜfɪ̃̄
ọlọfịnfunkẹ	ɔ̄lɔ́fɪ̃́fṹkɛ́
ọlọfịnmẹyẹ	ɔ̄lɔ́fɪ̃́mɛ̀jɛ̄
ọlọfịnmẹyẹ	ɔ̄lɔ́fɪ̃̄mɛ̀jɛ̄
ọlọgẹdẹ	ɔ̄lɔ́gɛ̀dɛ̀
ọlọinu	ɔ̄lɔ̄īnṹ
ọlọja	ɔ̄lɔ́dʒà
ọlọlade	ɔ̄lɔ́ládé
ọlọpaa	ɔ̄lɔ́ꜜkpá
ọlọrun	ɔ̄lɔ́ꜜɾũ̄
ọlọrunmila	ɔ̄lɔ́ɾṹmĩ̀là
ọlọrọ	ɔ̄lɔ́ɾɔ̀
ọlọsanyin	ɔ̄lɔ́sã́jĩ̀
ọlọsanyin	ɔ̄lɔ́sã̄jĩ̀
ọlọwọ	ɔ̄lɔ́wɔ̀
ọlọya	ɔ̄lɔ́jā
ọlọyẹ	ɔ̄lɔ̄jɛ́
ọlọṣun	ɔ̄lɔ́ʃũ̄
ọlụa	ɔ̄lʊ́ā
ọma	ɔ̄mã̄
ọmakọma	ɔ̄mã̄kɔ́mã̄
ọmama	ɔ̄mã̄mã̄
ọmiba	ɔ̄mĩ̄bā
ọmiwe	ɔ̀mĩ̀wé
ọmu	ɔ̀mũ̄
ọmu	ɔ̄mṹ
ọmunumunu	ɔ̀mũ̀nṹmũ̀nṹ
ọmuti	ɔ̀mũ̀tí
ọmuwe	ɔ̀mʊ̃̀wé
ọmọ	ɔ̄mɔ̃̄
ọmọale	ɔ̄mɔ̃̄àlè
ọmọba	ɔ̄mɔ̃̄bā
ọmọbọsẹde	ɔ̄mɔ̃́bɔ́sɛ̀dé
ọmọde	ɔ̄mɔ̃̄dé
ọmọdo	ɔ̄mɔ̃̄dó
ọmọewi	ɔ̄mɔ̃̄èwí
ọmọge	ɔ̄mɔ̃̄gē
ọmọileiwe	ɔ̄mɔ̃̄īléìwé
ọmọkọmọ	ɔ̄mɔ̃̄kɔ́mɔ̃̄
ọmọlabakẹ	ɔ̄mɔ̃̄làbákɛ́
ọmọlangi	ɔ̄mɔ̃̄láŋ́gī
ọmọlangidi	ɔ̄mɔ̃̄láŋ́gīdī
ọmọlanke	ɔ̄mɔ̃̄lāŋ̄kē
ọmọlarere	ɔ̄mɔ̃̄láɾèɾè
ọmọlarere	ɔ̄mɔ̃̄láɾèɾé
ọmọleti	ɔ̄mɔ̃̄létí
ọmọluwabi	ɔ̄mɔ̃̄lúwàbí
ọmọlẹyẹ	ɔ̄mɔ̃̄lɛ̀jɛ̄
ọmọlịịjẹ	ɔ̄mɔ̃̄lɪ̄ɪ́dʒɛ́
ọmọlọ	ɔ̄mɔ̃̄lɔ̄
ọmọnile	ɔ̄mɔ̃̄nĩ́lé
ọmọniyan	ɔ̄mɔ̃̄nĩ̀jã̀
ọmọodu	ɔ̄mɔ̃̄ōdù
ọmọpẹ	ɔ̄mɔ̃́kpɛ́
ọmọrẹmilẹkun	ɔ̄mɔ̃́ɾɛ̀mĩ́lɛ́kṹ
ọmọwe	ɔ̀mɔ̃̀wé
ọmọwu	ɔ̄mɔ̃̄wú
ọmọẹgbẹ	ɔ̄mɔ̃̄ɛ̄gbɛ́
ọmọọdọ	ɔ̄mɔ̃̄ɔ̀dɔ̀
ọn	ɔ̃́
ọn	ɔ̃̄
ọna	ɔ̀nã̀
ọna	ɔ̀nã́
ọna	ɔ̄nã̀
ọni	ɔ̀nĩ̀
ọni	ɔ̀nĩ̄
ọni	ɔ̄nĩ̄
ọnie	ɔ̄nĩ̄é
ọnikọni	ɔ̄nĩ̄kɔ́nĩ̄
ọnini	ɔ̀nĩ́nĩ́
ọniyan	ɔ̀nĩ̀jɔ̃̀
ọnẹ	ɔ̀nɛ̀
ọnẹ	ɔ̄nɛ̃̄
ọnị	ɔ̄nɪ̃̄
ọnịfọn	ɔ̄nɪ̃̀fɔ̃̀
ọnịfọnboyede	ɔ̄nɪ̃̀fɔ̃̀bójèdé
ọnịkọnị	ɔ̄nɪ̃̄kɔ́nɪ̃̄
ọnịyọn	ɔ̀nɪ̃̀jɔ̃̀
ọnọ	ɔ̀nɔ̀
ọnọkọn	ɔ̄nɔ̀kɔ̃̀
ọnọkọn	ɔ̄nɔ̀kɔ̃̄
ọpa	ɔ̀kpá
ọpalaba	ɔ̀kpálábá
ọpalamba	ɔ̀kpáláŋ́bá
ọpalanba	ɔ̀kpáláŋ́bá
ọparun	ɔ̄kpāɾũ̄
ọpẹ	ɔ̀kpɛ̀
ọpẹ	ɔ̀kpɛ̄
ọpẹ	ɔ̄kpɛ́
ọpẹlẹ	ɔ̀kpɛ̀lɛ̀
ọpẹrẹkẹtẹ	ɔ̀kpɛ̀ɾɛ̀kɛ́tɛ̀
ọpọ	ɔ̀kpɔ̀
ọpọlọ	ɔ̀kpɔ̀lɔ́
ọpọlọ	ɔ̄kpɔ̄lɔ̄
ọpọlọokun	ɔ̀kpɔ̀lɔ́òkũ̄
ọpọlọpọ	ɔ̀kpɔ̀lɔ́kpɔ̀
ọpọlọpọ	ɔ̀kpɔ̀lɔ̄kpɔ̀
ọpọn	ɔ̀kpɔ̃̀
ọpọn	ɔ̄kpɔ̃́
ọpọnifa	ɔ̄kpɔ̃́īfá
ọra	ɔ̀ɾá
ọra	ɔ̄ɾā
ọramfẹ	ɔ̀ɾàŋ̀fɛ̀
ọrangun	ɔ̀ɾã̀gṹ
ọranmiyan	ɔ̀ɾã̀mĩ́jã̀
ọruka	ɔ̀ɾùkā
ọrukọ	ɔ̄ɾúkɔ̄
ọrun	ɔ̀ɾũ̄
ọrun	ɔ̀ɾṹ
ọrun	ɔ̄ɾũ̀
ọrun	ɔ̄ɾũ̄
ọrun	ɔ̄ɾṹ
ọrunmila	ɔ̀ɾṹmĩ̀là
ọrẹ	ɔ̀ɾɛ́
ọrẹ	ɔ̄ɾɛ́
ọrẹ	ɔ̄ɾɛ̄
ọrẹluere	ɔ̄ɾɛ̄lúēɾē
ọrịjọ	ɔ̀ɾɪ̀dʒɔ́
ọrịṣa	ɔ̀ɾɪ̀ʃà
ọrọ	ɔ̀ɽɔ̀
ọrọ	ɔ̀ɾɔ̀
ọrọ	ɔ̀ɾɔ́
ọrọ	ɔ̄ɾɔ̀
ọrọ	ɔ̄ɾɔ́
ọrọ	ɔ̄ɾɔ̄
ọrọagba	ɔ̀ɾɔ̀àgbà
ọrọajọsọ	ɔ̀ɾɔ̀àdʒɔ̄sɔ̄
ọrọakanlo	ɔ̀ɾɔ̀àkã̀lò
ọrọawada	ɔ̀ɾɔ̀àwàdà
ọrọaṣiri	ɔ̀ɾɔ̀àʃíɾí
ọrọkọrọ	ɔ̀ɾɔ̀kɔ́ɾɔ̀
ọrọmpọtọ	ɔ̀ɾɔ̀ŋ̀kpɔ̀tɔ̀
ọrọnpọtọ	ɔ̀ɾɔ̀ŋ̀kpɔ̀tɔ̀
ọrọnpọtọ	ɔ̀ɾɔ̀ŋ̀kpɔ́tɔ̀
ọrọnṣẹn	ɔ̀ɾɔ̃̄ʃɛ̃̀
ọrọorukọ	ɔ̀ɾɔ̀ōɾúkɔ̄
ọrọwa	ɔ̄ɾɔ́wá
ọrọẹyin	ɔ̀ɾɔ̀ɛ̀jĩ̀
ọrọọrun	ɔ̄ɾɔ̄ɔ̄ɾṹ
ọrụka	ɔ̀ɾʊ̀kā
ọrụkọ	ɔ̄ɾʊ́kɔ̄
ọsa	ɔ̀sá
ọsagunda	ɔ̀ságṹdá
ọsan	ɔ̀sã́
ọsan	ɔ̄sã̀
ọsan	ɔ̄sã́
ọsanyin	ɔ̀sã́jĩ̀
ọsanyin	ɔ̀sã̄jĩ̀
ọsanyinlusi	ɔ̀sã̄jĩ́lúsì
ọsijin	ɔ́sídʒĩ̀
ọsin	ɔ̀sĩ̀
ọsirelia	ɔ̄sīɾélíà
ọsiria	ɔ́síɾíà
ọsun	ɔ̀sũ̄
ọsẹ	ɔ̀sɛ̀
ọsẹ	ɔ̀sɛ́
ọsẹ	ɔ̄sɛ̀
ọsẹifa	ɔ̀sɛ̀īfá
ọsẹjakuta	ɔ̀sɛ̀dʒàkútā
ọsẹogun	ɔ̀sɛ̀ògṹ
ọsẹọbatala	ɔ̀sɛ̀ɔ̄bàtálá
ọsọọsan	ɔ̀sɔ̀ɔ̀sã́
ọsọọsẹ	ɔ̀sɔ̀ɔ̀sɛ̀
ọta	ɔ̀tà
ọta	ɔ̀tá
ọta	ɔ̄tā
ọtabẹ	ɔ̄tābɛ̀
ọti	ɔ̄tí
ọtin	ɔ̀tĩ̀
ọtin	ɔ̄tĩ́
ọtun	ɔ̀tṹ
ọtunla	ɔ̀tũ̄lā
ọtunla	ɔ̀tṹlā
ọtẹ	ɔ̀tɛ̀
ọtẹlẹmuyẹ	ɔ̀tɛ̄lɛ̀mṹjɛ́
ọtẹtẹ	ɔ̀tɛ́tɛ́
ọtịta	ɔ̀tɪ̀tà
ọtụpa	ɔ̀tʊ̀kpà
ọwa	ɔ̄wá
ọwaara	ɔ̀wààɾà
ọwara	ɔ̀wàɾà
ọwawa	ɔ̀wàwà
ọwun	ɔ̀wũ̀
ọwẹ	ɔ̀wɛ̀
ọwọ	ɔ̀wɔ̀
ọwọ	ɔ̀wɔ́
ọwọ	ɔ̄wɔ̀
ọwọ	ɔ̄wɔ́
ọwọalaafia	ɔ̄wɔ́àlàáfíà
ọwọn	ɔ̀wɔ̃̄
ọwọnrin	ɔ̀wɔ̃́ɾĩ́
ọwọnwe	ɔ̀wɔ̃̀wé
ọwọnyẹn	ɔ̀wɔ̃̀jɛ̃̀
ọwọosi	ɔ̄wɔ́òsì
ọwọrin	ɔ̀wɔ́ɾĩ́
ọwọọtun	ɔ̄wɔ́ɔ̀tṹ
ọwụrọ	ɔ̀wʊ́ɾɔ̀
ọya	ɔ̀jà
ọya	ɔ̀jā
ọya	ɔ̄jà
ọya	ɔ̄jā
ọyagbọla	ɔ̄jágbɔ̄lá
ọyan	ɔ̀jã́
ọyan	ɔ̄jã̀
ọyaya	ɔ̀jàjà
ọyun	ɔ̄jṹ
ọyẹ	ɔ̄jɛ́
ọyẹku	ɔ̀jɛ̀kú
ọyẹyẹ	ɔ̀jɛ̀jɛ̀
ọyẹyẹ	ɔ̀jɛ́jɛ́
ọyịn	ɔ̀jɪ̃̀
ọyọ	ɔ̀jɔ́
ọyọmesi	ɔ̀jɔ́mèsì
ọyọtunji	ɔ̀jɔ́tṹdʒí
ọ̀	ɔ̀
ọ́	ɔ́
ọ̄	ɔ̄
ọ̌	ɔ̌
ọṣa	ɔ̀ʃà
ọṣa	ɔ̀ʃā
ọṣa	ɔ̄ʃà
ọṣara	ɔ̀ʃàɾà
ọṣaṣa	ɔ̀ʃáʃá
ọṣilẹ	ɔ̀ʃīlɛ̀
ọṣin	ɔ̄ʃĩ̀
ọṣun	ɔ̀ʃũ̄
ọṣuntokun	ɔ̀ʃṹtóꜜkũ̄
ọṣuntuyi	ɔ̀ʃṹtújì
ọṣẹ	ɔ̄ʃɛ̄
ọṣẹẹrẹmagbo	ɔ̀ʃɛ̀ɛ̀ɾɛ̀màgbò
ọṣọ	ɔ̀ʃɔ́
ọṣọsi	ɔ̀ʃɔ́sì
ọṣọọsi	ɔ̀ʃɔ́ɔ̀sì
ọṣụpa	ɔ̀ʃʊ̀kpá
ọịṣẹ	ɔ̀ɪ́ʃɛ́
ọọ	ɔɔ́
ọọ	ɔ̄ɔ̀
ọọdunrun	ɔ̀ɔ́dṹɾṹ
ọọdẹ	ɔ̀ɔ̀dɛ̀
ọọni	ɔ̀ɔ̀nĩ̄
ọọni	ɔ̄ɔ̀nĩ̄
ọọru	ɔ̀ɔ́ɾú
ọọrọ	ɔ̀ɔ́ɾɔ̀
ọọṣa	ɔ̀ɔ̀ʃà
ọọṣawẹ	ɔ̀ɔ̀ʃáwɛ̀
ộ	ɔ̂
ụa	ʊ̀à
ụa	ʊ̀á
ụdagẹrẹ	ʊ̀dàgɛ̀ɾɛ̀
ụdalẹ	ʊ̀dálɛ̀
ụdẹ	ʊ̀dɛ̀
ụdẹ	ʊ̄dɛ̄
ụgbade	ʊ̀gbàdè
ụgbae	ʊ̄gbáè
ụgbalẹ	ʊ̀gbálɛ̀
ụgbẹ	ʊ̀gbɛ̀
ụja	ʊ̀dʒā
ụkọ	ʊ̄kɔ̀
ụkọ	ʊ̄kɔ́
ụkọkọ	ʊ̄kɔ̄kɔ̄
ụmọlẹ	ʊ̄mɔ̃̄lɛ̀
ụmụ	ʊ̄mʊ̃́
ụpịnṣa	ʊ̀kpɪ̃̄ʃà
ụpọnju	ʊ̀kpɔ̃̀dʒú
ụrara	ʊ̄ɾāɾā
ụsụn	ʊ̀sʊ̃̄
ụọ	ʊ̀ɔ́
ụụrẹ	ʊ̀ʊ̀ɾɛ̀
