a	a
abacá	abaka
abada	aβaða̝
abade	aβaðɪ
abadengo	aβaðeŋgo̝
abadesa	aβaðesɐ
abadexo	aβaðeʃʊ
abadía	aβaðiɐ
abafante	aβafantɪ
abafar	aβafaɾ
abafo	aβ̞afʊ
abaixar	aβajʃaɾ
abalar	aβalaɾ
abalo	aβalo̝
abaloucar	aβalowkaɾ
abanar	aβanaɾ
abancar	aβaŋkaɾ
abanear	aβɑneaɾ
abanicar	aβanikaɾ
abanico	aβanikʊ
abano	aβano̝
abanqueiro	aβaŋkejɾo̝
abarquilar	aβaɾkilaɾ
abastanza	aβastanθa
abastar	aβastaɾ
abastecemento	aβasteθemɛntʊ
abasto	aβastʊ
abaxial	aβ̞aʃjɑɫ
abdome	abdɔmɪ
abeaca	aβeaka̝
abeberar	aβeβeɾaɾ
abecé	aβeθɛ
abeirar	aβejɾaɾ
abeiro	aβejɾo̝
abeleira	aβelejɾɐ
abella	aβeʎa̝
abellariza	aβeʎaɾiθa̝
abelleira	aβeʎejɾa̝
abelleiro	aβeʎejɾo̝
abellón	aβeʎoŋ
abeluria	aβeluɾjɐ
abelá	aβela
abeneiro	aβenejɾʊ
abeto	aβeto̝
abicar	aβikaɾ
abiñar	aβiɲaɾ
abofé	aβofɛ
aboiar	aβoi̯aɾ
aboiar	aβɔi̯aɾ
abondamento	aβondamentʊ
abondamento	aβondamɛntʊ
aborrallado	aβoraʎaðʊ
aborrecer	aβoreseɾ
aborrecer	aβoreθeɾ
abotoar	aβotoaɾ
abouxar	aβ̞owʃaɾ
abra	aβɾa̝
abraiar	aβɾajaɾ
abranguer	aβɾaŋgeɾ
abrasar	aβɾasaɾ
abrazar	aβ̞ɾasaɾ
abrazar	aβ̞ɾaθaɾ
abrazo	aβ̞ɾasʊ
abrazo	aβ̞ɾaθʊ
abrente	aβɾɛnte̝
abrigar	aβɾiɣaɾ
abrigo	aβɾiɣʊ
abrigoso	aβɾiɣosʊ
abril	aβɾil
abrir	aβɾiɾ
abrollo	aβɾɔʎʊ
abruñeiro	aβɾuɲejɾo̝
abruño	aβɾuɲo̝
abrótea	aβɾɔte̯a̝
abrótega	aβɾɔtɪɣɐ
absoluto	aβsolutʊ
abullar	aβuʎaɾ
abur	aβuɾ
aburar	aβuɾaɾ
aburiño	aβuɾiɲʊ
aburrir	aβ̞uriɾ
acalentar	akalentaɾ
acalentar	akalɛntaɾ
acanear	akɑneaɾ
acantazar	akɑntaθaɾ
acantilar	akɑntilaɾ
acantoar	akantoaɾ
acareo	akaɾeʊ
acariñar	akaɾiɲaɾ
acarreirar	akɑrejɾaɾ
acción	ɑksjoŋ
acción	ɑkθjoŋ
aceal	aθeal
acedume	aθeðumɪ
acedía	aseðiɐ
acedía	aθeðiɐ
aceite	asejt̪ɪ
aceite	aθejt̪ɪ
achaiar	a̠tʃajaɾ
achairar	atʃajɾaɾ
achanzar	atʃansaɾ
achanzar	atʃanθaɾ
achaque	atʃakɪ
acoiar	akojaɾ
acoitelar	akojtelaɾ
acolá	akola
acompañamento	akompaɲamentʊ
aconchegar	akontʃeɣaɾ
acordanza	akoɾðansɐ
acordanza	akoɾðanθɐ
acordar	akoɾðaɾ
acorrer	akoreɾ
acostuma	akostuma
acostumar	akostumaɾ
acougo	akowɣʊ
acre	akɾe
acrecer	akɾeseɾ
acrecer	akɾeθeɾ
actos	aktos
acugular	akuɣulaɾ
acurtar	akuɾtaɾ
adega	aðɛɣɐ
adegueiro	aðeɣejɾʊ
adentar	aðentaɾ
adentar	aðɛntaɾ
aderezo	aðeɾesʊ
aderezo	aðeɾeθʊ
aderno	aðɛɾnʊ
adeus	aðeʊ̯s
adiantar	aðjantaɾ
adiante	aðjantɪ
adiar	aðiaɾ
aditar	aðitaɾ
adival	aðiβal
adiviña	aðɪβiɲɐ
adiviñanza	aðɪβiɲansɐ
adiviñanza	aðɪβiɲanθɐ
adiviño	aðiβiɲʊ
adoecer	aðoeseɾ
adoecer	aðoeθeɾ
adoitar	aðojtaɾ
adormecer	aðoɾmeseɾ
adormecer	aðoɾmeθeɾ
adramán	aðɾamaŋ
aduanar	aðʊ̯anaɾ
aducir	aðuθiɾ
adufe	aðufɪ
aeroplano	aeɾoplanʊ
afacer	afaseɾ
afacer	afaθeɾ
afastado	afastaðʊ
afeitar	afejtaɾ
afeito	afejtʊ
aferidoiro	afɪɾiðoi̯ɾʊ
afervoar	afeɾβoaɾ
afiador	afjaðoɾ
afiar	afiaɾ
afillado	afiʎaðʊ
afillar	afiʎaɾ
afirmar	afiɾmaɾ
afogar	afoɣaɾ
afoletar	afoletaɾ
aforrar	aforaɾ
afouto	afowtʊ
afronta	afɾonta
afrontar	afɾontaɾ
afundir	afundiɾ
afusal	afusal
agachadas	aɣatʃaðɐs
aganar	aɣanaɾ
aganchar	aɣantʃaɾ
agano	aɣanʊ
agarda	aɣaɾða
agardar	aɣaɾðaɾ
agarimo	aɣaɾimʊ
agasallo	aɣasaʎʊ
agoirento	aɣojɾentʊ
agoirento	aɣojɾɛntʊ
agoiro	aɣojɾo̝
agora	aɣoɾɐ
agraz	aɣɾaθ
agre	aɣɾɪ
agremán	aɣɾemaŋ
agrión	aɣɾjoŋ
agua	aɣwa
aguana	aɣoanɐ
aguana	aɣwanɐ
aguaneta	aɣʊ̯anetɐ
aguiúncho	aɣiuntʃʊ
agulleiro	aɣuʎejɾʊ
agulleta	aɣuʎetɐ
aguzar	aɣuθar
ah	aː
ai	aj
aio	ajʊ
airiño	ai̯ɾiɲʊ
airoa	ajɾɔɐ
al	al
alagar	alaɣaɾ
alameda	alameðɐ
alancada	alaŋkaðɐ
alancar	alaŋkaɾ
alangrear	alaŋgɾeaɾ
alardo	alaɾðʊ
alarido	alaɾiðʊ
alasar	alasaɾ
alba	alβɐ
albarde	alβaɾðɪ
albariño	alβaɾiɲʊ
albeiro	alβejɾʊ
albelo	alβɛlʊ
albergar	alβeɾɣaɾ
albergaría	alβɛɾɣaɾiɐ
albitorno	alβitoɾnʊ
alborada	alβoɾaðɐ
alborecer	alβoɾeθeɾ
alborexar	alβoɾeʃaɾ
albízaras	alβiθɐɾɐs
alcouve	alkowβɪ
alcume	alkumɪ
alcuño	alkuɲʊ
aldariz	aldaɾiθ
aldariz	aldɾis
aldarís	aldaɾis
aldemunde	aldemundɪ
alegre	alɛɣɾɪ
alegría	aleɣɾiɐ
aleitar	alei̯taɾ
aleixado	alejʃaðʊ
alemán	alemaŋ
alentar	alentaɾ
alentar	alɛntaɾ
alento	alento
alento	alɛnto
alfa	alfɐ
alfaia	alfajɐ
alfaiate	alfai̯at̪ɪ
alferga	alfɛɾɣɐ
algo	alɣʊ
algodón	alɣoðoŋ
alguén	alɣɛŋ
algún	alɣuŋ
alicerce	alisɛɾsɪ
alicerce	aliθɛɾθɪ
alicornio	alikɔɾni̯ʊ
alindar	alindaɾ
alistado	alistaðʊ
aliviadoiro	aliβjaðojɾʊ
alleiro	aʎejɾʊ
alleo	aʎeʊ
allo	aʎʊ
alma	almɐ
alma	jalmɐ
almirante	almiɾantɪ
almofada	almofaðɐ
almogávar	almoɣaβɐɾ
alongamento	aloŋgamentʊ
alongar	aloŋgaɾ
aloumiño	alowmiɲʊ
alpabarda	alpaβaɾðɐ
alta	altɐ
alto	altʊ
altura	altuɾɐ
aluguer	alugɛɾ
alvariza	ɑlβ̞aɾisɐ
alvariza	ɑlβ̞aɾiθɐ
alvite	albitɪ
alxibe	alʃiβɪ
alxibeira	alʃiβejɾɐ
alzar	alsaɾ
alzar	alθaɾ
alá	ala
alí	ali
amalló	amaʎɔ
amantar	amãntaɾ
amarante	amaɾantɪ
amareloto	amaɾɛlɔtʊ
amargoso	amaɾɣosʊ
amaro	amaɾʊ
amasar	amasaɾ
amata	amatɐ
ameigar	amejɣaɾ
amencida	amensiðɐ
amencida	amenθiðɐ
ameneiro	amenei̯ɾʊ
amenta	amentɐ
amenta	amɛntɐ
amentar	amentaɾ
americano	amɛɾikanʊ
amiudar	amiuðaɾ
amoado	amoaðʊ
amocar	amokaɾ
amocelo	amoθelʊ
amocelo	amoθɛlʊ
amodiño	amɔðiɲʊ
amoestar	amoestaɾ
amontoar	amontoaɾ
amor	amoɾ
amordicar	amoɾðikaɾ
amorear	amoɾeaɾ
amornar	amoɾnaɾ
amorodo	amoɾoðʊ
amortuxar	amɔrtuʃaɾ
amos	amos
amosa	amosa
amosar	amosaɾ
amoxo	amoʃʊ
amparar	ampaɾaɾ
ampear	ampeaɾ
ampola	ampola
amuar	amuaɾ
amurar	amuɾaɾ
amádego	amaðɪɣʊ
ana	ana
anada	anaðɐ
anceio	anθei̯ʊ
anchear	antʃeaɾ
ancián	ansjaŋ
ancián	anθjaŋ
andamio	andamiʊ
andamio	andamjʊ
andar	an̪d̪aɾ
andazo	andasʊ
andazo	andaθʊ
andel	andɛl
andorga	andɔɾɣɐ
andosco	andoskʊ
andrade	andɾaðɪ
androlla	andɾoʎɐ
andrómenas	andɾɔmɪnɐ
anegar	aneɣaɾ
aneiro	anei̯ɾʊ
anicar	anikaɾ
aniñadoiro	aniɲaðojɾʊ
aniñar	anĩɲaɾ
ano	ano
anoitecer	anojteseɾ
anoitecer	anojteθeɾ
anoto	anotʊ
anovar	anoβaɾ
anquear	aŋkeaɾ
ansia	ansi̯ɐ
antano	antanʊ
antaruxa	antaɾuʃɐ
ante	ante
antecesor	anteθesoɾ
antelar	antelaɾ
antenas	antenas
antigo	antiɣʊ
antigüidade	antiɣwiðaðɪ
antollar	antoʎaɾ
antollo	antoʎʊ
antonte	antɔntɪ
antroido	antɾoi̯ðʊ
anubiar	anuβiaɾ
anubiar	anuβjaɾ
anzol	ansɔl
anzol	anθɔl
apadriñar	apaðɾiɲaɾ
apagar	apaɣaɾ
apalominado	apalominaðʊ
apampar	apampaɾ
apandar	apandaɾ
aparar	apaɾaɾ
aparcar	apaɾkɑɾ
aparecer	apaɾeseɾ
aparecer	apaɾeθeɾ
aparecido	apaɾeθiðʊ
apartar	apaɾtaɾ
aparvado	apaɾβaðʊ
apedar	apeðaɾ
apedrar	apeðɾaɾ
apelidar	apeliðaɾ
apelido	apeliðʊ
aperta	apɛɾtɐ
apertado	apeɾtaðʊ
apertar	apeɾtaɾ
apiegar	apjeɣaɾ
apigarado	apiɣaɾaðʊ
apio	apjʊ
apirolado	apiɾɔlaðʊ
apirolar	apiɾɔlaɾ
apoia	apoia
apoleirar	apolei̯ɾaɾ
aposto	apɔstʊ
apoucar	apou̯kaɾ
apoudigar	apowðiɣaɾ
apousentar	apou̯sentaɾ
apoutar	apowtaɾ
apreixar	apɾejʃaɾ
aprender	apɾendeɾ
aprontar	apɾontaɾ
aproveitar	apɾoβejtaɾ
apta	apta
apupo	apupʊ
apurrar	apuraɾ
apurrir	apuriɾ
apuxar	apuʃaɾ
apóstolo	apɔstʊlʊ
aquel	ɑkeɫ
aquela	akelɐ
aquela	akɛlɐ
aquelar	akelaɾ
aqueloutro	akelowtɾʊ
aqueste	akestɪ
ar	aɾ
arado	aɾaðʊ
arandeira	aɾandejɾɐ
arao	aɾaʊ̯
arcaz	aɾkas
arcaz	aɾkaθ
arcea	aɾsɛɐ
arcea	aɾθeɐ
arcebispo	aɾθɪβispʊ
ardaña	aɾðaɲɐ
arder	aɾðeɾ
ardido	aɾðiðʊ
areeiro	aɾeejɾʊ
arela	aɾɛlɐ
areoso	aɾeosʊ
aresta	aɾestɐ
argadelo	aɾɣaðelʊ
argallada	aɾɣaʎaðɐ
argalleiro	aɾgaʎejɾʊ
argallo	aɾɣaʎʊ
argallán	aɾɣaʎaŋ
argazo	aɾgasʊ
argazo	aɾgaθʊ
arma	aɾmɐ
armadura	aɾmaðuɾɐ
arna	aɾnɐ
aro	aɾʊ
arola	aɾɔlɐ
arpeu	aɾpew
arpeu	aɾpeʊ̯
arqueiro	aɾkei̯ɾʊ
arqueta	aɾketɐ
arquexar	aɾkeʃaɾ
arraiano	arai̯anʊ
arraigar	arajɣaɾ
arras	aras
arrebol	areβɔl
arredor	aredoɾ
arregar	areɣaɾ
arreitar	arejtaɾ
arreitó	arejtɔ
arrendar	arendaɾ
arrentar	arentaɾ
arrevesado	areβesaðʊ
arrexuntar	areʃuntaɾ
arrieiro	ariejrʊ
arrimado	arimaðʊ
arriscado	ariskaðʊ
arriscar	ariskaɾ
arrizar	ariθaɾ
arrodeo	aroðeʊ
arroio	aroi̯ʊ
arrolar	arolaɾ
arrolo	arolʊ
arroupar	arou̯paɾ
arroxo	aroʃʊ
arroz	aros
arroz	ɐroθ
arruído	aruiðʊ
arvaldo	aɾβalðʊ
arxila	aɾʃilɐ
arábigo	aɾaβiɣʊ
as	as
asado	asaðʊ
asadura	asaðuɾɐ
asañar	asaɲaɾ
asegurar	aseɣuɾaɾ
asentar	asentaɾ
asento	asɛntʊ
asexo	aseʃʊ
asistir	as̺is̺tiɾ
asno	asnʊ
asomar	asomaɾ
astucia	astusjɐ
astucia	astuθjɐ
asubío	asuβiʊ
asucar	asukaɾ
así	asi
ata	ata
atacar	atakaɾ
atado	ataðʊ
atafegar	atafeɣaɾ
ataviar	ataβjaɾ
atavío	ataβiʊ
ataúde	atauðɪ
ateigado	atejɣaɾ
atenzar	atenθaɾ
aterecer	ateɾeseɾ
aterecer	ateɾeθeɾ
aterir	ateɾiɾ
atizar	atisaɾ
atizar	atiθaɾ
atoamento	atʊ̯amẽntʊ
atontecer	atonteseɾ
atontecer	atonteθeɾ
atragoar	atɾaɣoaɾ
atricar	atɾikaɾ
atrouxar	atɾoʊ̯ʃaɾ
atufar	atufaɾ
auga	awħɐ
augueiro	au̯ɣei̯ɾʊ
auguento	awgentʊ
auguento	awgɛntʊ
autismo	ɑwt̪iz̺mʊ
avagar	aβaɣaɾ
avantar	aβantaɾ
avantaxar	aβantaʃaɾ
avante	aβantɪ
avanzar	aβansaɾ
avanzar	aβanθaɾ
ave	aβɪ
aveal	aβeal
avechucho	aβetʃutʃʊ
avelaíña	aβelaiɲɐ
avellentar	aβeʎentaɾ
avellentar	aβɛʎentaɾ
aventar	aβentaɾ
aventura	aβentuɾɐ
aventurar	aβentuɾaɾ
aves	aβes
avespa	aβespɐ
avestruz	aβestɾuθ
avir	aβiɾ
avisado	aβisaðʊ
avisar	aβisaɾ
avião	aβi̯oŋ
aviñotado	aβiɲotaðʊ
avión	aβi̯oŋ
avoa	aβ̞oɐ
avogacía	aβoɣaθiɐ
avogado	aβoɣaðʊ
avogar	aβoɣaɾ
avogoso	aβoɣosʊ
avéspora	aβɛspʊɾɐ
avó	aβ̞o
axe	aʃɪ
axeito	aʃejtʊ
axeonllar	aʃeonʎaɾ
axiña	aʃiɲɐ
axordar	aʃoɾðaɾ
axuda	aʃuðɐ
axudar	aʃuðaɾ
axuizar	aʃujsaɾ
axuizar	aʃujθaɾ
axóuxere	aʃou̯ʃɪɾɪ
azafate	asafatɪ
azafate	aθafatɪ
azoroñar	asoɾoɲaɾ
azoroñar	aθoɾoɲaɾ
azoso	aθosʊ
azucre	asukɾɪ
azucre	aθukɾɪ
azumbre	aθumbɾɪ
açom	asoŋ
açom	aθoŋ
aí	ai
aínda	aindɐ
añagoto	aɲaɣɔtʊ
año	aɲʊ
b	b
baba	baβɐ
baballa	baβaʎɐ
babar	baβaɾ
babexar	baβeʃaɾ
babuxar	baβuʃaɾ
bacallau	bakaʎaʊ̯
bacento	baθentʊ
bacharelato	βatʃarɛlato
badexo	baðeʃʊ
badil	baðil
badoco	baðɔkʊ
bagaxe	baɣaʃɪ
bagullar	baɣuʎaɾ
baila	bajlɐ
bailador	bajlaðoɾ
bailar	bajlaɾ
baile	bajlɪ
baiura	bai̯uɾɐ
baixada	bajʃaðɐ
baixamar	bajʃamaɾ
baixar	bajʃaɾ
baixo	bajʃʊ
balbordo	balβoɾðʊ
balde	balde
baldeiro	baldejɾʊ
baldequín	bɑldekiŋ
baldomero	baldomɛɾʊ
baldreo	baldɾeʊ̯
baldrogas	baldɾoɣɐs
baleirar	balejɾaɾ
baleiro	balei̯ɾʊ
ballón	baʎoŋ
balorento	baloɾentʊ
balorento	baloɾɛntʊ
balsa	balsɐ
baltroteiro	baltɾotejɾʊ
baltrón	baltɾoŋ
bambear	bambeaɾ
bambán	bambaŋ
banda	banda
bandada	bandaðɐ
bandallo	bandaʎʊ
bandear	bandeaɾ
bandexar	bandeʃaɾ
bandoxo	bandoʃʊ
bar	baɾ
barallada	baɾaʎaðɐ
barbacá	baɾβaka
barbada	baɾβaðʊ
barbado	baɾβaðʊ
barballar	baɾβaʎaɾ
barbear	baɾβeaɾ
barbeiro	baɾβejɾʊ
barbo	baɾβʊ
barcia	baɾθjɐ
barda	baɾðɐ
bardante	baɾðantɪ
barqueta	baɾketɐ
barquinazo	baɾkinaθʊ
barquín	baɾkiŋ
barrento	barentʊ
barreño	bareɲʊ
barriga	bariɣɐ
barrigudo	bariɣuðʊ
barril	bariɫ
barronca	baronkɐ
barrosiña	barosiɲɐ
barrufeiro	barufejɾʊ
barruzar	baruθaɾ
barruzo	baruθʊ
barulleiro	baɾuʎejɾʊ
barullento	baɾuʎentʊ
barullo	baɾuʎʊ
barón	baɾoŋ
bascuas	baskwɐs
basta	bastɐ
bastante	bas̺t̪an̪t̪ɪ
bastardo	bas̻taɾðʊ
basto	bastʊ
batalla	bataʎɐ
batallón	bat̪aɟoŋ
batume	batumɪ
batuxar	batuʃaɾ
batuxo	batuʃʊ
baza	basɐ
baza	baθɐ
bazo	basʊ
bazo	baθʊ
baña	baɲa
bañar	baɲaɾ
bebedela	beβeðɛlɐ
bebedoiro	beβeðojɾʊ
beber	beβeɾ
becho	betʃʊ
beira	bei̯ɾɐ
beiral	bejɾal
beizudo	bejsuðʊ
beizudo	bejθuðʊ
belaluz	bɛlaluθ
belida	beliðɐ
belleco	beʎɛkʊ
ben	bɛn
benia	bɛnjɐ
berberecho	beɾβeɾetʃʊ
bergamota	beɾɣamɔtɐ
berro	bɛrʊ
bertorella	beɾtoɾeʎɐ
besbello	besβeʎʊ
bica	bikɐ
bicada	bikaðɐ
bicho	bitʃʊ
bico	bikʊ
bilingüismo	biliŋgwiz̺mʊ
bilingüismo	biliŋħwiz̺mʊ
billa	biʎɐ
billote	biʎɔtɪ
bimar	bimaɾ
bimbastro	bimbastɾʊ
bioca	biɔkɐ
birta	biɾtɐ
bisarma	bisaɾmɐ
biscoito	biskojtʊ
bisonte	bis̺on̪t̪ɪ
bispo	bispʊ
bita	bitɐ
blida	bliðɐ
boamente	boamentɪ
boca	bokɐ
bocanoite	bokanojtɪ
bochinche	botʃintʃɪ
bocoi	bokoi̯
bocoi	bokɔi̯
bofetada	bofetaðɐ
bogada	bʊɣaðɐ
bondade	bonda
bondade	bondaðɪ
boqueadas	bokeaðɐs
boqueiro	bokei̯ɾʊ
borralleira	boraʎejɾɐ
borrallento	boraʎɛntʊ
borreante	boreantɪ
borrear	boreaɾ
borro	borʊ
bos	bos
bosques	boskes
bostela	bostɛlɐ
botefa	botɛfɐ
botín	botiŋ
bouba	bowβɐ
boudaña	bowðaɲɐ
boura	bowɾɐ
boureo	boʊ̯reʊ
bouta	bou̯tɐ
brado	bɾaðʊ
brafoneira	bɾafonejɾɐ
braga	bɾaɣɐ
bragada	bɾaɣaðɐ
bragado	bɾaɣaðʊ
bragal	bɾaɣal
brancellao	bɾanθeʎaʊ̯
branco	bɾaŋkʊ
brandear	bɾandeaɾ
brandir	bɾandiɾ
bravádego	bɾaβaðɪɣʊ
bravío	bɾaβiʊ
bravún	bɾaβuŋ
brazada	bɾasaðɐ
brazada	bɾaθaðɐ
brear	breaɾ
breca	bɾɛkɐ
breixo	bɾejʃʊ
breva	bɾeβɐ
brial	bɾial
brida	bɾiðɐ
brigada	bɾiɣaðɐ
brinca	bɾiŋkɐ
brinqueta	bɾiŋketɐ
brisa	bɾisɐ
brizo	bɾisʊ
brizo	bɾiθʊ
broa	bɾoɐ
broada	bɾoaðɐ
bronca	bɾoŋkɐ
brota	bɾɔtɐ
brotar	bɾɔtaɾ
brume	bɾumɪ
brun	bɾuŋ
bruneta	bɾunetɐ
bruxa	bɾuʃɐ
bruxas	bɾuʃa̝s̠
brétema	bɾɛtɪmɐ
bueu	buew
buf	buf
bufar	bufaɾ
bufardo	bufaɾðʊ
bugallón	buɣaʎoŋ
buguina	buħinɐ
buguina	buɣinɐ
bula	bulɐ
bulebule	buleβulɪ
buleira	bulejɾɐ
bulideiro	buliðejɾʊ
bulidor	buliðoɾ
bullote	buʎɔtɪ
burata	buɾatɐ
burremia	burɛmi̯ɐ
burrico	burikʊ
burricán	burikaŋ
burro	burʊ
busca	buskɐ
buxaina	buʃajnɐ
buxana	buʃanɐ
buxeiro	buʃejɾʊ
buxo	buʃʊ
bágoa	baɣo̯ɐ
bágoa	baɣʊ̯ɐ
bálsamo	balsɐmʊ
bárbaro	baɾβɐɾʊ
bébedo	beβ̞ɪð̞ʊ
bésta	bɛs̺t̪ɐ
bídalo	biðɐlʊ
bígaro	biɣɐɾʊ
bóla	bɔlɐ
ca	kɐ
cabal	kɑβal
cabala	kaβalɐ
cabaleiro	kaβalejɾʊ
cabalete	kaβaletɪ
cabalgar	kɑβalɣaɾ
cabalo	kɑβalʊ
cabeceira	kaβesei̯ɾɐ
cabeceira	kaβeθei̯ɾɐ
cabeiro	kaβei̯ɾʊ
cabelo	kɑβ̞ɛlʊ
caber	kɑβeɾ
cabezalla	kɑβesaʎɐ
cabezalla	kɑβeθaʎɐ
cabezolo	kɑβesɔlʊ
cabezolo	kɑβeθɔlʊ
cabezudo	kɑβesuðʊ
cabezudo	kɑβeθuðʊ
cabicha	kɑβitʃɐ
caboi	kɑβɔj
cabreiro	kɑβɾejɾʊ
cabrito	kɑβɾitʊ
cabuxa	kɑβuʃɐ
cabuxo	kɑβuʃʊ
cacarexo	kɑkɑreʃʊ
cachada	katʃaðɐ
cacharro	kɑtʃarʊ
cache	kɑtʃɪ
cacholudo	kɑtʃɔluðʊ
cachopo	kɑtʃɔpʊ
cachotaría	kɑtʃotaɾiɐ
cacifo	kaθifʊ
cacique	kɑθikɪ
cadabullo	kaðaβuʎʊ
cadanseu	kɑðansew
cadanseu	kɑðansɛw
cadarme	kaðaɾme
cadeado	kaðeaðo̝
cadeira	kɑðei̯ɾɐ
cadelo	kɑðɛlʊ
cadolo	kɑðolʊ
cadolo	kɑðɔlʊ
cadrifollo	kɑðɾifɔʎʊ
cadro	kɑðɾʊ
cadullo	kaðuʎʊ
cadáver	kaðaβɪɾ
cagada	kaɣaðɐ
cagado	kaɣaðʊ
cagarría	kɑɣariɐ
cagote	kɑɣɔtɪ
cai	kai̯
cais	kais
cais	kai̯s
calabrote	kalaβɾɔtɪ
calado	kɑlaðʊ
calafrío	kalafɾiʊ
calar	kɑlaɾ
callado	kɑʎaðʊ
callao	kaʎaʊ̯
calleiro	kɑʎejɾʊ
calmo	kɑlmʊ
calo	kɑlʊ
calor	kɑloɾ
calote	kɑlɔtɪ
caluga	kɑluɣɐ
calviño	kɑlβiɲʊ
calvo	kɑlβʊ
calza	kɑlsɐ
calza	kɑlθɐ
calzada	kɑlsaðɐ
calzada	kɑlθaða
calzada	kɑlθaðɐ
calzar	kɑlsaɾ
calzar	kɑlθaɾ
calzón	kɑlsoŋ
calzón	kɑlθoŋ
cama	kɑmɐ
camada	kɑmaðɐ
camareiro	kɑmaɾejɾʊ
camarón	kamaɾoŋ
camba	kɑmbɐ
cambada	kɑmbaðɐ
camballota	kɑmbaʎɔtɐ
camballón	kɑmbaʎoŋ
cambela	kambɛlɐ
cambiar	kɑmbjaɾ
cambiar	kɑmbɪaɾ
cambio	kɑmbjʊ
cambito	kɑmbitʊ
camboa	kɑmboɐ
cambre	kɑmbɾɪ
cambón	kɑmboŋ
camelo	kɑmɛlʊ
camioneiro	kɑmjonejɾʊ
camioneiro	kɑmjoneɾʊ
camiñante	kɑmiɲantɪ
camiñar	kamiɲaɾ
camiño	kamĩɲʊ
camión	kɑmjoŋ
camoesa	kamʊesɐ
campaíña	kɑmpaiɲɐ
campelo	kɑmpɛlʊ
cana	kanɐ
canabarro	kanaβarʊ
canalla	kɑnaʎɐ
canaveira	kanaβejɾɐ
canavela	kɑnaβɛlɐ
cancereixo	kɑnθeɾejʃʊ
canciño	kansiɲʊ
canciño	kanθiɲʊ
canción	kɑnsjoŋ
canción	kɑnθjoŋ
candea	kɑndeɐ
candeolo	kɑndɪɔlʊ
candorca	kandɔɾkɐ
caneco	kɑnɛkʊ
caneleira	kanɛlejɾɐ
caneta	kɑnetɐ
cangalla	kaŋgaʎɐ
cangalla	kaŋkaʎɐ
cangallo	kaŋgaʎʊ
cangallo	kaŋkaʎʊ
cangrexo	kɑŋgɾeʃʊ
cangrexo	kɑŋkɾeʃʊ
cangroia	kɐŋgɾɔjɐ
canipa	kɑnipɐ
canivete	kaniβetɪ
canle	kɑnlɪ
canouco	kɑnoʊ̯kʊ
cansar	kɑnsaɾ
cansazo	kansaθʊ
canseira	kɑnsei̯ɾɐ
canso	kansʊ
cantallao	kɑntaʎaʊ̯
cantar	kɑntaɾ
cantariña	kantaɾiɲɐ
cantaruxa	kantaɾuʃɐ
cantaruxar	kɑntaɾuʃaɾ
cantazo	kɑntasʊ
cantazo	kɑntaθʊ
cantiga	kɑntiɣɐ
cantroxo	kantɾɔʃʊ
canzorro	kanθorʊ
caos	kaʊs
capa	kapa
capador	kɑpaðoɾ
capar	kapaɾ
capaz	kɑpas
capaz	kɑpaθ
capela	kapɛlɐ
capelán	kɑpelaŋ
capetón	kapetɔŋ
capoeira	kɑpoejɾɐ
capoeira	kɑpʊejɾɐ
capuchino	kɑputʃinʊ
capudre	kɑpuðɾɪ
cara	kɑɾɐ
carabela	kɑɾaβɛlɐ
caracocha	kɑɾakɔtʃɐ
carafio	kɑɾafjʊ
carai	kɑɾaj
carallo	kaɾaʎʊ
caralludo	kɑɾaʎuðʊ
carallán	kɑɾaʎaŋ
carambo	kɑɾamβʊ
carantoña	kaɾantoɲɐ
carapa	kɑɾapɐ
carapela	kɑɾapɛlɐ
carapola	kɑɾapɔlɐ
caras	kaɾas
carballal	kaɾβaʎal
carballo	kɑɾβaʎʊ
carbúnculo	kaɾβuŋkulʊ
carda	kɑɾðɐ
cardeal	kɑɾðeal
cardeña	kaɾðeɲɐ
cardume	kaɾðumɪ
careiro	kɑɾejɾʊ
careza	kɑɾeθɐ
caritel	kɑɾitɛl
cariz	kɑɾis
cariz	kɑɾiθ
carme	kɑɾmɛ
carmela	kɑɾmɛlɐ
carmiña	kɑɾmiɲɐ
carnabaza	kɑɾnaβaθɐ
carniceiro	kɑɾnisejɾʊ
carniceiro	kɑɾniθejɾʊ
carnicería	kɑɾniseɾiɐ
carnicería	kɑɾniθeɾiɐ
carnizaría	kɑɾnisaɾiɐ
carnizaría	kɑɾniθaɾiɐ
carnocho	kɑɾnotʃʊ
caro	kɑɾʊ
caroca	karɔkɐ
carocha	kaɾɔtʃɐ
carouxo	kɑɾou̯ʃʊ
carpa	kaɾpa
carpanta	kaɾpantɐ
carpaza	kaɾpaθɐ
carpintaría	kɑɾpintaɾiɐ
carpín	kɑɾpiŋ
carraxe	kɑraʃɪ
carrear	kɑreaɾ
carreira	kɑrei̯ɾɐ
carreiro	karejɾʊ
carrelo	kɑɾɛlʊ
carreta	kɑretɐ
carrexar	kɑreʃaɾ
carricanta	karikantɐ
carriozo	kariɔθʊ
carriño	kariɲʊ
carro	karʊ
carromeiro	kɑromejɾʊ
carronzo	karonθʊ
carroucho	kɑrowtʃʊ
carruaxe	karuaʃɪ
carrán	kɑraŋ
carta	kaɾtɐ
carteira	kaɾtei̯ɾɐ
carteiro	kaɾteiɾʊ
cartón	kɑɾtoŋ
caruncho	kaɾuntʃʊ
carvea	kɑɾβeɐ
cas	kas
casa	kas̺ɐ
casamento	kɑsamentʊ
casar	kasaɾ
cascalleiro	kɑskɑʎejɾʊ
cascallento	kɑskɑʎentʊ
cascallento	kɑskɑʎɛntʊ
cascudo	kɑskuðʊ
case	kɑsɪ
caseño	kɑseɲʊ
casoiro	kɑsojɾʊ
castañeta	kɑstaɲetɐ
castaño	kɑstaɲʊ
castejano	kɑsteħanʊ
casteleiro	kɑstelejɾʊ
castigar	kastiɣaɾ
castiñeiro	kɑstiɲejɾʊ
castrolandín	kɑstɾolandiŋ
casula	kɑsulɐ
cata	kɑtɐ
catalexo	kataleʃo̝
catarreira	kɑtarejɾɐ
catro	kɑtɾʊ
causa	kau̯sɐ
cava	kɑβɐ
cavaca	kɑβakɐ
cavaco	kɑβakʊ
cavidar	kɑβiðaɾ
cavilar	kɑβilaɾ
caxato	kɑʃatʊ
caxigo	kɑʃiɣʊ
cazar	kɑsaɾ
cazar	kɑθaɾ
cazo	kɑsʊ
cazo	kɑθʊ
cazola	kɑsɔlɐ
cazola	kɑθɔlɐ
cazolo	kɑsɔlʊ
cazolo	kɑθɔlʊ
caño	kɑɲʊ
ceba	seβa̝
ceba	θeβa̝
cebadeira	seβaðejɾɐ
cebadeira	θeβaðejɾɐ
cebado	seβaðʊ
cebado	θeβaðʊ
cebar	sebaɾ
cebar	θebaɾ
cebola	sɛβɔla̝
cebola	θeβola̝
cebolo	seβolʊ
cebolo	θeβolʊ
cebra	θeβɾɐ
cedo	seðʊ
cedo	θeðʊ
cegoña	θeɣoɲɐ
cegoña	θɪɣoɲɐ
cella	seʎɐ
cella	θeʎɐ
celos	θelos
celoso	θelosʊ
celta	θɛltɐ
cemba	θembɐ
cempés	sempɛs
cempés	θɛmpɛs
cen	θen
centeeira	θenteejɾɐ
centoenrama	θɛntʊenramɐ
cenzo	sensʊ
cenzo	θenθʊ
ceo	sɛʊ̯
ceo	θɛʊ
ceo	θɛʊ̯
cercado	θeɾkaðʊ
cernada	θeɾnaðɐ
cerollo	θeɾoʎʊ
cerra	serɐ
cerra	θerɐ
cerralla	seraʎɐ
cerralla	θeraʎɐ
cerreta	sɛretɐ
cerreta	θɛretɐ
cerrizo	θeriθʊ
cerrote	θerɔtɪ
cerrume	θɛrumɪ
certidume	θɛɾtiðumɪ
certo	sɛɾtʊ
certo	θɛɾtʊ
cervato	θɛɾβatʊ
cervexa	seɾβeʃa̝
cervexa	θeɾβeʃa̝
cesta	sestɐ
cesta	θestɐ
cha	tʃa
chafallar	tʃafaʎaɾ
chagar	tʃaɣaɾ
chaira	tʃajɾɐ
chairo	tʃai̯ɾʊ
chalana	tʃalanɐ
chaleco	tʃalɛkʊ
chama	tʃama
chamamento	tʃamamentʊ
chamamento	tʃamamɛntʊ
chamar	tʃamaɾ
chamariza	tʃamaɾiθɐ
chambra	tʃambɾɐ
chanca	tʃaŋkɐ
chandarme	tʃandaɾmɪ
chanfaina	tʃaɱfajnɐ
chantado	tʃantaðʊ
chanteiro	tʃantei̯ɾʊ
chao	tʃaw
chao	tʃaʊ̯
chapurrear	tʃapureaɾ
chave	tʃaβe
chavello	tʃaβeʎʊ
chaíñas	tʃaiɲa̝s
che	tʃe
cheda	tʃeðɐ
cheiracús	tʃei̯ɾakus
cheirume	tʃejɾumɪ
cheminea	tʃeminɛɐ
chepudo	tʃepuðʊ
chicha	tʃitʃɐ
chicharra	tʃitʃarɐ
chicharro	tʃitʃarʊ
chifrar	tʃifɾaɾ
chimpín	tʃimpiŋ
chincho	tʃintʃʊ
chineiro	tʃinejɾʊ
chispa	tʃispɐ
chocar	tʃokaɾ
chocolate	tʃokolatɪ
choremia	tʃoɾɛmi̯ɐ
choricar	tʃoɾikaɾ
chorido	tʃoɾiðʊ
chorimicar	tʃoɾimikaɾ
chorume	tʃoɾumɪ
choscar	tʃoskaɾ
choupa	tʃowpɐ
choupa	tʃɔupɐ
chouparro	tʃowparʊ
choupín	tʃou̯piŋ
chourizo	tʃowɾiso̝
chourizo	tʃowɾiθo̝
chousume	tʃowsumɪ
chover	tʃoβ̞eɾ
chucho	tʃutʃʊ
chumbalagato	tʃumbalaɣatʊ
chupa	tʃupa
churrusqueiro	tʃuruskejɾʊ
chus	tʃus
chusqueiro	tʃuskejɾʊ
chusquiño	tʃuskiɲʊ
chuvascada	tʃuβ̞as̺kɑð̞ɐ
chuvioso	tʃuβjosʊ
chuvisca	tʃuβiskɐ
chuviscar	tʃuβiskaɾ
chuviña	tʃuβiɲɐ
chuviñar	tʃuβiɲaɾ
chuviñento	tʃoβiɲentʊ
chuzo	tʃusʊ
chuzo	tʃuθʊ
chícharo	tʃitʃɐɾʊ
cidade	siða
cidade	θiðaðɪ
cidra	siðɾɐ
cidra	θiðɾɐ
cimento	simentʊ
cimento	θimɛntʊ
cimo	θimʊ
cimón	θimoŋ
cincento	sinsentʊ
cincento	θinθɛntʊ
cinguideiro	θiŋgiðei̯ɾʊ
cinzarra	θinθarɐ
cirolas	siɾɔlɐs
cirolas	θiɾɔlɐs
cirrichar	siritʃaɾ
cirrichar	θiritʃaɾ
cirurxián	siɾuɾʃjɑŋ
cirurxián	θiɾuɾʃjɑŋ
cizañeiro	θiθaɲejɾʊ
cizañento	θiθaɲɛntʊ
claras	klaɾas
clarear	klaɾeaɾ
claustro	klawstɾʊ
co	ko
coa	koa
coada	koaðɐ
coadeira	koaðejɾɐ
coandro	koandɾʊ
coaña	kʊ̯aɲɐ
coañar	kʊ̯aɲaɾ
coañeira	kʊ̯aɲejɾɐ
coaño	kʊ̯aɲʊ
cobertoira	koβeɾtoi̯ɾɐ
cobertoiro	koβeɾtoi̯ɾʊ
cobertor	koβeɾtoɾ
cobertura	koβeɾtuɾɐ
cobra	koβɾa
cobrar	koβɾaɾ
cocedura	koseðuɾɐ
cocedura	koθeðuɾɐ
cocer	koseɾ
cocer	koθeɾ
coche	kɔtʃɪ
cociña	kosiɲɐ
cociña	koθiɲɐ
codela	koðɛlɐ
codelo	koðelʊ
codelo	koðɛlʊ
codicilo	coðisilʊ
codicilo	coðiθilʊ
codificar	koðifikaɾ
coeiro	koei̯ɾʊ
cofar	kofaɾ
cofiño	kofiɲʊ
cogombro	koɣombɾʊ
cogomelo	koɣomɛlʊ
cogordo	koɣoɾðʊ
coiro	kojɾʊ
coitadiño	kojtaðiɲʊ
coitela	kojtɛlɐ
coitelada	kojtelaðɐ
coitelo	kojtelʊ
cola	kola
colazo	kolaθʊ
colcha	kolʲtʃɐ
colchón	koʎtʃoŋ
colexio	koleʃiʊ
colgar	kolɣaɾ
colleitizo	koʎei̯tiθʊ
colmado	kolmaðʊ
colmadura	kolmaðuɾɐ
color	koloɾ
coma	koma
comadre	komaðɾɪ
comba	kombɐ
comba	kɔmbɐ
combar	kombaɾ
combo	kombʊ
comedela	komeðɛlɐ
comedio	komeðjʊ
comellón	komeʎoŋ
comen	komẽn
comenencia	komẽnẽnsi̯ɐ
comenencia	komẽnẽnθi̯ɐ
comenenciudo	komẽnẽnsʊðʊ
comenenciudo	komẽnẽnθi̯ʊðʊ
comer	komeɾ
comercio	komɛɾθi̯ʊ
comichar	komitʃaɾ
comichón	komitʃoŋ
comiño	komiɲʊ
compadre	kompaðɾɪ
compangar	kompaŋgaɾ
compango	kompaŋgʊ
compango	kompaŋkʊ
compangueiro	kompaŋgejɾʊ
comparanza	kompaɾansɐ
comparanza	kompaɾanθɐ
compañeiro	kompaɲejɾʊ
compañía	kompaɲiɐ
común	komũŋ
con	kɔŋ
con	kʊŋ
conacha	konatʃɐ
conachada	konatʃaðɐ
concello	konseʎʊ
concello	konθeʎʊ
concheiro	kontʃejɾʊ
concho	kontʃʊ
condado	kondaðʊ
conde	kondɪ
condenar	kondenaɾ
condesa	kondesɐ
condición	kondisi̯oŋ
condición	kondiθi̯oŋ
condoito	kondoi̯tʊ
confirmar	koɱfiɾmaɾ
confortar	koɱfoɾtaɾ
confraría	koɱfɾaɾiɐ
congro	koŋgɾʊ
congrua	kɔŋgɾwɐ
congruo	kɔŋgɾwʊ
conque	koŋkɪ
conquerir	kʊŋkeɾiɾ
consigo	konsiɣʊ
consolar	konsolaɾ
consolda	konsɔldɐ
constitución	konstituθjoŋ
constrinxir	konstɾinʃiɾ
conta	konta
contar	kontaɾ
contento	kontentʊ
contorna	kontoɾnɐ
contra	kontɾɐ
contrafeito	kontɾafejtʊ
contramestre	kontɾamɛstɾɪ
contras	kontɾas
contrasinal	kontɾasinal
contrato	kontɾatʊ
conversa	kombɛɾsɐ
convidado	kombiðaðʊ
convir	kombiɾ
convulsión	kombuls̺joŋ
cor	koɾ
cor	koːɾ
cor	kɔɾ
corbelo	koɾβelʊ
corda	kɔɾðɐ
cordal	kɔɾðal
cordeiro	koɾðejɾʊ
cordeiro	kɔɾðejɾʊ
cordo	kɔɾðʊ
cordura	kɔɾðuɾɐ
corenta	kɔrɛntɐ
corentena	koɾɛntenɐ
cores	kɔɾes
corgo	kɔɾɣʊ
corisco	koɾiskʊ
cornabude	kɔɾnaβuðɪ
cornella	koɾneʎɐ
cornello	koɾneʎʊ
cornizó	koɾniθɔ
corno	kɔɾnʊ
cornudo	kɔɾnuðʊ
corpo	koɾpʊ
correeiro	koreejɾʊ
corrente	korentɪ
corrente	korɛntɪ
correo	koreʊ
correr	korer
corrida	koriðɐ
corripa	coripɐ
cortador	koɾtaðoɾ
cortadoría	koɾtaðoɾiɐ
cortar	koɾtaɾ
cortegada	koɾteɣaðɐ
cortella	koɾteʎɐ
corticeiro	koɾtisejɾʊ
corticeiro	koɾtiθejɾʊ
corticeiro	kʊɾtiθejɾʊ
cortina	koɾtinɐ
cortizo	koɾtisʊ
cortizo	koɾtiθʊ
corzo	koɾsʊ
corzo	koɾθʊ
cos	kos
coser	koseɾ
costa	kosta
costado	kostaðʊ
costeira	kostejɾɐ
costeleta	kostɛletɐ
costoia	kostɔja̝
costume	kostumɪ
cota	kɔtɐ
cotelada	kotelaðɐ
coteno	kotenʊ
cotifar	kotifaɾ
cotorza	kɔtɔrθɐ
cotrento	kotɾɛntʊ
cotroso	kotɾosʊ
cotón	kotoŋ
coucillón	kowsiʎoŋ
coucillón	kowθiʎoŋ
coucón	kowkoŋ
couquizo	koʊ̯kiθʊ
cousa	kows̺ɐ
couselo	kowselʊ
coutado	kou̯taðʊ
coutar	kowtaɾ
covarde	koβaɾðɪ
covardía	koβaɾðiɐ
coveiro	kɔβejɾʊ
covo	kɔβʊ
coxa	koʃɐ
coxeira	coʃei̯ɾɐ
coxo	koʃo̝
coxote	koʃɔtɪ
coíña	kʊiɲɐ
coñecemento	koɲeθementʊ
coñecer	koɲeseɾ
coñecer	koɲeθeɾ
cre	kɾe
crea	kɾea
crecer	kɾeseɾ
crecer	kɾeθeɾ
crecha	kɾetʃɐ
crecho	kɾetʃʊ
cren	kɾen
crencha	kɾentʃɐ
crente	kɾɛntɪ
crenza	kɾenθɐ
crequenas	kɾekenɐs
crer	kɾeɾ
creto	kɾɛtʊ
criar	kɾiaɾ
criba	kɾiβɐ
cribar	kɾiβaɾ
cribelo	kɾiβelʊ
cribo	kɾiβʊ
criminal	kɾimĩnɑɫ
crin	kɾin
crina	kɾinɐ
crisma	kɾismɐ
croar	kɾoaɾ
croca	kɾɔkɐ
croucheira	kɾowtʃejɾɐ
cru	kɾu
crucificar	kɾuθifikaɾ
crucifixo	kɾuθifiʃʊ
cruz	kɾus
cruz	kɾuθ
cría	kɾia
crían	kɾian
cu	ku
cuadrilla	kwaðɾiʎɐ
cuadrilátero	kwað̞ɾilat̪eɾʊ
cuarzo	kwaɾsʊ
cuarzo	kwaɾθʊ
cuba	kuβa
cuberto	kuβɛɾtʊ
cubrir	kuβɾiɾ
cucho	kutʃʊ
cuco	kukʊ
cugula	kuɣulɐ
cugulo	kuɣulʊ
cuincar	kʊi̯ŋkaɾ
culpa	kulpɐ
culpar	kulpaɾ
cultura	kul̪t̪uɾɐ
cumprido	kumpɾiðʊ
cunca	kuŋkɐ
cunqueiro	kuŋkei̯ɾʊ
cuquelo	kukɛlʊ
currada	kuraðɐ
curral	kural
curruncho	kuruntʃʊ
curso	kuɾsʊ
curta	kuɾta
curtas	kuɾtɐs
curto	kuɾt̪ʊ
curuxo	kuɾuʃʊ
curva	kuɾβɐ
curvo	kuɾβʊ
custa	kustɐ
custas	kustɐs
cuxo	kuʃʊ
cuza	kuθɐ
cuzo	kuθʊ
cuña	kuɲɐ
cuño	kuɲʊ
cágado	kaɣɐðʊ
cáliz	kɑlis
cáliz	kɑliθ
cálsamo	kɑlsɐmʊ
cámara	kamɐɾɐ
cáncaro	kaŋkɐɾʊ
cántiga	kɑntiɣɐ
cárcava	kɑɾkɐβɐ
cóbado	koβɐðʊ
cóbrega	kɔβɾɪɣɐ
cócedra	koθɪðɾɐ
cómaro	komɐɾʊ
cónchega	kontʃɪɣɐ
cóntasnos	kontasnos
cúa	kuɐ
da	da
dado	daðʊ
daquela	dakela
davila	da‿βilɐ
de	dɛ
dea	dea
debruzar	deβɾusaɾ
debruzar	deβɾuθaɾ
decer	deθeɾ
decontado	dekontaðʊ
decorrer	dekoreɾ
decrecer	dekɾeseɾ
decrecer	dekɾeθeɾ
decreto	dekɾɛtʊ
decruar	dekɾuaɾ
decrúa	dekɾuɐ
dedal	deðal
dedil	deðil
defender	defendeɾ
defunto	defuntʊ
degaxar	deɣaʃaɾ
degrao	degɾaʊ̯
deixar	dejʃaɾ
del	del
delgado	delɣaðʊ
demandar	d̪emãnð̞ar
dengue	dɛŋgɪ
dengue	dɛŋkɪ
dentadura	dentaðuɾɐ
dentadura	dɛntaðuɾɐ
dentame	dentamɪ
dentame	dɛntamɪ
dentamia	dentamiɐ
dentamia	dɛntamiɐ
dentar	dentaɾ
dentar	dɛntaɾ
dente	dentɪ
dente	dɛntɪ
depenicar	depɪnikaɾ
deprender	depɾendeɾ
derramar	deramaɾ
derreado	dereaðʊ
derreter	dereteɾ
derribar	deriβaɾ
desacougo	desakowɣʊ
desarraigar	desarajɣaɾ
descabelado	deskaβelaðʊ
descastado	deskastaðʊ
descoser	deskoseɾ
deseguida	deseɣiðɐ
deseguido	deseɣiðʊ
desempenar	desempenaɾ
desexo	deseʃʊ
desfacer	desfaseɾ
desfacer	desfaθeɾ
desfalecer	desfaleseɾ
desfalecer	desfaleθeɾ
desfiar	desfiaɾ
desleigar	deslejɣaɾ
desmacelar	desmaθelaɾ
desmaiar	desmajar
desmellorar	desmeʎoɾaɾ
desmellorar	desmiʎoɾaɾ
despensa	despensɐ
despexar	despeʃaɾ
despregar	despɾeɣaɾ
desprezar	despɾeθaɾ
destemido	destemiðʊ
destruír	destɾuiɾ
desvariar	desβaɾiaɾ
desvariar	desβaɾi̯aɾ
deter	deteɾ
deus	dews
deusa	dewsɐ
deva	deβɐ
devalo	deβalʊ
devanceiro	deβanθei̯ɾʊ
devandito	deβanditʊ
devesa	deβesɐ
devoción	deβoθjoŋ
dez	d̪ɛs
dez	d̪ɛθ
dianteira	diantejɾɐ
dianteiro	diantejɾʊ
diola	djɔlɐ
dita	dita
ditar	ditaɾ
dito	ditʊ
ditongo	ditoŋgo̝
divertir	diβɪrtir
división	diβisjoŋ
diástole	d̪jas̺t̪olɪ
do	do
doazón	doasoŋ
doazón	doaθoŋ
doca	dɔkɐ
doce	dosɪ
doce	doθɪ
doente	doentɪ
doente	doɛntɪ
doente	do̯entɪ
doenza	doensɐ
doenza	doɛnθɐ
doer	doeɾ
doira	dojɾɐ
doira	dujɾɐ
doiro	dojɾʊ
doiro	dujɾʊ
doito	dojtʊ
dolmen	dɔlmɪŋ
dolorosamente	doloɾosamentɪ
doloroso	doloɾosʊ
domear	domeaɾ
don	don
doncela	donθɛlɐ
dono	dono
donos	donos
donoso	donosʊ
dor	d̪oːɾ
dormideira	doɾmiðei̯ɾɐ
dorna	dɔɾnɐ
dos	dos
dourar	doʊ̯ɾaɾ
dous	dows
dragón	dɾaɣoŋ
drama	ðɾama
dromedario	dɾomeðaɾjʊ
ducia	dusɪ̯ɐ
ducia	duθɪ̯ɐ
durmidor	duɾmiðor
durmir	duɾmiɾ
durmiñento	duɾmiɲentʊ
durmiñento	duɾmiɲɛntʊ
duro	duɾʊ
durén	duɾɛŋ
dá	da
dádiva	daðiβɐ
débeda	deβɪðɐ
débil	dɛβɪl
década	ðekaða
día	d̪iɐ
dó	dɔ
dúas	duɐs
e	e
edificio	ɛðifiθi̯ʊ
ei	ej
eito	ɛjtʊ
eixar	ei̯ʃaɾ
eixe	ejʃɪ
eixir	ejʃiɾ
eixo	ejʃʊ
el	ɛl
ela	elɐ
ela	ɛlɐ
elas	elas
elixir	ɛliksiɾ
elixir	ɛliʃiɾ
embaixada	embajʃaðɐ
embazar	embasaɾ
embazar	embaθaɾ
embebedentar	emβeβeðentaɾ
embelecar	embelekaɾ
embeleco	embelekʊ
embeleñar	embeleɲaɾ
embigo	embiɣʊ
emboutar	embou̯taɾ
embruxar	embɾuʃaɾ
embuligar	embuliɣaɾ
emenda	emɛ̃ndɐ
emendar	emendaɾ
empacho	empatʃʊ
empeitizo	empejtisʊ
empeitizo	empejtiθʊ
empenar	empenaɾ
empezoñar	empesoɲaɾ
empezoñar	empeθoɲaɾ
empeña	empeɲɐ
emporcallar	empɔɾkaʎɐɾ
emporcar	empɔɾkaɾ
emporiso	empoɾisʊ
emposta	empɔstɐ
emprega	empɾeɣa
empregado	empɾeɣaðʊ
empreñar	empɾeɲaɾ
empurrar	empuraɾ
empuxar	empuʃaɾ
en	em
encabar	eŋkaβaɾ
encabuxar	eŋkɑβuʃaɾ
encaixe	eŋkai̯ʃɪ
encalar	eŋkalaɾ
encaldada	eŋkaldaðɐ
encaldar	eŋkaldaɾ
encallar	enkaʎaɾ
encamiñar	eŋkamĩɲaɾ
encampecer	eŋkampeθeɾ
encantador	eŋkɑntaðoɾ
encargar	eŋkaɾɣaɾ
encerretar	enθeretaɾ
encirrar	ensiraɾ
encirrar	enθiraɾ
encontrar	eŋkontɾaɾ
encorar	eŋkoɾaɾ
encoro	eŋkorʊ
encosta	enkostɐ
encrechar	eŋkɾetʃaɾ
encrucillado	enkɾuθiʎaðʊ
encrucillar	enkɾusiʎaɾ
encrucillar	enkɾuθiʎaɾ
endegar	endeɣaɾ
endego	endeɣʊ
endereitar	endeɾejtaɾ
enderezo	endeɾeθʊ
endexamais	endeʃamai̯s
endrogar	endɾoɣaɾ
eneixar	enei̯ʃaɾ
eneixar	eŋei̯ʃaɾ
enfadar	eɱfaðaɾ
enfermar	eɱfeɾmaɾ
enfermaría	eɱfeɾmaɾiɐ
enfermeiro	eɱfeɾmejɾʊ
enfermidade	eɱfeɾmiða
enfermidade	eɱfeɾmiðaðɪ
enfermo	eɱfeɾmʊ
enferruxado	eɱferuʃaðʊ
enferruxar	eɱferuʃaɾ
enfestar	eɱfestaɾ
enfiar	eɱfiaɾ
enfociñar	eɱfoθiɲaɾ
enfondura	eɱfonduɾɐ
enforcar	eɱfoɾkaɾ
enfoumar	eɱfowmaɾ
enfouzar	eɱfowsaɾ
enfouzar	eɱfowθaɾ
enfraquecer	eɱfɾakeseɾ
enfraquecer	eɱfɾakeθeɾ
enfurruñar	eɱfuruɲaɾ
engadir	eŋgaðiɾ
engado	eŋgaðʊ
enganar	eŋganaɾ
enganchar	eŋgantʃaɾ
enganido	eŋganiðʊ
engano	eŋganʊ
engarrar	eŋgaraɾ
engoar	eŋgoaɾ
engordar	eŋgoɾðaɾ
engorde	eŋgɔɾðe̝
engoumado	eŋgou̯maðʊ
engoumar	eŋgou̯maɾ
engoumiñar	eŋgou̯miɲaɾ
engratidume	eŋgɾatiðumɪ
engrenaxe	eŋgɾenaʃɪ
engroba	eŋgɾɔβɐ
engrosar	eŋgɾosaɾ
engrudo	eŋgɾuðʊ
engruñar	eŋgɾuɲaɾ
enguedellar	eŋgeðeʎaɾ
enlagar	enlaɣaɾ
enlouquecer	enloʊ̯keθeɾ
enmeigar	eŋmejɣaɾ
enmerdar	eŋmerðaɾ
enrabiar	enraβjaɾ
ensaio	ensajʊ
ensanchar	ensantʃaɾ
ensarillar	ensaɾiʎaɾ
ensinar	ensinaɾ
ensumir	ensumiɾ
entalar	entalaɾ
entalla	entaʎɐ
entallar	entaʎaɾ
entanguiñar	entaŋgiɲaɾ
enteimar	entejmaɾ
enteirizo	entejɾisʊ
enteirizo	entejɾiθʊ
entender	entendeɾ
entestar	entestaɾ
entoucar	entowkaɾ
entrabar	entɾaβaɾ
entrampar	entɾampaɾ
entranhar	entraɲar
entrar	entɾaɾ
entraña	entɾaɲɐ
entrañar	entraɲar
entre	entɾɪ
entrechantar	entretʃantaɾ
entrecosto	entɾekɔstʊ
entrefebrado	entɾefeβɾaðʊ
entrementres	entɾementɾɪs
entrementres	entɾemɛntɾɪs
entremeter	entɾemeteɾ
entroido	entɾoi̯ðʊ
entupir	entupiɾ
enturrar	enturɑɾ
entusiasticamente	en̪t̪us̺jas̺t̪ikɑmẽn̪t̪ɪ
entón	entoŋ
envear	embeaɾ
envellecer	embeʎeseɾ
envellecer	embeʎeθeɾ
envellentar	embeʎentaɾ
envellentar	embɛʎentaɾ
envexa	embeʃɐ
envexigar	embeʃiɣaɾ
enviar	embiaɾ
enviar	embjaɾ
envolvedor	embolβeðoɾ
enxame	enʃamɪ
enxangada	enʃaŋgaðɐ
enxangar	enʃaŋgaɾ
enxaugado	enʃawɣaðʊ
enxaugar	enʃawɣaɾ
enxerto	enʃeɾtʊ
enxeño	enʃeɲʊ
enxoito	enʃojtʊ
enxordar	enʃoɾðaɾ
enxugar	enʃuɣaɾ
enxunlla	enʃunʎɐ
eo	eʊ̯
epidemia	ɛpiðɛmi̯ɐ
equipaxe	ekipaʃɪ
equipo	ekipʊ
ermosende	eɾmosendɪ
es	es
esbagullar	esbaɣuʎaɾ
esbandallar	esβandaʎaɾ
esbarrancar	esβaraŋkaɾ
esbarrufar	esbarufaɾ
esbatuxar	esβatuʃaɾ
esbigoar	esβiɣoaɾ
esbirrar	esβiraɾ
esbochar	esβɔtʃaɾ
esborrallar	esβoraʎaɾ
esbroar	esβɾoaɾ
esburo	esbuɾʊ
escachapedras	eskatʃapɛðɾɐs
escachapiollos	eskatʃapioʎʊ
escallar	eskɑʎaɾ
escallo	eskɑʎʊ
escama	eskɑmɐ
escamar	eskɑmaɾ
escampar	eskɑmpaɾ
escana	eskanɐ
escano	eskanʊ
escapar	eskapaɾ
escarabana	eskaɾaβanɐ
escarabanar	eskɑɾaβanaɾ
escarallado	eskaɾaʎaðʊ
escarapela	eskɑɾapɛlɐ
escarnar	eskaɾnaɾ
escarnecer	eskaɾneθeɾ
escarnir	eskaɾniɾ
escarranchar	eskarantʃaɾ
escaseza	eskɑseθɐ
escaso	eskɑsʊ
escatima	eskɑtimɐ
escatimar	eskɑtimaɾ
escavichar	eskaβitʃaɾ
escenario	esenaɾjʊ
escenario	esθenaɾjʊ
escoar	eskoaɾ
escocer	eskoseɾ
escocer	eskoθeɾ
escochado	eskotʃaðʊ
escola	es̺kɔlɐ
escolar	eskolaɾ
escomezar	eskʊmesaɾ
escomezar	eskʊmeθaɾ
esconder	eskondeɾ
escordar	eskɔɾðaɾ
escornavirus	eskɔɾnaβiɾus
escorredío	eskoreðiʊ
escorrer	eskoreɾ
escravo	eskɾaβʊ
escrequenar	eskɾekenaɾ
escribe	eskɾiβe
escribenta	eskɾiβentɐ
escribenta	eskɾiβɛntɐ
escrófula	eskɾɔfulɐ
escudir	eskuðiɾ
escudo	eskuðʊ
escumadeira	eskumaðei̯ɾɐ
escurecer	eskuɾeseɾ
escurecer	eskuɾeθeɾ
escáncer	eskanθɪɾ
esencia	esɛnθi̯ɐ
esfameado	esfameaðʊ
esfiar	esfiaɾ
esfiañado	esfjaɲaðʊ
esfiañar	esfjaɲaɾ
esfollada	esfoʎaðɐ
esforzar	esfoɾsaɾ
esforzar	esfoɾθaɾ
esforzo	esfɔɾsʊ
esforzo	esfɔɾθʊ
esfuracar	esfuɾakaɾ
esgarro	esɣarʊ
esleer	esleeɾ
esmadroar	esmaðɾoaɾ
esmalte	esmaltɪ
esmar	esmaɾ
esmelgar	esmelɣaɾ
esmeralda	esmeɾaldɐ
esmerar	esmeɾaɾ
esmerode	esmeɾoðɪ
esmolicar	esmɔlikaɾ
esmorode	esmoɾoðɪ
esnogar	esnoɣaɾ
esoutro	esowtɾʊ
espadeiro	espaðejɾʊ
espaldeira	espal
espalecer	espaleθeɾ
espantallo	espantaʎʊ
espanto	espantʊ
espantoso	espantosʊ
esparaván	espaɾaβaŋ
esparexemento	espaɾeʃementʊ
esparruñar	esparuɲaɾ
espazo	espaθʊ
españa	es̺paɲɐ
especia	espeθjɐ
espello	espeʎʊ
espeluxado	espeluʃaðʊ
espendoar	espendoaɾ
espera	espeɾa
esperanza	espeɾanθɐ
esperar	espeɾaɾ
espero	espeɾo
espertar	espeɾtaɾ
espeso	espesʊ
espiga	espiɣɐ
espigar	espiɣaɾ
espigo	espiɣʊ
espiña	espiɲa
espiñar	espiɲaɾ
espiñela	espiɲɛlɐ
espiñento	espiɲentʊ
espolar	espɔlaɾ
espoldrexar	espoldɾeʃaɾ
espoldriñar	espoldɾiɲaɾ
espoltrar	espoltɾaɾ
esponxa	esponʃɐ
espora	espɔɾɐ
esporear	espoɾeaɾ
esporoar	espoɾoaɾ
esporta	espɔɾtɐ
esportela	espɔɾtɛlɐ
espreguizar	espɾeɣisaɾ
espreguizar	espɾeɣiθaɾ
espurrir	espuriɾ
espurriñar	espuriɲaɾ
espía	espiɐ
espírito	espiɾitʊ
esquecemento	eskɛsementʊ
esquecemento	eskɛθemɛntʊ
esquerdeiro	eskeɾðejɾʊ
esquerdo	eskeɾðʊ
esquezo	eskɛsʊ
esquezo	eskɛθʊ
esquivo	eskiβʊ
esquía	eskiɐ
esquío	ɪskiʊ̯
esta	esta
estaba	estaβa
estable	estaβlɪ
estacada	estakaðɐ
estadounidense	es̺t̪að̞ownið̞ens̺ɪ
estadullo	estaðuʎʊ
estaleiro	estalejɾʊ
estalo	estalʊ
estalote	estalɔtɪ
estameña	estameɲɐ
estancar	estaŋkaɾ
estanco	estaŋkʊ
estantiga	estantiɣɐ
este	estɪ
esteira	estejɾɐ
estela	estɛla̝
estemorecer	estemoɾeθeɾ
estender	estendeɾ
esternina	esteɾninɐ
esterqueiro	esteɾkei̯ɾʊ
estes	estes
estimar	estimaɾ
estiñar	estiɲaɾ
estomballar	estombaʎaɾ
estoque	estɔkɪ
estorbar	estoɾβaɾ
estorbo	estɔɾβʊ
estordegar	estoɾðeɣaɾ
estornela	estoɾnɛlɐ
estou	estow
estouro	estowɾʊ
estoutro	estowtɾʊ
estoxo	estoʃʊ
estralouzar	estɾalowsaɾ
estralouzar	estɾalowθaɾ
estranxeiro	estɾaŋʃejɾʊ
estreito	estɾejtʊ
estrela	es̺tɾelɐ
estrelado	estɾelaðʊ
estrelar	estɾelaɾ
estrelecer	estɾeleseɾ
estrelecer	estɾeleθeɾ
estreleiro	estɾelejɾʊ
estremecer	estɾemeseɾ
estremecer	estɾemeθeɾ
estremeiro	estɾemei̯ɾʊ
estribiar	estɾiβjaɾ
estribo	estɾiβʊ
estriga	estɾiɣɐ
estrigar	estɾiɣaɾ
estroina	estrojnɐ
esturruxar	esturuʃaɾ
estábel	estaβɪl
estío	es̺t̪iʊ
esvaecer	esβaeseɾ
esvaecer	esβaeθeɾ
esvaer	esβaeɾ
esvaradoiro	esβaɾaðojɾʊ
esvirillar	esβiɾiʎaɾ
evanxeo	eβanʃeʊ
exemplo	eʃemplʊ
experto	ekspɛɾtʊ
fa	fa
faboca	faβɔkɐ
faceiroa	fasei̯ɾoɐ
faceiroa	faθei̯ɾoɐ
facelo	fakelo
facer	faseɾ
facer	faθeɾ
fachendoso	fatʃendosʊ
fachico	fatʃikʊ
fachuco	fatʃukʊ
fachuzo	fatʃusʊ
fachuzo	fatʃuθʊ
faco	fakʊ
facotexo	fakoteʃʊ
fada	faðɐ
fadar	faðaɾ
fala	fala
faladeiro	falaðei̯ɾʊ
falado	falado
falador	faladoɾ
falar	falaɾ
falcatruada	falkɑtɾuaðɐ
falcatrúa	falkatɾuɐ
falchoca	faltʃɔkɐ
faldriqueira	faldɾikejɾɐ
fale	fale
falecemento	falesementʊ
falecemento	faleθemɛntʊ
falecer	faleseɾ
falecer	faleθeɾ
falla	faʎɐ
fallo	faʎʊ
falmaguento	falmaɣentʊ
falmaguento	falmaɣɛntʊ
falsar	falsaɾ
falsario	falsaɾiʊ
falsidade	falsiðaðɪ
falso	falsʊ
falúa	faluɐ
fame	famɪ
famelgo	famelɣʊ
familia	familjɐ
famosa	famɔsa
fan	fan
fana	fana
fanado	fanaðʊ
fananco	fanaŋkʊ
faneca	fanɛkɐ
fanicar	fanikaɾ
fanico	fanikʊ
fanteira	fantejɾɐ
fantástico	fantastikʊ
faramalla	faɾamaʎɐ
faramalleiro	faɾamaʎejɾʊ
fardo	farðʊ
farfallar	faɾfaʎaɾ
farfallán	farfaʎaŋ
farfantón	farfantoŋ
fargallo	faɾɣaʎʊ
fariñento	faɾiɲentʊ
fariñento	faɾiɲɛntʊ
farra	farɐ
farrapa	farapɐ
farruco	farukʊ
fas	fas
fascaño	faskɑɲʊ
fasco	faskʊ
fasquía	faskiɐ
fatelo	fatɛlʊ
fatoeiro	fatoejɾʊ
fatoeiro	fatʊejɾʊ
favor	faβ̞oɾ
fazaña	faθaɲɐ
faísca	faiskɐ
faíscas	faiskas
fe	fɛ
feble	fɛβlɪ
febre	fɛβɾɪ
febreiro	feβɾejɾʊ
fecha	fetʃɐ
fechar	fetʃaɾ
fecho	fetʃʊ
fedor	feðoɾ
fedorento	feðoɾentʊ
feiticeira	fejtisejɾɐ
feiticeira	fejtiθejɾɐ
feitizo	fei̯tisʊ
feitizo	fei̯tiθʊ
feito	feitʊ
feitura	fejtuɾɐ
fel	fɛl
felicidade	feliθiðaðe̝
felonía	feloniɐ
felón	feloŋ
femenza	femenθɐ
femia	femjɐ
femias	femias
fene	fene
fento	fɛntʊ
feo	feo̝
ferida	feɾiðɐ
ferida	fiɾiðɐ
ferida	fɾiðɐ
fermentar	feɾmentaɾ
fermosura	feɾmosuɾɐ
ferramenta	fɛramɛntɐ
ferrar	feraɾ
ferraña	feraɲɐ
ferrete	feretɪ
ferreña	fereɲɐ
ferreño	fereɲʊ
ferrol	ferɔl
ferrudo	feruðʊ
ferrán	feraŋ
fervente	feɾβentɪ
fervente	feɾβɛntɪ
fervura	feɾβuɾɐ
fervón	feɾβoŋ
ferún	fɛɾuŋ
festa	fɛs̺tɐ
festas	festas
festeiro	fɛstejɾʊ
festexar	festeʃaɾ
fiada	fiaðɐ
fial	fial
fiaza	fiaθɐ
fiaña	fiaɲɐ
fiaño	fiaɲʊ
ficción	fiksjoŋ
ficción	fikθjoŋ
fieira	fiejɾɐ
fieiro	fiejɾʊ
fiel	fiɛl
fiel	fjɛl
figa	fiɣɐ
figo	fiɣʊ
figueira	fiɰejɾɐ
filial	filial
filipe	filipe
filloa	fiʎɔɐ
filósofo	filɔsʊfʊ
fimento	fimentʊ
fimento	fimɛntʊ
fin	fiŋ
finado	finaðʊ
fincar	fiŋkaɾ
finlandia	finlandia
fino	fin̪ʊ
firma	fiɾmɐ
firmar	fiɾmaɾ
firme	fiɾmɪ
firmedume	fiɾmeðumɪ
fisgar	fisɣaɾ
fita	fita
fiteiro	fitei̯ɾʊ
fiucego	fiuθɛɣʊ
fiúza	fiusɐ
fiúza	fiuθɐ
florido	floɾiðʊ
foca	fɔkɐ
fociño	fosiɲʊ
fociño	foθiɲʊ
foco	fɔkʊ
foda	foðɐ
fodechinchos	foðetʃintʃʊs
fodón	foðoŋ
fogaxe	foɣaʃɪ
fogaza	foɣasa̝
fogaza	foɣaθa̝
fogo	foɣʊ
fogo	fɔɣʊ
fogueira	foɣei̯ɾɐ
foguete	foɣetɪ
folga	fɔlɣɐ
folgar	folɣaɾ
folgo	folɣʊ
folgo	fɔlɣʊ
folguexar	folɣeʃaɾ
foliada	fɔljaðɐ
folla	foʎɐ
folla	foʝɐ
follado	foʎaðʊ
follato	foʎatʊ
folloso	foʎosʊ
fonda	fondɐ
fondeiro	fondejɾʊ
fonte	fontɪ
formigo	foɾmiɣʊ
formigos	foɾmiɣʊs
fornalla	foɾnaʎɐ
foro	fɔɾʊ
forquita	foɾkitɐ
forquito	foɾkitʊ
forra	forɐ
forro	forʊ
fortuna	foɾtunɐ
forza	fɔɾsɐ
forza	fɔɾθɐ
forzar	foɾsaɾ
forzar	foɾθaɾ
foucegata	fowθeɣatɐ
fouzaña	fowsaɲɐ
fouzaña	fowθaɲɐ
foz	fɔθ
foán	foaŋ
foán	fuaŋ
frade	fɾað̞ɪ
fragueiro	fɾaɣejɾʊ
francia	fɾaŋkia
franquear	fraŋkeaɾ
fraqueza	fɾakeθɐ
freba	fɾeβɐ
frecha	fɾetʃɐ
frecha	fɾɛtʃɐ
freguesía	fɾɛɣesiɐ
fregués	fɾɛɣes
freima	fɾejmɐ
freire	fɾejɾɪ
freita	fɾejtɐ
freituxe	fɾejtuʃɪ
freixedo	fɾejʃeðo̝
freo	fɾeʊ
freo	fɾeʊ̯
fresco	fɾeskʊ
frescoallo	fɾeskoallʊ
frescoallo	fɾeskʊ̯allʊ
fresqueira	fɾeskejɾɐ
fresquío	fɾeskiʊ
friúra	fɾiuɾɐ
fronte	fɾonte
fronteiro	fɾontejɾʊ
frota	fɾɔtɐ
froxán	fɾoʃaŋ
frágoa	fɾaɣwa̝
frío	fɾiʊ
fuco	fukʊ
fulán	fulaŋ
fuma	fuma
fumaxe	fumaʃɪ
fume	fumɪ
fumegar	fumeɣaɾ
función	funkion
funda	fundɐ
fundamento	fundamentʊ
fundir	fundiɾ
fungón	fuŋgoŋ
fungón	fuŋkoŋ
furaareas	fuɾaːɾeɐs
furacán	fuɾakaŋ
furado	fuɾaðʊ
furonciño	fuɾonsiɲʊ
furonciño	fuɾonθiɲʊ
furrica	furikɐ
furrica	fʊrikɐ
furricar	furikaɾ
furricoso	furikosʊ
furricán	furikaŋ
furto	fuɾtʊ
furuncho	fuɾuntʃʊ
furón	fuɾɔŋ
fuso	fusʊ
fustrigar	fustɾiɣaɾ
futuro	futuɾʊ
fábrica	faβɾika
fígado	fiħɐðʊ
fígado	fiɣɐðʊ
fócaro	fɔkɐɾʊ
fóra	fɔɾɐ
fósil	fosil
fústriga	fustɾiɣɐ
gabanza	gɑβ̞an̪θɐ
gabanza	ħɑβ̞ansɐ
gabanza	ħɑβ̞an̪θɐ
gache	gatʃɪ
gache	ħatʃɪ
gadoupa	gaðowpɐ
gaiola	gajɔlɐ
gaioto	gai̯ɔtʊ
gaita	gai̯tɐ
gala	galɐ
galante	galantɪ
galbana	galβanɐ
galdrir	galdɾiɾ
galdrumada	galdɾumaðɐ
galdrumar	galdɾumaɾ
galdrumeiro	galdɾumejɾʊ
galego	galeɣʊ
galego	ħaleħʊ
galego	χaleχʊ
galiñola	galiɲɔlɐ
gallada	gaʎaðɐ
galleiro	gaʎejɾʊ
galleta	gaʎetɐ
gallofa	gaʎɔfɐ
gallofeiro	gaʎɔfejɾʊ
gallofo	gaʎɔfʊ
galloufa	gaʎowfɐ
galloufeiro	gaʎowfejɾʊ
galo	galʊ
gamalleira	gamaʎei̯ɾɐ
gamallo	gamaʎʊ
gamba	gambɐ
gameito	gamejtʊ
gamón	gamoŋ
gancho	gantʃʊ
gandaina	gandajnɐ
ganduxo	ganduʃʊ
garaxe	gɐɾaʃɪ
garda	gaɾðɐ
gardarroupa	gaɾðarowpɐ
gardarríos	gaɾðariʊs
gardián	gaɾðjaŋ
garela	gaɾɛlɐ
garela	ħaɾɛlɐ
gargallo	gaɾɣaʎʊ
gargalo	gaɾɣalʊ
garganta	gaɾɣantɐ
gargueiro	gaɾɣejɾʊ
garrafón	garafoŋ
garrido	gariðʊ
garrir	gariɾ
garrotillo	garotiʎʊ
garula	gaɾulɐ
garza	gaɾθɐ
garza	ħaɾs̺ɐ
garzo	gaɾθʊ
garzo	ħaɾsʊ
garzota	gaɾθɔtɐ
gasalleiro	gasaʎei̯ɾʊ
gaspallada	gaspaʎaðɐ
gaspallo	gaspaʎʊ
gateira	gatejɾɐ
gato	gatʊ
gato	ħatʊ
gavacho	gaβatʃʊ
gazafello	gasafeʎʊ
gazafello	gaθafeʎʊ
ghanza	ħaŋs̺ɐ
gharsa	gaɾθɐ
gharsa	ħaɾs̺ɐ
gheada	geað̞ɐ
gheada	ħeað̞ɐ
gobernar	goβɛɾnaɾ
goberno	goβɛɾnʊ
godallo	goðaʎʊ
godallo	ɰoðaʎʊ
godello	goðeʎʊ
gol	gɔl
gol	ħɔl
golada	golaðɐ
golfeira	gɔlfei̯ɾɐ
golpear	golpeaɾ
goma	gomɐ
gonzo	gonsʊ
gonzo	gonθʊ
gordecho	goɾðetʃʊ
gordo	goɾðʊ
gordura	goɾðuɾɐ
gorga	gɔɾɣɐ
gorir	goɾiɾ
gorxa	gɔɾʃɐ
gosto	gʊs̺t̪ʊ
gosto	ħʊs̺t̪ʊ
gouño	gowɲʊ
goza	goθa
gozar	gosaɾ
gozar	goθaɾ
graciñas	gɾaθiɲɐs
graciñas	ħɾasiɲɐs
grado	gɾaðʊ
gran	gɾaŋ
granada	gɾanað̞ɐ
granada	ħɾanað̞ɐ
grandeiro	gɾandejɾʊ
grao	gɾaʊ̯
grecia	gɾɛθjɐ
grego	gɾeɣʊ
grillo	gɾiʎʊ
grilo	gɾilʊ
grima	gɾimɐ
gripallada	gɾipaʎaðɐ
gripalleira	gɾipaʎejɾɐ
gripaxe	gɾipaʃɪ
gripe	gɾipɪ
gripio	gɾipjʊ
gripo	gɾipʊ
gritar	gɾitaɾ
grito	gɾitʊ
grosa	gɾɔsɐ
groso	gɾɔsʊ
grosura	gɾosuɾɐ
guapo	gwapʊ
gubia	guβjɐ
guedella	geðeʎɐ
guedelludo	geðeʎuðʊ
gueldear	gɛldeaɾ
gueldo	gɛldʊ
guerla	gɛɾlɐ
guerra	gɛrɐ
guerrear	gereaɾ
guerrilleiro	geriʎejɾʊ
guinda	gindɐ
guindal	gindal
guindeira	gindejɾɐ
guipar	gipaɾ
guisado	gisaðʊ
gustar	gustar
gusto	gus̺t̪ʊ
gusto	ħus̺t̪ʊ
gustoso	gustosʊ
guímaro	gimɐɾʊ
gándara	gandɐɾɐ
haber	aβeɾ
hai	aj
hap	hap
hasta	astɐ
hay	aj
hebreo	eβɾeʊ
herba	ɛɾβɐ
herbal	ɛɾβal
herbeira	ɛɾβei̯ɾɐ
herdamento	ɛɾðamɛntʊ
herdeiro	erðejɾʊ
heroe	ɛɾɔɪ
heroi	ɛɾɔɪ
hexagonal	heksaɣonal
himno	imnʊ
himno	inʊ
himno	iŋnʊ
hipocrás	ipokɾas
hipoteca	ipotɛkɐ
historia	istoɾjɐ
hogano	oɣanʊ
home	ɔmɪ
homiño	ɔmiɲʊ
hora	oɾɐ
hora	ɔɾɐ
horror	ɔroɾ
hoxe	oʃ
hoxe	oʃɪ
humanidade	umãniða
humanidade	umãniðaðɪ
humedén	umɪðɛŋ
humidade	umiðaðɪ
hórreo	oreʊ
hóspede	ɔspɪðɪ
húmido	umɪðʊ
i	j
iago	jaɣʊ
ida	iðɐ
idade	iðaðɪ
igar	iɣaɾ
ignorar	ignoɾaɾ
ignorar	inoɾaɾ
igrexario	iħɾeʃaɾjʊ
igrexario	iɣ̞ɾeʃaɾjʊ
igual	iɣwal
igualar	iɣu̯alaɾ
il	il
illa	iʎa
imaxe	imaʃɪ
impar	impaɾ
impedir	impeðiɾ
implícito	implisit̪ʊ
implícito	impliθit̪ʊ
impo	impʊ
incensario	mejɾiɲʊ
inchazo	intʃaθʊ
inchazón	intʃaθoŋ
inclúe	inklue
incondicionalmente	iŋkon̪d̪isjonɑlmẽn̪t̪ɪ
incondicionalmente	iŋkon̪d̪iθjonɑlmẽn̪t̪ɪ
inda	indɐ
indiano	indi̯anʊ
infante	iɱfantɪ
infantes	infantes
infindo	iɱfindʊ
inglés	iŋgles
inimigo	inimiɣʊ
inmorrente	iŋmorentɪ
inocente	inoθentɪ
inquedanza	iŋkeðanθɐ
inquedo	iŋkeðʊ
instante	instantɪ
instante	istantɪ
instantiño	instantiɲʊ
instantiño	istantiɲʊ
insua	insuɐ
insua	inswɐ
insulto	insultʊ
invernada	imbɛɾnaðɐ
invernar	imbɛɾnaɾ
inverno	imbɛɾnʊ
inxenuo	inʲʃenwʊ
ir	iɾ
ira	iɾɐ
irado	iɾaðʊ
irmandade	iɾmanda
irmandade	iɾmandaðɪ
irmandiño	iɾmandiɲʊ
irregular	ireɣulaɾ
isaías	isaias
iscar	iskaɾ
isco	iskʊ
iso	isʊ
isto	istʊ
iñobre	iɲɔβɾɪ
la	la
labaza	laβ̞as̻ɐ
labaza	laβ̞aθɐ
labazada	laβasaðɐ
labazada	laβaθaðɐ
laboría	laβoɾiɐ
labrador	laβɾaðoɾ
labrar	laβɾaɾ
lacoada	lakoaðɐ
lacoeiro	lakoejɾʊ
ladar	laðaɾ
ladeiro	laðejɾʊ
laderno	laðɛɾnʊ
lado	laðʊ
lados	laðos
ladra	laðɾɐ
ladrizo	laðɾisʊ
ladrizo	laðɾiθʊ
ladro	laðɾʊ
ladrón	laðɾoŋ
lagarteiro	laɣaɾtei̯ɾʊ
lagartixa	laɣaɾtiʃɐ
lagoa	laɣʊɐ
lagorza	laɣoɾθɐ
lagrimexar	laɣɾimeʃaɾ
lagueiro	laɣei̯ɾʊ
lagumeiro	laɣumei̯ɾʊ
laio	lai̯ʊ
lama	lamɐ
lambaceiro	lambasejɾʊ
lambaceiro	lambaθejɾʊ
lambaz	lambas
lambaz	lambaθ
lamber	lambeɾ
lambespiñas	lambespiɲɐs
lambiscada	lambiskɑðɐ
lambiscar	lambiskaɾ
lambón	lamboŋ
lampantín	lampantiŋ
lanceiro	lansejɾʊ
lanceiro	lanθejɾʊ
lanceta	lanθetɐ
landriz	landɾiθ
landán	landaŋ
landín	landiŋ
lantemil	lantemil
lanxir	lanʃiɾ
lapa	lapɐ
laparada	lapaɾaðɐ
lapela	lapɛlɐ
lapuz	lapus
larafouzas	laɾafowsas
larafouzas	laɾafowθas
larchán	laɾtʃaŋ
lardo	laɾðʊ
larego	lareɣʊ
larego	larɛɣʊ
lareira	laɾejɾɐ
lareiro	lɑɾejɾʊ
larfar	laɾfaɾ
larfón	laɾfoŋ
largar	laɾɣaɾ
largo	laɾɣʊ
largueza	laɾɣeθɐ
larpeiro	laɾpejɾʊ
larpán	laɾpaŋ
lasca	laskɐ
laso	lasʊ
latexar	lateʃaɾ
latir	latiɾ
lauda	lauða
laura	lauɾa
lauto	lawtʊ
lavadura	laβaðuɾɐ
lavalouza	laβalowθɐ
lavanco	laβaŋkʊ
lazar	laθaɾ
le	lɛ
lebre	lɛβɾe̝
ledesma	leðesmɐ
lei	lej
leis	leis
leitarega	lejtaɾɛɣɐ
leite	lejt̪ɪ
lembranza	lembɾansɐ
lembranza	lembɾanθɐ
lenda	lendɐ
lendia	lendjɐ
lendia	lɛndjɐ
lentemil	lentemil
lentil	lentil
lentille	lentiʎɪ
lentisco	lentiskʊ
lentomil	lentomil
ler	leɾ
lerica	leɾikɐ
lestegal	lɛsteɣal
levantar	leβantaɾ
levedar	leβeðaɾ
león	leɔn
li	li
liberdade	liβeɾðaðɪ
libra	liβɾɐ
libraduras	liβɾaðuɾɐs
libre	liβɾɪ
libriño	liβɾiɲʊ
licenza	liθenθɐ
licenza	liθɛnθɐ
lide	liðɪ
liga	liɣa
ligar	liɣaɾ
lima	limɐ
limeta	limet̪ɐ
limo	limʊ
limoeiro	limoejɾʊ
limón	limoŋ
linas	linas
lindo	lindʊ
lindura	linduɾa
lindín	lindiŋ
linguado	liŋgwaðʊ
linguado	liŋkwaðʊ
lintel	lintɛl
lipe	lipɪ
lirio	liɾjʊ
lisca	liskɐ
lista	listɐ
listos	listos
listura	listuɾɐ
liteira	litejɾɐ
lixar	liʃaɾ
lixeiro	liʃejɾʊ
lizgairo	lisgai̯ɾʊ
lizgairo	liθgai̯ɾʊ
liñas	liɲas
llerga	ʎɛɾɣɐ
lobado	loβaðʊ
lobeto	loβetʊ
lobicán	lʊβikaŋ
lobiño	loβiɲʊ
loendro	loendɾʊ
logo	lɔ
logo	lɔħʊ
logo	lɔɣʊ
lograr	loɣɾaɾ
logro	loɣɾʊ
loito	lojtʊ
lombelo	lombɛlʊ
lombriga	lombɾiɣɐ
lombán	lombɑŋ
lomedro	lomeðɾʊ
londra	londɾɐ
longaínza	loŋgainθɐ
longo	loŋgʊ
longo	loŋkʊ
longo	lɔŋgʊ
longueirón	loŋgejɾoŋ
longueirón	loŋkejɾoŋ
lonxe	lonʃɪ
lorbaga	loɾβaɣɐ
lorcha	lɔɾtʃɐ
lorda	lɔɾðɐ
loriga	loɾiɣɐ
louco	lowkʊ
loucura	loʊ̯kuɾɐ
louquear	lowkeaɾ
loureiro	lou̯ɾei̯ɾʊ
lubión	luβioŋ
lucecú	luseku
lucecú	luθeku
luceiro	lusejɾʊ
luceiro	luθejɾʊ
lucir	lusiɾ
lucir	luθiɾ
ludro	luðɾʊ
lugar	luɣaɾ
lugo	luɣʊ
lula	lula
lumarada	lumaɾaðɐ
lumbrigar	lumbɾiɣaɾ
lume	lumɪ
lumeirada	lumei̯ɾaðɐ
lumieira	lumiejɾɐ
luns	luns
lurpia	luɾpjɐ
luz	lus
luz	luθ
lábil	labil
lágrima	laɣɾimɐ
lámpada	lampɐðɐ
lápara	lapɐɾɐ
lóstrego	lostɾɪɣʊ
lúa	luɐ
maceda	masɛð̞ɐ
maceda	maθɛð̞ɐ
macelo	maθelʊ
macicar	maθikaɾ
macico	masikʊ
macico	maθikʊ
macizar	masisaɾ
macizar	maθiθaɾ
macizo	maθiθʊ
madrasta	maðɾastɐ
madre	maðɾɪ
madreselva	maðɾesɛlβɐ
madreña	maðɾeɲɐ
madriña	maðɾiɲɐ
madrosende	maðɾosendɪ
madroña	maðɾoɲɐ
madrugada	maðɾuɣaðɐ
madrugar	maðɾuɣaɾ
magosto	maɣostʊ
magro	maɣɾʊ
maimiño	majmiɳʊ
maino	majnʊ
maioral	mai̯oɾal
mal	mɑɫ
malas	malas
malcabido	malkaβiðʊ
maldade	malda
maldade	maldaðɪ
maldición	maldision
maldición	maldiθion
maleta	maletɐ
malfacer	malfaθeɾ
malfadado	malfaðaðʊ
malfeito	malfejtʊ
malfeitor	malfejtoɾ
malferido	malfeɾiðʊ
malferido	malfɾiðʊ
malicia	malisi̯ɐ
malicia	maliθi̯ɐ
malla	maʎɐ
malparir	malpaɾiɾ
maltreito	maltɾejtʊ
malva	malβɐ
malvar	malβaɾ
mama	mama
mamai	mamaj
mamaie	mamajɪ
mamaíña	mamaiɲɐ
mami	mami
mamá	mama
man	man
mancadura	maŋkaðuɾɐ
mancar	maŋkaɾ
mancebo	mãnθeβʊ
manchar	mantʃaɾ
manciña	manθiɲɐ
manco	maŋkʊ
manda	manda
mandadeiro	mandaðei̯ɾʊ
mandado	mandaðʊ
maneira	manei̯ɾɐ
maneiro	manei̯ɾʊ
manexar	maneʃaɾ
manga	maŋgɐ
manga	maŋkɐ
mangallón	maŋgaʎoŋ
mango	maŋgʊ
mangueira	maŋgejɾɐ
manguela	maŋgɛlɐ
manicho	manitʃʊ
manicomio	mänikɔmjʊ
maniotas	maniɔtɐs
manle	manlɪ
manquexar	maŋkeʃaɾ
mans	mans
mansedume	manseðumɪ
manseliño	manseliɲʊ
manso	mansʊ
manxadoira	manʃaðojɾɐ
mao	maʊ̯
mar	maɾ
marabilla	maɾaβiʎɐ
marabillar	maɾaβiʎaɾ
marabilloso	maɾaβiʎosʊ
maragota	maɾaɣɔtɐ
maralloca	baɾaʎɔkɐ
maraxe	maɾaʃɪ
mareiro	maɾejɾʊ
mareo	maɾeʊ
mariscada	maɾiskaðɐ
mariscador	maɾiskaðoɾ
mariscar	maɾiskaɾ
marisma	maɾismɐ
mariñas	maɾiɲɐs
maroto	maɾɔtʊ
martelo	maɾtelʊ
martelo	maɾtɛlʊ
maruca	maɾukɐ
marulo	maɾulʊ
marulán	maɾulaŋ
marusía	maɾusiɐ
maruxiña	maɾuʃiɲɐ
marzo	maɾsʊ
marzo	maɾθʊ
maría	maɾiɐ
masas	masas
mascar	maskaɾ
mastigar	mastiɣaɾ
mastín	mastiŋ
mata	matɐ
matanza	mat̪ansɐ
matanza	mat̪an̪θɐ
maxestade	maʃestaðɪ
maza	masa
mazadoiro	masaðoi̯ɾʊ
mazadoiro	maθaðoi̯ɾʊ
mazá	masaː
mazá	maθaː
maña	maɲɐ
mañá	maɲa
me	mi
mea	meɐ
medianoite	meðjanojtɪ
medo	meðʊ
medoso	meðosʊ
medoñento	meðoɲentʊ
medoñento	meðoɲɛntʊ
medra	mɛðɾɐ
medroso	meðɾosʊ
medrán	meðɾaŋ
meiguería	mei̯ɣeriɐ
meimendro	mei̯mendɾʊ
meirande	mejɾandɪ
meiriño	mejɾiɲʊ
meixengra	mei̯ʃeŋgɾɐ
mel	mɛl
mela	mɛlɐ
melena	melenɐ
melindre	melindɾɪ
mellor	mɪʎoɾ
mellorar	meʎoɾaɾ
mellorar	miʎoɾaɾ
melro	mɛlrʊ
membro	mɛ̃mbɾʊ
memoria	mẽmɔɾjɐ
mencía	mensiɐ
mencía	menθiɐ
mendar	mendaɾ
mendo	mendʊ
meniña	meniɲɐ
meniñeiro	meniɲejɾʊ
meniño	mɪ̃nĩɲʊ
menos	menʊs
mente	mentɪ
mentir	mentiɾ
mentir	mintiɾ
mentira	mentiɾɐ
mentireiro	mentiɾejɾʊ
mentres	mentɾɪs
mentres	mɛntɾɪs
mercado	meɾkaðʊ
mercadotecnia	meɾkaðoteknja
mercaduría	meɾkaðuɾiɐ
mercé	meɾse
mercé	meɾθe
merendiña	meɾendiɲɐ
merexar	mɛɾeʃaɾ
merla	mɛɾlɐ
mesa	mesɐ
mesma	mesma
meso	mesʊ
mesoiro	mesojɾʊ
mesquindade	meskindaðɪ
mesquiño	meskiɲʊ
mesteiral	mestejɾal
mester	mestɛɾ
mesto	mestʊ
mestría	mɛstɾiɐ
mesura	mesuɾɐ
metade	meta
metade	metaðɪ
mexeriqueiro	meʃeɾikejɾʊ
mi	mi
migalla	miɣaʎa̝
miguel	miħɛɫ
miguel	miɣ̞ɛɫ
mil	mil
milagreiro	milaɣɾejɾʊ
milfa	milfɐ
milfo	milfʊ
millar	miʎaɾ
millarada	miʎaɾaðɐ
millarengo	miʎaɾeŋgʊ
millenta	miʎentɐ
millenta	miʎɛntɐ
millo	miʎʊ
min	miŋ
mina	minɐ
mingos	miŋgʊs
mingua	mĩŋgu̯ɐ
minguar	miŋɣwaɾ
mirar	miɾaɾ
mirfia	mirfjɐ
mirto	miɾtʊ
misa	misɐ
misto	mistʊ
mixiriqueiro	miʃiɾikejɾʊ
miña	miɲa
miñas	miɲɐs
miñaxoia	miɲaʃɔjɐ
miñoca	mĩɲokɐ
miñoca	mĩɲɔkɐ
miúdo	miuðʊ
mo	mʊ
mocada	mɔkaðɐ
mocazo	mokaθʊ
mocear	moseaɾ
mocear	moθeaɾ
mocedade	moθɪða
mocidade	moθiða
mocidade	moθiðaðɪ
moco	mokʊ
moente	moentɪ
moente	moɛntɪ
mofo	mofʊ
moi	moj
moimento	mojmentʊ
moinante	mojnantɪ
moitedume	mojteðumɪ
moito	mojtʊ
moleira	molejɾɐ
moleiro	molejɾʊ
moleiro	mulejɾʊ
molladura	moʎaðuɾɐ
mollo	moʎʊ
mollo	mɔʎʊ
momento	mõmẽn̪t̪ʊ
monstro	monstɾʊ
montaña	montaɲɐ
monte	mõntɪ
montecelo	monteselo̝
montecelo	monteθelo̝
monteira	montejɾɐ
montenegro	monteneɣɾʊ
monterrei	monterej
monticelo	montiθɛlo̝
monumento	monumɛntʊ
monxa	monʃɐ
monxe	monʃɪ
morango	moɾaŋgʊ
morcilla	moɾsiʎɐ
morcilla	moɾθiʎɐ
morder	moɾðeɾ
moreno	moɾenʊ
mormeira	moɾmei̯ɾɐ
mormo	mɔɾmʊ
morote	amoɾotɪ
morouzo	moɾowsʊ
morouzo	moɾowθʊ
morrer	moreɾ
morriñada	moriɲaðɐ
mortal	moɾtal
morto	moɾtʊ
morto	mɔɾtʊ
moscardo	moskaɾðʊ
mostra	mɔstɾɐ
moura	mowɾɐ
mouramia	mowɾamiɐ
moxena	moʃenɐ
mudanza	muðanθɐ
mudar	muðaɾ
muiñeira	muiɲejɾɐ
muiñeira	mujɲejɾɐ
mulida	muliðɐ
mulime	mulimɪ
muraño	muɾaɲʊ
murmuración	muɾmuɾaθi̯oŋ
murmurador	muɾmuɾaðoɾ
murmurar	muɾmuɾaɾ
murta	muɾtɐ
musas	musas
musgaño	musɣaɲʊ
musgo	musɣʊ
musguento	musgentʊ
musguento	musgɛntʊ
mutar	mutaɾ
muxica	muʃikɐ
mágoa	maɣʊ̯ɐ
márdea	maɾðɪɐ
mármore	maɾmʊɾɪ
máscara	maskɐɾɐ
máxico	maʃikʊ
mázcara	maskɐɾɐ
mógaro	mɔɣɐɾʊ
múltiplos	multiplos
música	musikɐ
músico	musikʊ
na	na
nabal	naβal
nabiña	naβiɲɐ
nace	nase
nacemento	nasementʊ
nacemento	naθemɛntʊ
nacente	nasentɪ
nacente	naθɛntɪ
nacenza	nasɛnsɐ
nacenza	naθɛnθɐ
nacer	naseɾ
nacer	naθeɾ
nacida	nasiðɐ
nacida	naθiðɐ
nación	naθjoŋ
nada	naðɐ
nado	naðʊ
nandín	nandiŋ
nantín	nantiŋ
narnexar	naɾneʃaɾ
narneón	naɾneoŋ
narno	naɾnʊ
natural	natuɾal
natureza	natuɾeθa
navalla	naβaʎɐ
navia	naβjɐ
neboeiro	nɛβoejɾʊ
nebra	nɛβɾɐ
necesidade	neθesiðaðɪ
nega	neɣa
negar	neɣaɾ
negra	neɣɾa
negral	neɣɾal
negro	neɣɾʊ
negrura	neɣɾuɾɐ
nel	nel
nela	nela
nembro	nẽmbɾʊ
nenez	neneθ
neno	nẽnʊ
neste	neste
nevada	neβaðɐ
nevar	neβaɾ
nevarento	neβaɾentʊ
nevarento	neβaɾɛntʊ
neve	nɛβ̞ɪ
neveira	nɛβejɾɐ
nidio	niðjʊ
nigromante	niɣɾomantɪ
ninguén	niŋgɛŋ
ningún	niŋguŋ
niñada	nĩɲaðɐ
niñeiro	niɲejɾʊ
niño	nĩɲʊ
no	no
nobelo	noβelo̝
nobelo	nuβelo̝
noca	nɔkɐ
nocella	noseʎɐ
nocella	noθeʎɐ
nocello	noseʎʊ
nocello	noθeʎʊ
noia	nɔjɐ
noite	noi̯t̪ɪ
nome	nomɪ
nomeada	nomeaðɐ
nomeada	nʊmɪaðɐ
nomear	nomeaɾ
non	nõŋ
non	nʊ̃ŋ
norte	nɔɾtɪ
norza	nɔɾθɐ
noutra	nowtɾɐ
noutro	nowtɾʊ
novas	nɔβɐs
nove	nɔ̃β̞ɪ
novo	noβʊ
novo	nɔβʊ
noxo	noʃo
noxoso	noʃosʊ
noz	nɔs
noz	nɔθ
nu	nu
nube	nuβɪ
nula	nula
nun	nũŋ
nunca	nũŋkɐ
náutico	nau̯tiko
nécora	nɛkʊɾɐ
níscaro	niskɐɾʊ
o	ʊ
obra	ɔβɾɐ
obriga	oβɾiɣɐ
obrigado	oβɾiɣaðu
obxecto	ou̯ʃɛtʊ
obxecto	oβʃɛtʊ
oco	ɔkʊ
odiar	ɔð̞jaɾ
odio	ɔð̞jʊ
oh	ɔː
oi	oj
oi	ɔj
ola	olɐ
oliva	oliβɐ
oliva	ɔliβɐ
oliveira	oliβejɾɐ
ollada	oʎaðɐ
ollada	ɔʎaðɐ
ollal	oʎal
olleiro	oʎejɾʊ
ollete	oʎetɪ
olláparo	ɔʎapɐɾʊ
ombreiro	ombɾejɾʊ
ombro	ombɾʊ
onda	ondɐ
onde	ɔnde
onta	ontɐ
onte	ɔntɪ
opor	opɔɾ
oportunidade	ɔpoɾtuniðaðɪ
ora	ɔɾɐ
orde	ɔɾð̞ɪ
orgo	ɔɾɣʊ
orgullo	oɾɣuʎʊ
orzamento	oɾθamentʊ
os	os
osga	ɔsɣɐ
osmar	osmaɾ
ou	ow
ou	oːw
ouca	owkɐ
oufegar	oʊ̯feɣaɾ
ourear	owɾeaɾ
ourego	owɾeɣʊ
ouricela	oʊ̯ɾiθɛlɐ
ouriños	owɾiɲʊs
ouropeso	ouɾopesʊ
outono	owt̪onʊ
outorgar	owtoɾɣaɾ
outro	oʊ̯tɾʊ
ouveo	ou̯βeʊ
ouxeto	ou̯ʃetʊ
ovella	oβeʎɐ
ovo	ɔβʊ
oído	oiðʊ
oír	ɔiɾ
pa	pa
pabón	paβoŋ
pachorra	patʃorɐ
pachorrento	patʃorentʊ
paciencia	pasjɛnsjɐ
paciencia	paθjɛnθjɐ
paciente	paθjɛntɪ
padal	paðal
padieira	paðiejɾɐ
padiola	paðjɔlɐ
padrasto	paðɾastʊ
padre	paðɾɪ
padriño	paðɾiɲo̝
padroádego	paðɾoaðɪɣʊ
padín	paːðiŋ
paga	paɣɐ
paifoco	pajfɔkʊ
paio	pajʊ
paiolo	pajɔlʊ
paisano	pai̯sanʊ
pala	palɐ
palafrén	palafɾɛŋ
palanquín	pɑlɑŋkiŋ
paleira	palei̯rɐ
palerma	paleɾmɐ
palidecer	paliðeseɾ
palidecer	paliðeθeɾ
palillar	paliʎaɾ
palilleira	paliʎejɾɐ
palillo	paliʎʊ
pallagueira	paʎaɣei̯ɾɐ
pallaso	paʎasʊ
palma	palma
palpexo	palpeʃʊ
pan	pan
pana	panɐ
panasco	panaskʊ
pancho	pantʃʊ
panchoz	pantʃɔs
panchoz	pantʃɔθ
pandeirada	pandejɾaðɐ
pandeiro	pandejɾʊ
pandelo	pandɛlʊ
pando	pandʊ
paneira	panejɾɐ
panterlo	panteɾlʊ
pantrigo	pantɾiɣʊ
panxoliña	panʃɔliɲɐ
papa	papa
papagaio	papaɣajʊ
papahostias	papaɔstiɐs
papaleisón	papalejsoŋ
paparota	papaɾotɐ
papasol	papasol
papasol	papasɔl
papaxoubas	papaʃowβas
paporroibo	paporojβʊ
papudo	papuðʊ
papá	papa
papón	papoŋ
paquistán	pakistan
par	paɾ
para	paɾɐ
para	pɐɾɐ
para	pɾɐ
parafuso	parafusʊ
parar	paɾaɾ
paraza	paɾaθɐ
parceiro	paɾsejɾʊ
parceiro	paɾθejɾʊ
parcela	paɾsɛlɐ
parcela	paɾθɛlɐ
pare	paɾe
parede	paɾeðe̝
parente	paɾentɪ
parición	paɾiθjoɲ
parir	paɾiɾ
parola	paɾɔlɐ
paroleiro	paɾɔlejɾʊ
parranda	parandɐ
parrocha	parɔtʃɐ
parroquia	parɔkjɐ
parte	paɾte
parteira	paɾtejɾɐ
parva	paɾβɐ
pasa	pasa
pasadeiro	pasaðejɾʊ
pasado	pasaðʊ
pasamáns	pasamaŋs
pasar	pasaɾ
pasaxe	pasaʃɪ
paseniño	paseniɲʊ
pasmaroco	pasmaɾɔkʊ
paso	pasʊ
pasos	pasos
paspán	paspaŋ
pasta	pastɐ
pastrán	pastɾaŋ
pata	patɐ
patamela	patamɛlɐ
pataqueira	patakejɾɐ
pateiro	pateɪ̯ɾʊ
patelo	patɛlʊ
pato	patʊ
pavor	paβoɾ
pavía	paβiɐ
pavón	paβoŋ
paxara	paʃaɾɐ
paxarela	paʃaɾɛlɐ
paxariño	paʃaɾiɲʊ
paxariños	paʃaɾiɲʊs
paxaro	paʃaɾʊ
paz	paθ
países	paises
peaña	pɪaɲɐ
pebideiro	peβiðejɾʊ
pecado	pekaðʊ
pecar	pekaɾ
pedal	peðal
pedazo	peðasʊ
pedazo	peðaθʊ
pedenza	peðenθɐ
pedenza	peðɛnθɐ
pedichar	peðitʃaɾ
pedichón	peðitʃoŋ
pedir	pɪðiɾ
pedra	pɛð̞ɾɐ
pedrada	peðɾaðɐ
pegada	peɣaðɐ
pegado	peɣaðʊ
pegamazo	peɣamaθʊ
pegarado	peɣaɾaðʊ
pegañento	peɣaŋɛntʊ
pego	peɣʊ
peitear	pejteaɾ
peitolobo	pejtoloβʊ
peituga	pejtuɣɐ
peitugada	pei̯tuɣaðɐ
peitugazo	pejtuɣaθʊ
pel	pel
pelame	pelamɪ
peleca	pelɛkɐ
pelo	pelʊ
peloural	pelowɾal
pelouro	pelowɾʊ
peltre	pɛl̪t̪ɾɪ
pementa	pementɐ
pementa	pemɛntɐ
pender	pendeɾ
pendón	pendoŋ
penela	penɛla
penico	pɪnikʊ
pensamento	pensamentʊ
penzo	penθʊ
penúltimo	penultimo
peor	peoɾ
peor	pjoɾ
peperetada	pɪpeɾetaðɐ
peperete	pɪpeɾetɪ
pequeniño	pekeniɲʊ
pequeno	pɪkenʊ
pequerrecho	pekeretʃʊ
pera	peɾɐ
percibir	peɾsiβiɾ
percibir	peɾθiβiɾ
perdas	peɾdas
perden	peɾðen
perder	peɾðer
perdido	peɾðiðʊ
perdigoto	peɾðiɣɔtʊ
perdurábel	peɾðuɾaβɪl
pereira	peɾejɾɐ
perfeba	peɾfeβɐ
perigo	peɾiɣʊ
perlesía	peɾlesiɐ
perna	peɾna
pernal	peɾnal
pero	peɾʊ
perponto	peɾpontʊ
perralleiro	peraʎejɾʊ
perrecha	peretʃɐ
perseguir	peɾseħiɾ
perseguir	peɾseɣiɾ
persoeiro	peɾsoejɾʊ
pertegueiro	peɾteɣejɾʊ
pertenza	peɾtensɐ
pertenza	peɾtɛnθɐ
perucho	perutʃʊ
perú	peɾu
pesa	pesa
pesadelo	pesaðɛlʊ
pesado	pessaðʊ
pesadume	pesaðumɪ
pesar	pesaɾ
pescada	peskɑðɐ
pescadiña	peskɑðiɲɐ
peta	pɛtɐ
petada	petaðɐ
petisco	petiskʊ
peto	peto
petouto	petowtʊ
pexego	peʃeɣʊ
pexegueiro	peʃeɣejɾʊ
pez	pes
pez	peθ
pezoñento	peθoɲentʊ
piada	piaðɐ
piarda	piaɾðɐ
picada	pikaðɐ
picado	pikɐðʊ
picapeixe	pikapejʃɪ
picaraña	pikaɾaɲɐ
picaña	pikaɲɐ
piche	pitʃɪ
picheta	pitʃetɐ
pichola	pitʃɔlɐ
picón	pikoŋ
pilatos	pilatos
pimpín	pimpiŋ
pinabete	pinaβetɪ
pingallo	piŋgaʎʊ
pingallón	pinkaʎoŋ
pingallón	piŋgaʎoŋ
pinta	pintɐ
pintada	pintaðɐ
pintasilgo	pintasilɣʊ
pioga	piɔɣɐ
piollento	pioʎentʊ
piollento	pioʎɛntʊ
piolloso	pioʎosʊ
pior	pɨɔɾ
pipa	pipɐ
pipo	pipʊ
pipote	pipɔtɪ
piquet	piket
pirola	piɾɔlɐ
pirolazo	piɾolasʊ
pirolazo	piɾolaθʊ
pisco	piskʊ
piso	pisʊ
pitacega	pitasɛħɐ
pitacega	pitaθɛɣɐ
pitelo	pitɛlʊ
pixo	piʃʊ
pixota	piʃɔtɐ
piña	piɲɐ
piñeiro	piɲejɾʊ
piño	piɲʊ
pión	pioŋ
pluma	plumɐ
pléiades	plejɐðɪs
pneumonía	newmoniɐ
po	pɔː
poallar	poaʎaɾ
pobreza	poβɾeθɐ
pobriño	poβɾiɲʊ
podar	poðaɾ
pode	poðe
poden	poðeŋ
podengo	poðeŋgʊ
poder	poðeɾ
poderoso	poðeɾosʊ
poderá	poðeɾa
podredume	poðɾeðumɪ
poexo	poeʃʊ
pois	pojs
pol	pol
pola	polʊ
polaina	polajnɐ
polbeiro	pɔlβejɾʊ
poleiro	polejɾʊ
polgar	polgaɾ
polgar	pulgaɾ
polo	polʊ
polo	pʊlʊ
polos	polos
poma	pomɐ
ponte	pontɪ
ponte	pɔntɪ
pop	pop
porca	pɔɾkɐ
porcalla	pɔɾkɑʎɐ
porco	pɔɾkʊ
porfiado	porfiaðʊ
porfiar	poɾfiaɾ
porfillar	poɾfiʎaɾ
porfía	poɾfiɐ
pornográfico	po̞ɾno̞ɣ̞ɾäɸiko̞
poro	pɔɾʊ
porral	poral
porta	poɾta
portada	poɾtaðɐ
portaxe	pɔɾtaʃɪ
porteiro	poɾtejɾʊ
porteiro	pɔɾtejɾʊ
porto	poɾt̪ʊ
porto	pɔɾtʊ
portos	poɾtos
portugués	poɾtuɣes
portádego	pɔɾtaðɪɣʊ
posta	pɔstɐ
poste	pɔstɪ
postizo	postiθʊ
postremeiro	postɾemejɾʊ
pota	pɔtɐ
potada	pɔtaðɐ
poubea	powβeɐ
poucas	poukas
pouso	powsʊ
poxigo	poʃiɣʊ
poñente	poɲentɪ
poñente	poɲɛntɪ
pra	pɾa
pradairo	pɾaðajɾʊ
pradella	pɾaðeʎɐ
prago	pɾaɣʊ
prata	pɾatɐ
prateiro	pɾatejɾʊ
prato	pɾatʊ
precioso	pɾeθjosʊ
precisa	pɾesisɐ
precisa	pɾeθisɐ
precisar	pɾesisɐɾ
precisar	pɾeθisɐɾ
preciso	pɾesisʊ
preciso	pɾeθisʊ
pregar	pɾeħɑɾ
pregar	pɾeɣ̞ɑɾ
pregar	pɾɛħɑɾ
pregar	pɾɛɣ̞ɑɾ
preguntar	pɾeɣuntaɾ
preito	pɾejtʊ
prelado	pɾelaðʊ
prelo	pɾɛlʊ
prender	pɾendeɾ
presebe	pɾeseβɪ
presente	pɾesentɪ
presenza	pɾesɛnθɐ
presoira	pɾesojɾɐ
presoiro	pɾesojɾʊ
presunto	pɾesuntʊ
preto	pɾetʊ
prezo	pɾesʊ
prezo	pɾeθʊ
preñe	pɾeɲɪ
prime	pɾime
primeiramente	pɾimejɾamentɪ
primeiro	pɾimejɾʊ
prisión	pɾisi̯oŋ
privado	pɾiβaðʊ
privanza	pɾiβanθɐ
proba	pɾɔβɐ
prolongar	pɾoloŋgaɾ
pronto	pɾontʊ
proseguir	prʊseħiɾ
proseguir	prʊseɣiɾ
pucheiro	putʃejɾʊ
pucho	putʃʊ
puf	puf
pufento	pufentʊ
pufento	pufɛntʊ
pufista	pufistɐ
pufo	pufʊ
puidoiro	puiðoi̯ɾʊ
pulga	pulɣɐ
pulmón	pulmoŋ
pulo	pulʊ
pulso	pulsʊ
pumarega	pumaɾɛɣɐ
pumba	pumbɐ
punta	puntɐ
puntear	punteaɾ
punteiro	punteiɾʊ
punto	puntʊ
puntos	puntos
purrela	purɛlɐ
pus	pus
pusgallo	pusɣaʎʊ
putear	puteaɾ
puxar	puʃaɾ
puxavante	puʃaβantɪ
pálpebra	pɑlpeβ̞ɾɐ
pándega	pandɪɣɐ
pé	pe
péga	pɛɣɐ
pégaro	peɣɐɾʊ
péndola	pendʊlɐ
pértega	peɾtɪɣɐ
pértega	pɛɾtɪɣɐ
pértego	peɾtɪɣʊ
pértego	pɛɾtɪɣɐ
pícaro	pikɐɾʊ
píntega	pintɪɣɐ
pór	poɾ
púcaro	pukɐɾʊ
que	ke
quedar	keðaɾ
quedo	keðʊ
queima	kejmɐ
queimacasas	kei̯makasɐs
queiroa	kejɾɔɐ
queixa	kei̯ʃɐ
queixada	kejʃaða̝
queixeiro	kei̯ʃei̯ɾʊ
queixoso	kei̯ʃosʊ
quen	kẽn
quenda	kɛnda
quenta	kɛntɐ
quentar	kɛntaɾ
quente	kɛnt̪ɪ
quentura	kɛntuɾɐ
quere	keɾe
querelar	keɾelaɾ
quieto	kjɛtʊ
quilate	kilatɪ
quilma	kilmɐ
quincalla	kiŋkɑʎɐ
quino	kinʊ
quizais	kisajs
quizais	kiθajs
quiñón	kiɲoŋ
raba	raβɐ
rabada	raβaðɐ
rabecha	raβetʃɐ
rabudo	raβuðʊ
rafa	rafɐ
raigado	rajɣaðʊ
raigoto	rajɣɔtʊ
raio	rajʊ
raioto	rai̯ɔtʊ
ralo	ralʊ
rama	ramɐ
ramallo	ramaʎʊ
ranco	raŋkʊ
rancura	raŋkuɾɐ
rapa	rapɐ
rapazada	rapasaðɐ
rapazada	rapaθaðɐ
rapazolo	rapasɔlʊ
rapazolo	rapaθɔlʊ
rapeiro	rapejrʊ
raro	raɾʊ
rascar	raskaɾ
rasgar	rasɣaɾ
raspallo	raspaʎʊ
raspiñar	raspiɲaɾ
raspiñeiro	raspiɲejɾʊ
rata	ratɐ
raza	rasɐ
raza	raθɐ
razón	rasoŋ
razón	raθoŋ
raíña	raiɲɐ
rea	reɐ
rebanda	reβandɐ
rebentar	reβentaɾ
rebento	rebentʊ
rebillar	reβiʎaɾ
rebo	reβʊ
rebola	reβolɐ
rebolada	reβolaðɐ
rebolar	reβolaɾ
rebolo	reβolʊ
reboutallo	reβowtaʎʊ
reboutar	reβou̯taɾ
rebuldeiro	reβuldejɾʊ
rebuldo	reβuldʊ
recachar	rekatʃaɾ
recadar	rekɑð̞aɾ
recadeiro	rekaðei̯ɾʊ
recebar	resebaɾ
recebar	reθebaɾ
recebo	reseβʊ
recebo	reθeβʊ
rechamante	retʃamantɪ
rechamar	retʃamaɾ
rechegar	retʃeɣaɾ
rechouchío	retʃowtʃiʊ
rechumido	retʃumiðʊ
recibir	reθiβiɾ
recina	reθinɐ
recobrar	rekoβɾaɾ
recolleita	rekoʎejtɐ
recosto	rekostʊ
recruar	rekɾuaɾ
redada	reðaðɐ
redar	reðaɾ
redor	redoɾ
redrollo	reðɾoʎʊ
refacho	refatʃʊ
refaixo	refai̯ʃʊ
refertar	refeɾtaɾ
refolgo	refɔlɣʊ
refucir	refuθiɾ
refén	refeŋ
regalar	reɣalaɾ
regalo	reɣalʊ
regalía	reɣaliɐ
regaña	reɣaɲɐ
regañar	reɣaɲaɾ
rego	reɣʊ
rego	rɛɣʊ
regular	reɣulaɾ
rei	rej
reirrei	rejrej
reiseñor	rejseɲoɾ
releixar	relejʃaɾ
releixo	relejʃʊ
relento	relentʊ
rellón	reʎoŋ
relo	relʊ
relo	rɛlʊ
reloucar	relowkɑɾ
relouco	relowkʊ
relucir	relusiɾ
relucir	reluθiɾ
remangar	remãŋgaɾ
remedio	remɛði̯ʊ
remollo	remoʎʊ
remonta	remontɐ
remoscar	remoskaɾ
renche	rentʃɪ
renda	rendɐ
rendeiro	rendejɾʊ
rendemento	rendementʊ
rendemento	rendemɛntʊ
render	rendeɾ
rendido	rendiðʊ
renque	reŋkɪ
reparar	repaɾaɾ
repelo	repɛlʊ
repenico	repenikʊ
repolo	repolʊ
repoludo	repoluðʊ
repouso	repowsʊ
represa	repɾesɐ
requentar	rekɛntaɾ
requente	rekentɪ
requente	rekɛntɪ
requirir	rekiɾiɾ
rescaldar	reskaldaɾ
rescaldo	reskaldʊ
resina	resinɐ
resollar	resoʎaɾ
respectuoso	res̺pekt̪wos̺ʊ
respigo	respiɣʊ
restreba	restɾeβa
restrinxir	restɾinʃiɾ
restrollo	restɾoʎʊ
resésego	resɛsɪɣʊ
retallo	retaʎʊ
reter	reteɾ
reto	reto
retorno	retoɾnʊ
retranca	retɾaŋkɐ
revendedor	reβendeðoɾ
revirichar	reβiɾitʃaɾ
rexedor	reʃeðoɾ
rexo	reʃʊ
rexouba	reʃowβɐ
rexoubar	reʃowβaɾ
rexoubeiro	reʃowβeiɾʊ
rilleira	riʎei̯ɾɐ
rincha	rintʃɐ
rinchón	rintʃoŋ
ringleira	riŋglei̯ɾɐ
ripa	ripɐ
ripote	ripɔtɪ
riquiño	rikiɲʊ
risada	ris̺að̞ɐ
riseiro	risejɾʊ
risoño	risɔɲʊ
rispar	rispaɾ
risón	risoŋ
roco	rokʊ
roda	rɔð̞ɐ
rodada	roð̞að̞ɐ
rodar	roð̞aɾ
rodear	roðeaɾ
rodelo	roðɛlʊ
rodeo	roðeʊ
rodicio	roðiθjʊ
roeiro	roei̯ɾʊ
roga	rɔɣɐ
rogar	roɣaɾ
rolada	rolaðɐ
rolar	rolaɾ
rolda	rɔldɐ
roldar	roldaɾ
roleiro	rolejɾʊ
rolla	roʎɐ
rolleiro	roʎei̯ɾʊ
roma	roma
romai	romaj
romariz	romaɾiθ
romaría	romaɾiɐ
romarís	romaɾis
romaxe	romaʃɪ
romper	rompeɾ
román	romɑŋ
roqueiro	rokejrʊ
roqueiro	rɔkejrʊ
rosa	rosa
rosada	rosaðɐ
rosado	rosaðʊ
rosmón	rosmoŋ
roubar	rowβaɾ
roubo	rowβʊ
rouco	rowkʊ
roufeño	roʊ̯feɲʊ
roupa	rowpɐ
roupeiro	rowpejɾʊ
rouquear	rou̯kear
roxo	roʃʊ
roán	roaŋ
roñón	roɲoŋ
ruela	ruɛlɐ
rufo	rufʊ
ruindade	ruindaðɪ
rula	rulɐ
rumba	ɾumba
ruxerruxe	ruʃeruʃɪ
ruxir	ruʃiɾ
ruzo	rusʊ
ruzo	ruθʊ
ruán	ruaŋ
ría	riɐ
río	riʊ
ríspeto	rispetʊ
rúa	ruɐ
sabedor	saβeðoɾ
sabedoría	saβeðoɾiɐ
sabenla	saβɛŋlɐ
sabenza	saβɛnθɐ
sabichón	saβitʃoŋ
sabido	saβiðʊ
saboga	saβoɣɐ
sacabeira	sakaβejɾɐ
sacamanteigas	sakamantejɣɐs
sacudir	sakuðiɾ
saial	sajal
saio	sajʊ
saiñento	saiɲentʊ
sal	s̺al
sala	sala
salagre	salaɣɾɪ
salamántiga	salamantiɣɐ
salchicha	s̺ɑlʲtʃitʃɐ
salgadura	salɣaðuɾɐ
salpreso	salpɾesʊ
salpura	salpuɾɐ
salsa	salsɐ
salseiro	salsei̯ɾʊ
saltón	saltoŋ
samo	samʊ
san	saŋ
sangría	saŋgɾiɐ
sanguento	saŋgentʊ
sanguento	saŋgɛntʊ
santeiro	santejɾʊ
santiago	santjaɣʊ
santiaguiño	santjaɣiɲʊ
sapagueira	sapaɣei̯ɾɐ
sapo	s̺apʊ
sar	saɾ
sara	s̺aɾɐ
sarabela	saɾaβɛlɐ
sarabia	saɾaβjɐ
sarabia	saɾaβɪɐ
sarabiar	saɾaβiaɾ
saramaganta	saɾamaɣantɐ
sarampelo	saɾampɛlʊ
sargo	saɾɣʊ
sartego	saɾtɛɣʊ
satisfeito	satisfei̯tʊ
satrexas	satɾeʃɐs
saudade	sawðaðɪ
saudar	saʊ̯ðaɾ
saír	saiɾ
sañudo	saɲuðʊ
saúde	sauðɪ
seca	sekɐ
secasí	sekɑsi
seco	sekʊ
sega	seɣa
segar	seɣaɾ
segredo	seɣɾeðʊ
seguir	seħiɾ
seguir	seɣiɾ
segura	seɣuɾa
seguranza	seɣuɾansɐ
seguranza	seɣuɾanθɐ
seica	sei̯kɐ
seistra	sejz̺tɾɐ
seiva	sejβɐ
seivar	sejβaɾ
seixada	sejʃaðɐ
seixo	s̺ejʃʊ
sela	sɛlɐ
selo	selo
semellanza	semeʎanθɐ
sementeiro	sementejɾʊ
sempre	sɛmpɾɪ
sen	sɛŋ
sen	s̺ɪŋ
sendeiro	sendejɾo̝
sentadeiro	sentaðei̯ɾʊ
sentidiño	sentiðiɲʊ
senón	senoŋ
seo	seʊ
sepultura	sepultuɾa
sequera	sekɛɾɐ
ser	s̺eɾ
serao	seɾaʊ̯
serpa	seɾpɐ
serpa	ʃeɾpɐ
serventía	seɾβentiɐ
servidume	serβiðumɪ
servir	seɾβiɾ
servir	sɪɾβiɾ
servizo	seɾβiθʊ
servo	sɛɾβʊ
sese	sɛsɪ
sesego	sesɛɣʊ
sete	sɛte
seteira	sɛtejɾɐ
setestrelo	sɛtestɾɛlʊ
seu	sew
seu	sɛw
severo	s̺eβ̞ɛɾʊ
seña	seɲɐ
señardade	seɲaɾðaðɪ
señeiro	seɲejɾʊ
si	si
silabario	s̺ilaβaɾjʊ
silencio	silɛnθiʊ
silencio	silɛnθjʊ
silveira	silβejɾɐ
sina	sinɐ
sinatura	sinatuɾɐ
sirgo	s̺iɾħʊ
sirgo	s̺iɾɣ̞ʊ
sisto	sistʊ
sisudo	sisuðʊ
situación	sit̪wasjoŋ
situación	s̺it̪waθjoŋ
so	sʊ
soba	soβɐ
sobar	soβaɾ
sobeira	soβejɾɐ
sobre	soβɾɪ
sobrecella	soβɾeseʎɐ
sobrecella	soβɾeθeʎɐ
sobreira	s̺oβ̞ɾejɾa̝
sobresinal	soβɾesinal
sobriño	soβɾiɲʊ
socairo	sokajɾʊ
socheira	sotʃejɾɐ
sociable	s̺ɔθjaβle̝
sofraxe	sʊfɾaʃɪ
sofía	sofia
soga	soɣɐ
sogra	sɔɣɾɐ
sogro	sɔɣɾʊ
sol	s̺ol
sol	s̺ɔl
solaz	solas
solaz	solaθ
soldado	soldaðʊ
soleira	solejɾɐ
solerma	solɛɾmɐ
soles	s̺olɪs̺
solleiro	soʎei̯ɾʊ
solloso	soʎosʊ
solta	soltɐ
solta	sɔltɐ
solteiro	soltejɾʊ
solto	soltʊ
solto	sɔltʊ
soma	somɐ
sombreiro	sombɾejɾʊ
sombrizo	sombɾisʊ
sombrizo	sombɾiθʊ
somonte	somontɪ
son	s̺oŋ
sona	sonɐ
sono	sɔnʊ
sopapo	sopapʊ
sopostallo	sopostaʎʊ
sorba	soɾβɐ
sorriso	sorisʊ
sorteira	sɔɾtei̯ɾɐ
sos	sɔs
sosegar	soseɣaɾ
sospeita	sospejtɐ
sospeitar	sospejtaɾ
sosubir	sosuβiɾ
souria	sowɾjɐ
soño	soɲʊ
su	su
suba	suβɐ
subidoiro	suβiðojɾʊ
subir	suβiɾ
sucesor	suθesoɾ
suco	sukʊ
sueco	s̺wɛkʊ
suegos	swɛɣʊs
suevos	swɛβʊs
sufrín	sufɾin
sugar	suɣaɾ
sugota	suɣɔtɐ
sumidoiro	sumiðojɾʊ
sumir	sumiɾ
sur	suɾ
surbia	suɾβjɐ
sutil	sutil
suxeito	suʃejtʊ
sábado	s̺aβaðʊ
sámago	samɐɣʊ
só	sɔ
súa	s̺uɐ
súpeto	supeto
tabao	taβaʊ̯
taboleiro	tabʊlei̯ɾʊ
tacha	tatʃa̝
tal	tal
tala	talɐ
talizo	talisʊ
talizo	taliθʊ
tallada	taʎaðɐ
tallado	taʎaðʊ
tallante	taʎantɪ
tamaño	tamaɲʊ
tamboril	tamboɾil
tamborilada	tamboɾilaðɐ
tamborileiro	tamboɾilei̯ɾʊ
tambre	tambɾɪ
tampouco	tampoʊ̯kʊ
tan	tɑŋ
tangalexo	taŋgaleʃo̝
tangaraño	taŋgaɾaɲʊ
tanto	tantʊ
tapadeira	tapaðejɾɐ
tapete	tapetɪ
tapia	tapjɐ
tapiz	tapis
tapiz	tapiθ
tapume	tapumɪ
tarabela	taɾaβɛlɐ
tarabelear	taɾaβeleaɾ
tarambollo	taɾamboʎʊ
tarandeira	taɾandejɾɐ
tardanza	taɾðanθa
tardar	taɾðaɾ
tardo	taɾðʊ
tarraxa	taraʃɐ
tarrelo	tarelʊ
tarrelo	tarɛlʊ
tartaraña	taɾtaɾaɲɐ
tarteira	taɾtei̯ɾɐ
tarxeteiro	taɾʃetei̯ɾʊ
tascador	taskaðoɾ
tatexar	tateʃaɾ
tatexo	tateʃʊ
taza	tasɐ
taza	taθɐ
te	te
tega	tɛɣɐ
teima	tejmɐ
teimar	tejmaɾ
teimoso	tei̯mosʊ
teimudo	tei̯muðʊ
teixugo	tei̯ʃuɣʊ
teixugueira	t̪ejʃuħejɾɐ
teixugueira	t̪ejʃuɣ̞ejɾɐ
telepatía	telepatia
televisión	t̪eleβ̞is̺jɔŋ
temoa	temoɐ
temoeiro	temʊei̯ɾʊ
temoncela	temonθɛlɐ
temor	temoɾ
tempada	tempaðɐ
temperar	tempeɾaɾ
tempero	tempeɾʊ
tempero	tempɛɾʊ
temperán	tempeɾaŋ
tempo	t̪empʊ
tempo	t̪ɛmpʊ
tena	tena
tenaces	tenasɪs
tenaces	tenaθɪs
tendón	tendoŋ
tenreira	tenrejɾɐ
tenreiro	tenrejɾʊ
tenro	tɛnrʊ
tensas	tensas
tentar	tentaɾ
tenue	tɛnʊ̯ɪ
teo	teʊ
ter	teɾ
termo	tɛɾmʊ
terreiro	terejɾʊ
terrexar	tɛreʃaɾ
terror	tɛroɾ
terrádego	tɛraðɪɣʊ
terza	teɾθɐ
tes	tes
testamento	testamentʊ
testemuña	testemuɲɐ
testemuño	testemuɲʊ
testo	testo̝
testán	testaŋ
teto	tetʊ
texas	teksas
teño	teɲʊ
ti	t̪i
tibia	tiβjɐ
tibio	tiβjʊ
tilleira	tiʎejɾɐ
tinta	tintɐ
tinteiro	tintejɾʊ
tintura	tintuɾɐ
tioira	tioi̯ɾɐ
tirapuxa	tiɾapuʃɐ
tizón	tisoŋ
tizón	tiθoŋ
tiúlfe	tiulfɪ
to	tɔː
toca	toka
tocar	tokaɾ
todo	toðʊ
tolaxe	tolaʃɪ
tolear	toleaɾ
tolemia	tolɛmi̯ɐ
tolleito	toʎejto̝
tolosa	t̪olos̺ɐ
tolosano	t̪olos̺anʊ
tom	tom
tomba	tombɐ
tome	tome
tomento	tomentʊ
toniña	toniɲɐ
tonto	tontʊ
torar	toɾaɾ
torcida	toɾsiðɐ
torcida	toɾθiðɐ
tordear	toɾðeaɾ
torga	tɔɾɣɐ
torgar	toɾɣaɾ
torgo	tɔɾɣʊ
tornada	toɾnaðɐ
tornasol	t̪ɔɾnas̺oɫ
tornasol	t̪ɔɾnas̺ɔɫ
torneo	tɔɾneʊ
torpe	toɾpɪ
torre	torɪ
torresmo	torɛsmʊ
torticeiro	toɾtiθejɾʊ
torzón	toɾsoŋ
torzón	toɾθoŋ
tosar	tosaɾ
tosta	tɔstɐ
tostado	tostaðʊ
toste	tɔstɪ
toucelo	towselʊ
touliña	toʊ̯liɲɐ
toupeira	towpejɾɐ
toupello	towpeʎʊ
touquinegra	towkineɣɾɐ
toural	towɾal
tourengo	towɾeŋgʊ
touro	tou̯ɾʊ
touzar	touθaɾ
toxedo	toʃeðʊ
toxo	toʃʊ
traballador	tɾaβaʎaðoɾ
traballo	tɾaβaʎʊ
tradar	tɾaðaɾ
trade	tɾaðɪ
traer	tɾaeɾ
tragar	tɾaɣaɾ
tragueira	tɾaɣejɾɐ
traizón	tɾajθoŋ
trama	tɾamɐ
tramallo	tɾamaʎʊ
trampulleiro	tɾampuʎejɾʊ
trancho	tɾantʃʊ
tranqueiro	tɾaŋkei̯ɾʊ
trapalleiro	tɾapaʎejɾʊ
trapeira	tɾapejɾɐ
tras	tɾas
trasantonte	tɾasantɔntɪ
trasariz	tɾasaɾiθ
traseira	tɾasei̯ɾɐ
traseiro	tɾasei̯ɾʊ
trasfegar	tɾasfeɣaɾ
trasmil	tɾasmil
trasno	tɾasnʊ
traten	traten
trato	tɾatʊ
traza	tɾasa
traza	tɾaθa
trazar	tɾasaɾ
trazar	tɾaθaɾ
treita	tɾei̯tɐ
treitoira	tɾei̯toi̯ɾɐ
treixa	tɾejʃɐ
treixadura	tɾejʃaðuɾɐ
trela	tɾɛlɐ
tremar	tɾemaɾ
tremendo	tɾemendʊ
tremo	tremo
tren	tɾen
trencha	tɾentʃɐ
trenco	tɾeŋkʊ
trepeza	tɾepɛθɐ
tres	tɾes
trigal	tɾiɣal
trincha	tɾintʃɐ
trinchante	tɾentʃantɪ
trinchar	tɾintʃaɾ
tripada	tɾipaðɐ
tripaxe	tɾipaʃɪ
trisca	tɾiskɐ
tristeiro	tɾisteiɾʊ
tristura	tɾistuɾɐ
trobisco	tɾoβiskʊ
trobo	tɾɔβʊ
troco	tɾɔkʊ
troiteiro	tɾoɪ̯teɪ̯ɾʊ
trollo	tɾoʎʊ
troneira	tɾɔnejɾɐ
tropa	tɾɔpɐ
tropel	tɾɔpɛl
tropezar	tɾopesaɾ
tropezar	tɾopeθaɾ
troulada	tɾou̯laðɐ
troupelear	tɾoʊ̯peleaɾ
trouxa	tɾowʃɐ
trueiro	tɾuei̯ɾʊ
trunfar	tɾuɱfaɾ
trunfo	tɾuɱfʊ
truque	tɾukɪ
truquel	tɾukɛl
trémaro	tɾɛmɐɾʊ
trópago	tɾɔpɐɣʊ
tuche	tutʃɪ
tunda	tunda
turba	tuɾβɐ
turbeira	tuɾβei̯ɾɐ
turbina	t̪uɾβ̞inɐ
turra	turɐ
turrar	turaɾ
tusido	tusiðʊ
tutelo	tutɛlʊ
tuíxe	tuiʃɪ
tártago	taɾtɐɣʊ
tépedo	tepɪðʊ
tódolos	toðʊlʊs
ubre	uβɾɪ
ucheira	utʃejɾɐ
ulla	uʎɐ
ulloa	uʎoɐ
un	un
ungüento	uŋgwɛntʊ
uniformemente	unifɔɾmẽmẽn̪t̪ɪ
unllar	unʎaɾ
untar	untaɾ
urda	uɾðɐ
urdume	uɾðumɪ
urraca	urakɐ
uso	usʊ
usurpar	usuɾpaɾ
ut	ut
uva	uβɐ
uxa	uʃɐ
uzal	usal
uzal	uθal
vaca	bakɐ
vaca	βakɐ
vacío	basiʊ
vacío	baθiʊ
vaga	baɣa
vaganta	baɣantɐ
vagar	baɣaɾ
vagaroso	baɣaɾosʊ
vagón	baɣoŋ
vai	βai
val	bal
vale	bale
valedeiro	baleðejɾʊ
valente	balentɪ
valente	balɛntɪ
valer	baleɾ
valixa	balixa
valiña	baliɲa
valse	balsɪ
vantaxe	βantaʃɪ
varanda	baɾandɐ
varelo	baɾɛlʊ
varelo	bɾɛlʊ
varexar	baɾeʃaɾ
varredoiro	bareðojɾʊ
varrer	bareɾ
varón	baɾoŋ
vas	bas
vasalaxe	basalaʃɪ
vasallo	basaʎʊ
vaso	basʊ
vasoira	bas̺oi̯ɾɐ
vaxa	baʃɐ
vazante	baθantɪ
vazar	basaɾ
vazar	baθaɾ
ve	be
veceira	beθejɾɐ
vega	beɣa
vegada	beɣaðɐ
veiro	bejɾʊ
vela	bela
velaquí	belaki
velar	belaɾ
velaí	belai
veleno	belenʊ
vellez	beʎes
vellez	beʎeθ
vellote	beʎɔtɪ
velorio	belɔɾjʊ
ven	ben
vencer	benθeɾ
vencido	benθiðʊ
vender	bendeɾ
venta	bentɐ
ventosidade	bentʊsiða
ventosidade	bentʊsiðaðɪ
ventoso	bentosʊ
ventre	bentɾɪ
ventre	bɛntɾɪ
ventrecha	bentɾetʃɐ
ventrullo	bentɾuʎʊ
venturoso	bentuɾosʊ
ver	beɾ
verdade	beɾða
verdade	beɾðaðɪ
verdadeiro	beɾðaðei̯ɾʊ
verde	beɾðɪ
verdel	beɾðɛl
verderolo	beɾðeɾɔlʊ
verdexar	beɾðeʃaɾ
verdura	beɾðuɾɐ
vergallo	beɾɣaʎʊ
vergasta	beɾɣastɐ
vergonza	beɾɣonsɐ
vergonza	beɾɣonθɐ
vergoña	beɾɣoɲɐ
vergoñento	beɾɣoɲɛntʊ
verme	bɛɾmɪ
vermello	beɾmeʎʊ
vermello	βeɾmeʎʊ
vermioso	βeɾmiosʊ
verro	bɛrʊ
verruga	beruɣɐ
versatilidade	beɾs̺at̪ilið̞að̞ɪ
versátil	beɾs̺at̪iɫ
vertedoiro	beɾteɗoi̯ɾʊ
verter	beɾteɾ
vertixe	beɾtiʃɪ
vesadoiro	besaðoi̯ɾʊ
veso	besʊ
vestidura	bestiðuɾɐ
vexiga	beʃiɣa̝
vexiga	biʃiɣa̝
vez	bes
vezar	besaɾ
vezar	beθaɾ
vida	biðɐ
vida	βiðɐ
vidalla	biðaʎɐ
vidreira	biðɾejɾɐ
vidro	biðɾʊ
vieira	biejɾɐ
vieira	bjejɾɐ
viela	biɛlɐ
vigairo	biɣajɾʊ
vila	bilɐ
vilatuíxe	bilatuiʃɪ
vilego	bilɛɣʊ
vincallo	biŋkaʎo̝
vinchoca	bintʃɔkɐ
vinco	biŋkʊ
vinculeiro	biŋkulei̯ɾʊ
vinda	bindɐ
vindeiro	bindejɾʊ
vinga	biŋgɐ
vinganza	biŋgansɐ
vinganza	biŋganθɐ
vir	biɾ
viradeira	biɾaðei̯ɾɐ
virote	biɾote
virtude	biɾtu
virtude	biɾtuðɪ
visaxe	bisaʃɪ
vitela	bitɛlɐ
viturón	bituɾoŋ
vivir	bibiɾ
vivo	biβʊ
vixiante	biʃiantɪ
vixilante	biʃilantɪ
vixilia	biʃiliɐ
vixilia	biʃiljɐ
vixía	biʃiɐ
viña	biɲa̝
viño	biɲʊ
viúva	biuβɐ
viúvo	biuβʊ
voar	boaɾ
vocábulo	bokaβ̞ulʊ
voda	boð̞ɐ
vogar	bɔɣaɾ
voitirón	boi̯tiɾoŋ
voleibol	bolejβ̞ɔɫ
voltar	bɔltaɾ
volve	bolβe
volver	bolβeɾ
vontade	bontaðɪ
vorcar	boɾkaɾ
voso	bɔsʊ
voz	bɔs
voz	bɔθ
vulgar	bulɣaɾ
válido	baliðʊ
vélaro	bɛlɐɾʊ
vérrago	bɛrɐɣʊ
véspera	bɛspɪɾɐ
vía	biɐ
víbora	biβʊɾɐ
vínculo	biŋkʊlʊ
vós	bos
xa	ʃa
xabardo	ʃaβaɾðʊ
xabrón	ʃaβɾoŋ
xabón	ʃaβoŋ
xagobe	ʃaɣoβɪ
xalde	ʃaldɪ
xamais	ʃamajs
xamba	ʃambɐ
xamón	ʃamõŋ
xaneira	ʃanejɾɐ
xaneiro	ʃanejɾʊ
xango	ʃaŋgʊ
xarampón	ʃaɾampoŋ
xardín	ʃaɾðiŋ
xarrete	ʃaretɪ
xarxa	ʃaɾʃɐ
xasmín	ʃasmiŋ
xastre	ʃas̺t̪ɾɪ
xeadento	ʃeaðentʊ
xeira	ʃejɾɐ
xema	ʃemɐ
xemelgo	ʃemɛlɣʊ
xenarde	ʃenaɾðɪ
xenreira	ʃenrejɾɐ
xenxibre	ʃenʃiβɾɪ
xeo	ʃeʊ
xerra	ʃɛrɐ
xesto	ʃestʊ
xesús	ʃɛsus
xetafe	ʃetafe
xi	ʃi
xibardo	ʃiβaɾðʊ
xiboso	ʃiβosʊ
xibón	ʃiβoŋ
xieiro	ʃiejɾʊ
xil	ʃil
xilbarbeira	ʃilβaɾβejɾɐ
xira	ʃiɾa
xirafa	ʃiɾafɐ
xirín	ʃiɾiŋ
xistra	ʃistɾɐ
xo	ʃoː
xoana	ʃʊ̯anɐ
xoaniña	ʃʊ̯aniɲɐ
xoeira	ʃɔejɾɐ
xoga	ʃoɣa
xogar	ʃoɣaɾ
xoguete	ʃoɣetɪ
xoia	ʃɔjɐ
xoio	ʃɔjʊ
xordo	ʃoɾðʊ
xornalista	ʃoɾnalistɐ
xovenco	ʃʊβeŋkʊ
xugada	ʃuɣaðɐ
xugo	ʃuɣʊ
xulgado	ʃulɣaðʊ
xulgar	ʃulɣaɾ
xuncras	ʃuŋkɾɐs
xunguir	ʃuŋgiɾ
xuntanza	ʃuntansɐ
xuntanza	ʃuntanθɐ
xuntar	ʃuntaɾ
xunto	ʃunto
xuntoiro	ʃuntojɾʊ
xura	ʃuɾɐ
xurar	ʃuɾaɾ
xurdio	ʃuɾðjʊ
xurdiu	ʃuɾðiu
xuro	ʃuɾʊ
xusta	ʃus̺t̪ɐ
xustiza	ʃustiθɐ
xusto	ʃus̺t̪ʊ
xuventude	ʃuβentu
xuventude	ʃuβentuðɪ
xácea	ʃaθɪɐ
xícara	ʃikɐɾɐ
xílgaro	ʃilɣɐɾʊ
zafado	sɑfaðʊ
zafado	θɑfaðʊ
zafar	safaɾ
zafar	zafaɾ
zafo	safʊ
zafo	θafʊ
zamarra	samarɐ
zamarra	θamarɐ
zamborca	sambɔɾkɐ
zamborca	θambɔɾkɐ
zanco	saŋkʊ
zanco	θaŋkʊ
zapa	sapɐ
zapa	θapɐ
zapato	sapat̪ʊ
zapato	θapat̪ʊ
zaragata	saɾaħatɐ
zaragata	θaɾaɣatɐ
zarzallar	θaɾθaʎaɾ
zoco	sɔkʊ
zoco	θɔkʊ
zona	θonɐ
zoscadoiro	soskaðojɾʊ
zoscadoiro	θoskaðojɾʊ
zoupada	soʊ̯paðɐ
zoupada	θoʊ̯paðɐ
zreixa	θɾei̯ʃɐ
zucre	sukɾɪ
zucre	θukɾɪ
zumbar	θumbaɾ
zume	sumɪ
zume	θumɪ
zumegar	sumeɣaɾ
zumegar	θumeɣaɾ
zurcir	suɾsiɾ
zurcir	θuɾθiɾ
á	a
á	aː
ábaco	abako
ábaco	aβako
ábrego	aβ̞ɾeħʊ
ábrego	aβ̞ɾeɣ̞ʊ
áncora	aŋkʊɾɐ
árbore	aɾβo̝ɾe̝
ás	as
ástrago	astɾɐɣʊ
é	ɛ
éndez	endeθ
ézaro	ɛsɐɾʊ
ía	ia
ídolo	iðʊlʊ
ó	ɔ
óleo	ɔleʊ
úcera	useɾɐ
úcera	uθeɾɐ
única	unika
