"độ	do˨˩˨
-	ki˧
a	a˧˧
a-di-đà	a˧˧-ji˧˧-da˧˨
a-lê	a˧˧-le˧˧
a-mi-nô	a˧˧-mi˧˧-no˧˧
a-rập	a˧˧-ʐɤ̆p˨˩˨
a-xê-ti-len	a˧˧-se˧˧-ti˧˧-lɛŋ˧˧
a-xít	a˧˧-sit˦˥
ai	aj˧˧
alo	pala˧
am	am˧˧
am-pe	am˧˧-pɛ˧˧
an	aŋ˧˧
ang	aŋ˧˧
anh	an˧˧
ao	aw˧˧
au	ăw˧˧
ay	ăj˧˧
ba	ba˧
ba	ba˧˧
ba-trui	ba˧˧-ʈuj˧˧
ba-xí	ba˧˧-si˦˥
bai	baj˧˧
bam	bam˧˧
ban	ban˧
ban	baŋ˧˧
bang	baŋ˧˧
bao	baw˧˧
bay	băj˧˧
be	bɛ˧˧
bem	bɛm˧˧
beng	bɛŋ˧˧
beo	beo˧˧
bi	bi˧˧
bia	biə˧˧
bin	bin˧˧
binh	bin˧˧
biên	biəŋ˧˧
biêng	biəŋ˧˧
biếc	biək˦˥
biếm	bim˦˥
biến	biəŋ˦˥
biếng	biəŋ˦˥
biết	biək˦˥
biếu	biəw˦˥
biền	biəŋ˧˨
biển	biəŋ˨˩˦
biểu	biəw˨˩˦
biện	biəŋ˨˩˨
biệt	biək˨˩˨
bo	bɔ˧˧
bom	bɔm˧˧
bon	bɔŋm˧˧
bong	bɔŋm˧˧
boong	bɔŋm˧˧
boóc	bɔkp˦˥
bu	bu˧˧
bui	buj˧˧
bum	bum˧˧
bun	buŋm˧˧
bung	buŋm˧˧
buôn	buəŋ˧˧
buông	buəŋ˧˧
buốt	buək˦˥
buồm	bum˧˨
buồn	buəŋ˧˨
buồng	buəŋ˧˨
buổi	buəj˨˩˦
buộc	buək˨˩˨
buột	buək˨˩˨
bà	baː˥˨˩
bà	baː˧˨˩
bà	baː˨˩
bà	ba˥˩˨˩
bà	ba˧˨
bà	ba˨˩
bài	baj˧˨
bàm	bam˧˨
bàn	baŋ˧˨
bàng	baŋ˧˨
bành	ban˧˨
bào	baw˧˨
bàu	băw˧˨
bày	băj˧˨
bá	ba˦˥
bác	bak˦˥
bách	bat˦˥
bái	baj˦˥
bám	bam˦˥
bán	baŋ˦˥
báng	baŋ˦˥
bánh	ban˦˥
báo	baw˦˥
báo	baw˧˥
bát	bat˦˥
bát-tràng	bat˦˥-ʈaŋ˧˨
báu	băw˦˥
bân	bɤ̆ŋ˧˧
bâng	bɤ̆ŋ˧˧
bâu	bɤ̆w˧˧
bây	bɤ̆j˧˧
bã	ba˨˩˦
bãi	baj˨˩˦
bão	baw˨˩˦
bè	bɛ˧˨
bèm	bɛm˧˨
bèn	bɛŋ˧˨
bèo	beo˧˨
bé	bɛn˧˥
bé	bɛ˦˥
béc	bɛk˦˥
bén	bɛŋ˦˥
béo	beo˦˥
bép	bɛp˦˥
bét	bɛt˦˥
bê	be˧˧
bê-tông	be˧˧-toŋm˧˧
bên	ben˧
bên	ben˧˧
bênh	ben˧˧
bêu	bɛu˧˧
bì	bi˧˨
bìa	biə˧˨
bìm	bim˧˨
bình	bin˧˨
bìu	biw˧˨
bí	bi˦˥
bích	bit˦˥
bích-câu	bit˦˥-kɤ̆w˧˧
bín	bin˦˥
bính	bin˦˥
bíp	bip˦˥
bít	bit˦˥
bíu	biw˦˥
bò	bɔ˧˨
bòi	bɔj˧˨
bòm	bɔm˧˨
bòn	bɔŋm˧˨
bòng	bɔŋm˧˨
bó	bɔː˧˥
bó	bɔ˦˥
bóc	bɔkp˦˥
bói	bɔj˦˥
bón	bɔŋm˦˥
bóng	bɔŋm˦˥
bóp	bɔp˦˥
bô	bo˧˧
bôi	boj˧˧
bôm	bom˧˧
bôn	boŋm˧˧
bôn-sê-vích	boŋm˧˧-ʂe˧˧-jit˦˥
bông	boŋm˧˧
bõ	bɔ˨˩˦
bù	bu˧˨
bùa	buə˧˨
bùi	buj˧˨
bùm	bum˧˨
bùn	buŋm˧˨
bùn	bˈʊn˨˩
bùng	buŋm˧˨
bú	bu˦˥
búa	buə˦˥
búi	buj˦˥
bún	buŋm˦˥
búng	buŋm˦˥
búp	bup˦˥
bút	bukp˦˥
băm	băm˧˧
băn	băŋ˧˧
băng	băŋ˧˧
băng-giô	băŋ˧˧-jo˧˧
bĩ	bi˨˩˦
bĩnh	bin˨˩˦
bĩu	biw˨˩˦
bơ	bɤ˧˧
bơi	bɤj˧˧
bơm	bɤm˧˧
bơn	bɤŋ˧˧
bư	bɯ˧˧
bưng	bɯŋ˧˧
bưu	bɯw˧˧
bươm	bɯm˧˧
bươn	bɯəŋ˧˧
bương	bɯəŋ˧˧
bươu	bɯəw˧˧
bước	bɯək˦˥
bướm	bɯm˦˥
bướng	bɯəŋ˦˥
bướu	bɯəw˦˥
bưởi	bɯəj˨˩˦
bạ	ba˨˩˨
bạc	bak˨˩˨
bạch	bat˨˩˨
bại	baj˨˩˨
bạn	baŋ˨˩˨
bạn	baːn˨˩˨
bạn	bãn˨˩˨
bạn	bɑːn˨˩˨
bạn	bɛn˨˩˨
bạn	bˈb˨˩˨
bạn	la˨˩˨
bạn	ɑɛn˨˩˨
bạng	baŋ˨˩˨
bạnh	ban˨˩˨
bạo	baw˨˩˨
bạt	bat˨˩˨
bạu	băw˨˩˨
bả	ba˨˩˦
bải	baj˨˩˦
bản	baŋ˨˩˦
bảng	baŋ˨˩˦
bảnh	ban˨˩˦
bảo	baw˨˩˦
bảu	băw˨˩˦
bảy	băj˨˩˦
bấc	bɤ̆k˦˥
bấm	bɤ̆m˦˥
bấn	bɤ̆ŋ˦˥
bấp	bɤ̆p˦˥
bất	bɤ̆k˦˥
bấu	bɤ̆w˦˥
bấy	bɤ̆j˦˥
bầm	bɤ̆m˧˨
bần	bɤ̆ŋ˧˨
bầng	bɤ̆ŋ˧˨
bầu	bɤ̆w˧˨
bầy	bɤ̆j˧˨
bẩm	bɤ̆m˨˩˦
bẩn	bɤ̆ŋ˨˩˦
bẩy	bɤ̆j˨˩˦
bẫm	bɤ̆m˨˩˦
bẫy	bɤ̆j˨˩˦
bậc	bɤ̆k˨˩˨
bậm	bɤ̆m˨˩˨
bận	bɛng˧
bận	bɤ̆ŋ˨˩˨
bập	bɤ̆p˨˩˨
bật	bɤ̆k˨˩˨
bậu	bɤ̆w˨˩˨
bậy	bɤ̆j˨˩˨
bắc	băk˦˥
bắn	băŋ˦˥
bắng	băŋ˦˥
bắp	băp˦˥
bắt	băk˦˥
bằn	băŋ˧˨
bằng	bãn˧
bằng	băŋ˧˨
bằng	mɛ˧
bẳn	băŋ˨˩˦
bẵng	băŋ˨˩˦
bặc	băk˨˩˨
bặm	băm˨˩˨
bặng	băŋ˨˩˨
bặt	băk˨˩˨
bẹ	bɛ˨˩˨
bẹp	bɛp˨˩˨
bẹt	bɛt˨˩˨
bẻ	bɛ˨˩˦
bẻm	bɛm˨˩˦
bẻo	beo˨˩˦
bẽ	bɛ˨˩˦
bẽn	bɛŋ˨˩˦
bế	be˦˥
bến	ben˦˥
bếp	bep˦˥
bết	bet˦˥
bề	be˧˨
bền	ben˧˨
bềnh	ben˧˨
bều	bɛu˧˨
bể	be˨˩˦
bệ	be˨˩˨
bệch	bet˨˩˨
bện	ben˨˩˨
bệnh	ben˨˩˨
bệt	bet˨˩˨
bệu	bɛu˨˩˨
bỉ	bi˨˩˦
bỉm	bim˨˩˦
bỉnh	bin˨˩˦
bị	biː˨˩˨
bị	bi˨˩˨
bị	bɛj˨˩˨
bị	lɛ˨˩˨
bị	zɪ˨˩˨
bịa	biə˨˩˨
bịn	bin˨˩˨
bịp	bip˨˩˨
bịt	bit˨˩˨
bọ	bɔ˨˩˨
bọc	bɔkp˨˩˨
bọn	bɔŋm˨˩˨
bọng	bɔŋm˨˩˨
bọp	bɔp˨˩˨
bọt	bɔkp˨˩˨
bỏ	bɔː˨˧
bỏ	bɔ˨˩˦
bỏm	bɔm˨˩˦
bỏn	bɔŋm˨˩˦
bỏng	bɔŋm˨˩˦
bố	boː˧
bố	bo˦˥
bố	buː˧
bố	bu˧
bố	ɛm˧
bốc	bokp˦˥
bối	boj˦˥
bốn	boŋm˦˥
bống	boŋm˦˥
bốp	bop˦˥
bồ	bo˧˨
bồi	boj˧˨
bồm	bom˧˨
bồn	boŋm˧˨
bồng	boŋm˧˨
bổ	bo˨˩˦
bổi	boj˨˩˦
bổn	boŋm˨˩˦
bổng	boŋm˨˩˦
bỗ	bo˨˩˦
bỗng	boŋm˨˩˦
bỗng	bɔk˧
bỗng	lũŋ˧
bộ	bo˨˩˨
bộc	bokp˨˩˨
bội	boj˨˩˨
bộn	boŋm˨˩˨
bộng	boŋm˨˩˨
bộp	bop˨˩˨
bột	bokp˨˩˨
bớ	bɤ˦˥
bới	bɤj˦˥
bớp	bɤp˦˥
bớt	bɤk˦˥
bờ	bɤ˧˨
bời	bɤj˧˨
bờm	bɤm˧˨
bờn	bɤŋ˧˨
bở	bɤ˨˩˦
bởi	bɤj˨˩˦
bỡ	bɤ˨˩˦
bỡn	bɤŋ˨˩˦
bợ	bɤ˨˩˨
bợm	bɤm˨˩˨
bợn	bɤŋ˨˩˨
bợp	bɤp˨˩˨
bợt	bɤk˨˩˨
bụ	bu˨˩˨
bụi	buj˨˩˨
bụng	buŋm˨˩˨
bụt	bukp˨˩˨
bủ	bu˨˩˦
bủa	buə˨˩˦
bủn	buŋm˨˩˦
bủng	buŋm˨˩˦
bứ	bɯ˦˥
bức	bɯk˦˥
bứt	bɯk˦˥
bừa	bɯə˧˨
bừng	bɯŋ˧˨
bửng	bɯŋ˨˩˦
bửu	bɯw˨˩˦
bữa	bɯə˨˩˦
bự	bɯ˨˩˨
bực	bɯk˨˩˨
ca	ka˧˧
cai	kaj˧˧
cam	kam˧˧
can	kaŋ˧˧
cang	kaŋ˧˧
canh	kan˧˧
cao	kaw˧˧
cau	kăw˧˧
cay	kăj˧˧
cha	ca˧˧
chai	caj˧˧
cham	cam˧˧
chan	caŋ˧˧
chang	caŋ˧˧
chanh	can˧˧
chao	caw˧˧
chau	căw˧˧
chay	căj˧˧
che	cɛ˧˧
chem	cɛm˧˧
chen	cɛŋ˧˧
cheng	cɛŋ˧˧
cheo	ceo˧˧
chi	ci˧˧
chia	ciə˧˧
chim	cim˧˧
chin	cin˧˧
chinh	cin˧˧
chiu	ciw˧˧
chiêm	cim˧˧
chiên	ciəŋ˧˧
chiêng	ciəŋ˧˧
chiêu	ciəw˧˧
chiếc	ciək˦˥
chiếm	cim˦˥
chiến	ciəŋ˦˥
chiếng	ciəŋ˦˥
chiếp	cip˦˥
chiết	ciək˦˥
chiếu	ciəw˦˥
chiền	ciəŋ˧˨
chiềng	ciəŋ˧˨
chiều	ciəw˧˨
chiểu	ciəw˨˩˦
cho	cɔ˧˧
cho	tɔː˧˧
choai	cwaj˧˧
choang	cwaŋ˧˧
choe	cwe˧˧
choen	cwen˧˧
choi	cɔj˧˧
chon	cɔŋm˧˧
chong	cɔŋm˧˧
choàm	cwam˧˨
choàng	cwaŋ˧˨
choá	cwa˦˥
choác	cwak˦˥
choáng	cwaŋ˦˥
choèn	cwen˧˨
choăn	cwăŋ˧˧
choạc	cwak˨˩˨
choạng	cwaŋ˨˩˨
choắt	cwăk˦˥
chu	cu˧˧
chua	cuə˧˧
chui	cuj˧˧
chum	cum˧˧
chun	cuŋm˧˧
chung	cuŋm˧˧
chuyên	cwiəŋ˧˧
chuyến	cwiəŋ˦˥
chuyền	cwiəŋ˧˨
chuyển	cwiəŋ˨˩˦
chuyện	cwiəŋ˨˩˨
chuôi	cuəj˧˧
chuôm	cum˧˧
chuông	cuəŋ˧˧
chuẩn	cwɤ̆ŋ˨˩˦
chuế	cwe˦˥
chuếch	cwet˦˥
chuếnh	cwen˦˥
chuểnh	cwen˨˩˦
chuệch	cwet˨˩˨
chuệnh	cwen˨˩˨
chuốc	cuək˦˥
chuối	cuəj˦˥
chuốt	cuək˦˥
chuồi	cuəj˧˨
chuồn	cuəŋ˧˨
chuồng	cuəŋ˧˨
chuỗi	cuəj˨˩˦
chuộc	cuək˨˩˨
chuội	cuəj˨˩˨
chuộng	cuəŋ˨˩˨
chuột	cuək˨˩˨
chà	ca˧˨
chài	caj˧˨
chàm	cam˧˨
chàng	caŋ˧˨
chành	can˧˨
chào	caw˧˨
chàu	căw˧˨
chày	căj˧˨
chác	cak˦˥
chán	caŋ˦˥
chánh	can˦˥
cháo	caw˦˥
chát	cat˦˥
cháu	căw˦˥
cháy	căj˦˥
châm	cɤ̆m˧˧
chân	cɤ̆ŋ˧˧
châng	cɤ̆ŋ˧˧
châu	cɤ̆w˧˧
chây	cɤ̆j˧˧
chão	caw˨˩˦
chè	cɛ˧˨
chèm	cɛm˧˨
chèn	cɛŋ˧˨
chèo	ceo˧˨
chém	cɛm˦˥
chén	cɛŋ˦˥
chéo	ceo˦˥
chép	cɛp˦˥
chét	cɛt˦˥
chê	ce˧˧
chêm	cem˧˧
chênh	cen˧˧
chêu	cɛu˧˧
chì	ci˧˨
chìa	ciə˧˨
chìm	cim˧˨
chình	cin˧˨
chí	ci˦˥
chích	cit˦˥
chín	cin˦˥
chính	cin˦˥
chíp	cip˦˥
chít	cit˦˥
chíu	ciw˦˥
chò	cɔ˧˨
chòi	cɔj˧˨
chòm	cɔm˧˨
chòng	cɔŋm˧˨
chó	cɔ˦˥
chóc	cɔkp˦˥
chói	cɔj˦˥
chóng	cɔŋm˦˥
chóp	cɔp˦˥
chót	cɔkp˦˥
chô	co˧˧
chôm	com˧˧
chôn	coŋm˧˧
chông	coŋm˧˧
chõ	cɔ˨˩˦
chõm	cɔm˨˩˦
chù	cu˧˨
chùa	cuə˧˨
chùi	cuj˧˨
chùm	cum˧˨
chùn	cuŋm˧˨
chùng	cuŋm˧˨
chú	cu˦˥
chúa	cuə˦˥
chúc	cukp˦˥
chúi	cuj˦˥
chúm	cum˦˥
chúng	cuŋm˦˥
chút	cukp˦˥
chăm	căm˧˧
chăn	căŋ˧˧
chăng	căŋ˧˧
chĩa	ciə˨˩˦
chĩnh	cin˨˩˦
chũm	cum˨˩˦
chũn	cuŋm˨˩˦
chơ	cɤ˧˧
chơi	cɤj˧˧
chơm	cɤm˧˧
chơn	cɤŋ˧˧
chư	cɯ˧˧
chưa	cɯə˧˧
chưng	cɯŋ˧˧
chương	cɯəŋ˧˧
chước	cɯək˦˥
chướng	cɯəŋ˦˥
chưởng	cɯəŋ˨˩˦
chạ	ca˨˩˨
chạc	cak˨˩˨
chạch	cat˨˩˨
chạm	cam˨˩˨
chạng	caŋ˨˩˨
chạnh	can˨˩˨
chạo	caw˨˩˨
chạp	cap˨˩˨
chạy	căj˨˩˨
chả	ca˨˩˦
chải	caj˨˩˦
chảng	caŋ˨˩˦
chảnh	can˨˩˦
chảo	caw˨˩˦
chảu	căw˨˩˦
chảy	căj˨˩˦
chấm	cɤ̆m˦˥
chấn	cɤ̆ŋ˦˥
chấp	ba˧
chấp	cɤ̆p˦˥
chấp	na˧
chất	cɤ̆k˦˥
chấu	cɤ̆w˦˥
chấy	cɤ̆j˦˥
chầm	cɤ̆m˧˨
chần	cɤ̆ŋ˧˨
chầu	cɤ̆w˧˨
chầy	cɤ̆j˧˨
chẩm	cɤ̆m˨˩˦
chẩn	cɤ̆ŋ˨˩˦
chẫu	cɤ̆w˨˩˦
chậc	cɤ̆k˨˩˨
chậm	cɤ̆m˨˩˨
chận	cɤ̆ŋ˨˩˨
chập	cɤ̆p˨˩˨
chật	cɤ̆k˨˩˨
chậu	cɤ̆w˨˩˨
chắc	căk˦˥
chắc	tɑk˧
chắn	căŋ˦˥
chắp	căp˦˥
chắt	căk˦˥
chằm	căm˧˨
chằn	căŋ˧˨
chằng	căŋ˧˨
chẳng	căŋ˨˩˦
chẵn	căŋ˨˩˦
chặc	căk˨˩˨
chặn	căŋ˨˩˨
chặng	căŋ˨˩˨
chặp	căp˨˩˨
chặt	căk˨˩˨
chẹn	cɛŋ˨˩˨
chẹp	cɛp˨˩˨
chẹt	cɛt˨˩˨
chẻ	cɛ˨˩˦
chẻm	cɛm˨˩˦
chẻn	cɛŋ˨˩˦
chẻo	ceo˨˩˦
chế	ce˦˥
chếch	cet˦˥
chếnh	cen˦˥
chết	cet˦˥
chề	ce˧˨
chềm	cem˧˨
chềnh	cen˧˨
chểnh	cen˨˩˦
chễm	cem˨˩˦
chễnh	cen˨˩˦
chệch	cet˨˩˨
chệnh	cen˨˩˨
chỉ	ci˨˩˦
chỉn	cin˨˩˦
chỉnh	cin˨˩˦
chị	ci˨˩˨
chị	tɔ˨˩˨
chị	xi˨˩˨
chị	ɛm˨˩˨
chịu	ciw˨˩˨
chọc	cɔkp˨˩˨
chọi	cɔj˨˩˨
chọn	cɔŋm˨˩˨
chỏm	cɔm˨˩˦
chỏn	cɔŋm˨˩˦
chỏng	cɔŋm˨˩˦
chốc	cokp˦˥
chối	coj˦˥
chốn	coŋm˦˥
chống	coŋm˦˥
chốt	cokp˦˥
chồi	coj˧˨
chồm	com˧˨
chồn	coŋm˧˨
chồng	coŋm˧˨
chổi	coj˨˩˦
chổng	coŋm˨˩˦
chỗ	co˨˩˦
chỗ	tɨ˧
chộn	coŋm˨˩˨
chộp	cop˨˩˨
chột	cokp˨˩˨
chớ	cɤ˦˥
chới	cɤj˦˥
chớm	cɤm˦˥
chớp	cɤp˦˥
chớt	cɤk˦˥
chờ	cɤ˧˨
chờm	cɤm˧˨
chờn	cɤŋ˧˨
chở	cɤ˨˩˦
chợ	cɤ˨˩˨
chợp	cɤp˨˩˨
chục	cukp˨˩˨
chụm	cum˨˩˨
chụp	cup˨˩˨
chụt	cukp˨˩˨
chủ	cu˨˩˦
chủn	cuŋm˨˩˦
chủng	cuŋm˨˩˦
chứ	cɯ˦˥
chứ	ʃy˧
chứa	cɯə˦˥
chức	cɯk˦˥
chứng	cɯŋ˦˥
chừ	cɯ˧˨
chừa	cɯə˧˨
chừng	cɯŋ˧˨
chửa	cɯə˨˩˦
chửi	cɯj˨˩˦
chữ	cɯ˨˩˦
chữa	cɯə˨˩˦
chững	cɯŋ˨˩˦
chực	cɯk˨˩˨
co	kɔ˧˧
co	kɛn˧˧
coi	kɔj˧˧
com	kɔm˧˧
con	kɔn˧
con	kɔŋm˧˧
cong	kɔŋm˧˧
coóc	kɔkp˦˥
cu	ku˧˧
cua	kuə˧˧
cui	kuj˧˧
cum	kum˧˧
cun	kuŋm˧˧
cung	kuŋm˧˧
cuốc	kuək˦˥
cuối	kuəj˦˥
cuốn	kuəŋ˦˥
cuống	kuəŋ˦˥
cuồn	kuəŋ˧˨
cuồng	kuəŋ˧˨
cuộc	kuək˨˩˨
cuội	kuəj˨˩˨
cuộn	kuəŋ˨˩˨
cuộng	kuəŋ˨˩˨
cà	ka˧˨
cà-phê	ka˧˨-fe˧˧
cài	kaj˧˨
càn	kaŋ˧˨
càng	kaŋ˧˨
cành	kan˧˨
cào	kaw˧˨
càu	kăw˧˨
cày	kăj˧˨
cá	ka˦˥
các	kak˦˥
các-tông	kak˦˥-toŋm˧˧
cách	kat˦˥
cách	kɛkˈ˧˥
cái	kaj˦˥
cám	kam˦˥
cán	kaŋ˦˥
cáng	kaŋ˦˥
cánh	kan˦˥
cáo	kaw˦˥
cáp	kap˦˥
cát	kat˦˥
cáu	kăw˦˥
cáy	kăj˦˥
câm	kɤ̆m˧˧
cân	kɤ̆ŋ˧˧
câng	kɤ̆ŋ˧˧
câu	kɤ̆w˧˧
cây	kɤ̆j˧˧
cãi	kaj˨˩˦
cò	kɔ˧˨
còi	kɔj˧˨
còm	kɔm˧˨
còn	kɔng˨˩
còn	kɔn˧˨˩
còn	kɔn˨˩
còn	kɔŋm˧˨
còng	kɔŋm˧˨
có	kɔl˧˥
có	kɔm˧˥
có	kɔsɔ˧˥
có	kɔŋ˧˥
có	kɔːn˧˥
có	kɔː˧˥
có	kɔ˦˥
có	kɔ˧˥
cóc	kɔkp˦˥
cói	kɔj˦˥
cóm	kɔm˦˥
cóng	kɔŋm˦˥
cóp	kɔp˦˥
cót	kɔkp˦˥
cô	koː˧
cô	ko˧
cô	ko˧˧
cô-đê	ko˧˧-de˧˧
côi	koj˧˧
côm	kom˧˧
côn	koŋm˧˧
công	koŋm˧˧
công-xinh	koŋm˧˧-sin˧˧
cõi	kɔj˨˩˦
cõng	kɔŋm˨˩˦
cù	ku˧˨
cùi	kuj˧˨
cùm	kum˧˨
cùn	kuŋm˧˨
cùng	kuŋm˧˨
cú	ku˦˥
cúc	kukp˦˥
cúi	kuj˦˥
cúm	kum˦˥
cúng	kuŋm˦˥
cúp	kup˦˥
cút	kukp˦˥
căm	kăm˧˧
căn	kăŋ˧˧
căng	kăŋ˧˧
cũ	kuˌ˧˥˧
cũ	ku˧˥˧
cũ	ku˨˩˦
cũi	kuj˨˩˦
cũn	kuŋm˨˩˦
cũng	kuŋm˨˩˦
cơ	kɤ˧˧
cơi	kɤj˧˧
cơm	kɤm˧˧
cơn	kɤŋ˧˧
cư	kɯ˧˧
cưa	kɯə˧˧
cưng	kɯŋ˧˧
cưu	kɯw˧˧
cương	kɯəŋ˧˧
cước	kɯək˦˥
cưới	kɯəj˦˥
cướp	kɯp˦˥
cười	kɯəj˧˨
cườm	kɯm˧˨
cường	kɯəŋ˧˨
cưỡi	kɯəj˨˩˦
cưỡng	kɯəŋ˨˩˦
cạc	kak˨˩˨
cạch	kat˨˩˨
cạm	kam˨˩˨
cạn	kaŋ˨˩˨
cạnh	kan˨˩˨
cạo	kaw˨˩˨
cạp	kap˨˩˨
cạy	kăj˨˩˨
cả	ka˨˩˦
cải	kaj˨˩˦
cảm	kam˨˩˦
cản	kaŋ˨˩˦
cảng	kaŋ˨˩˦
cảnh	kan˨˩˦
cảo	kaw˨˩˦
cảu	kăw˨˩˦
cảy	kăj˨˩˦
cấc	kɤ̆k˦˥
cấm	kɤ̆m˦˥
cấn	kɤ̆ŋ˦˥
cấp	kɤ̆p˦˥
cất	kɤ̆k˦˥
cấu	kuɔ˧
cấu	kɤ̆w˦˥
cấy	kɤ̆j˦˥
cầm	kɑm˧
cầm	kɛm˧
cầm	kɤ̆m˧˨
cầm	ɛm˧
cần	kɤ̆ŋ˧˨
cầu	kɤ̆w˧˨
cầy	kɤ̆j˧˨
cẩm	kɤ̆m˨˩˦
cẩn	kɤ̆ŋ˨˩˦
cẩu	kɤ̆w˨˩˦
cậm	kɤ̆m˨˩˨
cận	kɤ̆ŋ˨˩˨
cập	kɤ̆p˨˩˨
cật	kɤ̆k˨˩˨
cậu	kɤ̆w˨˩˨
cậy	kɤ̆j˨˩˨
cắc	kăk˦˥
cắm	kăm˦˥
cắn	kăŋ˦˥
cắp	kăp˦˥
cắt	ka˧
cắt	kăk˦˥
cằm	kăm˧˨
cằn	kăŋ˧˨
cẳn	kăŋ˨˩˦
cẳng	kăŋ˨˩˦
cặc	kăk˨˩˨
cặm	kăm˨˩˨
cặn	kăŋ˨˩˨
cặp	kăp˨˩˨
cọ	kɔ˨˩˨
cọc	kɔkp˨˩˨
cọm	kɔm˨˩˨
cọp	kɔp˨˩˨
cọt	kɔkp˨˩˨
cỏ	kɔ˨˩˦
cỏ	oː˨˧
cỏm	kɔm˨˩˦
cỏn	kɔŋm˨˩˦
cỏng	kɔŋm˨˩˦
cố	ko˦˥
cố	kuː˧
cố	ku˧
cốc	kokp˦˥
cối	koj˦˥
cối	ɛː˧
cốm	kom˦˥
cống	koŋm˦˥
cốp	kop˦˥
cốt	kokp˦˥
cồ	ko˧˨
cồm	kom˧˨
cồn	koŋm˧˨
cồng	koŋm˧˨
cổ	ko˨˩˦
cổ	kɔː˧
cổi	koj˨˩˦
cổn	koŋm˨˩˦
cổng	koŋm˨˩˦
cỗ	ko˨˩˦
cỗi	koj˨˩˦
cộc	kokp˨˩˨
cội	koj˨˩˨
cộng	koŋm˨˩˨
cột	kokp˨˩˨
cớ	kɤ˦˥
cớn	kɤŋ˦˥
cớt	kɤk˦˥
cờ	kɤ˧˨
cời	kɤj˧˨
cờn	kɤŋ˧˨
cởi	kɤj˨˩˦
cỡn	kɤŋ˨˩˦
cợt	kɤk˨˩˨
cụ	ku˨˩˨
cục	kukp˨˩˨
cụi	kuj˨˩˨
cụm	kum˨˩˨
cụng	kuŋm˨˩˨
cụp	kup˨˩˨
cụt	kukp˨˩˨
củ	ku˨˩˦
của	kuə˨˩˦
củi	kuj˨˩˦
củng	kuŋm˨˩˦
cứ	gɨ˧
cứ	kyn˧
cứ	kɯn˧
cứ	kɯ˦˥
cứ	kɯ˧
cứ	ɛk˧
cứa	kɯə˦˥
cức	kɯk˦˥
cứng	kɯŋ˦˥
cứt	kɯk˦˥
cứu	kɯw˦˥
cừ	kɯ˧˨
cừu	kɯw˧˨
cử	kuɔ˧
cử	kɯ˨˩˦
cửa	kɯə˨˩˦
cửi	kɯj˨˩˦
cửu	kɯw˨˩˦
cự	kɯ˨˩˨
cựa	kɯə˨˩˨
cực	kɯk˨˩˨
cựu	kɯw˨˩˨
da	ja˧˧
da	za˧
dai	jaj˧˧
dan	jaŋ˧˧
dang	jaŋ˧˧
danh	jan˧˧
dao	jaw˧˧
day	jăj˧˧
de	jɛ˧˧
deo	jeo˧˧
di	ji˧˧
dinh	jin˧˧
diêm	jim˧˧
diên	jiəŋ˧˧
diếc	jiək˦˥
diếp	jip˦˥
diềm	jim˧˨
diều	jiəw˧˨
diễm	jim˨˩˦
diễn	jiəŋ˨˩˦
diễu	jiəw˨˩˦
diệc	jiək˨˩˨
diệm	jim˨˩˨
diện	jiəŋ˨˩˨
diệp	jip˨˩˨
diệt	jiək˨˩˨
diệu	jiəw˨˩˨
do	jɔ˧˧
doanh	jwan˧˧
doi	jɔj˧˧
dong	jɔŋm˧˧
doạ	jwa˨˩˨
du	ju˧˧
dua	juə˧˧
dun	juŋm˧˧
dung	juŋm˧˧
duy	jwi˧˧
duyên	jwiəŋ˧˧
duyệt	jwiək˨˩˨
duật	jwɤ̆k˨˩˨
duềnh	jwen˧˨
duốc	juək˦˥
duỗi	juəj˨˩˦
dà	ja˧˨
dài	jaj˧˨
dàn	jaŋ˧˨
dàng	jaŋ˧˨
dành	jan˧˨
dào	jaw˧˨
dàu	jăw˧˨
dày	jăj˧˨
dái	jaj˦˥
dám	jam˦˥
dán	jaŋ˦˥
dáng	jaŋ˦˥
dáo	jaw˦˥
dát	jat˦˥
dáu	jăw˦˥
dâm	jɤ̆m˧˧
dân	jɤ̆ŋ˧˧
dâng	jɤ̆ŋ˧˧
dâu	jɤ̆w˧˧
dây	jɤ̆j˧˧
dã	ja˨˩˦
dãi	jaj˨˩˦
dãn	jaŋ˨˩˦
dãy	jăj˨˩˦
dè	jɛ˧˨
dèn	jɛŋ˧˨
dé	jɛ˦˥
dép	jɛp˦˥
dê	je˧˧
dì	ji˧˨
dìu	jiw˧˨
dí	ji˦˥
dích	jit˦˥
dính	jin˦˥
díp	jip˦˥
díu	jiw˦˥
dò	jɔ˧˨
dòi	jɔj˧˨
dòm	jɔm˧˨
dòng	jɔŋm˧˨
dó	jɔ˦˥
dóc	jɔkp˦˥
dóng	jɔŋm˦˥
dô	jo˧˧
dôi	joj˧˧
dông	joŋm˧˧
dõi	jɔj˨˩˦
dõng	jɔŋm˨˩˦
dù	ju˧˨
dù	ɛɛ˨˩
dùi	juj˧˨
dùng	juŋm˧˨
dúi	juj˦˥
dúm	jum˦˥
dún	juŋm˦˥
dúng	juŋm˦˥
dút	jukp˦˥
dăm	jăm˧˧
dăn	jăŋ˧˧
dăng	jăŋ˧˧
dĩ	ji˨˩˦
dĩnh	jin˨˩˦
dũ	ju˨˩˦
dũng	juŋm˨˩˦
dơ	jɤ˧˧
dơi	jɤj˧˧
dư	jɯ˧˧
dưa	jɯə˧˧
dưng	jɯŋ˧˧
dương	jɯəŋ˧˧
dưới	jɯəj˦˥
dường	jɯəŋ˧˨
dưỡng	jɯəŋ˨˩˦
dược	jɯək˨˩˨
dạ	ja˨˩˨
dạc	jak˨˩˨
dại	jaj˨˩˨
dạm	jam˨˩˨
dạn	jaŋ˨˩˨
dạng	jaŋ˨˩˨
dạo	jaw˨˩˨
dạt	jat˨˩˨
dạt	ja˨˩˨
dạy	jăj˨˩˨
dải	jaj˨˩˦
dảy	jăj˨˩˦
dấm	jɤ̆m˦˥
dấn	jɤ̆ŋ˦˥
dấp	jɤ̆p˦˥
dấu	jɤ̆w˦˥
dấy	jɤ̆j˦˥
dầm	jɤ̆m˧˨
dần	jɤ̆ŋ˧˨
dầu	jɤ̆w˧˨
dẫm	jɤ̆m˨˩˦
dẫn	jɤ̆ŋ˨˩˦
dẫu	jɤ̆w˨˩˦
dẫy	jɤ̆j˨˩˦
dậm	jɤ̆m˨˩˨
dận	jɤ̆ŋ˨˩˨
dập	jɤ̆p˨˩˨
dật	jɤ̆k˨˩˨
dậu	jɤ̆w˨˩˨
dậy	dɑ˧
dậy	jai˧
dậy	jɤ̆j˨˩˨
dắm	jăm˦˥
dắt	jăk˦˥
dằn	jăŋ˧˨
dằng	jăŋ˧˨
dẳn	jăŋ˨˩˦
dẳng	jăŋ˨˩˦
dặc	jăk˨˩˨
dặm	jăm˨˩˨
dặn	jăŋ˨˩˨
dặng	jăŋ˨˩˨
dặt	jăk˨˩˨
dẹp	jɛp˨˩˨
dẹt	jɛt˨˩˨
dẻ	jɛ˨˩˦
dẻo	jeo˨˩˦
dẽ	jɛ˨˩˦
dế	je˦˥
dề	je˧˨
dền	jen˧˨
dềnh	jen˧˨
dể	je˨˩˦
dễ	je˨˩˦
dệnh	jen˨˩˨
dệt	jet˨˩˨
dỉ	ji˨˩˦
dị	ji˨˩˨
dịch	dɤ˨˩˨
dịch	jit˨˩˨
dịch	ʃs˨˩˨
dịp	jip˨˩˨
dịu	jiw˨˩˨
dọ	jɔ˨˩˨
dọa	jwa˨˩˨
dọc	jɔkp˨˩˨
dọn	jɔŋm˨˩˨
dốc	jokp˦˥
dối	joj˦˥
dốt	jokp˦˥
dồi	joj˧˨
dồn	joŋm˧˨
dồng	joŋm˧˨
dỗ	jo˨˩˦
dội	joj˨˩˨
dộng	joŋm˨˩˨
dột	jokp˨˩˨
dớ	jɤ˦˥
dớn	jɤŋ˦˥
dời	jɤj˧˨
dờn	jɤŋ˧˨
dở	jɤ˨˩˦
dỡ	jɤ˨˩˦
dụ	ju˨˩˨
dụ	ni˨˩˨
dục	jukp˨˩˨
dụm	jum˨˩˨
dụng	juŋm˨˩˨
dứa	jɯə˦˥
dức	jɯk˦˥
dứt	jɯk˦˥
dứt	zit˧
dừ	jɯ˧˨
dừa	jɯə˧˨
dừng	jɯŋ˧˨
dử	jɯ˨˩˦
dửng	jɯŋ˨˩˦
dữ	jɯ˨˩˦
dự	jɯ˨˩˨
dựa	jɯə˨˩˨
dựng	jɯŋ˨˩˨
e	ɛ˧˧
em	ɛmɲe˧
em	ɛm˦˧
em	ɛm˧
em	ɛm˧˧
en	ɛŋ˧˧
eng	ɛŋ˧˧
eo	eo˧˧
ga	ɣa˧˧
gai	ɣaj˧˧
gan	ɣaŋ˧˧
gang	ɣaŋ˧˧
ganh	ɣan˧˧
gau	ɣăw˧˧
gay	ɣăj˧˧
ghe	ɣɛ˧˧
ghen	ɣɛŋ˧˧
ghi	ɣi˧˧
ghim	ɣim˧˧
ghiền	ɣiəŋ˧˨
ghè	ɣɛ˧˨
ghèn	ɣɛŋ˧˨
ghé	ɣɛ˦˥
ghép	ɣɛp˦˥
ghét	ɣɛt˦˥
ghê	ɣe˧˧
ghẹ	ɣɛ˨˩˨
ghẹo	ɣeo˨˩˨
ghẻ	ɣɛ˨˩˦
ghế	ɣe˦˥
ghểnh	ɣen˨˩˦
gi	ji˧˧
gia	ja˧˧
giai	jaj˧˧
giam	jam˧˧
gian	jaŋ˧˧
giang	jaŋ˧˧
giao	jaw˧˧
giau	jăw˧˧
gieo	jeo˧˧
gio	jɔ˧˧
gion	jɔŋm˧˧
giong	jɔŋm˧˧
giu	ju˧˧
giun	juŋm˧˧
già	ja˧˨
già	za˨˩
giàn	jaŋ˧˨
giàng	jaŋ˧˨
giành	jan˧˨
giàu	jăw˧˨
giày	jăj˧˨
giá	ja˦˥
giá	zaː˧˥
giác	jak˦˥
giám	jam˦˥
gián	jaŋ˦˥
giáng	jaŋ˦˥
giáo	jaw˦˥
giáp	jap˦˥
giát	jat˦˥
giâu	jɤ̆w˧˧
giây	jɤ̆j˧˧
giã	ja˨˩˦
giãi	jaj˨˩˦
giãn	jaŋ˨˩˦
giãy	jăj˨˩˦
gièm	jɛm˧˨
giéo	jeo˦˥
giêng	jen˧˧
giò	jɔ˧˨
giòi	jɔj˧˨
giòn	jɔŋm˧˨
gió	jɔ˦˥
gió	zɔkɛ˧˥
gióng	jɔŋm˦˥
giôn	joŋm˧˧
giông	joŋm˧˧
giùi	juj˧˨
giùm	jum˧˨
giúi	juj˦˥
giúp	jup˦˥
giúp	zupː˧˥
giăm	jăm˧˧
giăng	jăŋ˧˧
giũ	ju˨˩˦
giũa	juə˨˩˦
giơ	jɤ˧˧
giương	jɯəŋ˧˧
giường	jɯəŋ˧˨
giạc	jak˨˩˨
giạng	jaŋ˨˩˨
giạt	jat˨˩˨
giả	ja˨˩˦
giải	jaj˨˩˦
giảm	jam˨˩˦
giản	jaŋ˨˩˦
giảng	jaŋ˨˩˦
giảo	jaw˨˩˦
giảu	jăw˨˩˦
giấc	jɤ̆k˦˥
giấc	zɨːk˧
giấm	jɤ̆m˦˥
giấn	jɤ̆ŋ˦˥
giấp	jɤ̆p˦˥
giấu	jɤ̆w˦˥
giấy	jɤ̆j˦˥
giầm	jɤ̆m˧˨
giần	jɤ̆ŋ˧˨
giầu	jɤ̆w˧˨
giầy	jɤ̆j˧˨
giẫm	jɤ̆m˨˩˦
giẫy	jɤ̆j˨˩˦
giậm	jɤ̆m˨˩˨
giận	jɤ̆ŋ˨˩˨
giập	jɤ̆p˨˩˨
giật	jɤ̆k˨˩˨
giật	kɛt˧
giật	zɨp˧
giật	zˈat˧
giậu	jɤ̆w˨˩˨
giắm	jăm˦˥
giắng	jăŋ˦˥
giắt	jăk˦˥
giằn	jăŋ˧˨
giằng	jăŋ˧˨
giặc	jăk˨˩˨
giặt	jăk˨˩˨
giẹo	jeo˨˩˨
giẹp	jɛp˨˩˨
giẻ	jɛ˨˩˦
giếc	jet˦˥
giếng	jen˦˥
giết	jet˦˥
giền	jen˧˨
giềng	jen˧˨
giễu	jɛu˨˩˦
giọng	jɔŋm˨˩˨
giọt	jɔkp˨˩˨
giỏ	jɔ˨˩˦
giỏi	jɔj˨˩˦
giỏng	jɔŋm˨˩˦
giối	joj˦˥
giống	joŋm˦˥
giồi	joj˧˨
giồng	joŋm˧˨
giỗ	jo˨˩˦
giội	joj˨˩˨
giới	jɤj˦˥
giờ	jɤ˧˨
giời	jɤj˧˨
giở	jɤ˨˩˦
giục	jukp˨˩˨
giữ	jɯ˨˩˦
giữa	jɯə˨˩˦
gom	ɣɔm˧˧
goá	ɣwa˦˥
goòng	ɣɔŋm˧˨
guốc	ɣuək˦˥
guồng	ɣuəŋ˧˨
guột	ɣuək˨˩˨
gà	ɣa˧˨
gài	ɣaj˧˨
gàn	ɣaŋ˧˨
gào	ɣaw˧˨
gàu	ɣăw˧˨
gày	ɣăj˧˨
gá	ɣa˦˥
gác	ɣak˦˥
gái	ɣaj˦˥
gán	ɣaŋ˦˥
gánh	ɣan˦˥
gáo	ɣaw˦˥
gáy	ɣăj˦˥
gâm	ɣɤ̆m˧˧
gân	ɣɤ̆ŋ˧˧
gâu	ɣɤ̆w˧˧
gây	ɣɤ̆j˧˧
gãi	ɣaj˨˩˦
gãy	ɣăj˨˩˦
gì	ɣi˧˨
gìn	zin˧˨
gò	ɣɔ˧˨
gòn	ɣɔŋm˧˨
gòn-gia	ɣɔŋm˧˨-ja˧˧
góa	ɣwa˦˥
góc	ɣɔkp˦˥
gói	ɣɔj˦˥
góp	ɣɔp˦˥
gót	ɣɔkp˦˥
gô	ɣo˧˧
gôm	ɣom˧˧
gông	ɣoŋm˧˧
gõ	ɣɔ˨˩˦
gùn	ɣuŋm˧˨
gút	ɣukp˦˥
găm	ɣăm˧˧
găn	ɣăŋ˧˧
găng	ɣăŋ˧˧
gươm	ɣɯm˧˧
gương	ɣɯəŋ˧˧
gườm	ɣɯm˧˨
gường	ɣɯəŋ˧˨
gượng	ɣɯəŋ˨˩˨
gạ	ɣa˨˩˨
gạc	ɣak˨˩˨
gạch	ɣat˨˩˨
gạn	ɣaŋ˨˩˨
gạo	ɣaw˨˩˨
gạt	ɣat˨˩˨
gả	ɣa˨˩˦
gảy	ɣăj˨˩˦
gấm	ɣɤ̆m˦˥
gấp	ɣɤ̆p˦˥
gấu	ɣɤ̆w˦˥
gấy	ɣɤ̆j˦˥
gầm	ɣɤ̆m˧˨
gần	ɣɤ̆ŋ˧˨
gầu	ɣɤ̆w˧˨
gầy	ɣɤ̆j˧˨
gẩy	ɣɤ̆j˨˩˦
gẫu	ɣɤ̆w˨˩˦
gẫy	ɣɤ̆j˨˩˦
gậm	ɣɤ̆m˨˩˨
gập	ɣɤ̆p˨˩˨
gật	ɣɤ̆k˨˩˨
gậy	ɣɤ̆j˨˩˨
gắm	ɣăm˦˥
gắn	ɣăŋ˦˥
gắng	ɣăŋ˦˥
gắp	ɣăp˦˥
gắt	ɣăk˦˥
gằm	ɣăm˧˨
gằn	ɣăŋ˧˨
gặc	ɣăk˨˩˨
gặm	ɣăm˨˩˨
gặng	ɣăŋ˨˩˨
gặp	ɣăp˨˩˨
gặt	ɣăk˨˩˨
gỉ	ɣi˨˩˦
gọ	ɣɔ˨˩˨
gọi	ɣɔj˨˩˨
gọn	ɣɔŋm˨˩˨
gọng	ɣɔŋm˨˩˨
gọt	ɣɔkp˨˩˨
gỏi	ɣɔj˨˩˦
gốc	ɣokp˦˥
gối	ɣoj˦˥
gồ	ɣo˧˨
gồng	ɣoŋm˧˨
gỗ	ɣo˨˩˦
gội	ɣoj˨˩˨
gộp	ɣop˨˩˨
gột	ɣokp˨˩˨
gớm	ɣɤm˦˥
gờ	ɣɤ˧˨
gờm	ɣɤm˧˨
gờn	ɣɤŋ˧˨
gở	ɣɤ˨˩˦
gởi	ɣɤj˨˩˦
gỡ	ɣɤ˨˩˦
gợi	ɣɤj˨˩˨
gợn	ɣɤŋ˨˩˨
gục	ɣukp˨˩˨
gừ	ɣɯ˧˨
gừng	ɣɯŋ˧˨
gửi	ɣɯj˨˩˦
ha	ha˧˧
hai	haj˧˧
ham	ham˧˧
han	haŋ˧˧
hang	haŋ˧˧
hanh	han˧˧
hao	haw˧˧
hau	hăw˧˧
hay	hăj˧˧
hen	hɛŋ˧˧
heo	heo˧˧
hi	hi˧˧
him	him˧˧
hinh	hin˧˧
hiu	hiw˧˧
hiên	hiəŋ˧˧
hiêng	hiəŋ˧˧
hiếm	him˦˥
hiến	hiəŋ˦˥
hiếp	hip˦˥
hiếu	hiəw˦˥
hiềm	him˧˨
hiền	hiəŋ˧˨
hiểm	him˨˩˦
hiển	hiəŋ˨˩˦
hiểu	hiəw˨˩˦
hiện	hiəŋ˨˩˨
hiệp	hip˨˩˨
hiệu	hiəw˨˩˨
ho	hɔ˧˧
hoa	hwa˧˧
hoan	hwaŋ˧˧
hoang	hwaŋ˧˧
hoay	hwăj˧˧
hoe	hwe˧˧
hoen	hwen˧˧
hoi	hɔj˧˧
hom	hɔm˧˧
hon	hɔŋm˧˧
hong	hɔŋm˧˧
hoà	hwa˧˨
hoài	hwaj˧˨
hoàn	hwaŋ˧˨
hoàng	hwaŋ˧˨
hoành	hwan˧˨
hoá	hwa˦˥
hoác	hwak˦˥
hoán	hwaŋ˦˥
hoãn	hwaŋ˨˩˦
hoè	hwe˧˨
hoăm	hwăm˧˧
hoăng	hwăŋ˧˧
hoạ	hwa˨˩˨
hoạch	hwat˨˩˨
hoại	hwaj˨˩˨
hoạn	hwaŋ˨˩˨
hoạnh	hwan˨˩˨
hoạt	hwat˨˩˨
hoả	hwa˨˩˦
hoải	hwaj˨˩˦
hoảng	hwaŋ˨˩˦
hoắc	hwăk˦˥
hoắm	hwăm˦˥
hoặc	hwăk˨˩˨
hoặc	hɑːk˧
hoặc	hɔːk˧
hoặn	hwăŋ˨˩˨
hu	hu˧˧
hui	huj˧˧
hum	hum˧˧
hun	huŋm˧˧
hung	huŋm˧˧
huy	hwi˧˧
huynh	hwin˧˧
huyên	hwiəŋ˧˧
huyết	hwiək˦˥
huyền	hwiəŋ˧˨
huyễn	hwiəŋ˨˩˦
huyện	hwiəŋ˨˩˨
huyệt	hwiək˨˩˨
huân	hwɤ̆ŋ˧˧
huê	hwe˧˧
huênh	hwen˧˧
huý	hwi˦˥
huých	hwit˦˥
huýt	hwit˦˥
huơ	huə˧˧
huấn	hwɤ̆ŋ˦˥
huếch	hwet˦˥
huề	hwe˧˨
huệ	hwe˨˩˨
huống	huəŋ˦˥
huỳnh	hwin˧˨
huỵch	hwit˨˩˨
huỷ	hwi˨˩˦
hy	hi˧˧
hà	hani˨˩
hà	haːd˨˩
hà	haː˨˩
hà	ha˧˨
hà	ha˨˩
hà-đông	ha˧˨-doŋm˧˧
hài	haj˧˨
hàm	ham˧˨
hàn	haŋ˧˨
hàng	haŋ˧˨
hàng	hæŋ˧˨˩
hành	han˧˨
hào	haw˧˨
há	ha˦˥
hách	hat˦˥
hái	haj˦˥
hám	ham˦˥
hán	haŋ˦˥
hánh	han˦˥
háo	haw˦˥
hát	hat˦˥
háu	hăw˦˥
háy	hăj˦˥
hâm	hɤ̆m˧˧
hân	hɤ̆ŋ˧˧
hây	hɤ̆j˧˧
hãi	haj˨˩˦
hãm	ham˨˩˦
hãn	haŋ˨˩˦
hãng	haŋ˨˩˦
hãnh	han˨˩˦
hão	haw˨˩˦
hãy	hăj˨˩˦
hè	hɛ˧˨
hèm	hɛm˧˨
hèn	hɛŋ˧˨
hèo	heo˧˨
hé	hɛ˦˥
héc	hɛk˦˥
héo	heo˦˥
hét	hɛt˦˥
hên	hen˧˧
hênh	hen˧˧
hì	hi˧˨
hình	hin˧˨
hí	hi˦˥
híp	hip˦˥
hít	hit˦˥
hò	hɔ˧˨
hòa	hwa˧˨
hòm	hɔm˧˨
hòn	hɔŋm˧˨
hòng	hɔŋm˧˨
hó	hɔ˦˥
hóa	hwa˦˥
hóc	hɔkp˦˥
hói	hɔj˦˥
hóm	hɔm˦˥
hóng	hɔŋm˦˥
hóp	hɔp˦˥
hót	hɔkp˦˥
hô	ho˧˧
hôi	hoj˧˧
hôm	hom˧˧
hôn	hoŋm˧˧
hông	hoŋm˧˧
hù	hu˧˨
hùi	huj˧˨
hùm	hum˧˨
hùn	huŋm˧˨
hùng	huŋm˧˨
hú	hu˦˥
húc	hukp˦˥
húng	huŋm˦˥
húp	hup˦˥
hút	hukp˦˥
húy	huj˦˥
hăm	hăm˧˧
hăng	hăŋ˧˧
hũ	huː˧˥˧
hũ	hu˨˩˦
hơ	hɤ˧˧
hơi	hɤj˧˧
hơn	hɤŋ˧˧
hư	hɯ˧˧
hưng	hɯŋ˧˧
hưu	hɯw˧˧
hương	hɯəŋ˧˧
hươu	hɯəw˧˧
hướng	hɯəŋ˦˥
hưởng	hɯəŋ˨˩˦
hạ	ha˨˩˨
hạc	hak˨˩˨
hạch	hat˨˩˨
hại	haj˨˩˨
hạm	ham˨˩˨
hạn	haŋ˨˩˨
hạng	haŋ˨˩˨
hạnh	han˨˩˨
hạo	haw˨˩˨
hạp	hap˨˩˨
hạt	hat˨˩˨
hả	ha˨˩˦
hải	haj˨˩˦
hảo	haw˨˩˦
hấm	hɤ̆m˦˥
hấn	hɤ̆ŋ˦˥
hấp	hɤ̆p˦˥
hất	hɤ̆k˦˥
hầm	hɤ̆m˧˨
hầu	hɤ̆w˧˨
hẩm	hɤ̆m˨˩˦
hẩu	hɤ̆w˨˩˦
hẫng	hɤ̆ŋ˨˩˦
hậm	hɤ̆m˨˩˨
hận	hɤ̆ŋ˨˩˨
hậu	hɤ̆w˨˩˨
hắc	hăk˦˥
hắn	hăŋ˦˥
hắng	hăŋ˦˥
hắt	hăk˦˥
hằm	hăm˧˨
hằn	hăŋ˧˨
hằng	hăŋ˧˨
hẳn	hăŋ˨˩˦
hặc	hăk˨˩˨
hặm	hăm˨˩˨
hẹn	hɛŋ˨˩˨
hẹp	hɛp˨˩˨
hẻm	hɛm˨˩˦
hẻo	heo˨˩˦
hếch	het˦˥
hết	het˦˥
hề	hebi˧
hề	he˧˨
hềnh	hen˧˨
hể	he˨˩˦
hểnh	hen˨˩˦
hểu	hɛu˨˩˦
hệ	he˨˩˨
hệch	het˨˩˨
hỉ	hi˨˩˦
hỉnh	hin˨˩˦
hịch	hit˨˩˨
họ	hɔ˨˩˨
họa	hwa˨˩˨
học	hɔkp˨˩˨
họng	hɔŋm˨˩˨
họp	hɔp˨˩˨
hỏa	hwa˨˩˦
hỏi	hɔj˨˩˦
hỏm	hɔm˨˩˦
hỏn	hɔŋm˨˩˦
hỏng	hɔŋm˨˩˦
hố	ho˦˥
hốc	hokp˦˥
hối	hoj˦˥
hống	hoŋm˦˥
hốt	hokp˦˥
hồ	ho˧˨
hồ	hɔː˧
hồi	hoj˧˨
hồn	hoŋm˧˨
hồng	hoŋm˧˨
hổ	ho˨˩˦
hổi	hoj˨˩˦
hổm	hom˨˩˦
hổn	hoŋm˨˩˦
hổng	hoŋm˨˩˦
hỗ	ho˨˩˦
hỗn	hoŋm˨˩˦
hỗng	hoŋm˨˩˦
hộ	ho˨˩˨
hộc	hokp˨˩˨
hội	hoj˨˩˨
hộn	hoŋm˨˩˨
hộp	hop˨˩˨
hột	hokp˨˩˨
hớ	hɤ˦˥
hớn	hɤŋ˦˥
hớp	hɤp˦˥
hớt	hɤk˦˥
hờ	hɤ˧˨
hời	hɤj˧˨
hờn	hɤŋ˧˨
hở	hɤ˨˩˦
hởi	hɤj˨˩˦
hỡi	hɤj˨˩˦
hợm	hɤm˨˩˨
hợp	hɤp˨˩˨
hục	hukp˨˩˨
hụp	hup˨˩˨
hụt	hukp˨˩˨
hủ	hu˨˩˦
hủn	huŋm˨˩˦
hủng	huŋm˨˩˦
hủy	huj˨˩˦
hứa	hɯə˦˥
hứng	hɯŋ˦˥
hừ	hɯ˧˨
hừng	hɯŋ˧˨
hửng	hɯŋ˨˩˦
hững	hɯŋ˨˩˦
hữu	hɯw˨˩˦
hực	hɯk˨˩˨
i	i˧˧
i-ôn	i˧˧-oŋm˧˧
ic	it˧˧
im	im˧˧
in	in˧
in	in˧˧
inh	in˧˧
iu	iw˧˧
ka	ka˧˧
ka-li	ka˧˧-li˧˧
ke	kɛ˧˧
kem	kɛm˧˧
ken	kɛŋ˧˧
keng	kɛŋ˧˧
keo	keo˧˧
kha	xa˧˧
khai	xaj˧˧
kham	xam˧˧
khan	xaŋ˧˧
khang	xaŋ˧˧
khanh	xan˧˧
khao	xaw˧˧
khay	xăj˧˧
khe	xɛ˧˧
khem	xɛm˧˧
khen	xɛŋ˧˧
kheo	xeo˧˧
khi	xiː˧
khi	xi˧˧
khin	xin˧˧
khinh	xin˧˧
khiêm	xim˧˧
khiên	xiəŋ˧˧
khiêng	xiəŋ˧˧
khiêu	xiəw˧˧
khiếm	xim˦˥
khiếp	xip˦˥
khiếu	xiəw˦˥
khiển	xiəŋ˨˩˦
kho	xɔ˧˧
khoa	xwa˧˧
khoai	xwaj˧˧
khoan	xwaŋ˧˧
khoang	xwaŋ˧˧
khoanh	xwan˧˧
khoe	xwe˧˧
khoen	xwen˧˧
khoeo	xwew˧˧
khom	xɔm˧˧
khoành	xwan˧˨
khoá	xwa˦˥
khoác	xwak˦˥
khoái	xwaj˦˥
khoán	xwaŋ˦˥
khoáng	xwaŋ˦˥
khoát	xwat˦˥
khoèo	xwew˧˨
khoé	xwe˦˥
khoét	xwet˦˥
khoăm	xwăm˧˧
khoả	xwa˨˩˦
khoản	xwaŋ˨˩˦
khoảng	xwaŋ˨˩˦
khoảnh	xwan˨˩˦
khoằm	xwăm˧˨
khoẻ	xwe˨˩˦
khu	xu˧˧
khua	xuə˧˧
khum	xum˧˧
khung	xuŋm˧˧
khuy	xwi˧˧
khuya	xwiə˧˧
khuynh	xwin˧˧
khuyên	xwiəŋ˧˧
khuyến	xwiəŋ˦˥
khuyết	xwiək˦˥
khuyển	xwiəŋ˨˩˦
khuân	xwɤ̆ŋ˧˧
khuây	xwɤ̆j˧˧
khuê	xwe˧˧
khuôn	xuəŋ˧˧
khuông	xuəŋ˧˧
khuất	xwɤ̆k˦˥
khuấy	xwɤ̆j˦˥
khuẩn	xwɤ̆ŋ˨˩˦
khuếch	xwet˦˥
khuờ	xuə˧˨
khuỳnh	xwin˧˨
khyển	xiɛŋ˨˩˦
khà	xa˧˨
khàn	xaŋ˧˨
khành	xan˧˨
khá	xa˦˥
khác	xak˦˥
khác	xak˧˥
khách	xat˦˥
khái	xaj˦˥
khám	xam˦˥
khán	xaŋ˦˥
kháng	xaŋ˦˥
khánh	xan˦˥
khánh-hạ	xan˦˥-ha˨˩˨
khát	xat˦˥
kháu	xăw˦˥
khâm	xɤ̆m˧˧
khâng	xɤ̆ŋ˧˧
khâu	xɤ̆w˧˧
khè	xɛ˧˨
khèn	xɛŋ˧˨
khèng	xɛŋ˧˨
khé	xɛ˦˥
khéo	xeo˦˥
khép	xɛp˦˥
khét	xɛt˦˥
khê	xe˧˧
khêu	xɛu˧˧
khì	xi˧˨
khìn	xin˧˨
khí	xi˦˥
khía	xiə˦˥
khích	xit˦˥
khít	xit˦˥
khò	xɔ˧˨
khòe	xwe˧˨
khòm	xɔm˧˨
khòng	xɔŋm˧˨
khó	xɔːr˧˥
khó	xɔ˦˥
khóa	xwa˦˥
khóc	xɔkp˦˥
khóe	xwe˦˥
khói	xɔj˦˥
khô	xo˧˧
khôi	xoj˧˧
khôn	xoŋm˧˧
không	xoŋm˧˧
khù	xu˧˨
khùng	xuŋm˧˨
khú	xu˦˥
khúc	xukp˦˥
khúm	xum˦˥
khúng	xuŋm˦˥
khăm	xăm˧˧
khăn	xăŋ˧˧
khăng	xăŋ˧˧
khơ	xɤ˧˧
khơ-me	xɤ˧˧-mɛ˧˧
khơ-mú	xɤ˧˧-mu˦˥
khơi	xɤj˧˧
khư	xɯ˧˧
khươm	xɯm˧˧
khước	xɯək˦˥
khướt	xɯək˦˥
khướu	xɯəw˦˥
khạ	xa˨˩˨
khạc	xak˨˩˨
khạng	xaŋ˨˩˨
khả	xa˨˩˦
khảch	xat˨˩˦
khải	xaj˨˩˦
khảm	xam˨˩˦
khản	xaŋ˨˩˦
khảng	xaŋ˨˩˦
khảnh	xan˨˩˦
khảo	xaw˨˩˦
khấm	xɤ̆m˦˥
khấn	xɤ̆ŋ˦˥
khấp	xɤ̆p˦˥
khất	xɤ̆k˦˥
khấu	xɤ̆w˦˥
khầng	xɤ̆ŋ˧˨
khẩn	xɤ̆ŋ˨˩˦
khẩu	xɤ̆w˨˩˦
khậm	xɤ̆m˨˩˨
khập	xɤ̆p˨˩˨
khật	xɤ̆k˨˩˨
khắc	xăk˦˥
khắm	xăm˦˥
khắn	xăŋ˦˥
khắng	xăŋ˦˥
khắp	xăp˦˥
khắt	xăk˦˥
khằng	xăŋ˧˨
khẳn	xăŋ˨˩˦
khẳng	xăŋ˨˩˦
khặc	xăk˨˩˨
khẻ	xɛ˨˩˦
khẽ	xɛ˨˩˦
khế	xe˦˥
khề	xe˧˨
khềnh	xen˧˨
khều	xɛu˧˨
khểnh	xen˨˩˦
khễnh	xen˨˩˦
khệ	xe˨˩˨
khệnh	xen˨˩˨
khỉ	xi˨˩˦
khịt	xit˨˩˨
khọm	xɔm˨˩˨
khỏa	xwa˨˩˦
khỏe	xwe˨˩˦
khỏi	xɔj˨˩˦
khố	xo˦˥
khốc	xokp˦˥
khối	xoj˦˥
khốn	xoŋm˦˥
khống	xoŋm˦˥
khổ	xo˨˩˦
khổn	xoŋm˨˩˦
khổng	xoŋm˨˩˦
khớp	xɤp˦˥
khờ	xɤ˧˨
khởi	xɤj˨˩˦
khụ	xu˨˩˨
khục	xukp˨˩˨
khụng	xuŋm˨˩˨
khụt	xukp˨˩˨
khủ	xu˨˩˦
khủng	xuŋm˨˩˦
khứ	xɯ˦˥
khứu	xɯw˦˥
khừ	xɯ˧˨
khử	xɯ˨˩˦
khự	xɯ˨˩˨
ki	ki˧˧
ki-lô	ki˧˧-lo˧˧
ki-lô-oát	ki˧˧-lo˧˧-wat˦˥
ki-tô	ki˧˧-to˧˧
kia	kiə˧˧
kim	kim˧˧
kin	kin˧˧
kinh	kin˧˧
kiêm	kim˧˧
kiên	kiəŋ˧˧
kiêng	kiəŋ˧˧
kiêu	kiəw˧˧
kiếm	kim˦˥
kiến	kiəŋ˦˥
kiếp	kip˦˥
kiết	kiək˦˥
kiếu	kiəw˦˥
kiềm	kim˧˨
kiền	kiəŋ˧˨
kiềng	kiəŋ˧˨
kiều	kiəw˧˨
kiểm	kim˨˩˦
kiểu	kiəw˨˩˦
kiệm	kim˨˩˨
kiện	kiəŋ˨˩˨
kiệt	kiək˨˩˨
kiệu	kiəw˨˩˨
ky	ki˧˧
kè	kɛ˧˨
kèm	kɛm˧˨
kèn	kɛŋ˧˨
kèo	keo˧˨
ké	kɛ˦˥
kém	kɛm˦˥
kén	kɛŋ˦˥
kéo	keo˦˥
kép	kɛp˦˥
két	kɛt˦˥
kê	ke˧˧
kên	ken˧˧
kênh	ken˧˧
kêu	kɛu˧˧
kì	ki˧˨
kìa	kiə˧˨
kìm	kim˧˨
kìn	kin˧˨
kình	kin˧˨
kí	ki˦˥
kích	kit˦˥
kín	kin˦˥
kính	kin˦˥
kíp	kip˦˥
kíu	kiw˦˥
ký	kiː˧˥
ký	ki˦˥
kĩ	ki˨˩˦
kĩu	kiw˨˩˦
kẹn	kɛŋ˨˩˨
kẹo	keo˨˩˨
kẹp	kɛp˨˩˨
kẹt	kɛt˨˩˨
kẻ	kɛ˨˩˦
kẻm	kɛm˨˩˦
kẻo	keo˨˩˦
kẽ	kɛ˨˩˦
kẽm	kɛm˨˩˦
kẽo	keo˨˩˦
kế	ke˦˥
kếch	ket˦˥
kết	ket˦˥
kề	ke˧˨
kềm	kem˧˨
kền	ken˧˨
kềnh	ken˧˨
kể	ke˨˩˦
kễnh	ken˨˩˦
kệ	ke˨˩˨
kệch	ket˨˩˨
kỉ	ki˨˩˦
kị	ki˨˩˨
kịch	kit˨˩˨
kịp	kip˨˩˨
kỳ	ki˧˨
kỵ	ki˨˩˨
kỷ	ki˨˩˦
kỹ	ki˨˩˦
la	la˧˧
la-mã	la˧˧-ma˨˩˦
la-tinh	la˧˧-tin˧˧
la-tê-rít	la˧˧-te˧˧-ʐit˦˥
lai	laj˧˧
lai-ly	laj˧˧-li˧˧
lai-đa	laj˧˧-da˧˧
lam	lam˧˧
lan	laŋ˧˧
lang	laŋ˧˧
lanh	lan˧˧
lao	law˧
lao	law˧˧
lau	lăw˧˧
lay	lăj˧˧
le	lɛ˧˧
lem	lɛm˧˧
len	lɛŋ˧˧
leng	lɛŋ˧˧
leo	leo˧˧
li	li˧˧
lia	liə˧˧
lim	lim˧˧
linh	lin˧˧
linh	lɪŋ˧˧
liu	liw˧˧
liêm	lim˧˧
liên	liəŋ˧˧
liêng	liəŋ˧˧
liêu	liəw˧˧
liếc	liək˦˥
liếm	lim˦˥
liến	liəŋ˦˥
liếp	lip˦˥
liếu	liəw˦˥
liềm	lim˧˨
liền	liəŋ˧˨
liều	liəw˧˨
liểng	liəŋ˨˩˦
liễu	liəw˨˩˦
liệm	lim˨˩˨
liệt	liək˨˩˨
liệu	liəw˨˩˨
lo	lɔː˧
lo	lɔ˧˧
loa	lwa˧˧
loai	lwaj˧˧
loan	lwaŋ˧˧
loang	lwaŋ˧˧
loanh	lwan˧˧
loay	lwăj˧˧
loe	lwe˧˧
loen	lwen˧˧
loi	lɔj˧˧
lom	lɔm˧˧
lon	lɔŋm˧˧
long	lɔŋm˧˧
loong	lɔŋm˧˧
loà	lwa˧˨
loài	lwaj˧˨
loàng	lwaŋ˧˨
loá	lwa˦˥
loáng	lwaŋ˦˥
loáo	lwaw˦˥
loát	lwat˦˥
loáy	lwăj˦˥
loã	lwa˨˩˦
loãng	lwaŋ˨˩˦
loè	lwe˧˨
loé	lwe˦˥
loét	lwet˦˥
loăn	lwăŋ˧˧
loăng	lwăŋ˧˧
loạc	lwak˨˩˨
loạch	lwat˨˩˨
loại	lwaj˨˩˨
loạn	lwaŋ˨˩˨
loạng	lwaŋ˨˩˨
loạt	lwat˨˩˨
loả	lwa˨˩˦
loảng	lwaŋ˨˩˦
loắn	lwăŋ˦˥
loắt	lwăk˦˥
loằn	lwăŋ˧˨
loằng	lwăŋ˧˨
loẹt	lwet˨˩˨
loẻng	lwen˨˩˦
loẻo	lwew˨˩˦
lu	lu˧˧
lua	luə˧˧
lui	luj˧˧
lum	lum˧˧
lung	luŋm˧˧
luy	lwi˧˧
luyên	lwiəŋ˧˧
luyến	lwiəŋ˦˥
luyện	lwiəŋ˨˩˨
luân	lwɤ̆ŋ˧˧
luôm	lum˧˧
luôn	luəŋ˧˧
luông	luəŋ˧˧
luýnh	lwin˦˥
luấn	lwɤ̆ŋ˦˥
luẩn	lwɤ̆ŋ˨˩˦
luận	lwɤ̆ŋ˨˩˨
luật	lwɤ̆k˨˩˨
luống	luəŋ˦˥
luốt	luək˦˥
luồn	luəŋ˧˨
luồng	luəŋ˧˨
luộm	lum˨˩˨
luỵ	lwi˨˩˨
luỹ	lwi˨˩˦
ly	li˧˧
là	la-˨˩
là	laː˨˩
là	la˧˨
là	la˨˩
lài	laj˧˨
làm	lam˧˨
làn	laŋ˧˨
làng	laŋ˧˨
lành	lan˧˨
lào	law˧˨
làu	lăw˧˨
lày	lăj˧˨
lá	la˦˥
lác	lak˦˥
lách	lat˦˥
lái	laj˦˥
lán	laŋ˦˥
láng	laŋ˦˥
lánh	lan˦˥
láo	law˦˥
láp	lap˦˥
lát	lat˦˥
láu	lăw˦˥
láy	lăj˦˥
lâm	lɤ̆m˧˧
lân	lɤ̆ŋ˧˧
lâng	lɤ̆ŋ˧˧
lâp	lɤ̆p˧˧
lâu	lɤ̆w˧˧
lây	lɤ̆j˧˧
lã	la˨˩˦
lãi	laj˨˩˦
lãm	lam˨˩˦
lãn	laŋ˨˩˦
lãng	laŋ˨˩˦
lãnh	lan˨˩˦
lão	law˨˩˦
lè	lɛ˧˨
lèm	lɛm˧˨
lèn	lɛŋ˧˨
lèo	leo˧˨
lé	lɛ˦˥
lém	lɛm˦˥
lén	lɛŋ˦˥
léng	lɛŋ˦˥
léo	leo˦˥
lép	lɛp˦˥
lét	lɛt˦˥
lê	le˧˧
lên	len˧˧
lênh	len˧˧
lêu	lɛu˧˧
lì	li˧˨
lìa	liə˧˨
lìm	lim˧˨
lình	lin˧˨
lí	li˦˥
lích	lit˦˥
lính	lin˦˥
líp	lip˦˥
lít	lit˦˥
líu	liw˦˥
lò	lɔ˧˨
lòa	lwa˧˨
lòe	lwe˧˨
lòi	lɔj˧˨
lòm	lɔm˧˨
lòn	lɔŋm˧˨
lòng	lɔŋm˧˨
ló	lɔ˦˥
lóc	lɔkp˦˥
lóm	lɔm˦˥
lóng	lɔŋm˦˥
lóp	lɔp˦˥
lót	lɔkp˦˥
lô	lo˧˧
lô-gích	lo˧˧-ɣit˦˥
lôi	loj˧˧
lôm	lom˧˧
lông	loŋm˧˧
lõ	lɔ˨˩˦
lõa	lwa˨˩˦
lõi	lɔj˨˩˦
lõm	lɔm˨˩˦
lõng	lɔŋm˨˩˦
lù	lu˧˨
lùi	luj˧˨
lùm	lum˧˨
lùn	luŋm˧˨
lùng	luŋm˧˨
lú	lu˦˥
lúa	luə˦˥
lúc	lukp˦˥
lúi	luj˦˥
lúm	lum˦˥
lún	luŋm˦˥
lúng	luŋm˦˥
lúp	lup˦˥
lút	lukp˦˥
lý	li˦˥
lăm	lăm˧˧
lăn	lăŋ˧˧
lăng	lăŋ˧˧
lĩnh	lin˨˩˦
lũ	luː˧˥˧
lũ	lu˨˩˦
lũm	lum˨˩˦
lũn	luŋm˨˩˦
lũng	luŋm˨˩˦
lũy	luj˨˩˦
lơ	lɤ˧˧
lơi	lɤj˧˧
lơn	lɤŋ˧˧
lư	lɯ˧˧
lưa	lɯə˧˧
lưng	lɯŋ˧˧
lưu	lɯw˧˧
lươm	lɯm˧˧
lươn	lɯəŋ˧˧
lương	lɯəŋ˧˧
lưới	lɯəj˦˥
lướng	lɯəŋ˦˥
lướp	lɯp˦˥
lướt	lɯək˦˥
lướu	lɯəw˦˥
lười	lɯəj˧˨
lườm	lɯm˧˨
lường	lɯəŋ˧˨
lưởi	lɯəj˨˩˦
lưỡi	lɯəj˨˩˦
lưỡng	lɯəŋ˨˩˦
lược	lɯək˨˩˨
lượm	lɯm˨˩˨
lượn	lɯəŋ˨˩˨
lượng	lɯəŋ˨˩˨
lượt	lɯək˨˩˨
lạ	la˨˩˨
lạc	lak˨˩˨
lạch	lat˨˩˨
lại	laj˨˩˨
lạm	lam˨˩˨
lạng	laŋ˨˩˨
lạnh	lan˨˩˨
lạo	law˨˩˨
lạp	lap˨˩˨
lạt	la-˨˩˨
lạt	lat˨˩˨
lạu	lăw˨˩˨
lạy	lăj˨˩˨
lả	la˨˩˦
lải	laj˨˩˦
lảm	lam˨˩˦
lảng	laŋ˨˩˦
lảnh	lan˨˩˦
lảo	law˨˩˦
lảu	lăw˨˩˦
lảy	lăj˨˩˦
lấc	lɤ̆k˦˥
lấm	lɤ̆m˦˥
lấn	lɤ̆ŋ˦˥
lấp	lɤ̆p˦˥
lất	lɤ̆k˦˥
lấu	lɤ̆w˦˥
lấy	lɤ̆j˦˥
lầm	lɤ̆m˧˨
lần	lɤ̆ŋ˧˨
lầu	lɤ̆w˧˨
lầy	lɤ̆j˧˨
lẩm	lɤ̆m˨˩˦
lẩn	lɤ̆ŋ˨˩˦
lẩu	lɤ̆w˨˩˦
lẩy	lɤ̆j˨˩˦
lẫm	lɤ̆m˨˩˦
lẫn	lɤ̆ŋ˨˩˦
lẫy	lɤ̆j˨˩˦
lận	lɤ̆ŋ˨˩˨
lập	lɤ̆p˨˩˨
lật	lɤ̆k˨˩˨
lậu	lɤ̆w˨˩˨
lậy	lɤ̆j˨˩˨
lắc	lăk˦˥
lắc	sɛ˧
lắm	lăm˦˥
lắng	lăŋ˦˥
lắp	lăp˦˥
lắt	lăk˦˥
lằm	lăm˧˨
lằn	lăŋ˧˨
lằng	lăŋ˧˨
lẳn	lăŋ˨˩˦
lẳng	lăŋ˨˩˦
lẵng	lăŋ˨˩˦
lặc	lăk˨˩˨
lặn	lăŋ˨˩˨
lặng	lăŋ˨˩˨
lặp	lăp˨˩˨
lặt	lăk˨˩˨
lẹ	lɛ˨˩˨
lẹm	lɛm˨˩˨
lẹo	leo˨˩˨
lẹp	lɛp˨˩˨
lẹt	lɛt˨˩˨
lẻ	lɛ˨˩˦
lẻn	lɛŋ˨˩˦
lẻng	lɛŋ˨˩˦
lẻo	leo˨˩˦
lẽ	lɛ˨˩˦
lẽo	leo˨˩˦
lếch	let˦˥
lết	let˦˥
lếu	lɛu˦˥
lề	le˧˨
lềnh	len˧˨
lều	lɛu˧˨
lể	le˨˩˦
lểu	lɛu˨˩˦
lễ	le˨˩˦
lễu	lɛu˨˩˦
lệ	le˨˩˨
lệch	let˨˩˨
lệnh	len˨˩˨
lệt	let˨˩˨
lỉnh	lin˨˩˦
lị	li˨˩˨
lịch	lit˨˩˨
lịu	liw˨˩˨
lọ	lɔ˨˩˨
lọc	lɔkp˨˩˨
lọi	lɔj˨˩˨
lọm	lɔm˨˩˨
lọn	lɔŋm˨˩˨
lọng	lɔŋm˨˩˨
lọp	lɔp˨˩˨
lọt	lɔkp˨˩˨
lỏa	lwa˨˩˦
lỏm	lɔm˨˩˦
lỏn	lɔŋm˨˩˦
lỏng	lɔŋm˨˩˦
lố	lo˦˥
lốc	lokp˦˥
lối	loj˦˥
lốm	lom˦˥
lốn	loŋm˦˥
lốp	lop˦˥
lốt	lokp˦˥
lồ	lo˧˨
lồi	loj˧˨
lồm	lom˧˨
lồn	loŋm˧˨
lồng	loŋm˧˨
lổ	lo˨˩˦
lổm	lom˨˩˦
lổn	loŋm˨˩˦
lổng	loŋm˨˩˦
lỗ	lo˨˩˦
lỗi	loj˨˩˦
lỗm	lom˨˩˦
lộ	lo˨˩˨
lộc	lokp˨˩˨
lội	loj˨˩˨
lộm	lom˨˩˨
lộn	loŋm˨˩˨
lộng	loŋm˨˩˨
lộp	lop˨˩˨
lột	lokp˨˩˨
lớ	lɤ˦˥
lớn	lɤŋ˦˥
lớp	lɤp˦˥
lớt	lɤk˦˥
lờ	lɤ˧˨
lời	lɤj˧˨
lờm	lɤm˧˨
lờn	lɤŋ˧˨
lở	lɤ˨˩˦
lởm	lɤm˨˩˦
lởn	lɤŋ˨˩˦
lỡ	lɤ˨˩˦
lỡ	lɨː˧
lợ	lɤ˨˩˨
lợi	lɤj˨˩˨
lợm	lɤm˨˩˨
lợn	lɤŋ˨˩˨
lợp	lɤp˨˩˨
lợt	lɤk˨˩˨
lụ	lu˨˩˨
lụa	luə˨˩˨
lục	lukp˨˩˨
lụi	luj˨˩˨
lụm	lum˨˩˨
lụn	luŋm˨˩˨
lụng	luŋm˨˩˨
lụp	lup˨˩˨
lụt	lukp˨˩˨
lụy	luj˨˩˨
lủ	lu˨˩˦
lủa	luə˨˩˦
lủi	luj˨˩˦
lủm	lum˨˩˦
lủn	luŋm˨˩˦
lủng	luŋm˨˩˦
lứa	lɯə˦˥
lừ	lɯ˧˨
lừa	lɯə˧˨
lừng	lɯŋ˧˨
lử	lɯ˨˩˦
lửa	lɯə˨˩˦
lửng	lɯŋ˨˩˦
lữ	lɯ˨˩˦
lững	lɯŋ˨˩˦
lự	lɯ˨˩˨
lựa	lɯə˨˩˨
lực	lɯk˨˩˨
lựng	lɯŋ˨˩˨
lựu	lɯw˨˩˨
lỵ	li˨˩˨
ma	maˈa˧
ma	maː˧
ma	ma˧
ma	ma˧˧
ma-cà-bông	ma˧˧-ka˧˨-boŋm˧˧
mai	maj˧˧
man	maŋ˧˧
mang	maŋ˧˧
manh	man˧˧
mao	maw˧˧
mau	măw˧˧
may	măj˧˧
me	mɛ˧˧
men	mɛŋ˧˧
meo	meo˧˧
mi	mi˧˧
mim	mim˧˧
minh	min˧˧
miên	miəŋ˧˧
miêu	miəw˧˧
miếng	miəŋ˦˥
miếu	miəw˦˥
miền	miəŋ˧˨
miều	miəw˧˨
miễn	miəŋ˨˩˦
miệng	miəŋ˨˩˨
miệt	miək˨˩˨
mo	mɔ˧˧
moay	mwăj˧˧
moi	mɔj˧˧
mon	mɔŋm˧˧
mong	mɔŋm˧˧
moóc	mɔkp˦˥
mua	muə˧˧
mui	muj˧˧
mum	mum˧˧
mun	muŋm˧˧
mung	muŋm˧˧
muôn	muəŋ˧˧
muông	muəŋ˧˧
muối	muəj˦˥
muốn	mun˧
muốn	muəŋ˦˥
muống	muəŋ˦˥
muồm	mum˧˨
muỗi	muəj˨˩˦
muội	muəj˨˩˨
muộn	muəŋ˨˩˨
mà	maj˨˩
mà	maka˨˩
mà	mani˨˩
mà	man˨˩
mà	maˈa˨˩
mà	maː˦˨˩
mà	maː˨˩
mà	ma˧˨
mà	ma˨˩
mài	maj˧˨
màn	maŋ˧˨
màng	maŋ˧˨
mành	man˧˨
mào	maw˧˨
màu	măw˧˨
mày	măj˧˨
má	ma˦˥
mác	mak˦˥
mác-xít	mak˦˥-sit˦˥
mách	mat˦˥
mái	maj˦˥
mán	maŋ˦˥
máng	maŋ˦˥
mánh	man˦˥
mát	mat˦˥
máu	măw˦˥
máy	măj˦˥
mâm	mɤ̆m˧˧
mân	mɤ̆ŋ˧˧
mâng	mɤ̆ŋ˧˧
mâu	mɤ̆w˧˧
mây	mɤ̆j˧˧
mã	ma˨˩˦
mãi	maj˨˩˦
mãn	maŋ˨˩˦
mãng	maŋ˨˩˦
mãnh	man˨˩˦
mè	mɛ˧˨
mèo	meo˧˨
méo	meo˦˥
mép	mɛp˦˥
mét	mɛt˦˥
mê	me˧˧
mên	men˧˧
mênh	men˧˧
mì	mi˧˨
mìn	min˧˨
mình	min˧˨
mía	miə˦˥
mích	mit˦˥
mít	mit˦˥
mò	mɔ˧˨
mòi	mɔj˧˨
mòm	mɔm˧˨
mòn	mɔŋm˧˨
mòng	mɔŋm˧˨
mó	mɔ˦˥
móc	mɔkp˦˥
móm	mɔm˦˥
món	mɔŋm˦˥
móng	mɔŋm˦˥
móp	mɔp˦˥
mót	mɔkp˦˥
mô	mo˧˧
mô-bin	mo˧˧-bin˧˧
mô-men	mo˧˧-mɛŋ˧˧
mô-tô	mo˧˧-to˧˧
môi	moj˧˧
môn	moŋm˧˧
mông	moŋm˧˧
mõ	mɔ˨˩˦
mõm	mɔm˨˩˦
mù	mu˧˨
mùa	muə˧˨
mùi	muj˧˨
mùn	muŋm˧˨
mùng	muŋm˧˨
mú	mu˦˥
múa	muə˦˥
múi	muj˦˥
múm	mum˦˥
múp	mup˦˥
mút	mukp˦˥
măm	măm˧˧
măn	măŋ˧˧
măng	măŋ˧˧
mĩ	mi˨˩˦
mũ	mu˨˩˦
mũi	muj˨˩˦
mũm	mum˨˩˦
mơ	mɤ˧˧
mơn	mɤŋ˧˧
mưa	mɯə˧˧
mưng	mɯŋ˧˧
mưu	mɯw˧˧
mươi	mɯəj˧˧
mươn	mɯəŋ˧˧
mương	mɯəŋ˧˧
mướn	mɯəŋ˦˥
mướp	mɯp˦˥
mướt	mɯək˦˥
mười	mɯəj˧˨
mườn	mɯəŋ˧˨
mường	mɯəŋ˧˨
mượn	mɯəŋ˨˩˨
mượt	mɯək˨˩˨
mạ	ma˨˩˨
mạc	mak˨˩˨
mạc-sê	mak˨˩˨-ʂe˧˧
mạch	mat˨˩˨
mại	maj˨˩˨
mạn	maŋ˨˩˨
mạng	maŋ˨˩˨
mạnh	man˨˩˨
mạo	maw˨˩˨
mạt	mat˨˩˨
mạy	măj˨˩˨
mả	ma˨˩˦
mải	maj˨˩˦
mảng	maŋ˨˩˦
mảnh	man˨˩˦
mảy	măj˨˩˦
mấn	mɤ̆ŋ˦˥
mấp	mɤ̆p˦˥
mất	mak˧
mất	mɛtː˧
mất	mɤ̆k˦˥
mất	mˈt˧
mất	m˧
mất	ˈɔt˧
mấu	mɤ̆w˦˥
mấy	mɤ̆j˦˥
mầm	mɤ̆m˧˨
mần	mɤ̆ŋ˧˨
mầu	mɤ̆w˧˨
mầy	mɤ̆j˧˨
mẩm	mɤ̆m˨˩˦
mẩn	mɤ̆ŋ˨˩˦
mẩy	mɤ̆j˨˩˦
mẫm	mɤ̆m˨˩˦
mẫn	mɤ̆ŋ˨˩˦
mẫu	mɤ̆w˨˩˦
mận	mɤ̆ŋ˨˩˨
mập	mɤ̆p˨˩˨
mật	mɤ̆k˨˩˨
mậu	mɤ̆w˨˩˨
mắc	măk˦˥
mắc	mɑːk˧
mắm	măm˦˥
mắn	măŋ˦˥
mắng	măŋ˦˥
mắt	mak˧
mắt	maˈt˧
mắt	maːt˧
mắt	măk˦˥
mắt	mɑ˧
mắt	mˈat˧
mắt	mˈk˧
mắt	mˈq˧
mắt	mˈt˧
mằn	măŋ˧˨
mẵm	măm˨˩˦
mặc	măk˨˩˨
mặc	mˈak˧
mặn	măŋ˨˩˨
mặt	ma˧
mặt	măk˨˩˨
mặt	əɹ˧
mẹ	mɛ˨˩˨
mẹo	meo˨˩˨
mẻ	mɛ˨˩˦
mẽ	mɛ˨˩˦
mếch	met˦˥
mến	men˦˥
mếu	mɛu˦˥
mề	me˧˨
mềm	mem˧˨
mền	men˧˨
mễ	me˨˩˦
mệnh	men˨˩˨
mệt	met˨˩˨
mỉ	mi˨˩˦
mỉa	miə˨˩˦
mỉm	mim˨˩˦
mỉu	miw˨˩˦
mị	mi˨˩˨
mịn	min˨˩˨
mịt	mit˨˩˨
mọc	mɔkp˨˩˨
mọi	mɔj˨˩˨
mọng	mɔŋm˨˩˨
mọt	mɔkp˨˩˨
mỏ	mɔ˨˩˦
mỏi	mɔj˨˩˦
mỏm	mɔm˨˩˦
mỏng	mɔŋm˨˩˦
mố	mo˦˥
mốc	mokp˦˥
mối	moj˦˥
mống	moŋm˦˥
mốt	mokp˦˥
mồ	mo˧˨
mồ	mɔ˧
mồi	moj˧˨
mồm	mom˧˨
mồn	moŋm˧˨
mồng	moŋm˧˨
mổ	mo˨˩˦
mỗi	moj˨˩˦
mộ	mo˨˩˨
mộc	mokp˨˩˨
mộng	moŋm˨˩˨
một	mokp˨˩˨
mớ	mɤ˦˥
mới	mɤj˦˥
mớm	mɤm˦˥
mớn	mɤŋ˦˥
mờ	mɤ˧˨
mời	mɤj˧˨
mở	mɤ˨˩˦
mởn	mɤŋ˨˩˦
mỡ	mɤ˨˩˦
mụ	mu˨˩˨
mục	mukp˨˩˨
mục	mˈuk˨˩˨
mụn	muŋm˨˩˨
mụt	mukp˨˩˨
mủ	mu˨˩˦
mủi	muj˨˩˦
mủm	mum˨˩˦
mủng	muŋm˨˩˦
mức	mɯk˦˥
mứn	mɯŋ˦˥
mứt	mɯk˦˥
mừng	mɯŋ˧˨
mửa	mɯə˨˩˦
mực	mɯk˨˩˨
mỹ	mi˨˩˦
na	naː˧
na	na˧
na	na˧˧
nai	naj˧˧
nam	namˈ˧
nam	nam˧˧
nam-hạ	nam˧˧-ha˨˩˨
nam-sang	nam˧˧-ʂaŋ˧˧
nam-đà	nam˧˧-da˧˨
nan	naŋ˧˧
nang	naŋ˧˧
nanh	nan˧˧
nao	naw˧˧
nay	năj˧˧
ne	nɛ˧˧
nem	nɛm˧˧
nen	nɛŋ˧˧
neo	neo˧˧
nga	ŋa˧˧
ngai	ŋaj˧˧
ngam	ŋam˧˧
ngan	ŋaŋ˧˧
ngang	ŋaŋ˧˧
ngao	ŋaw˧˧
ngau	ŋăw˧˧
ngay	ŋăj˧˧
nghe	ŋɛ˧˧
nghi	ŋi˧˧
nghim	ŋim˧˧
nghinh	ŋin˧˧
nghiêm	ŋim˧˧
nghiên	ŋiəŋ˧˧
nghiêng	ŋiəŋ˧˧
nghiêu	ŋiəw˧˧
nghiến	ŋiəŋ˦˥
nghiền	ŋiəŋ˧˨
nghiễm	ŋim˨˩˦
nghiệm	ŋim˨˩˨
nghiện	ŋiəŋ˨˩˨
nghiệp	ŋip˨˩˨
nghiệt	ŋiək˨˩˨
nghè	ŋɛ˧˨
nghèn	ŋɛŋ˧˨
nghèo	ŋeo˧˨
nghé	ŋɛ˦˥
nghê	ŋe˧˧
nghênh	ŋen˧˧
nghêu	ŋɛu˧˧
nghì	ŋi˧˨
nghìn	ŋin˧˨
nghí	ŋi˦˥
nghĩ	ŋi˨˩˦
nghĩa	ŋiə˨˩˦
nghẹn	ŋɛŋ˨˩˨
nghẹt	ŋɛt˨˩˨
nghẽn	ŋɛŋ˨˩˦
nghếch	ŋet˦˥
nghề	ŋe˧˨
nghền	ŋen˧˨
nghềnh	ŋen˧˨
nghều	ŋɛu˧˨
nghể	ŋe˨˩˦
nghển	ŋen˨˩˦
nghễnh	ŋen˨˩˦
nghễu	ŋɛu˨˩˦
nghệ	ŋe˨˩˨
nghệch	ŋet˨˩˨
nghệt	ŋet˨˩˨
nghỉ	ŋi˨˩˦
nghỉu	ŋiw˨˩˦
nghị	ŋi˨˩˨
nghịch	ŋit˨˩˨
ngo	ŋɔ˧˧
ngoa	ŋwa˧˧
ngoai	ŋwaj˧˧
ngoam	ŋwam˧˧
ngoan	ŋwaŋ˧˧
ngoang	ŋwaŋ˧˧
ngoao	ŋwaw˧˧
ngoay	ŋwăj˧˧
ngoe	ŋwe˧˧
ngoem	ŋwem˧˧
ngoen	ŋwen˧˧
ngoeo	ŋwew˧˧
ngoi	ŋɔj˧˧
ngon	ŋɔŋm˧˧
ngong	ŋɔŋm˧˧
ngoài	ŋwaj˧˨
ngoái	ŋwaj˦˥
ngoáo	ŋwaw˦˥
ngoã	ŋwa˨˩˦
ngoèo	ŋwew˧˨
ngoéo	ŋwew˦˥
ngoăn	ŋwăŋ˧˧
ngoạ	ŋwa˨˩˨
ngoạch	ŋwat˨˩˨
ngoại	ŋwaj˨˩˨
ngoạn	ŋwaŋ˨˩˨
ngoảnh	ŋwan˨˩˦
ngoắc	ŋwăk˦˥
ngoắt	ŋwăk˦˥
ngoằn	ŋwăŋ˧˨
ngoằng	ŋwăŋ˧˨
ngoặc	ŋwăk˨˩˨
ngoặt	ŋwăk˨˩˨
ngoẻo	ŋwew˨˩˦
ngu	ŋu˧˧
ngun	ŋuŋm˧˧
nguy	ŋwi˧˧
nguyên	ŋwiəŋ˧˧
nguyền	ŋwiəŋ˧˨
nguyện	ŋwiəŋ˨˩˨
nguyệt	ŋwiək˨˩˨
nguây	ŋwɤ̆j˧˧
nguôi	ŋuəj˧˧
nguých	ŋwit˦˥
nguýt	ŋwit˦˥
nguầy	ŋwɤ̆j˧˨
nguẩy	ŋwɤ̆j˨˩˦
nguếch	ŋwet˦˥
nguệch	ŋwet˨˩˨
nguồi	ŋuəj˧˨
nguồn	ŋuəŋ˧˨
nguội	ŋuəj˨˩˨
nguỵ	ŋwi˨˩˨
ngà	ŋa˧˨
ngài	ŋaj˧˨
ngàm	ŋam˧˨
ngàn	ŋaŋ˧˨
ngành	ŋan˧˨
ngào	ŋaw˧˨
ngàu	ŋăw˧˨
ngày	ŋăj˧˨
ngác	ŋak˦˥
ngái	ŋaj˦˥
ngán	ŋaŋ˦˥
ngáng	ŋaŋ˦˥
ngáo	ŋaw˦˥
ngáp	ŋap˦˥
ngát	ŋat˦˥
ngáy	ŋăj˦˥
ngâm	ŋɤ̆m˧˧
ngân	ŋɤ̆ŋ˧˧
ngâu	ŋɤ̆w˧˧
ngây	ŋɤ̆j˧˧
ngã	ŋa˨˩˦
ngãi	ŋaj˨˩˦
ngãng	ŋaŋ˨˩˦
ngò	ŋɔ˧˨
ngòi	ŋɔj˧˨
ngòm	ŋɔm˧˨
ngòn	ŋɔŋm˧˨
ngòng	ŋɔŋm˧˨
ngó	ŋɔ˦˥
ngóc	ŋɔkp˦˥
ngóeo	ŋwew˦˥
ngói	ŋɔj˦˥
ngón	ŋɔŋm˦˥
ngóng	ŋɔŋm˦˥
ngót	ŋɔkp˦˥
ngô	ŋo˧˧
ngôi	ŋoj˧˧
ngôn	ŋoŋm˧˧
ngông	ŋoŋm˧˧
ngõ	ŋɔ˨˩˦
ngù	ŋu˧˨
ngùi	ŋuj˧˨
ngùn	ŋuŋm˧˨
ngú	ŋu˦˥
ngúc	ŋukp˦˥
ngúng	ŋuŋm˦˥
ngút	ŋukp˦˥
ngăm	ŋăm˧˧
ngăn	ŋăŋ˧˧
ngũ	ŋu˨˩˦
ngũn	ŋuŋm˨˩˦
ngũng	ŋuŋm˨˩˦
ngơ	ŋɤ˧˧
ngơi	ŋɤj˧˧
ngơm	ŋɤm˧˧
ngơn	ŋɤŋ˧˧
ngư	ŋɯ˧˧
ngưa	ŋɯə˧˧
ngưng	ŋɯŋ˧˧
ngưu	ŋɯw˧˧
ngươi	ŋɯəj˧˧
ngước	ŋɯək˦˥
ngườ	ŋɯə˧˨
người	ŋɯəj˧˨
ngường	ŋɯəŋ˧˨
ngưỡng	ŋɯəŋ˨˩˦
ngược	ŋɯək˨˩˨
ngượng	ŋɯəŋ˨˩˨
ngạc	ŋak˨˩˨
ngạch	ŋat˨˩˨
ngại	ŋaj˨˩˨
ngạn	ŋaŋ˨˩˨
ngạo	ŋaw˨˩˨
ngạt	ŋat˨˩˨
ngả	ŋa˨˩˦
ngải	ŋaj˨˩˦
ngảnh	ŋan˨˩˦
ngấc	ŋɤ̆k˦˥
ngấm	ŋɤ̆m˦˥
ngấn	ŋɤ̆ŋ˦˥
ngấp	ŋɤ̆p˦˥
ngất	ŋɤ̆k˦˥
ngấu	ŋɤ̆w˦˥
ngấy	ŋɤ̆j˦˥
ngầm	ŋɤ̆m˧˨
ngần	ŋɤ̆ŋ˧˨
ngầu	ŋɤ̆w˧˨
ngầy	ŋɤ̆j˧˨
ngẩm	ŋɤ̆m˨˩˦
ngẩn	ŋɤ̆ŋ˨˩˦
ngẩng	ŋɤ̆ŋ˨˩˦
ngẫm	ŋɤ̆m˨˩˦
ngẫu	ŋɤ̆w˨˩˦
ngậm	ŋɤ̆m˨˩˨
ngận	ŋɤ̆ŋ˨˩˨
ngập	ŋɤ̆p˨˩˨
ngật	ŋɤ̆k˨˩˨
ngậu	ŋɤ̆w˨˩˨
ngắc	ŋăk˦˥
ngắm	ŋăm˦˥
ngắn	ŋăŋ˦˥
ngắt	ŋăk˦˥
ngằn	ŋăŋ˧˨
ngẳng	ŋăŋ˨˩˦
ngặt	ŋăk˨˩˨
ngọ	ŋɔ˨˩˨
ngọc	ŋɔkp˨˩˨
ngọn	ŋɔŋm˨˩˨
ngọng	ŋɔŋm˨˩˨
ngọt	ŋɔkp˨˩˨
ngỏ	ŋɔ˨˩˦
ngỏm	ŋɔm˨˩˦
ngỏn	ŋɔŋm˨˩˦
ngỏng	ŋɔŋm˨˩˦
ngốc	ŋokp˦˥
ngốn	ŋoŋm˦˥
ngốt	ŋokp˦˥
ngồ	ŋo˧˨
ngồi	ŋoj˧˨
ngồm	ŋom˧˨
ngồn	ŋoŋm˧˨
ngồng	ŋoŋm˧˨
ngổ	ŋo˨˩˦
ngổm	ŋom˨˩˦
ngổn	ŋoŋm˨˩˦
ngổng	ŋoŋm˨˩˦
ngỗ	ŋo˨˩˦
ngỗng	ŋoŋm˨˩˦
ngộ	ŋo˨˩˨
ngộc	ŋokp˨˩˨
ngột	ŋokp˨˩˨
ngớ	ŋɤ˦˥
ngớt	ŋɤk˦˥
ngờ	ŋɤ˧˨
ngời	ŋɤj˧˨
ngờm	ŋɤm˧˨
ngỡ	ŋɤ˨˩˦
ngợi	ŋɤj˨˩˨
ngợm	ŋɤm˨˩˨
ngợp	ŋɤp˨˩˨
ngụ	ŋu˨˩˨
ngục	ŋukp˨˩˨
ngụp	ŋup˨˩˨
ngụy	ŋuj˨˩˨
ngủ	ŋu˨˩˦
ngủn	ŋuŋm˨˩˦
ngủng	ŋuŋm˨˩˦
ngứa	ŋɯə˦˥
ngừng	ŋɯŋ˧˨
ngửa	ŋɯə˨˩˦
ngửi	ŋɯj˨˩˦
ngửng	ŋɯŋ˨˩˦
ngữ	ŋɯ˨˩˦
ngự	ŋɯ˨˩˨
ngựa	ŋɯə˨˩˨
ngực	ŋɯk˨˩˨
nha	ɲa˧˧
nhai	ɲaj˧˧
nham	ɲam˧˧
nhan	ɲaŋ˧˧
nhang	ɲaŋ˧˧
nhanh	ɲan˧˧
nhao	ɲaw˧˧
nhau	ɲăw˧˧
nhay	ɲăj˧˧
nhe	ɲɛ˧˧
nhem	ɲɛm˧˧
nhen	ɲɛŋ˧˧
nheo	ɲeo˧˧
nhi	ɲi˧˧
nhinh	ɲin˧˧
nhiu	ɲiw˧˧
nhiên	ɲiəŋ˧˧
nhiêu	ɲiəw˧˧
nhiếc	ɲiək˦˥
nhiếp	ɲip˦˥
nhiều	ɲiəw˧˨
nhiễm	ɲim˨˩˦
nhiễu	ɲiəw˨˩˦
nhiệm	ɲim˨˩˨
nhiệt	ɲiək˨˩˨
nho	ɲɔ˧˧
nhoang	ɲwaŋ˧˧
nhoay	ɲwăj˧˧
nhoe	ɲwe˧˧
nhoen	ɲwen˧˧
nhoi	ɲɔj˧˧
nhom	ɲɔm˧˧
nhon	ɲɔŋm˧˧
nhong	ɲɔŋm˧˧
nhoáng	ɲwaŋ˦˥
nhoè	ɲwe˧˨
nhoét	ɲwet˦˥
nhoẻn	ɲwen˨˩˦
nhu	ɲu˧˧
nhun	ɲuŋm˧˧
nhung	ɲuŋm˧˧
nhuyễn	ɲwiəŋ˨˩˦
nhuôm	ɲum˧˧
nhuần	ɲwɤ̆ŋ˧˨
nhuận	ɲwɤ̆ŋ˨˩˨
nhuế	ɲwe˦˥
nhuệ	ɲwe˨˩˨
nhuốc	ɲuək˦˥
nhuốm	ɲum˦˥
nhuộm	ɲum˨˩˨
nhà	ɲaː˨˩
nhà	ɲa˧˨
nhài	ɲaj˧˨
nhàm	ɲam˧˨
nhàn	ɲaŋ˧˨
nhàng	ɲaŋ˧˨
nhào	ɲaw˧˨
nhàu	ɲăw˧˨
nhày	ɲăj˧˨
nhá	ɲa˦˥
nhác	ɲak˦˥
nhái	ɲaj˦˥
nhám	ɲam˦˥
nháo	ɲaw˦˥
nhát	ɲat˦˥
nháy	ɲăj˦˥
nhâm	ɲɤ̆m˧˧
nhân	ɲɤ̆ŋ˧˧
nhâng	ɲɤ̆ŋ˧˧
nhâu	ɲɤ̆w˧˧
nhây	ɲɤ̆j˧˧
nhã	ɲa˨˩˦
nhãi	ɲaj˨˩˦
nhãn	ɲaŋ˨˩˦
nhãng	ɲaŋ˨˩˦
nhão	ɲaw˨˩˦
nhè	ɲɛ˧˨
nhèm	ɲɛm˧˨
nhèn	ɲɛŋ˧˨
nhèo	ɲeo˧˨
nhênh	ɲen˧˧
nhì	ɲi˧˨
nhìn	ɲin˧˨
nhí	ɲi˦˥
nhím	ɲim˦˥
nhíp	ɲip˦˥
nhòe	ɲwe˧˨
nhòm	ɲɔm˧˨
nhóc	ɲɔkp˦˥
nhóm	ɲɔm˦˥
nhón	ɲɔŋm˦˥
nhóng	ɲɔŋm˦˥
nhóp	ɲɔp˦˥
nhót	ɲɔkp˦˥
nhôm	ɲom˧˧
nhôn	ɲoŋm˧˧
nhông	ɲoŋm˧˧
nhõng	ɲɔŋm˨˩˦
nhù	ɲu˧˨
nhùn	ɲuŋm˧˨
nhùng	ɲuŋm˧˨
nhúc	ɲukp˦˥
nhúm	ɲum˦˥
nhún	ɲuŋm˦˥
nhúng	ɲuŋm˦˥
nhút	ɲukp˦˥
nhăm	ɲăm˧˧
nhăn	ɲăŋ˧˧
nhăng	ɲăŋ˧˧
nhĩ	ɲi˨˩˦
nhũ	ɲu˨˩˦
nhũn	ɲuŋm˨˩˦
nhũng	ɲuŋm˨˩˦
nhơ	ɲɤ˧˧
nhơm	ɲɤm˧˧
nhơn	ɲɤŋ˧˧
như	ɲɯ˧˧
nhưng	ɲɯŋ˧˧
nhường	ɲɯəŋ˧˨
nhưỡng	ɲɯəŋ˨˩˦
nhược	ɲɯək˨˩˨
nhượng	ɲɯəŋ˨˩˨
nhạc	ɲak˨˩˨
nhạn	ɲaŋ˨˩˨
nhạo	ɲaw˨˩˨
nhạt	ɲat˨˩˨
nhạy	ɲăj˨˩˨
nhả	ɲa˨˩˦
nhảm	ɲam˨˩˦
nhảu	ɲăw˨˩˦
nhảy	ɲăj˨˩˦
nhấc	ɲɤ̆k˦˥
nhấm	ɲɤ̆m˦˥
nhấn	ɲɤ̆ŋ˦˥
nhấp	ɲɤ̆p˦˥
nhất	ɲɤ̆k˦˥
nhầm	ɲɤ̆m˧˨
nhần	ɲɤ̆ŋ˧˨
nhầu	ɲɤ̆w˧˨
nhầy	ɲɤ̆j˧˨
nhẩn	ɲɤ̆ŋ˨˩˦
nhẩy	ɲɤ̆j˨˩˦
nhẫn	ɲɤ̆ŋ˨˩˦
nhậm	ɲɤ̆m˨˩˨
nhận	ɲɤ̆ŋ˨˩˨
nhập	ɲɤ̆p˨˩˨
nhật	ɲɤ̆k˨˩˨
nhậu	ɲɤ̆w˨˩˨
nhắc	ɲak˧
nhắc	ɲăk˦˥
nhắc	ɲˈak˧
nhắm	ɲam˧t˧˧
nhắm	ɲăm˦˥
nhắn	ɲăŋ˦˥
nhắng	ɲăŋ˦˥
nhắp	ɲăp˦˥
nhằm	ɲăm˧˨
nhằng	ɲăŋ˧˨
nhẳn	ɲăŋ˨˩˦
nhẳng	ɲăŋ˨˩˦
nhẵn	ɲăŋ˨˩˦
nhặm	ɲăm˨˩˨
nhặng	ɲăŋ˨˩˨
nhặt	ɲăk˨˩˨
nhẹ	ɲɛ˨˩˨
nhẻ	ɲɛ˨˩˦
nhẻm	ɲɛm˨˩˦
nhẽ	ɲɛ˨˩˦
nhẽo	ɲeo˨˩˦
nhếch	ɲet˦˥
nhếu	ɲɛu˦˥
nhều	ɲɛu˧˨
nhễ	ɲe˨˩˦
nhện	ɲen˨˩˨
nhệu	ɲɛu˨˩˨
nhị	ɲi˨˩˨
nhịn	ɲin˨˩˨
nhịp	ɲip˨˩˨
nhịu	ɲiw˨˩˨
nhọ	ɲɔ˨˩˨
nhọc	ɲɔkp˨˩˨
nhọn	ɲɔŋm˨˩˨
nhọt	ɲɔkp˨˩˨
nhỏ	nɔ˨˧
nhỏ	ɲɔ˨˩˦
nhỏm	ɲɔm˨˩˦
nhỏn	ɲɔŋm˨˩˦
nhỏng	ɲɔŋm˨˩˦
nhố	ɲo˦˥
nhốn	ɲoŋm˦˥
nhồi	ɲoj˧˨
nhồm	ɲom˧˨
nhồn	ɲoŋm˧˨
nhổ	ɲo˨˩˦
nhộn	ɲoŋm˨˩˨
nhộng	ɲoŋm˨˩˨
nhột	ɲokp˨˩˨
nhớ	ɲɤ˦˥
nhớn	ɲɤŋ˦˥
nhớp	ɲɤp˦˥
nhớt	ɲɤk˦˥
nhờ	ɲɤ˧˨
nhời	ɲɤj˧˨
nhờn	ɲɤŋ˧˨
nhởn	ɲɤŋ˨˩˦
nhỡ	ɲɤ˨˩˦
nhỡn	ɲɤŋ˨˩˦
nhợt	ɲɤk˨˩˨
nhục	ɲukp˨˩˨
nhụng	ɲuŋm˨˩˨
nhụt	ɲukp˨˩˨
nhủ	ɲu˨˩˦
nhủn	ɲuŋm˨˩˦
nhủng	ɲuŋm˨˩˦
nhức	ɲɯk˦˥
nhừ	ɲɯ˧˨
nhửng	ɲɯŋ˨˩˦
nhữ	ɲɯ˨˩˦
những	ɲɯŋ˨˩˦
nhựa	ɲɯə˨˩˨
nhựt	ɲɯk˨˩˨
ni	niː˧
ni	ni˧
ni	ni˧˧
nin	nin˧˧
ninh	nin˧˧
niu	niw˧˧
niêm	nim˧˧
niên	niəŋ˧˧
niêu	niəw˧˧
niết	niək˦˥
niềm	nim˧˨
niềng	niəŋ˧˨
niệm	nim˨˩˨
niệu	niəw˨˩˨
no	nɔ˧˧
no,	nɔː˧
noi	nɔj˧˧
non	nɔŋm˧˧
nong	nɔŋm˧˧
noong	nɔŋm˧˧
noãn	nwaŋ˨˩˦
nu	nu˧˧
nua	nuə˧˧
num	num˧˧
nung	nuŋm˧˧
nuôi	nuəj˧˧
nuông	nuəŋ˧˧
nuối	nuəj˦˥
nuốt	nuək˦˥
nuột	nuək˨˩˨
nà	na˧˨
nài	naj˧˨
nàng	naŋ˧˨
nào	naw˧˨
này	năj˧˨
ná	na˦˥
nách	nat˦˥
nái	naj˦˥
náo	naw˦˥
náp	nap˦˥
nát	nat˦˥
náu	năw˦˥
nân	nɤ̆ŋ˧˧
nâng	nɤ̆ŋ˧˧
nâu	nɤ̆w˧˧
nây	nɤ̆j˧˧
não	naw˨˩˦
nãy	năj˨˩˦
né	nɛ˦˥
ném	nɛm˦˥
nén	nɛŋ˦˥
néo	neo˦˥
nét	nɛt˦˥
nê	ne˧˧
nêm	nem˧˧
nên	nenˈi˧
nên	nen˧˧
nêu	nɛu˧˧
nì	ni˧˨
nình	nin˧˨
ních	nit˦˥
nín	nin˦˥
níu	niw˦˥
nòi	nɔj˧˨
nòng	nɔŋm˧˨
nó	nɔːi˧˥
nó	nɔːl˧˥
nó	nɔːm˧˥
nó	nɔːn˧˥
nó	nɔːt˧˥
nó	nɔː˧˥
nó	nɔ˦˥
nó	nɔ˧˥
nóc	nɔkp˦˥
nói	nɔj˦˥
nói	nɔj˧˥
nón	nɔŋm˦˥
nóng	nɔŋm˦˥
nót	nɔkp˦˥
nô	no˧˧
nôm	nom˧˧
nôn	noŋm˧˧
nông	noŋm˧˧
nõ	nɔ˨˩˦
nõn	nɔŋm˨˩˦
nùng	nuŋm˧˨
núa	nuə˦˥
núc	nukp˦˥
núi	nuj˦˥
núm	num˦˥
núng	nuŋm˦˥
núp	nup˦˥
nút	nukp˦˥
năm	năm˧˧
năn	năŋ˧˧
năng	năŋ˧˧
nũng	nuŋm˨˩˦
nơ	nɤ˧˧
nơi	nɤj˧˧
nơm	nɤm˧˧
nưng	nɯŋ˧˧
nương	nɯəŋ˧˧
nước	nɯək˦˥
nướng	nɯəŋ˦˥
nườm	nɯm˧˨
nạ	na˨˩˨
nạc	nak˨˩˨
nại	naj˨˩˨
nạm	nam˨˩˨
nạn	naŋ˨˩˨
nạng	naŋ˨˩˨
nạo	naw˨˩˨
nạp	nap˨˩˨
nạt	nat˨˩˨
nản	naŋ˨˩˦
nảo	naw˨˩˦
nảy	năj˨˩˦
nấc	nɤ̆k˦˥
nấm	nɤ̆m˦˥
nấn	nɤ̆ŋ˦˥
nấp	nɤ̆p˦˥
nấu	nɤ̆w˦˥
nấy	nɤ̆j˦˥
nầm	nɤ̆m˧˨
nần	nɤ̆ŋ˧˨
nẩy	nɤ̆j˨˩˦
nẫng	nɤ̆ŋ˨˩˦
nẫu	nɤ̆w˨˩˦
nắc	năk˦˥
nắm	năm˦˥
nắn	năŋ˦˥
nắng	năŋ˦˥
nắng	n˧aŋ˧˥˧
nắp	năp˦˥
nằm	năm˧˨
nằn	năŋ˧˨
nằng	năŋ˧˨
nặc	năk˨˩˨
nặn	năŋ˨˩˨
nặng	năŋ˨˩˨
nẹp	nɛp˨˩˨
nẹt	nɛt˨˩˨
nẻ	nɛ˨˩˦
nẻo	neo˨˩˦
nếm	nem˦˥
nến	nen˦˥
nếp	nep˦˥
nết	net˦˥
nếu	nɛu˦˥
nếu	nɛu˧
nếu	nɛːˈ˦˧
nề	ne˧˨
nền	nen˧˨
nể	ne˨˩˦
nệ	ne˨˩˨
nệm	nem˨˩˨
nỉ	ni˨˩˦
nịch	nit˨˩˨
nịnh	nin˨˩˨
nịt	nit˨˩˨
nọ	nɔ˨˩˨
nọc	nɔkp˨˩˨
nỏ	nɔ˨˩˦
nốc	nokp˦˥
nối	noj˦˥
nốt	nokp˦˥
nồi	noj˧˨
nồng	noŋm˧˨
nổ	no˨˩˦
nổi	noj˨˩˦
nỗ	no˨˩˦
nỗi	noj˨˩˦
nộ	no˨˩˨
nội	noj˨˩˨
nộn	noŋm˨˩˨
nộp	nop˨˩˨
nới	nɤj˦˥
nớp	nɤp˦˥
nờm	nɤm˧˨
nở	nɤ˨˩˦
nỡ	nɤ˨˩˦
nợ	nɤ˨˩˨
nụ	nu˨˩˨
nụ	nəʊ˨˩˨
nục	nukp˨˩˨
nứa	nɯə˦˥
nức	nɯk˦˥
nứt	nɯk˦˥
nử	nɯ˨˩˦
nửa	nɯə˨˩˦
nữ	nɯ˨˩˦
nữa	nɯə˨˩˦
nực	nɯk˨˩˨
nựng	nɯŋ˨˩˨
o	ɔ˧˧
o-xi	ɔ˧˧-si˧˧
o-xy	ɔ˧˧-si˧˧
o-xít	ɔ˧˧-sit˦˥
oa	wa˧˧
oai	waj˧˧
oan	waŋ˧˧
oang	waŋ˧˧
oanh	wan˧˧
oe	we˧˧
oeng	wen˧˧
oi	ɔj˧˧
om	ɔm˧˧
ong	ɔŋm˧˧
oong	ɔŋm˧˧
oàm	wam˧˨
oàng	waŋ˧˨
oành	wan˧˨
oác	wak˦˥
oái	waj˦˥
oán	waŋ˦˥
oát	wat˦˥
oé	we˦˥
oăn	wăŋ˧˧
oăng	wăŋ˧˧
oải	waj˨˩˦
oản	waŋ˨˩˦
oắt	wăk˦˥
oằn	wăŋ˧˨
oẳn	wăŋ˨˩˦
oặt	wăk˨˩˨
oẻ	we˨˩˦
pa	pa˧˧
pe-man-ga-nát	pɛ˧˧-maŋ˧˧-ɣa˧˧-nat˦˥
pen	pɛŋ˧˧
pha	fa˧˧
phai	faj˧˧
phang	faŋ˧˧
phanh	fan˧˧
phao	faw˧˧
phau	făw˧˧
phay	făj˧˧
phe	fɛ˧˧
phi	fi˧˧
phim	fim˧˧
phin	fin˧˧
phinh	fin˧˧
phiên	fiəŋ˧˧
phiêu	fiəw˧˧
phiếm	fim˦˥
phiến	fiəŋ˦˥
phiếu	fiəw˦˥
phiền	fiəŋ˧˨
phiệt	fiək˨˩˨
pho	fɔ˧˧
phong	fɔŋm˧˧
phoóc	fɔkp˦˥
phu	fu˧˧
phui	fuj˧˧
phun	fuŋm˧˧
phung	fuŋm˧˧
phà	fa˧˨
phàm	fam˧˨
phàn	faŋ˧˨
phành	fan˧˨
phá	fa˦˥
phác	fak˦˥
phách	fat˦˥
phái	faj˦˥
phán	faŋ˦˥
pháo	faw˦˥
pháp	fap˦˥
phát	fat˦˥
phân	fɤ̆ŋ˧˧
phây	fɤ̆j˧˧
phè	fɛ˧˨
phèn	fɛŋ˧˨
phèng	fɛŋ˧˨
phéc	fɛk˦˥
phép	fɛp˦˥
phét	fɛt˦˥
phê	fe˧˧
phên	fen˧˧
phì	fi˧˨
phìa	fiə˧˨
phìn	fin˧˨
phình	fin˧˨
phí	fi˦˥
phím	fim˦˥
phò	fɔ˧˨
phòi	fɔj˧˨
phòng	fɔŋm˧˨
phó	fɔ˦˥
phóng	fɔŋm˦˥
phô	fo˧˧
phôi	foj˧˧
phôm	fom˧˧
phông	foŋm˧˧
phù	fu˧˨
phùn	fuŋm˧˨
phùng	fuŋm˧˨
phú	fu˦˥
phúc	fukp˦˥
phún	fuŋm˦˥
phúng	fuŋm˦˥
phút	fukp˦˥
phăm	făm˧˧
phăn	făŋ˧˧
phăng	făŋ˧˧
phĩnh	fin˨˩˦
phũ	fu˨˩˦
phơ	fɤ˧˧
phơi	fɤj˧˧
phơn	fɤŋ˧˧
phưng	fɯŋ˧˧
phương	fɯəŋ˧˧
phước	fɯək˦˥
phướn	fɯəŋ˦˥
phường	fɯəŋ˧˨
phượng	fɯəŋ˨˩˨
phạch	fat˨˩˨
phạm	fam˨˩˨
phạn	faŋ˨˩˨
phạt	fat˨˩˨
phả	fa˨˩˦
phải	faj˨˩˦
phản	faŋ˨˩˦
phảng	faŋ˨˩˦
phấn	fɤ̆ŋ˦˥
phấp	fɤ̆p˦˥
phất	fɤ̆k˦˥
phầm	fɤ̆m˧˨
phần	fɤ̆ŋ˧˨
phẩm	fɤ̆m˨˩˦
phẩy	fɤ̆j˨˩˦
phẫn	fɤ̆ŋ˨˩˦
phẫu	fɤ̆w˨˩˦
phận	fɤ̆ŋ˨˩˨
phập	fɤ̆p˨˩˨
phật	fɤ̆k˨˩˨
phắc	făk˦˥
phắt	făk˦˥
phẳng	făŋ˨˩˦
phẹt	fɛt˨˩˨
phế	fe˦˥
phề	fe˧˨
phềnh	fen˧˨
phều	fɛu˧˨
phệ	fe˨˩˨
phệnh	fen˨˩˨
phỉ	fi˨˩˦
phỉnh	fin˨˩˦
phịu	fiw˨˩˨
phọng	fɔŋm˨˩˨
phọt	fɔkp˨˩˨
phỏng	fɔŋm˨˩˦
phố	fo˦˥
phốc	fokp˦˥
phối	foj˦˥
phốp	fop˦˥
phốt	fokp˦˥
phồm	fom˧˨
phồn	foŋm˧˨
phồng	foŋm˧˨
phổ	fo˨˩˦
phổi	foj˨˩˦
phổng	foŋm˨˩˦
phỗng	foŋm˨˩˦
phộng	foŋm˨˩˨
phới	fɤj˦˥
phớn	fɤŋ˦˥
phớt	fɤk˦˥
phờ	fɤ˧˨
phở	fɤ˨˩˦
phởn	fɤŋ˨˩˦
phụ	fu˨˩˨
phục	fukp˨˩˨
phụng	fuŋm˨˩˨
phủ	fu˨˩˦
phủi	fuj˨˩˦
phứa	fɯə˦˥
phức	fɯk˦˥
phừn	fɯŋ˧˨
phừng	fɯŋ˧˨
pi	pi˧˧
pin	pin˧˧
pom	pɔm˧˧
pu	pu˧˧
puốc	puək˦˥
pà	pa˧˨
pác	pak˦˥
pát	pat˦˥
pâu	pɤ̆w˧˧
pê	pe˧˧
pít	pit˦˥
pô	po˧˧
pô-li-me	po˧˧-li˧˧-mɛ˧˧
pơ	pɤ˧˧
qua	kwaŋa˧
qua	kwa˧
qua	wa˧˧
quai	waj˧˧
quan	waŋ˧˧
quang	waŋ˧˧
quanh	wan˧˧
quau	wăw˧˧
quay	wăj˧˧
que	wɛ˧˧
quen	wɛŋ˧˧
queng	wɛŋ˧˧
queo	weo˧˧
qui	wi˧˧
quy	wi˧˧
quyên	wiɛŋ˧˧
quyến	wiɛŋ˦˥
quyết	wiɛt˦˥
quyền	wiɛŋ˧˨
quyển	wiɛŋ˨˩˦
quà	wa˧˨
quài	waj˧˨
quàng	waŋ˧˨
quành	wan˧˨
quàu	wăw˧˨
quày	wăj˧˨
quá	wa˦˥
quác	wak˦˥
quách	wat˦˥
quái	waj˦˥
quán	waŋ˦˥
quáng	waŋ˦˥
quánh	wan˦˥
quát	wat˦˥
quân	wɤ̆ŋ˧˧
quây	wɤ̆j˧˧
quãng	waŋ˨˩˦
què	wɛ˧˨
quèn	wɛŋ˧˨
quèo	weo˧˨
quét	wɛt˦˥
quê	we˧˧
quên	wen˧˧
quì	wi˧˨
quình	win˧˨
quí	wi˦˥
quít	wit˦˥
quý	wi˦˥
quýnh	win˦˥
quýt	wit˦˥
quăm	wăm˧˧
quăn	wăŋ˧˧
quăng	wăŋ˧˧
quĩ	wi˨˩˦
quơ	wɤ˧˧
quạ	wa˨˩˨
quạc	wak˨˩˨
quạnh	wan˨˩˨
quạt	wat˨˩˨
quạu	wăw˨˩˨
quả	wa˨˩˦
quải	waj˨˩˦
quản	waŋ˨˩˦
quảng	waŋ˨˩˦
quảy	wăj˨˩˦
quấn	wɤ̆ŋ˦˥
quất	wɤ̆k˦˥
quấy	wɤ̆j˦˥
quần	wɤ̆ŋ˧˨
quầng	wɤ̆ŋ˧˨
quầy	wɤ̆j˧˨
quẩn	wɤ̆ŋ˨˩˦
quẩng	wɤ̆ŋ˨˩˦
quẫn	wɤ̆ŋ˨˩˦
quận	wɤ̆ŋ˨˩˨
quật	wɤ̆k˨˩˨
quậy	wɤ̆j˨˩˨
quắc	wăk˦˥
quắp	wăp˦˥
quắt	wăk˦˥
quằm	wăm˧˨
quằn	wăŋ˧˨
quẳng	wăŋ˨˩˦
quặm	wăm˨˩˨
quặn	wăŋ˨˩˨
quặp	wăp˨˩˨
quặt	wăk˨˩˨
quẹo	weo˨˩˨
quẹt	wɛt˨˩˨
quẻ	wɛ˨˩˦
quế	we˦˥
quếch	wet˦˥
quến	wen˦˥
quếnh	wen˦˥
quết	wet˦˥
quếu	wɛu˦˥
quề	we˧˨
quềnh	wen˧˨
quều	wɛu˧˨
quệch	wet˨˩˨
quệnh	wen˨˩˨
quỉ	wi˨˩˦
quị	wi˨˩˨
quốc	wokp˦˥
quới	wɤj˦˥
quờ	wɤ˧˨
quờn	wɤŋ˧˨
quở	wɤ˨˩˦
quỳ	wi˧˨
quỳnh	win˧˨
quỵ	wi˨˩˨
quỷ	wi˨˩˦
quỹ	wi˨˩˦
ra	ʐa˧˧
ra-đi-ô	ʐa˧˧-di˧˧-o˧˧
ram	ʐam˧˧
ran	ʐaŋ˧˧
rang	ʐaŋ˧˧
ranh	ʐan˧˧
rao	ʐaw˧˧
rau	ʐăw˧˧
ray	ʐăj˧˧
re	ʐɛ˧˧
ren	ʐɛŋ˧˧
reng	ʐɛŋ˧˧
reo	ʐeo˧˧
ri	ʐi˧˧
rin	ʐin˧˧
rinh	ʐin˧˧
riu	ʐiw˧˧
riêng	ʐiəŋ˧˧
riêu	ʐiəw˧˧
riết	ʐiək˦˥
riềng	ʐiəŋ˧˨
ro	ʐɔ˧˧
roi	ʐɔj˧˧
rong	ʐɔŋm˧˧
ru	ʐu˧˧
run	ʐuŋm˧˧
rung	ʐuŋm˧˧
ruôn	ʐuəŋ˧˧
ruốc	ʐuək˦˥
ruồi	ʐuəj˧˨
ruồng	ʐuəŋ˧˨
ruổi	ʐuəj˨˩˦
ruỗng	ʐuəŋ˨˩˦
ruộng	ʐuəŋ˨˩˨
ruột	ʐuək˨˩˨
rà	ʐa˧˨
ràn	ʐaŋ˧˨
ràng	ʐaŋ˧˨
rành	ʐan˧˨
rào	ʐaw˧˨
rày	ʐăj˧˨
rá	ʐa˦˥
rác	ʐak˦˥
rách	ʐat˦˥
rái	ʐaj˦˥
rám	ʐam˦˥
rán	ʐaŋ˦˥
ráng	ʐaŋ˦˥
ráo	ʐaw˦˥
ráp	ʐap˦˥
rát	ʐat˦˥
ráu	ʐăw˦˥
ráy	ʐăj˦˥
râm	ʐɤ̆m˧˧
rân	ʐɤ̆ŋ˧˧
râu	ʐɤ̆w˧˧
rã	ʐa˨˩˦
rãi	ʐaj˨˩˦
rãnh	ʐan˨˩˦
rè	ʐɛ˧˨
rèn	ʐɛŋ˧˨
rèo	ʐeo˧˨
ré	ʐɛ˦˥
rén	ʐɛŋ˦˥
réo	ʐeo˦˥
rét	ʐɛt˦˥
rên	ʐen˧˧
rêu	ʐɛu˧˧
rì	ʐi˧˨
rìa	ʐiə˧˨
rình	ʐin˧˨
rìu	ʐiw˧˨
rí	ʐi˦˥
rích	ʐit˦˥
rít	ʐit˦˥
ríu	ʐiw˦˥
rò	ʐɔ˧˨
ròm	ʐɔm˧˨
ròn	ʐɔŋm˧˨
ròng	ʐɔŋm˧˨
ró	ʐɔ˦˥
róc	ʐɔkp˦˥
rón	ʐɔŋm˦˥
rót	ʐɔkp˦˥
rô	ʐo˧˧
rôm	ʐom˧˧
rôn	ʐoŋm˧˧
rông	ʐoŋm˧˧
rõ	ʐɔ˨˩˦
rù	ʐu˧˨
rùa	ʐuə˧˨
rùm	ʐum˧˨
rùng	ʐuŋm˧˨
rú	ʐu˦˥
rúc	ʐukp˦˥
rúi	ʐuj˦˥
rúm	ʐum˦˥
rún	ʐuŋm˦˥
rúng	ʐuŋm˦˥
rút	ʐukp˦˥
răm	ʐăm˧˧
răn	ʐăŋ˧˧
răng	ʐăŋ˧˧
rĩ	ʐi˨˩˦
rũ	ʐu˨˩˦
rơ	ʐɤ˧˧
rơi	ʐɤj˧˧
rơm	ʐɤm˧˧
rơn	ʐɤŋ˧˧
rưa	ʐɯə˧˧
rưng	ʐɯŋ˧˧
rươi	ʐɯəj˧˧
rươm	ʐɯm˧˧
rương	ʐɯəŋ˧˧
rước	ʐɯək˦˥
rướn	ʐɯəŋ˦˥
rười	ʐɯəj˧˨
rườm	ʐɯm˧˨
rườn	ʐɯəŋ˧˨
rường	ʐɯəŋ˧˨
rượn	ʐɯəŋ˨˩˨
rượu	ʐɯəw˨˩˨
rạ	ʐa˨˩˨
rạc	ʐak˨˩˨
rạch	ʐat˨˩˨
rạn	ʐaŋ˨˩˨
rạng	ʐaŋ˨˩˨
rạo	ʐaw˨˩˨
rạp	ʐap˨˩˨
rả	ʐa˨˩˦
rải	ʐaj˨˩˦
rảnh	ʐan˨˩˦
rảo	ʐaw˨˩˦
rấm	ʐɤ̆m˦˥
rấn	ʐɤ̆ŋ˦˥
rấp	ʐɤ̆p˦˥
rất	rˈt˧
rất	vɪt˧
rất	ʐɤ̆k˦˥
rầm	ʐɤ̆m˧˨
rần	ʐɤ̆ŋ˧˨
rầu	ʐɤ̆w˧˨
rầy	ʐɤ̆j˧˨
rẫy	ʐɤ̆j˨˩˦
rậm	ʐɤ̆m˨˩˨
rận	ʐɤ̆ŋ˨˩˨
rập	ʐɤ̆p˨˩˨
rắc	ʐăk˦˥
rắm	ʐăm˦˥
rắn	ʐăŋ˦˥
rắp	ʐăp˦˥
rằm	ʐăm˧˨
rằm	ʒam˧
rằn	ʐăŋ˧˨
rằng	ʐăŋ˧˨
rặm	ʐăm˨˩˨
rặt	ʐăk˨˩˨
rẹo	ʐeo˨˩˨
rẻ	ʐɛ˨˩˦
rẻo	ʐeo˨˩˦
rẽ	ʐɛ˨˩˦
rế	ʐe˦˥
rếch	ʐet˦˥
rết	ʐet˦˥
rề	ʐe˧˨
rền	ʐen˧˨
rềnh	ʐen˧˨
rể	ʐe˨˩˦
rểnh	ʐen˨˩˦
rễ	ʐe˨˩˦
rệp	ʐep˨˩˨
rệu	ʐɛu˨˩˨
rỉ	ʐi˨˩˦
rỉa	ʐiə˨˩˦
rị	ʐi˨˩˨
rịa-vũng	ʐiə˨˩˨-juŋm˨˩˦
rịch	ʐit˨˩˨
rọ	ʐɔ˨˩˨
rọc	ʐɔkp˨˩˨
rọt	ʐɔkp˨˩˨
rỏ	ʐɔ˨˩˦
rốc	ʐokp˦˥
rối	ʐoj˦˥
rốn	ʐoŋm˦˥
rống	ʐoŋm˦˥
rốt	tut˧
rốt	ʐokp˦˥
rồ	sɛ˧
rồ	ʐo˧˨
rồi	ʐoj˧˨
rồm	ʐom˧˨
rồn	ʐoŋm˧˨
rồng	ʐoŋm˧˨
rổ	ʐo˨˩˦
rổn	ʐoŋm˨˩˦
rỗ	ʐo˨˩˦
rỗi	ʐoj˨˩˦
rỗng	ʐoŋm˨˩˦
rộ	ʐo˨˩˨
rộc	ʐokp˨˩˨
rộn	ʐoŋm˨˩˨
rộng	ʐoŋm˨˩˨
rột	ʐokp˨˩˨
rớt	ʐɤk˦˥
rờ	ʐɤ˧˨
rời	ʐɤj˧˨
rờm	ʐɤm˧˨
rờn	ʐɤŋ˧˨
rởm	ʐɤm˨˩˦
rởn	ʐɤŋ˨˩˦
rỡ	ʐɤ˨˩˦
rợ	ʐɤ˨˩˨
rợn	ʐɤŋ˨˩˨
rợp	ʐɤp˨˩˨
rụ	ʐu˨˩˨
rục	ʐukp˨˩˨
rụng	ʐuŋm˨˩˨
rụp	ʐup˨˩˨
rụt	ʐukp˨˩˨
rủ	ʐu˨˩˦
rủa	ʐuə˨˩˦
rủi	ʐuj˨˩˦
rủn	ʐuŋm˨˩˦
rủng	ʐuŋm˨˩˦
rứt	ʐɯk˦˥
rừng	ʐɯŋ˧˨
rửa	ʐɯə˨˩˦
rửng	ʐɯŋ˨˩˦
rữa	ʐɯə˨˩˦
rựa	ʐɯə˨˩˨
rực	ʐɯk˨˩˨
sa	ʂa˧˧
sai	ʂaj˧˧
sam	ʂam˧˧
san	ʂaŋ˧˧
sang	ʂaŋ˧˧
sanh	ʂan˧˧
sao	ʂaw˧˧
sau	ʂăw˧˧
say	ʂăj˧˧
se	ʂɛ˧˧
sen	ʂɛŋ˧˧
seo	ʂeo˧˧
si	ʂi˧˧
sim	ʂim˧˧
sin	ʂin˧˧
sinh	ʂin˧˧
siêng	ʂiəŋ˧˧
siêu	ʂiəw˧˧
siết	ʂiək˦˥
siểm	ʂim˨˩˦
so	ʂɔ˧˧
soi	ʂɔj˧˧
son	ʂɔŋm˧˧
song	ʂɔŋm˧˧
soàm	ʂwam˧˨
soàn	ʂwaŋ˧˨
soái	ʂwaj˦˥
soán	ʂwaŋ˦˥
soát	ʂwat˦˥
soạn	ʂwaŋ˨˩˨
su	ʂu˧˧
sui	ʂuj˧˧
sum	ʂum˧˧
sun	ʂuŋm˧˧
sun-phát	ʂuŋm˧˧-fat˦˥
sung	ʂuŋm˧˧
suy	ʂwi˧˧
suôn	ʂuəŋ˧˧
suông	ʂuəŋ˧˧
suý	ʂwi˦˥
suýt	ʂwit˦˥
suất	ʂwɤ̆k˦˥
suối	ʂuəj˦˥
suốt	sot˧
suốt	suku˧
suốt	ʂuək˦˥
suốt	ʃuːt˧
suồng	ʂuəŋ˧˨
suỵt	ʂwit˨˩˨
sà	ʂa˧˨
sài	ʂaj˧˨
sàm	ʂam˧˨
sàn	ʂaŋ˧˨
sàng	ʂaŋ˧˨
sành	ʂan˧˨
sào	ʂaw˧˨
sá	ʂa˦˥
sách	ʂat˦˥
sái	ʂaj˦˥
sám	ʂam˦˥
sán	ʂaŋ˦˥
sáng	ʂaŋ˦˥
sánh	ʂan˦˥
sáo	ʂaw˦˥
sáp	ʂap˦˥
sát	ʂat˦˥
sáu	ʂăw˦˥
sâm	ʂɤ̆m˧˧
sân	ʂɤ̆ŋ˧˧
sâu	ʂɤ̆w˧˧
sây	ʂɤ̆j˧˧
sã	ʂa˨˩˦
sãi	ʂaj˨˩˦
sè	ʂɛ˧˨
sém	ʂɛm˦˥
sét	ʂɛt˦˥
sê	ʂe˧˧
sên	ʂen˧˧
sênh	ʂen˧˧
sêu	ʂɛu˧˧
sì	ʂi˧˨
sìn	ʂin˧˨
sình	ʂin˧˨
sín	ʂin˦˥
sính	ʂin˦˥
sít	ʂit˦˥
sò	ʂɔ˧˨
sòm	ʂɔm˧˨
sòn	ʂɔŋm˧˨
sòng	ʂɔŋm˧˨
sóc	ʂɔkp˦˥
sói	ʂɔj˦˥
sóm	ʂɔm˦˥
sóng	ʂɔŋm˦˥
sót	ʂɔkp˦˥
sô	ʂo˧˧
sô-vanh	ʂo˧˧-jan˧˧
sôi	ʂoj˧˧
sông	ʂoŋm˧˧
sõi	ʂɔj˨˩˦
sõng	ʂɔŋm˨˩˦
sù	ʂu˧˨
sùi	ʂuj˧˨
sùm	ʂum˧˨
sùng	ʂuŋm˧˨
sú	ʂu˦˥
súc	ʂukp˦˥
sún	ʂuŋm˦˥
súng	ʂuŋm˦˥
súp	ʂup˦˥
sút	ʂukp˦˥
súy	ʂuj˦˥
săm	ʂăm˧˧
săn	ʂăŋ˧˧
săng	ʂăŋ˧˧
sĩ	ʂi˨˩˦
sơ	ʂɤ˧˧
sơm	ʂɤm˧˧
sơn	ʂɤŋ˧˧
sư	ʂɯ˧˧
sưng	ʂɯŋ˧˧
sưu	ʂɯw˧˧
sương	ʂɯəŋ˧˧
sướng	ʂɯəŋ˦˥
sướt	ʂɯək˦˥
sườn	ʂɯəŋ˧˨
sường	ʂɯəŋ˧˨
sưởi	ʂɯəj˨˩˦
sượng	ʂɯəŋ˨˩˨
sạch	ʂat˨˩˨
sạm	ʂam˨˩˨
sạn	ʂaŋ˨˩˨
sạo	ʂaw˨˩˨
sạp	ʂap˨˩˨
sạt	ʂat˨˩˨
sả	ʂa˨˩˦
sải	ʂaj˨˩˦
sản	ʂaŋ˨˩˦
sảng	ʂaŋ˨˩˦
sảnh	ʂan˨˩˦
sảo	ʂaw˨˩˦
sảy	ʂăj˨˩˦
sấm	ʂɤ̆m˦˥
sấn	ʂɤ̆ŋ˦˥
sấp	ʂɤ̆p˦˥
sấy	ʂɤ̆j˦˥
sầm	ʂɤ̆m˧˨
sần	ʂɤ̆ŋ˧˨
sầu	ʂɤ̆w˧˨
sầy	ʂɤ̆j˧˨
sẩm	ʂɤ̆m˨˩˦
sẩy	ʂɤ̆j˨˩˦
sậm	ʂɤ̆m˨˩˨
sập	ʂɤ̆p˨˩˨
sắc	ʂăk˦˥
sắm	ʂăm˦˥
sắn	ʂăŋ˦˥
sắp	ʂăp˦˥
sắt	ʂăk˦˥
sằng	ʂăŋ˧˨
sẵn	ʂăŋ˨˩˦
sẵp	ʂăp˨˩˦
sặc	ʂăk˨˩˨
sặm	ʂăm˨˩˨
sặt	ʂăk˨˩˨
sẹo	ʂeo˨˩˨
sẻ	ʂɛ˨˩˦
sẻn	ʂɛŋ˨˩˦
sẽ	ʂɛ˨˩˦
sến	ʂen˦˥
sếp	ʂep˦˥
sếu	ʂɛu˦˥
sề	ʂe˧˨
sền	ʂen˧˨
sềnh	ʂen˧˨
sểnh	ʂen˨˩˦
sệ	ʂe˨˩˨
sỉ	ʂi˨˩˦
sỉa	ʂiə˨˩˦
sịt	ʂit˨˩˨
sọ	ʂɔ˨˩˨
sọm	ʂɔm˨˩˨
sọt	ʂɔkp˨˩˨
sỏi	ʂɔj˨˩˦
số	ʂo˦˥
sống	ʂoŋm˦˥
sốp	ʂop˦˥
sốt	ʂokp˦˥
sồ	ʂo˧˨
sồi	ʂoj˧˨
sồn	ʂoŋm˧˨
sồng	ʂoŋm˧˨
sổ	ʂo˨˩˦
sổng	ʂoŋm˨˩˦
sỗ	ʂo˨˩˦
sộc	ʂokp˨˩˨
sột	ʂokp˨˩˨
sớ	ʂɤ˦˥
sớm	ʂɤm˦˥
sớn	ʂɤŋ˦˥
sờ	ʂɤ˧˨
sờm	ʂɤm˧˨
sờn	ʂɤŋ˧˨
sở	ʂɤ˨˩˦
sởn	ʂɤŋ˨˩˦
sợ	sɨ˧
sợ	ʂɤ˨˩˨
sợ	ʃɔ˧
sợ	˥˩˧
sợi	ʂɤj˨˩˨
sụ	ʂu˨˩˨
sục	ʂukp˨˩˨
sụm	ʂum˨˩˨
sụn	ʂuŋm˨˩˨
sụp	ʂup˨˩˨
sụt	ʂukp˨˩˨
sủ	ʂu˨˩˦
sủa	ʂuə˨˩˦
sủi	ʂuj˨˩˦
sủng	ʂuŋm˨˩˦
sứ	ʂɯ˦˥
sứa	ʂɯə˦˥
sức	huk˧
sức	ʂɯk˦˥
sứt	ʂɯk˦˥
sừn	ʂɯŋ˧˨
sừng	ʂɯŋ˧˨
sử	ʂɯ˨˩˦
sửa	ʂɯə˨˩˦
sửng	ʂɯŋ˨˩˦
sữa	ʂɯə˨˩˦
sững	ʂɯŋ˨˩˦
sự	suː˧
sự	əm˧
sự	ɛt˧
sự	ʂɨ˧
sự	ʂɯ˨˩˨
sự	ʃu˧
sự	ʃɛ˧
sự	˥˩˧
sực	ʂɯk˨˩˨
sựng	ʂɯŋ˨˩˨
sỹ	ʂi˨˩˦
ta	taka˧
ta	tako˧
ta	ta˧
ta	ta˧˧
tai	taj˧˧
tam	tam˧˧
tan	taŋ˧˧
tang	taŋ˧˧
tanh	tan˧˧
tao	taw˧
tao	taw˧˧
tao	taː˧˥˧
tay	tăj˧˧
te	tɛ˧˧
tem	tɛm˧˧
ten	tɛŋ˧˧
teng	tɛŋ˧˧
teo	teo˧˧
tha	tʰa˧˧
thai	tʰaj˧˧
tham	tʰam˧˧
than	tʰaŋ˧˧
thang	tʰaŋ˧˧
thanh	tʰan˧˧
thao	tʰaw˧˧
thau	tʰăw˧˧
thay	tʰăj˧˧
the	tʰɛ˧˧
then	tʰɛŋ˧˧
theo	tʰeo˧˧
thi	tʰi˧˧
thia	tʰiə˧˧
thin	tʰin˧˧
thinh	tʰin˧˧
thiu	tʰiw˧˧
thiêm	tʰim˧˧
thiên	tʰiəŋ˧˧
thiêng	tʰiəŋ˧˧
thiêu	tʰiəw˧˧
thiếc	tʰiək˦˥
thiếp	tʰip˦˥
thiết	tʰiək˦˥
thiếu	tʰiəw˦˥
thiềm	tʰim˧˨
thiền	tʰiəŋ˧˨
thiều	tʰiəw˧˨
thiểm	tʰim˨˩˦
thiển	tʰiəŋ˨˩˦
thiểu	tʰiəw˨˩˦
thiện	tʰiəŋ˨˩˨
thiệp	tʰip˨˩˨
thiệt	tʰiək˨˩˨
thiệu	tʰiəw˨˩˨
thoa	tʰwa˧˧
thoai	tʰwaj˧˧
thoang	tʰwaŋ˧˧
thoi	tʰɔj˧˧
thom	tʰɔm˧˧
thon	tʰɔŋm˧˧
thong	tʰɔŋm˧˧
thoá	tʰwa˦˥
thoái	tʰwaj˦˥
thoán	tʰwaŋ˦˥
thoáng	tʰwaŋ˦˥
thoát	tʰwat˦˥
thoòng	tʰɔŋm˧˨
thoăn	tʰwăŋ˧˧
thoại	tʰwaj˨˩˨
thoạt	tʰwat˨˩˨
thoả	tʰwa˨˩˦
thoải	tʰwaj˨˩˦
thoảng	tʰwaŋ˨˩˦
thoắt	tʰwăk˦˥
thu	tʰu˧˧
thua	tʰuə˧˧
thui	tʰuj˧˧
thum	tʰum˧˧
thun	tʰuŋm˧˧
thung	tʰuŋm˧˧
thuyên	tʰwiəŋ˧˧
thuyết	tʰwiək˦˥
thuyền	tʰwiəŋ˧˨
thuê	tʰwe˧˧
thuôn	tʰuəŋ˧˧
thuông	tʰuəŋ˧˧
thuý	tʰwi˦˥
thuần	tʰwɤ̆ŋ˧˨
thuận	tʰwɤ̆ŋ˨˩˨
thuật	tʰwɤ̆k˨˩˨
thuế	tʰwe˦˥
thuể	tʰwe˨˩˦
thuốc	tʰuək˦˥
thuồi	tʰuəj˧˨
thuồn	tʰuəŋ˧˨
thuồng	tʰuəŋ˧˨
thuộc	tʰuək˨˩˨
thuở	tʰuə˨˩˦
thuỳ	tʰwi˧˨
thuỵ	tʰwi˨˩˨
thuỷ	tʰwi˨˩˦
thà	tʰa˧˨
thài	tʰaj˧˨
thàm	tʰam˧˨
thành	tʰan˧˨
thào	tʰaw˧˨
thày	tʰăj˧˨
thác	tʰak˦˥
thách	tʰat˦˥
thái	tʰaj˦˥
thám	tʰam˦˥
thán	tʰaŋ˦˥
tháng	tʰaŋ˦˥
thánh	tʰan˦˥
tháo	tʰaw˦˥
tháp	tʰap˦˥
thát	tʰat˦˥
tháu	tʰăw˦˥
tháy	tʰăj˦˥
thâm	tʰɤ̆m˧˧
thân	tʰɤ̆ŋ˧˧
thâu	tʰɤ̆w˧˧
thây	tʰɤ̆j˧˧
thè	tʰɛ˧˨
thèm	tʰɛm˧˨
thèn	tʰɛŋ˧˨
thèo	tʰeo˧˨
thép	tʰɛp˦˥
thét	tʰɛt˦˥
thê	tʰe˧˧
thêm	tʰem˧˧
thênh	tʰen˧˧
thêu	tʰɛu˧˧
thì	tʰi˧˨
thìa	tʰiə˧˨
thình	tʰin˧˨
thí	tʰi˦˥
thích	tʰit˦˥
thính	tʰin˦˥
thít	tʰit˦˥
thò	tʰɔ˧˨
thòi	tʰɔj˧˨
thòm	tʰɔm˧˨
thòng	tʰɔŋm˧˨
thóa	tʰwa˦˥
thóc	tʰɔkp˦˥
thói	tʰɔj˦˥
thô	tʰo˧˧
thôi	tʰoj˧˧
thôn	tʰoŋm˧˧
thông	tʰoŋm˧˧
thõng	tʰɔŋm˨˩˦
thù	tʰu˧˨
thùa	tʰuə˧˨
thùi	tʰuj˧˨
thùm	tʰum˧˨
thùn	tʰuŋm˧˨
thùng	tʰuŋm˧˨
thùy	tʰuj˧˨
thú	tʰu˦˥
thúc	tʰukp˦˥
thúng	tʰuŋm˦˥
thút	tʰukp˦˥
thăm	tʰăm˧˧
thăn	tʰăŋ˧˧
thăng	tʰăŋ˧˧
thũng	tʰuŋm˨˩˦
thơ	tʰɤ˧˧
thơm	tʰɤm˧˧
thơn	tʰɤŋ˧˧
thư	tʰɯ˧˧
thưa	tʰɯə˧˧
thưng	tʰɯŋ˧˧
thương	tʰɯəŋ˧˧
thước	tʰɯək˦˥
thướt	tʰɯək˦˥
thười	tʰɯəj˧˨
thườn	tʰɯəŋ˧˨
thường	tʰɯəŋ˧˨
thưởng	tʰɯəŋ˨˩˦
thưỡn	tʰɯəŋ˨˩˦
thược	tʰɯək˨˩˨
thượng	tʰɯəŋ˨˩˨
thạc	tʰak˨˩˨
thạch	tʰat˨˩˨
thạnh	tʰan˨˩˨
thạo	tʰaw˨˩˨
thả	tʰa˨˩˦
thải	tʰaj˨˩˦
thảm	tʰam˨˩˦
thản	tʰaŋ˨˩˦
thảng	tʰaŋ˨˩˦
thảnh	tʰan˨˩˦
thảo	tʰaw˨˩˦
thảy	tʰăj˨˩˦
thấm	tʰɤ̆m˦˥
thấp	tʰɤ̆p˦˥
thất	tʰɤ̆k˦˥
thấu	tʰɤ̆w˦˥
thấy	tʰɤ̆j˦˥
thầm	tʰɤ̆m˧˨
thần	tʰɤ̆ŋ˧˨
thầu	tʰɤ̆w˧˨
thầy	tʰɤ̆j˧˨
thẩm	tʰɤ̆m˨˩˦
thẩn	tʰɤ̆ŋ˨˩˦
thẩu	tʰɤ̆w˨˩˦
thẫn	tʰɤ̆ŋ˨˩˦
thậm	tʰɤ̆m˨˩˨
thận	tʰɤ̆ŋ˨˩˨
thập	tʰɤ̆p˨˩˨
thật	tɔp˧
thật	tʰɤ̆k˨˩˨
thật	tˌɑt˧
thắc	tʰăk˦˥
thắm	tʰăm˦˥
thắng	tʰăŋ˦˥
thắp	tʰăp˦˥
thắt	tʰăk˦˥
thằn	tʰăŋ˧˨
thằng	tʰăŋ˧˨
thẳm	tʰăm˨˩˦
thẳng	tʰăŋ˨˩˦
thặng	tʰăŋ˨˩˨
thẹn	tʰɛŋ˨˩˨
thẹp	tʰɛp˨˩˨
thẻ	tʰɛ˨˩˦
thẽ	tʰɛ˨˩˦
thế	tʰe˦˥
thếp	tʰep˦˥
thết	tʰet˦˥
thề	tʰe˧˨
thềm	tʰem˧˨
thều	tʰɛu˧˨
thể	tʰe˨˩˦
thệ	tʰe˨˩˨
thỉ	tʰi˨˩˦
thỉnh	tʰin˨˩˦
thị	tʰi˨˩˨
thịch	tʰit˨˩˨
thịnh	tʰin˨˩˨
thịt	tʰit˨˩˨
thọ	tʰɔ˨˩˨
thọc	tʰɔkp˨˩˨
thỏ	tʰɔ˨˩˦
thỏa	tʰwa˨˩˦
thố	tʰo˦˥
thốc	tʰokp˦˥
thối	tʰoj˦˥
thốn	tʰoŋm˦˥
thống	tʰoŋm˦˥
thốt	tʰokp˦˥
thồ	tʰo˧˨
thồm	tʰom˧˨
thồn	tʰoŋm˧˨
thổ	tʰo˨˩˦
thổi	tʰoj˨˩˦
thổn	tʰoŋm˨˩˦
thỗn	tʰoŋm˨˩˦
thộp	tʰop˨˩˨
thớ	tʰɤ˦˥
thới	tʰɤj˦˥
thớt	tʰɤk˦˥
thờ	tʰɤ˧˨
thời	tʰɤj˧˨
thờn	tʰɤŋ˧˨
thở	tʰɤ˨˩˦
thợ	tʰɤ˨˩˨
thụ	tʰu˨˩˨
thục	tʰukp˨˩˨
thụng	tʰuŋm˨˩˨
thụp	tʰup˨˩˨
thụt	tʰukp˨˩˨
thụy	tʰuj˨˩˨
thủ	tʰu˨˩˦
thủa	tʰuə˨˩˦
thủi	tʰuj˨˩˦
thủng	tʰuŋm˨˩˦
thủy	tʰuj˨˩˦
thứ	tʰɯ˦˥
thứ	va˧
thức	tʰɯk˦˥
thừa	tʰɯə˧˨
thừng	tʰɯŋ˧˨
thử	tʰɯ˨˩˦
thự	tʰɯ˨˩˨
thực	tʰɯk˨˩˨
ti	ti˧˧
tia	tiə˧˧
tim	tim˧˧
tin	tin˧˧
tinh	tin˧˧
tiu	tiw˧˧
tiêm	tim˧˧
tiên	tiəŋ˧˧
tiêng	tiəŋ˧˧
tiêu	tiəw˧˧
tiếc	tiək˦˥
tiếm	tim˦˥
tiến	tiəŋ˦˥
tiếng	tiəŋ˦˥
tiếp	tip˦˥
tiết	tiək˦˥
tiếu	tiəw˦˥
tiềm	tim˧˨
tiền	tiəŋ˧˨
tiều	tiəw˧˨
tiểu	tiəw˨˩˦
tiễn	tiəŋ˨˩˦
tiễu	tiəw˨˩˦
tiệc	tiək˨˩˨
tiệm	tim˨˩˨
tiện	tiəŋ˨˩˨
tiệp	tip˨˩˨
tiệt	tiək˨˩˨
to	tɔ˧˧
toa	twa˧˧
toan	twaŋ˧˧
toang	twaŋ˧˧
toe	twe˧˧
toen	twen˧˧
toi	tɔj˧˧
tom	tɔm˧˧
ton	tɔŋm˧˧
tong	tɔŋm˧˧
toong	tɔŋm˧˧
top	tɔp˧˧
toà	twa˧˨
toàn	twaŋ˧˨
toá	twa˦˥
toác	twak˦˥
toán	twaŋ˦˥
toát	twat˦˥
toèn	twen˧˨
toé	twe˦˥
toét	twet˦˥
toòng	tɔŋm˧˨
toạ	twa˨˩˨
toạc	twak˨˩˨
toại	twaj˨˩˨
toả	twa˨˩˦
tra	ʈa˧˧
trai	ʈaj˧˧
trang	ʈaŋ˧˧
tranh	ʈan˧˧
trao	ʈaw˧˧
trau	ʈăw˧˧
tre	ʈɛ˧˧
treo	ʈeo˧˧
tri	ʈi˧˧
trinh	ʈin˧˧
triêu	ʈiəw˧˧
triết	ʈiək˦˥
triền	ʈiəŋ˧˨
triều	ʈiəw˧˨
triển	ʈiəŋ˨˩˦
triệt	ʈiək˨˩˨
triệu	ʈiəw˨˩˨
tro	ʈɔ˧˧
trong	ʈɔŋm˧˧
tru	ʈu˧˧
trui	ʈuj˧˧
trung	ʈuŋm˧˧
truy	ʈwi˧˧
truyền	ʈwiəŋ˧˨
truyện	ʈwiəŋ˨˩˨
truân	ʈwɤ̆ŋ˧˧
truông	ʈuəŋ˧˧
truất	ʈwɤ̆k˦˥
truồng	ʈuəŋ˧˨
truỵ	ʈwi˨˩˨
trà	ʈa˧˨
trài	ʈaj˧˨
tràm	ʈam˧˨
tràn	ʈaŋ˧˨
tràng	ʈaŋ˧˨
trào	ʈaw˧˨
trày	ʈăj˧˨
trá	ʈa˦˥
trác	ʈak˦˥
trách	ʈat˦˥
trái	ʈaj˦˥
trám	ʈam˦˥
trán	ʈaŋ˦˥
tráng	ʈaŋ˦˥
tránh	ʈan˦˥
tráo	ʈaw˦˥
trát	ʈat˦˥
trâm	ʈɤ̆m˧˧
trân	ʈɤ̆ŋ˧˧
trâng	ʈɤ̆ŋ˧˧
trâu	ʈɤ̆w˧˧
trây	ʈɤ̆j˧˧
trèn	ʈɛŋ˧˨
trèo	ʈeo˧˨
tréc	ʈɛk˦˥
trém	ʈɛm˦˥
tréo	ʈeo˦˥
trét	ʈɛt˦˥
trê	ʈe˧˧
trên	ʈen˧˧
trêu	ʈɛu˧˧
trì	ʈi˧˨
trình	ʈin˧˨
trìu	ʈiw˧˨
trí	ʈi˦˥
trích	ʈit˦˥
trò	ʈɔ˧˨
tròi	ʈɔj˧˨
tròm	ʈɔm˧˨
tròn	ʈɔŋm˧˨
tròng	ʈɔŋm˧˨
tróc	ʈɔkp˦˥
trói	ʈɔj˦˥
tróm	ʈɔm˦˥
tróng	ʈɔŋm˦˥
trót	ʈɔkp˦˥
trô	ʈo˧˧
trôi	ʈoj˧˧
trôn	ʈoŋm˧˧
trông	ʈoŋm˧˧
trù	ʈu˧˨
trùi	ʈuj˧˨
trùm	ʈum˧˨
trùng	ʈuŋm˧˨
trú	ʈu˦˥
trúc	ʈukp˦˥
trúng	ʈuŋm˦˥
trút	ʈukp˦˥
trăm	ʈăm˧˧
trăn	ʈăŋ˧˧
trăng	ʈăŋ˧˧
trĩ	ʈi˨˩˦
trĩu	ʈiw˨˩˦
trơ	ʈɤ˧˧
trơn	ʈɤŋ˧˧
trưa	ʈɯə˧˧
trưng	ʈɯŋ˧˧
trương	ʈɯəŋ˧˧
trước	ʈɯək˦˥
trướng	ʈɯəŋ˦˥
trường	ʈɯəŋ˧˨
trưởng	ʈɯəŋ˨˩˦
trượng	ʈɯəŋ˨˩˨
trượt	ʈɯək˨˩˨
trạch	ʈat˨˩˨
trại	ʈaj˨˩˨
trạm	ʈam˨˩˨
trạng	ʈaŋ˨˩˨
trả	ʈa˨˩˦
trải	ʈaj˨˩˦
trảm	ʈam˨˩˦
trảng	ʈaŋ˨˩˦
trảo	ʈaw˨˩˦
trấn	ʈɤ̆ŋ˦˥
trất	ʈɤ̆k˦˥
trấu	ʈɤ̆w˦˥
trầm	ʈɤ̆m˧˨
trần	ʈɤ̆ŋ˧˨
trầu	ʈɤ̆w˧˨
trầy	ʈɤ̆j˧˨
trẩu	ʈɤ̆w˨˩˦
trẩy	ʈɤ̆j˨˩˦
trẫm	ʈɤ̆m˨˩˦
trậm	ʈɤ̆m˨˩˨
trận	ʈɤ̆ŋ˨˩˨
trập	ʈɤ̆p˨˩˨
trật	ʈɤ̆k˨˩˨
trắc	ʈăk˦˥
trắm	ʈăm˦˥
trắng	ʈăŋ˦˥
trằm	ʈăm˧˨
trằn	ʈăŋ˧˨
trằng	ʈăŋ˧˨
trẹo	ʈeo˨˩˨
trẹt	ʈɛt˨˩˨
trẻ	ʈɛ˨˩˦
trẽn	ʈɛŋ˨˩˦
trẽo	ʈeo˨˩˦
trết	ʈet˦˥
trếu	ʈɛu˦˥
trề	ʈe˧˨
trễ	ʈe˨˩˦
trệ	ʈe˨˩˨
trệt	ʈet˨˩˨
trệu	ʈɛu˨˩˨
trị	ʈi˨˩˨
trịch	ʈit˨˩˨
trịnh	ʈin˨˩˨
trọ	ʈɔ˨˩˨
trọc	ʈɔkp˨˩˨
trọi	ʈɔj˨˩˨
trọn	ʈɔŋm˨˩˨
trọng	ʈɔŋm˨˩˨
trỏ	ʈɔ˨˩˦
trốc	ʈokp˦˥
trối	ʈoj˦˥
trốn	ʈoŋm˦˥
trống	ʈoŋm˦˥
trồng	ʈoŋm˧˨
trổ	ʈo˨˩˦
trổi	ʈoj˨˩˦
trỗ	ʈo˨˩˦
trỗi	ʈoj˨˩˦
trộc	ʈokp˨˩˨
trội	ʈoj˨˩˨
trộm	ʈom˨˩˨
trộn	ʈoŋm˨˩˨
trớ	ʈɤ˦˥
trớn	ʈɤŋ˦˥
trớt	ʈɤk˦˥
trờ	ʈɤ˧˨
trời	ʈɤj˧˨
trờn	ʈɤŋ˧˨
trở	ʈɤ˨˩˦
trợ	ʈɤ˨˩˨
trợn	ʈɤŋ˨˩˨
trợt	ʈɤk˨˩˨
trụ	ʈu˨˩˨
trục	ʈukp˨˩˨
trụi	ʈuj˨˩˨
trụy	ʈuj˨˩˨
trủng	ʈuŋm˨˩˦
trứ	ʈɯ˦˥
trứng	ʈɯŋ˦˥
trừ	ʈɯ˧˨
trừng	ʈɯŋ˧˨
trừu	ʈɯw˧˨
trữ	ʈɯ˨˩˦
trực	ʈɯk˨˩˨
tu	tu˧˧
tua	tuə˧˧
tum	tum˧˧
tun	tuŋm˧˧
tung	tuŋm˧˧
tuy	twi˧
tuy	twi˧˧
tuyên	twiəŋ˧˧
tuyến	twiəŋ˦˥
tuyết	twiək˦˥
tuyền	twiəŋ˧˨
tuyển	twiəŋ˨˩˦
tuyệt	twiək˨˩˨
tuân	twɤ̆ŋ˧˧
tuôn	tuəŋ˧˧
tuý	twi˦˥
tuýt	twit˦˥
tuấn	twɤ̆ŋ˦˥
tuần	twɤ̆ŋ˧˨
tuẫn	twɤ̆ŋ˨˩˦
tuế	twe˦˥
tuếch	twet˦˥
tuềnh	twen˧˨
tuệ	twe˨˩˨
tuệch	twet˨˩˨
tuốt	tuək˦˥
tuồn	tuəŋ˧˨
tuồng	tuəŋ˧˨
tuổi	tuəj˨˩˦
tuột	tuək˨˩˨
tuỳ	twi˧˨
tuỷ	twi˨˩˦
ty	ti˧˧
tà	ta˧˨
tài	taj˧˨
tàm	tam˧˨
tàn	tanta˨˩
tàn	taŋ˧˨
tàng	taŋ˧˨
tành	tan˧˨
tào	taw˧˨
tàu	tăw˧˨
tày	tăj˧˨
tá	ta˦˥
tác	tak˦˥
tách	tat˦˥
tái	taj˦˥
tám	tam˦˥
tán	taŋ˦˥
táng	taŋ˦˥
tánh	tan˦˥
táo	taw˦˥
táp	tap˦˥
tát	tat˦˥
táy	tăj˦˥
tâm	tɤ̆m˧˧
tân	tɤ̆ŋ˧˧
tâng	tɤ̆ŋ˧˧
tâu	tɤ̆w˧˧
tây	tɤ̆j˧˧
tã	ta˨˩˦
tè	tɛ˧˨
tèm	tɛm˧˨
tèn	tɛŋ˧˨
tèng	tɛŋ˧˨
tèo	teo˧˨
té	tɛ˦˥
tén	tɛŋ˦˥
tép	tɛp˦˥
tê	te˧˧
têm	tem˧˧
tên	ten˧˧
tên	tən˧˥˧
tênh	ten˧˧
tì	ti˧˨
tìm	tim˧˨
tình	tin˧˨
tình	tiŋkɤ˨˩
tí	ti˦˥
tía	tiə˦˥
tích	tit˦˥
tím	tim˦˥
tín	tin˦˥
tính	tin˦˥
típ	tip˦˥
tít	tit˦˥
tíu	tiw˦˥
tò	tɔː˨˩
tò	tɔ˧˨
tòa	twa˧˨
tòm	tɔm˧˨
tòn	tɔŋm˧˨
tòng	tɔŋm˧˨
tóc	tɔkp˦˥
tóe	twe˦˥
tóm	tɔm˦˥
tóp	tɔp˦˥
tót	tɔkp˦˥
tô	to˧˧
tô-pô	to˧˧-po˧˧
tô-tem	to˧˧-tɛm˧˧
tôi	toji˧
tôi	toj˧
tôi	toj˧˧
tôm	tom˧˧
tôn	toŋm˧˧
tông	toŋm˧˧
tù	tu˧˨
tùm	tum˧˨
tùng	tuŋm˧˨
tùy	tuj˧˨
tú	tu˦˥
túc	tukp˦˥
túi	tuj˦˥
túm	tum˦˥
túng	tuŋm˦˥
túp	tup˦˥
túy	tuj˦˥
tăm	tăm˧˧
tăng	tăŋ˧˧
tĩnh	tin˨˩˦
tơ	tɤ˧˧
tơi	tɤj˧˧
tư	tɯ˧
tư	tɯ˧˧
tưng	tɯŋ˧˧
tươi	tɯəj˧˧
tươm	tɯm˧˧
tương	tɯəŋ˧˧
tước	tɯək˦˥
tưới	tɯəj˦˥
tướng	tɯəŋ˦˥
tướt	tɯək˦˥
tườm	tɯm˧˨
tường	tɯəŋ˧˨
tườu	tɯəw˧˨
tưởng	tɯəŋ˨˩˦
tượng	tɯəŋ˨˩˨
tạ	ta˨˩˨
tạc	tak˨˩˨
tại	taj˨˩˨
tạm	tak˨˩˨
tạm	tam˨˩˨
tạng	taŋ˨˩˨
tạnh	tan˨˩˨
tạo	taw˨˩˨
tạp	tap˨˩˨
tạt	tat˨˩˨
tả	ta˨˩˦
tải	taj˨˩˦
tản	taŋ˨˩˦
tảng	taŋ˨˩˦
tảo	taw˨˩˦
tấc	tɤ̆k˦˥
tấm	tɤ̆m˦˥
tấn	tɤ̆ŋ˦˥
tấp	tɤ̆p˦˥
tất	tɔk˧
tất	tɔ˧
tất	tɤt˧
tất	tɤ̆k˦˥
tất	tɨ˧
tất	tˈɔt˧
tất	tˈɪt˧
tấu	tɤ̆w˦˥
tầm	ma˧
tầm	tɤ̆m˧˨
tần	tɤ̆ŋ˧˨
tầng	tɤ̆ŋ˧˨
tầu	tɤ̆w˧˨
tầy	tɤ̆j˧˨
tẩm	tɤ̆m˨˩˦
tẩn	tɤ̆ŋ˨˩˦
tẩu	tɤ̆w˨˩˦
tẩy	tɤ̆j˨˩˦
tậm	tɤ̆m˨˩˨
tận	tɤ̆ŋ˨˩˨
tập	tɤ̆p˨˩˨
tật	tɤ̆k˨˩˨
tậu	tɤ̆w˨˩˨
tắc	tăk˦˥
tắm	tăm˦˥
tắp	tăp˦˥
tắt	dɛ˧
tắt	tăk˦˥
tằm	tăm˧˨
tằn	tăŋ˧˨
tằng	tăŋ˧˨
tẳn	tăŋ˨˩˦
tặc	tăk˨˩˨
tặng	tăŋ˨˩˨
tẹp	tɛp˨˩˨
tẹt	tɛt˨˩˨
tẻ	tɛ˨˩˦
tẻo	teo˨˩˦
tẽn	tɛŋ˨˩˦
tế	te˦˥
tếch	tet˦˥
tết	tet˦˥
tếu	tɛu˦˥
tề	te˧˨
tềnh	ten˧˨
tể	te˨˩˦
tễ	te˨˩˦
tệ	te˨˩˨
tỉ	ti˨˩˦
tỉa	tiə˨˩˦
tỉm	tim˨˩˦
tỉnh	tin˨˩˦
tỉu	tiw˨˩˦
tị	ti˨˩˨
tịch	tit˨˩˨
tịnh	tin˨˩˨
tịt	tit˨˩˨
tọa	twa˨˩˨
tọc	tɔkp˨˩˨
tọt	tɔkp˨˩˨
tỏ	tɔ˨˩˦
tỏa	twa˨˩˦
tỏi	tɔj˨˩˦
tỏm	tɔm˨˩˦
tỏng	tɔŋm˨˩˦
tố	to˦˥
tốc	tokp˦˥
tối	toj˦˥
tốn	toŋm˦˥
tống	toŋm˦˥
tốp	top˦˥
tốt	dɛ˧
tốt	tokp˦˥
tồ	to˧˨
tồi	toj˧˨
tồm	tom˧˨
tồn	toŋm˧˨
tồng	toŋm˧˨
tổ	to˨˩˦
tổn	toŋm˨˩˦
tổng	toŋm˨˩˦
tộc	tokp˨˩˨
tộc-ngôn	tokp˨˩˨-ŋoŋm˧˧
tội	toj˨˩˨
tột	tokp˨˩˨
tớ	tɤ˦˥
tới	tɤj˦˥
tớn	tɤŋ˦˥
tờ	tɤ˧˨
tở	tɤ˨˩˦
tởm	tɤm˨˩˦
tợn	tɤŋ˨˩˨
tụ	tu˨˩˨
tục	tukp˨˩˨
tụi	tuj˨˩˨
tụm	tum˨˩˨
tụng	tuŋm˨˩˨
tụt	tukp˨˩˨
tụy	tuj˨˩˨
tủ	tu˨˩˦
tủa	tuə˨˩˦
tủi	tuj˨˩˦
tủm	tum˨˩˦
tủn	tuŋm˨˩˦
tủng	tuŋm˨˩˦
tủy	tuj˨˩˦
tứ	tɯ˦˥
tức	tɯk˦˥
từ	do˧
từ	tɤ˧
từ	tɨ˧
từ	tɯ˧˨
từ	tˈu˧
từ	tˈy˧
từa	tɯə˧˨
từng	tɯŋ˧˨
tử	tɯ˨˩˦
tửu	tɯw˨˩˦
tự	tɯ˨˩˨
tựa	tɯə˨˩˨
tựu	tɯw˨˩˨
tỳ	ti˧˨
tỵ	ti˨˩˨
tỷ	ti˨˩˦
u	u˧˧
ui	uj˧˧
um	um˧˧
un	uŋm˧˧
ung	uŋm˧˧
uy	wi˧˧
uyên	wiəŋ˧˧
uyển	wiəŋ˨˩˦
uôm	um˧˧
uông	uəŋ˧˧
uý	wi˦˥
uất	wɤ̆k˦˥
uẩn	wɤ̆ŋ˨˩˦
uế	we˦˥
uể	we˨˩˦
uốn	uəŋ˦˥
uống	uəŋ˦˥
uổng	uəŋ˨˩˦
uỳnh	win˧˨
uỷ	wi˨˩˦
va	ja˧˧
vai	jaj˧˧
van	jaŋ˧˧
vang	jaŋ˧˧
vang	vaŋ˧
vanh	jan˧˧
vay	jăj˧˧
ve	jɛ˧˧
ven	jɛŋ˧˧
veo	jeo˧˧
vi	ji˧˧
vi-rút	ji˧˧-ʐukp˦˥
vi-đê-ô	ji˧˧-de˧˧-o˧˧
vin	jin˧˧
vinh	jin˧˧
viêm	jim˧˧
viên	jiəŋ˧˧
viên	viːn˧˧
viêng	jiəŋ˧˧
viêt	vˈɪt˧
viếng	jiəŋ˦˥
viết	jiək˦˥
viển	jiəŋ˨˩˦
viễn	jiəŋ˨˩˦
việc	jiək˨˩˨
viện	jiəŋ˨˩˨
việt	jiək˨˩˨
việt-nam	jiək˨˩˨-nam˧˧
vo	jɔ˧˧
voi	jɔj˧˧
von	jɔŋm˧˧
vong	jɔŋm˧˧
voọc	jɔkp˨˩˨
vu	ju˧˧
vua	juə˧˧
vui	juj˧˧
vun	juŋm˧˧
vung	juŋm˧˧
vuông	juəŋ˧˧
vuốt	juək˦˥
vuột	juək˨˩˨
vy	ji˧˧
và	ja˧˨
và	vaː˨˩
và	va˨˩
vài	jaj˧˨
vàm	jam˧˨
vàn	jaŋ˧˨
vàng	jaŋ˧˨
vành	jan˧˨
vào	jaw˧˨
vày	jăj˧˨
vá	ja˦˥
vác	jak˦˥
vách	jat˦˥
vái	jaj˦˥
ván	jaŋ˦˥
váng	jaŋ˦˥
váy	jăj˦˥
vân	jɤ̆ŋ˧˧
vâng	jɤ̆ŋ˧˧
vây	jɤ̆j˧˧
vã	ja˨˩˦
vãi	jaj˨˩˦
vãn	jaŋ˨˩˦
vãng	jaŋ˨˩˦
vè	jɛ˧˨
vèo	jeo˧˨
vé	jɛ˦˥
véc	jɛk˦˥
vén	jɛŋ˦˥
véo	jeo˦˥
vét	jɛt˦˥
vê	je˧˧
vên	jen˧˧
vênh	jen˧˧
vêu	jɛu˧˧
vì	ji˧˨
vì	viː˨˩
vì	vi˨˩
ví	ji˦˥
vía	jiə˦˥
vò	jɔ˧˨
vòi	jɔj˧˨
vòm	jɔm˧˨
vòn	jɔŋm˧˨
vòng	jɔŋm˧˨
vó	jɔ˦˥
vóc	jɔkp˦˥
vót	jɔkp˦˥
vô	jo˧˧
vôi	joj˧˧
vôn	joŋm˧˧
vông	joŋm˧˧
võ	jɔ˨˩˦
võng	jɔŋm˨˩˦
vù	ju˧˨
vùa	juə˧˨
vùi	juj˧˨
vùn	juŋm˧˨
vùng	juŋm˧˨
vú	ju˦˥
vúc	jukp˦˥
vút	jukp˦˥
văn	jăŋ˧˧
văng	jăŋ˧˧
vĩ	ji˨˩˦
vĩnh	jin˨˩˦
vũ	ju˨˩˦
vũ	ɛv˧˥˧
vũng	juŋm˨˩˦
vơ	jɤ˧˧
vơi	jɤj˧˧
vưu	jɯw˧˧
vươn	jɯəŋ˧˧
vương	jɯəŋ˧˧
vướng	jɯəŋ˦˥
vườn	jɯəŋ˧˨
vượn	jɯəŋ˨˩˨
vượng	jɯəŋ˨˩˨
vượt	jɯək˨˩˨
vạ	ja˨˩˨
vạc	jak˨˩˨
vạch	jat˨˩˨
vạm	jam˨˩˨
vạn	jaŋ˨˩˨
vạt	jat˨˩˨
vạy	jăj˨˩˨
vả	ja˨˩˦
vải	jaj˨˩˦
vảy	jăj˨˩˦
vấn	jɤ̆ŋ˦˥
vấp	jɤ̆p˦˥
vất	jɤ̆k˦˥
vấy	jɤ̆j˦˥
vần	jɤ̆ŋ˧˨
vầng	jɤ̆ŋ˧˨
vầy	jɤ̆j˧˨
vẩn	jɤ̆ŋ˨˩˦
vẫn	jɤ̆ŋ˨˩˦
vẫn	v˨˩˦˧
vẫy	jɤ̆j˨˩˦
vậm	jɤ̆m˨˩˨
vận	jɤ̆ŋ˨˩˨
vập	jɤ̆p˨˩˨
vật	jɤ̆k˨˩˨
vậy	jɤ̆j˨˩˨
vắn	jăŋ˦˥
vắng	jăŋ˦˥
vắt	jăk˦˥
vằm	jăm˧˨
vằn	jăŋ˧˨
vằng	jăŋ˧˨
vặc	jăk˨˩˨
vặn	jăŋ˨˩˨
vặt	jăk˨˩˨
vẹc	jɛk˨˩˨
vẹn	jɛŋ˨˩˨
vẹo	jeo˨˩˨
vẹt	jɛt˨˩˨
vẻ	jɛ˨˩˦
vẻn	jɛŋ˨˩˦
vẽ	jɛ˨˩˦
vết	jet˦˥
về	je˧˨
vền	jen˧˨
vểnh	jen˨˩˦
vệ	je˨˩˨
vỉ	ji˨˩˦
vỉa	jiə˨˩˦
vị	ji˨˩˨
vị	viː˨˩˨
vị	vˈi˨˩˨
vịt	jit˨˩˨
vọ	jɔ˨˩˨
vọc	jɔkp˨˩˨
vọng	jɔŋm˨˩˨
vọp	jɔp˨˩˨
vọt	jɔkp˨˩˨
vỏ	jɔ˨˩˦
vỏn	jɔŋm˨˩˦
vốn	joŋm˦˥
vồ	jo˧˨
vồi	joj˧˨
vồn	joŋm˧˨
vỗ	jo˨˩˦
vội	joj˨˩˨
vớ	jɤ˦˥
với	jɤj˦˥
vớt	jɤk˦˥
vờ	jɤ˧˨
vời	jɤj˧˨
vở	jɤ˨˩˦
vỡ	jɤ˨˩˦
vợ	jɤ˨˩˨
vợ	vˈœ˧
vợ	ɛn˧
vụ	ju˨˩˨
vụ	ɔm˨˩˨
vụn	juŋm˨˩˨
vụng	juŋm˨˩˨
vụt	jukp˨˩˨
vứt	jɯk˦˥
vừa	jɯə˧˨
vừng	jɯŋ˧˨
vữa	jɯə˨˩˦
vững	jɯŋ˨˩˦
vựa	jɯə˨˩˨
vực	jɯk˨˩˨
vựng	jɯŋ˨˩˨
xa	saa˧
xa	saka˧
xa	sama˧
xa	saː˧
xa	sa˧˧
xa,	sa˧
xam	sam˧˧
xanh	san˧˧
xao	saw˧˧
xay	săj˧˧
xe	sɛ˧
xe	sɛ˧˧
xem	sɛm˧
xem	sɛm˧˧
xen	sɛŋ˧˧
xeo	seo˧˧
xi	si˧˧
xin	sin˧
xin	sin˧˧
xinh	sin˧˧
xiêm	sim˧˧
xiên	siəŋ˧˧
xiêu	siəw˧˧
xiết	siək˦˥
xiếu	siəw˦˥
xiềng	siəŋ˧˨
xiểm	sim˨˩˦
xiển	siəŋ˨˩˦
xiểng	siəŋ˨˩˦
xo	sɔ˧˧
xoa	swa˧˧
xoai	swaj˧˧
xoan	swaŋ˧˧
xoang	swaŋ˧˧
xoay	swăj˧˧
xoen	swen˧˧
xoi	sɔj˧˧
xom	sɔm˧˧
xon	sɔŋm˧˧
xong	sɔŋm˧˧
xoong	sɔŋm˧˧
xoài	swaj˧˨
xoàn	swaŋ˧˨
xoàng	swaŋ˧˨
xoành	swan˧˨
xoá	swa˦˥
xoáy	swăj˦˥
xoèn	swen˧˨
xoăn	swăŋ˧˧
xoạc	swak˨˩˨
xoắn	swăŋ˦˥
xoẳn	swăŋ˨˩˦
xu	su˧˧
xua	suə˧˧
xui	suj˧˧
xum	sum˧˧
xun	suŋm˧˧
xung	suŋm˧˧
xuy	swi˧˧
xuyên	swiəŋ˧˧
xuân	swɤ̆ŋ˧˧
xuê	swe˧˧
xuôi	suəj˧˧
xuý	swi˦˥
xuýt	swit˦˥
xuất	swɤ̆k˦˥
xuẩn	swɤ̆ŋ˨˩˦
xuề	swe˧˨
xuềnh	swen˧˨
xuệch	swet˨˩˨
xuống	suəŋ˦˥
xuồng	suəŋ˧˨
xà	sa˧˨
xài	saj˧˨
xàm	sam˧˨
xàng	saŋ˧˨
xành	san˧˨
xào	saw˧˨
xá	sa˦˥
xác	sak˦˥
xách	sat˦˥
xái	saj˦˥
xám	sam˦˥
xán	saŋ˦˥
xáo	saw˦˥
xáp	sap˦˥
xát	sat˦˥
xâm	sɤ̆m˧˧
xâu	sɤ̆w˧˧
xây	sɤ̆j˧˧
xã	sa˨˩˦
xè	sɛ˧˨
xèn	sɛŋ˧˨
xèo	seo˧˨
xé	sɛ˦˥
xén	sɛŋ˦˥
xéo	seo˦˥
xép	sɛp˦˥
xét	sɛt˦˥
xê	se˧˧
xênh	sen˧˧
xì	si˧˨
xình	sin˧˨
xìu	siw˧˨
xí	si˦˥
xích	sit˦˥
xín	sin˦˥
xính	sin˦˥
xít	sit˦˥
xíu	siw˦˥
xòm	sɔm˧˨
xòng	sɔŋm˧˨
xó	sɔ˦˥
xóc	sɔkp˦˥
xói	sɔj˦˥
xóm	sɔm˦˥
xóp	sɔp˦˥
xót	sɔkp˦˥
xô	so˧˧
xô-viết	so˧˧-jiək˦˥
xôi	soj˧˧
xôm	som˧˧
xôn	son˧
xôn	soŋm˧˧
xông	soŋm˧˧
xõng	sɔŋm˨˩˦
xù	su˧˨
xùm	sum˧˨
xùng	suŋm˧˨
xú	su˦˥
xúc	sukp˦˥
xúi	suj˦˥
xúm	sum˦˥
xúng	suŋm˦˥
xúp	sup˦˥
xăm	săm˧˧
xăn	săŋ˧˧
xăng	săŋ˧˧
xơ	sɤ˧˧
xơi	sɤj˧˧
xơn	sɤŋ˧˧
xưa	sɯə˧˧
xưng	sɯŋ˧˧
xương	sɯəŋ˧˧
xước	sɯək˦˥
xướng	sɯəŋ˦˥
xười	sɯəj˧˨
xường	sɯəŋ˧˨
xưởng	sɯəŋ˨˩˦
xạ	sa˨˩˨
xạc	sak˨˩˨
xạch	sat˨˩˨
xạu	săw˨˩˨
xả	sa˨˩˦
xảo	saw˨˩˦
xảy	săj˨˩˦
xấc	sɤ̆k˦˥
xấp	sɤ̆p˦˥
xấu	sɤ̆w˦˥
xầm	sɤ̆m˧˨
xầu	sɤ̆w˧˨
xẩm	sɤ̆m˨˩˦
xẩn	sɤ̆ŋ˨˩˦
xẩy	sɤ̆j˨˩˦
xậm	sɤ̆m˨˩˨
xập	sɤ̆p˨˩˨
xắc	săk˦˥
xắm	săm˦˥
xắn	săŋ˦˥
xằng	săŋ˧˨
xẵng	săŋ˨˩˦
xẹo	seo˨˩˨
xẹp	sɛp˨˩˨
xẻ	sɛ˨˩˦
xẻn	sɛŋ˨˩˦
xẻng	sɛŋ˨˩˦
xế	se˦˥
xếch	set˦˥
xếp	sep˦˥
xề	se˧˨
xềm	sem˧˨
xềnh	sen˧˨
xều	sɛu˧˨
xệch	set˨˩˨
xệu	sɛu˨˩˨
xỉ	si˨˩˦
xỉa	siə˨˩˦
xỉu	siw˨˩˦
xị	si˨˩˨
xịu	siw˨˩˨
xọ	sɔ˨˩˨
xọc	sɔkp˨˩˨
xỏ	sɔ˨˩˦
xỏng	sɔŋm˨˩˦
xốc	sokp˦˥
xối	soj˦˥
xốn	soŋm˦˥
xống	soŋm˦˥
xốp	sop˦˥
xốt	sokp˦˥
xồm	som˧˨
xồn	soŋm˧˨
xồng	soŋm˧˨
xổ	so˨˩˦
xổi	soj˨˩˦
xổn	soŋm˨˩˦
xổng	soŋm˨˩˦
xộc	sokp˨˩˨
xộn	soŋm˨˩˨
xớ	sɤ˦˥
xới	sɤj˦˥
xớn	sɤŋ˦˥
xớt	sɤk˦˥
xờ	sɤ˧˨
xờm	sɤm˧˨
xởi	sɤj˨˩˦
xợp	sɤp˨˩˨
xụ	su˨˩˨
xục	sukp˨˩˨
xụi	suj˨˩˨
xủ	su˨˩˦
xủng	suŋm˨˩˦
xứ	sɯ˦˥
xức	sɯk˦˥
xứng	sɯŋ˦˥
xử	sɯ˨˩˦
xửa	sɯə˨˩˦
xửng	sɯŋ˨˩˦
y	i˧˧
yêm	iɛm˧˧
yên	iɛŋ˧˧
yêng	iɛŋ˧˧
yêu	iəw˧˧
yếm	iɛm˦˥
yến	iɛŋ˦˥
yết	iɛt˦˥
yếu	iəw˦˥
yểm	iɛm˨˩˦
yểng	iɛŋ˨˩˦
yểu	iəw˨˩˦
à	a˧˨
ành	an˧˨
ào	aw˧˨
á	a˦˥
ác	ak˦˥
ác-bít	ak˦˥-bit˦˥
ác-ten	ak˦˥-tɛŋ˧˧
ách	at˦˥
ái	aj˦˥
ám	am˦˥
án	aŋ˦˥
áng	aŋ˦˥
ánh	an˦˥
áo	aw˦˥
áp	ap˦˥
át	at˦˥
áy	ăj˦˥
â	ɤ̆˧˧
âm	ɤ̆m˧˧
ân	ɤ̆ŋ˧˧
âu	ɤ̆w˧˧
è	ɛ˧˨
èng	ɛŋ˧˨
èo	eo˧˨
é	ɛ˦˥
éc	ɛk˦˥
ém	ɛm˦˥
én	ɛŋ˦˥
éo	eo˦˥
ép	ɛp˦˥
ét	ɛt˦˥
ê	e˧˧
êm	em˧˧
êu	ɛu˧˧
ì	i˧˨
ìn	in˧˨
ình	in˧˨
í	i˦˥
ích	it˦˥
ít	it˦˥
ò	ɔ˧˨
òi	ɔj˧˨
òm	ɔm˧˨
òng	ɔŋm˧˨
ó	ɔ˦˥
óc	ɔkp˦˥
ói	ɔj˦˥
óng	ɔŋm˦˥
óp	ɔp˦˥
ót	ɔkp˦˥
ô	o˧˧
ô-tô	o˧˧-to˧˧
ôi	oj˧˧
ôm	om˧˧
ôn	oŋm˧˧
ông	oŋm˧˧
õng	ɔŋm˨˩˦
ù	u˧˨
ùa	uə˧˨
ùm	um˧˨
ùn	uŋm˧˨
ùng	uŋm˧˨
ú	u˦˥
úa	uə˦˥
úc	ukp˦˥
úi	uj˦˥
úm	um˦˥
úng	uŋm˦˥
úp	up˦˥
út	ukp˦˥
ý	iko˧
ý	i˦˥
ý	i˧˥
ăm	ăm˧˧
ăn	ăŋ˧˧
ăng	ăŋ˧˧
đa	da˧˧
đai	daj˧˧
đam	dam˧˧
đan	daŋ˧˧
đang	daŋ˧˧
đanh	dan˧˧
đao	daw˧˧
đau	dăw˧˧
đay	dăj˧˧
đe	dɛ˧˧
đem	dɛm˧˧
đen	dɛŋ˧˧
đeo	deo˧˧
đi	dili˧
đi	diː˧
đi	di˧
đi	di˧˧
đinh	din˧˧
điên	diəŋ˧˧
điêu	diəw˧˧
điếc	diək˦˥
điếm	dim˦˥
điếu	diəw˦˥
điềm	dim˧˨
điền	diəŋ˧˨
điều	diəw˧˨
điểm	dim˨˩˦
điển	diəŋ˨˩˦
điểu	diəw˨˩˦
điện	diəŋ˨˩˨
điệp	dip˨˩˨
điệu	diəw˨˩˨
đo	dɔ˧˧
đoan	dwaŋ˧˧
đoi	dɔj˧˧
đom	dɔm˧˧
đon	dɔŋm˧˧
đong	dɔŋm˧˧
đoàn	dwaŋ˧˨
đoàng	dwaŋ˧˨
đoành	dwan˧˨
đoái	dwaj˦˥
đoán	dwaŋ˦˥
đoạ	dwa˨˩˨
đoạn	dwaŋ˨˩˨
đoạt	dwat˨˩˨
đoản	dwaŋ˨˩˦
đoảng	dwaŋ˨˩˦
đu	du˧˧
đua	duə˧˧
đui	duj˧˧
đum	dum˧˧
đun	duŋm˧˧
đung	duŋm˧˧
đuôi	duəj˧˧
đuềnh	dwen˧˨
đuểnh	dwen˨˩˦
đuễnh	dwen˨˩˦
đuốc	duək˦˥
đuối	duəj˦˥
đuồn	duəŋ˧˨
đuổi	duəj˨˩˦
đà	da˧˨
đài	daj˧˨
đàm	dam˧˨
đàn	daŋ˧˨
đàng	daŋ˧˨
đành	dan˧˨
đào	daw˧˨
đày	dăj˧˨
đá	da˦˥
đách	dat˦˥
đái	daj˦˥
đám	dam˦˥
đáng	daŋ˦˥
đánh	dan˦˥
đáo	daw˦˥
đáp	dap˦˥
đáy	dăj˦˥
đâm	dɤ̆m˧˧
đâu	dɤ̆w˧˧
đây	dɤ̆j˧˧
đã	da˨˩˦
đãi	daj˨˩˦
đãng	daŋ˨˩˦
đè	dɛ˧˨
đèm	dɛm˧˨
đèn	dɛŋ˧˨
đèo	deo˧˨
đéo	deo˦˥
đê	de˧˧
đêm	demn˧
đêm	dem˧˧
đì	di˧˨
đình	din˧˨
đìu	diw˧˨
đí	di˦˥
đích	dit˦˥
đính	din˦˥
đít	dit˦˥
đò	dɔ˧˨
đòi	dɔj˧˨
đòm	dɔm˧˨
đòn	dɔŋm˧˨
đòng	dɔŋm˧˨
đó	dɔ˦˥
đói	dɔj˦˥
đóm	dɔm˦˥
đón	dɔŋm˦˥
đóng	dɔŋm˦˥
đô	do˧˧
đôi	doj˧
đôi	doj˧˧
đôm	dom˧˧
đôn	doŋm˧˧
đông	doŋm˧˧
đông-nam	doŋm˧˧-nam˧˧
đù	du˧˨
đùa	duə˧˨
đùi	duj˧˨
đùm	dum˧˨
đùn	duŋm˧˨
đùng	duŋm˧˨
đú	du˦˥
đúc	dukp˦˥
đún	duŋm˦˥
đúng	duŋm˦˥
đút	dukp˦˥
đăm	dăm˧˧
đăng	dăŋ˧˧
đĩ	di˨˩˦
đĩa	diə˨˩˦
đĩnh	din˨˩˦
đũa	duə˨˩˦
đũng	duŋm˨˩˦
đơm	dɤm˧˧
đơn	dɤŋ˧˧
đưa	dɯə˧˧
đương	dɯəŋ˧˧
đười	dɯəj˧˨
đườn	dɯəŋ˧˨
đường	dɯəŋ˧˨
được	dukː˧
được	duːk˧
được	døk˧
được	dɔw˧
được	dɔːk˧
được	dɨlk˧
được	dɯək˨˩˨
được	dˈy˧
được	dˈɑk˧
được	dˈɯ˧
được	dˌɯkˈ˧
được	dˌʊk˧
được	wɔk˧
được	ɑːk˧
đượm	dɯm˨˩˨
đạc	dak˨˩˨
đại	daj˨˩˨
đạm	dam˨˩˨
đạn	daŋ˨˩˨
đạo	daw˨˩˨
đạp	dap˨˩˨
đạt	dat˨˩˨
đạt-lai	dat˨˩˨-laj˧˧
đả	da˨˩˦
đảm	dam˨˩˦
đản	daŋ˨˩˦
đảng	daŋ˨˩˦
đảo	daw˨˩˦
đấm	dɤ̆m˦˥
đấng	dɤ̆ŋ˦˥
đất	dɤ̆k˦˥
đấu	dɤ̆w˦˥
đấy	dɤ̆j˦˥
đầm	dɤ̆m˧˨
đần	dɤ̆ŋ˧˨
đầu	dɤ̆w˧˨
đầy	dɤ̆j˧˨
đẩu	dɤ̆w˨˩˦
đẩy	dɤ̆j˨˩˦
đẫm	dɤ̆m˨˩˦
đẫn	dɤ̆ŋ˨˩˦
đẫy	dɤ̆j˨˩˦
đậm	dɤ̆m˨˩˨
đận	dɤ̆ŋ˨˩˨
đập	dɤ̆p˨˩˨
đậu	dɤ̆w˨˩˨
đậy	dɤ̆j˨˩˨
đắc	dăk˦˥
đắm	dăm˦˥
đắn	dăŋ˦˥
đắng	dăŋ˦˥
đắp	dăp˦˥
đắt	dăk˦˥
đằm	dăm˧˨
đằng	dăŋ˧˨
đẳng	dăŋ˨˩˦
đẵm	dăm˨˩˦
đặc	dăk˨˩˨
đặm	dăm˨˩˨
đặt	dăk˨˩˨
đẹn	dɛŋ˨˩˨
đẹp	dɛp˨˩˨
đẹt	dɛt˨˩˨
đẻ	dɛ˨˩˦
đẽo	deo˨˩˦
đế	de˦˥
đếch	det˦˥
đếm	dem˦˥
đến	den˦˥
đề	de˧˨
đền	den˧˨
đềnh	den˧˨
đều	dɛu˧˨
để	de˨˩˦
đểnh	den˨˩˦
đểu	dɛu˨˩˦
đễnh	den˨˩˦
đệ	de˨˩˨
đệm	dem˨˩˨
đỉa	diə˨˩˦
đỉnh	din˨˩˦
địa	diə˨˩˨
địch	dit˨˩˨
định	din˨˩˨
địt	dit˨˩˨
đọ	dɔ˨˩˨
đọa	dwa˨˩˨
đọc	dɔkp˨˩˨
đọi	dɔj˨˩˨
đọng	dɔŋm˨˩˨
đỏ	dɔ˨˩˦
đỏm	dɔm˨˩˦
đỏng	dɔŋm˨˩˦
đố	do˦˥
đốc	dokp˦˥
đốc-tơ	dokp˦˥-tɤ˧˧
đối	doj˦˥
đốm	dom˦˥
đốn	doŋm˦˥
đống	doŋm˦˥
đốp	dop˦˥
đốt	dokp˦˥
đồ	do˧˨
đồi	doj˧˨
đồm	dom˧˨
đồn	doŋm˧˨
đồng	doŋm˧˨
đổ	do˨˩˦
đổi	doj˨˩˦
đổng	doŋm˨˩˦
đỗ	do˨˩˦
đỗ	ʊn˧
độ	do˨˩˨
độc	dokp˨˩˨
đội	doj˨˩˨
độn	doŋm˨˩˨
động	doŋm˨˩˨
độp	dop˨˩˨
đột	dokp˨˩˨
đớ	dɤ˦˥
đới	dɤj˦˥
đớn	dɤŋ˦˥
đớp	dɤp˦˥
đờ	dɤ˧˨
đờ-mi	dɤ˧˨-mi˧˧
đời	dɤj˧˨
đờn	dɤŋ˧˨
đởm	dɤm˨˩˦
đỡ	dɒ˧
đỡ	dɤ˨˩˦
đỡ	dˈœ˧
đỡ	sɛ˧
đỡ	ˈda˧
đợ	dɤ˨˩˨
đợi	dɤj˨˩˨
đụ	du˨˩˨
đục	dukp˨˩˨
đụn	duŋm˨˩˨
đụng	duŋm˨˩˨
đủ	du˨˩˦
đủng	duŋm˨˩˦
đứ	dɯ˦˥
đứa	dɯə˦˥
đức	dɯk˦˥
đức	dˈɪk˧
đứng	dɯŋ˦˥
đứt	dɯk˦˥
đừng	dɯŋ˧˨
đử	dɯ˨˩˦
đực	dɯk˨˩˨
đựng	dɯŋ˨˩˨
ĩnh	in˨˩˦
ơ	ɤ˧˧
ơi	ɤj˧˧
ơn	ɤŋ˧˧
ư	ɯ˧˧
ưa	ɯə˧˧
ưng	ɯŋ˧˧
ưu	ɯw˧˧
ươi	ɯəj˧˧
ươm	ɯm˧˧
ươn	ɯəŋ˧˧
ương	ɯəŋ˧˧
ước	ɯək˦˥
ướm	ɯm˦˥
ướp	ɯp˦˥
ướt	ɯək˦˥
ưỡn	ɯəŋ˨˩˦
ạ	a˨˩˨
ạ	ɑ˨˩˨
ạch	at˨˩˨
ạo	aw˨˩˨
ả	a˨˩˦
ải	aj˨˩˦
ảm	am˨˩˦
ảnh	an˨˩˦
ảo	aw˨˩˦
ấm	ɔm˧
ấm	ɛm˧
ấm	ɤ̆m˦˥
ấn	ɤ̆ŋ˦˥
ấp	ɛb˧
ấp	ɤ̆p˦˥
ất	ɤ̆k˦˥
ấu	ɤ̆w˦˥
ấy	ɤ̆j˦˥
ầm	ɤ̆m˧˨
ầu	ɤ̆w˧˨
ẩm	ɤ̆m˨˩˦
ẩn	ɛn˧
ẩn	ɤ̆ŋ˨˩˦
ẩu	ɤ̆w˨˩˦
ẫm	ɤ̆m˨˩˦
ậm	ɤ̆m˨˩˨
ập	ɤ̆p˨˩˨
ắc	ăk˦˥
ắc-coóc	ăk˦˥-kɔkp˦˥
ắng	ăŋ˦˥
ắt	ăk˦˥
ằng	ăŋ˧˨
ẳng	ăŋ˨˩˦
ẵm	ăm˨˩˦
ặc	ăk˨˩˨
ẹ	ɛ˨˩˨
ẹc	ɛk˨˩˨
ẹo	eo˨˩˨
ẻo	eo˨˩˦
ẽo	eo˨˩˦
ế	e˦˥
ếch	et˦˥
ề	e˧˨
ềnh	en˧˨
ễng	en˨˩˦
ễnh	en˨˩˦
ỉ	i˨˩˦
ỉa	iə˨˩˦
ỉm	im˨˩˦
ỉu	iw˨˩˦
ị	i˨˩˨
ịt	it˨˩˨
ọ	ɔ˨˩˨
ọc	ɔkp˨˩˨
ọp	ɔp˨˩˨
ọt	ɔkp˨˩˨
ỏe	we˨˩˦
ỏi	ɔj˨˩˦
ỏm	ɔm˨˩˦
ỏn	ɔŋm˨˩˦
ỏng	ɔŋm˨˩˦
ố	o˦˥
ốc	okp˦˥
ối	oj˦˥
ốm	om˦˥
ốm	ʔm˧
ống	oŋm˦˥
ốp	op˦˥
ốt	okp˦˥
ồ	o˧˨
ồi	oj˧˨
ồm	om˧˨
ồn	oŋm˧˨
ồng	oŋm˧˨
ổ	o˨˩˦
ổi	oj˨˩˦
ổm	om˨˩˦
ổn	oŋm˨˩˦
ộ	o˨˩˨
ộc	okp˨˩˨
ộn	oŋm˨˩˨
ộp	op˨˩˨
ớ	ɤ˦˥
ớn	ɤŋ˦˥
ớt	ɤk˦˥
ờ	ɤ˧˨
ời	ɤj˧˨
ờn	ɤŋ˧˨
ở	ɤ˨˩˦
ỡm	ɤm˨˩˦
ợ	ɤ˨˩˨
ụ	u˨˩˨
ụa	uə˨˩˨
ục	ukp˨˩˨
ụt	ukp˨˩˨
ủ	u˨˩˦
ủi	uj˨˩˦
ủn	uŋm˨˩˦
ủng	uŋm˨˩˦
ủy	uj˨˩˦
ứ	ɯ˦˥
ứa	ɯə˦˥
ức	ɯk˦˥
ứng	ɯŋ˦˥
ừ	ɯ˧˨
ừng	ɯŋ˧˨
ửng	ɯŋ˨˩˦
ỷ	i˨˩˦
