ং	ŋ
অ	ɔ
অঁ	ɔ̃
অঁকৰা	ɔ̃kɔɹa
অংক	ɔŋkɔ
অংগ	ɔŋgɔ
অইন	ɔɪn
অকল	ɔkɔl
অকলশৰীয়া	ɔkɔlxɔɹia
অকলে	ɔkɔlɛ
অকাপী	ɔkapi
অক্টোবৰ	ɔktʊbɔɹ
অক্ষ	ɔkʰ
অক্সাইড	ɔksaɪd
অচিনাকি	ɔsinaki
অচিনাকী	ɔsinaki
অজগৰ	ɔzɔgɔɹ
অজানিতে	ɔzanitɛ
অটা	ɔta
অট্টালিকা	ɔttalika
অঠাৰ	ɔtɦaɹɔ
অণুজীৱ	ɔnuzibɔ
অণুজীৱ	ɔnuziβɔ
অনা	ɔna
অনাটন	ɔnatɔn
অনুবাদ	ɔnubad
অনুবাদক	ɔnubadɔk
অনোৱা	ɔnʊa
অন্তৰ্জাল	ɔntɔɹzal
অন্য	ɔɪnnɔ
অপ্সৰা	ɔpsɔɹa
অবৈধ	ɔbɔɪdɦɔ
অভাৱ	ɔbʱaw
অভিমন্যু	ɔbʱimɔɪnnu
অভিযান	ɔbʱizan
অভ্যাস	ɔɪbbʱax
অমিতা	ómita
অমিয়	ɔmiʱ
অমিয়া	ɔmia
অম্লজান	ɔmlɔzan
অয়স্কান্ত	ɔjɔskantɔ
অযুত	ɔzut
অলপ	ɔlɔp
অশোক	ɔxʊk
অশ্বেত	ɔssɛt
অষ্ট্ৰেলিয়া	ɔstɹɛlia
অসম	ɔxɔm
অসমীয়া	ɔxomia
অসমীয়াভাষী	ɔxɔmiabʱaxi
অসুখ	ɔxukʰ
অহা	ɔɦa
অহাকালি	ɔɦakali
অহাবছৰ	ɔɦabɔsɔɹ
অৰকা	ɔɹɔka
অৰ্থ	ɔɹtʰɔ
অ’	ó
আ	a
আঁউজ	ãuz
আঁউজা	ãuza
আঁউজোৱা	ãuzʊa
আঁক	ãk
আঁকা	ãka
আঁকোৰগোঁজ	ãkʊɹgʊ̃z
আঁকোৱাল	ãkʊal
আঁচ	ãs
আঁচনি	ãsɔni
আঁচল	ãsɔl
আঁচোৰ	ãsʊɹ
আঁচোৰা	ãsʊɹa
আঁট	ãt
আঁটকাল	ãtɔkal
আঁঠু	ãtʰu
আঁত	ãt
আঁতৰ	ãtɔɹ
আঁতৰা	ãtɔɹa
আঁতৰোৱা	ãtɔɹʊa
আঁহ	ãʱ
আঁহত	ãɦɔt
আঁৰ	ãɹ
আঁৰি	ãɹi
আঁৱৰি	aɔɹi
আঁৱৰি	ãɔɹi
আঁৱৰীয়া	aɔɹia
আঁৱৰীয়া	ãɔɹia
আংগাৰ	aŋgaɹ
আই	aɪ
আইচলেণ্ড	aislɛn
আইচ‌্ক্ৰিম	aɪskɹim
আইতা	aɪta
আইন	aɪn
আইনা	aɪna
আউটি	aʊti
আউল	aʊl
আও	aʊ
আওৰা	aʊɹa
আক	ak
আকন	akɔn
আকাশ	akax
আকাশ	akaʰ
আকো	aqɔ
আকৌ	akoː
আকৌ	akɔʊ
আকৌ	akɔː
আখি	akʰi
আখৈ	akʰoɪ
আখৰ	akʰɔɹ
আখৰ	axɔɹ
আগ	ag
আগত	agɔt
আগতীয়াকৈ	agɔtiakoɪ
আগতে	agɔtɛ
আগনি	agɔni
আগি	agi
আগুনি	aguni
আগেয়ে	agɛɛ
আঘোণ	agʱʊn
আঙঠা	aŋɔtʰa
আঙঠি	aŋɔtʰi
আঙাৰ	aŋaɹ
আঙুঠি	aŋutʰi
আঙুঠি	aŋʊtʰi
আঙুল	aŋul
আঙুলি	aŋuli
আঙুলিওৱা	aŋuliʊa
আঙুলিয়া	aŋulia
আঙ্গাৰ	aŋgaɹ
আচল	asɔl
আচলটল	asɔlɔtɔl
আচহুৱা	asɔɦua
আচাভুৱা	asabʱua
আছে	asɛ
আজান	azan
আজি	azi
আজিনাই	azinaɪ
আজো	azʊ
আজ্ঞা	agga
আঞ্জা	anza
আট	at
আটা	ata
আটাই	ataɪ
আটাইতকে	ataɪtkɛ
আটাইতকৈ	ataɪtkoɪ
আটাহ	ataʱ
আটিল	atil
আঠ	atʰ
আঠচল্লিছ	atsɔllis
আঠত্ৰিছ	atʰɔtɹis
আঠষষ্ঠি	atxɔstʰi
আঠসত্তৰ	atxɔttɔɹ
আঠা	atʰa
আঠাইছ	atʰaɪs
আঠান্নব্বৈ	atʰannɔbboɪ
আঠাশী	atʰaxi
আঠাৱন	atʰaɔn
আঢ়ৈ	aɹʱoɪ
আতা	ata
আতৰ	atɔɹ
আথৰ	atʰɔɹ
আদহ	adɔɦ
আদহীয়া	adɔɦia
আদা	ada
আদালত	adalɔt
আদৰ	adɔɹ
আধা	adʱa
আধিপত্য	adʱipɔɪttɔ
আধৰুৱা	adʱɔɹua
আন	an
আনা	ana
আনাৰস	anaɹɔx
আনোৱা	anʊa
আন্দাজ	andaz
আন্ধাৰ	andʱaɹ
আপঁইতা	apɔ̃ita
আপা	apa
আপুনি	apuni
আপেল	apɛl
আপোন	apʊn
আপোনাক	apʊnak
আপোনালোক	apʊnalʊk
আপোনাৰ	apʊnaɹ
আফগানিস্তান	apʰganistan
আফচোচ	apsʊs
আফচোচ	apʰsʊs
আফিং	apʰiŋ
আফৰ	apʰɔɹ
আবা	aba
আবিয়ৈ	abioɪ
আবেলি	abɛli
আব্বা	abba
আবৰ	abɔɹ
আবৰা	abɔɹa
আম	am
আমঠি	amɔtʰi
আমঠু	amɔtʰu
আমাৰ	amaɹ
আমি	ami
আমুউৱা	amuua
আমুৱা	amua
আম্মা	amma
আম্মী	ammi
আয়	aj
আল	al
আলগ	alɔg
আলবেনিয়া	albɛnia
আলমাৰী	almaɹi
আলসুৱা	alɔxua
আলহী	alɔɦi
আলি	ali
আলু	alu
আলুগুটি	aluguti
আশা	axa
আশী	axi
আহ	aʱ
আহা	aɦa
আহু	aɦu
আৰক্ষী	aɹɔkʰi
আৰু	aɹu
আৰ্চি	aɹsi
আৰ্হি	aɹɦi
আৱাজ	awaz
আৱাজ	aʊaz
ই	i
ই	iː
ইউক্ৰেইন	iukɹɛin
ইউজাৰ	iuzaɹ
ইউৰোপ	iuɹʊp
ইকৰা	ikɔɹa
ইগ্লো	iglʊ
ইছলাম	islam
ইজ্জত	idʑɔt
ইটানগৰ	itanɔgɔɹ
ইণ্ডোনেচিয়া	indʊnɛsia
ইতিহাস	itiɦax
ইতৰ	itɔɹ
ইন্ধন	indʱɔn
ইমান	iman
ইয়ংচাক	ijɔŋsak
ইয়াত	iat
ইলাচি	ilasi
ইলিছ	ilis
ইলীহ	iliʱ
ইলীহি	iliɦi
ইষ্টেবুল	istɛbul
ইস্কুল	iskul
ইস্ত্ৰি	isti
ইস্ত্ৰি	istɹi
ইস্পাত	ispat
ঈ	i
ঈদ	id
ঈশ্বৰ	issɔɹ
ঈহ	iʱ
উ	u
উঁই	ũi
উঁইপোক	ũipʊk
উঁইপৰুৱা	ũipɔɹua
উঁহ	uʱ
উকল	ukɔl
উকহ	ukɔɦ
উকা	uka
উকাহ	ukaʱ
উকি	uki
উকিল	ukil
উখৰা	ukʰɔɹa
উখৰা	uxɔɹa
উগাৰ	ugaɹ
উঘলা	ugʱɔla
উঘাল	ugʱal
উঘালা	ugʱala
উজনি	uzɔni
উজবেকিস্তান	uzbɛkistan
উজলা	uzɔla
উজান	uzan
উট	ut
উঠোৱা	utʰʊa
উতনুৱা	utɔnua
উতল	utɔl
উতলা	utɔla
উতলোৱা	utɔlʊa
উদ	ud
উদং	udɔŋ
উদ্যোগ	uddʊg
উদ্যোগ	uɪddʊg
উপত্যকা	upɔɪttɔka
উপদ্বীপ	upɔddip
উপনিষদ	upnixɔd
উপন্যাস	upɔɪnnax
উপায়	upaj
উফি	upʰi
উভত	ubʱɔt
উভাল	ubʱal
উম	um
উমনি	umɔni
উমা	uma
উলিওৱা	uliʊa
উলিয়া	ulia
উলুপী	ulupi
উলূ	ulu
উলূকাছ	ulukasɔɦ
উলূম’ৰা	ulumoɹa
উশাহ	uxaʱ
উৰ	uɹ
উৰহ	uɹɔʱ
উৰহী	uɹɔɦi
উৰা	uɹa
উৰাবাতৰি	uɹabatɔɹi
ঊ	u
ঊনআশী	unɔaxi
ঊনচল্লিছ	unsɔllis
ঊননব্বৈ	unɔnɔbboɪ
ঊনপঞ্চাছ	unɔpɔnsas
ঊনষাঠি	unɔxatʰi
ঊনসত্তৰ	unɔxɔttɔɹ
ঊনৈছ	unoɪs
ঊন্ত্ৰিছ	untɹis
ঋ	ɹi
ঌ	li
এ	ɛ
এংগাৰ	ɛŋgaɹ
এই	ɛi
এইটো	ɛitʊ
এওঁ	ɛʊ̃
এওঁলোক	ɛʊ̃lʊk
এওঁৰা	ɛʊɾa
এক	ɛk
একচল্লিছ	ɛksɔllis
একতা	ɛkɔta
একত্ৰিছ	ɛkɔtɹis
একনায়ক	ɛkɔnaɛɔk
একাডেমি	ɛkadɛmi
একাধিপতি	ɛkadʱipɔti
একান্নব্বৈ	ɛkannɔbboɪ
একাশী	ɛkaxi
একাৱন	ɛkaɔn
একে	ɛkɛ
একেলেথাৰিয়ে	ɛkɛlɛtʰaɹiɛ
একৈছ	ɛkoɪs
একো	ɛkʊ
এখেত	ɛkʰɛt
এঙাৰ	ɛŋaɹ
এঙ্গাৰ	ɛŋgaɹ
এটা	ɛta
এটি	ɛti
এঠা	ɛtʰa
এণ্ড্ৰৈড	ɛndɹɔid
এতিয়া	ɛtia
এনাই	ɛnaɪ
এনে	ɛnɛ
এনেকে	ɛnɛkɛ
এনেকৈ	ɛnɛkoɪ
এন্দুৰ	ɛnduɹ
এন্ধাৰ	ɛndʱaɹ
এপ	ɛp
এপ্লিকেচন	ɛplikɛsɔn
এম্বুলেঞ্চ	ɛmbulɛns
এয়াৰপ’ৰ্ট	ɛaɹpoɹt
এলাহ	ɛlaʱ
এলেহুৱা	ɛlɛɦua
এল্পেকা	ɛlpɛka
এশ	ɛxɔɦ
এষষ্ঠি	ɛxɔstʰi
এসত্তৰ	ɛxɔttɔɹ
এহাজাৰ	ɛɦazaɹ
এহেজাৰ	ɛɦɛzaɹ
এৰ	ɛɹ
এৰা	ɛɹa
এৰাখাতী	ɛɹakʰati
এৰাল	ɛɹal
এৰোৱা	ɛɹʊa
এ’	é
ঐ	oɪ
ঐতিহ্য	ɔitidʑɔ
ও	ʊ
ওঁ	om
ওঁ	ʊm
ওঁ	ʊ̃
ওঁঠ	ʊ̃tʰ
ওকালতি	ʊkalɔti
ওখ	ʊkʰɒ
ওখল	ʊkʰɔl
ওখৰ	ʊkʰɔɹ
ওচৰ	ʊsɔɹ
ওজন	ʊzɔn
ওজা	ʊza
ওটা	ʊta
ওঠৰ	ʊtʰɔɹɔɦ
ওপঙা	ʊpɔŋa
ওপৰ	ʊpɔɹ
ওল	ʊl
ওলগ	ʊlɔg
ওলটা	ʊlɔta
ওলটোৱা	ʊlɔtʊa
ওলমা	ʊlɔma
ওলমোৱা	ʊlɔmʊa
ওলা	ʊla
ওলোটা	ʊlʊta
ওলোটোৱা	ʊlʊtʊa
ওলোমা	ʊlʊma
ওলোমোৱা	ʊlʊmʊa
ওলোৱা	ʊlʊa
ওষ্ঠ্য	ʊstʰjɔ
ওস্তাদ	ʊstad
ওৰ	ʊɹ
ওৰণি	ʊɹɔni
ওৰোণা	ʊɹʊna
ঔ	oʊ
ক	kɔ
কঁকাল	kɔ̃kal
কঁকিলা	kɔ̃kila
কঁটলা	kɔ̃tɔla
কঁটা	kɔ̃ta
কঁঠাল	kɔ̃tʰal
কঁপা	kɔ̃pa
কঁহ	kɔ̃ɦ
কঁহকঁহীয়া	kɔ̃ɦkɔ̃ɦia
কঁহকহীয়া	kɔ̃ɦkɔ̃ɦia
কঁহাৰ	kɔ̃ɦaɹ
কঁহুৱা	kɔ̃ɦua
কংগ্ৰেছ	kɔŋgɛs
কংগ্ৰেছ	kɔŋgɹɛs
কইনা	kɔɪna
ককা	kɔka
ককাই	kɔkaɪ
কচা	kɔsa
কচু	kɔsu
কটা	kɔta
কটোৱা	kɔtʊa
কঢ়া	kɔɹʱa
কঢ়িওৱা	kɔɦiʊa
কঢ়িওৱা	kɔɹʱiʊa
কণা	kɔna
কণামুচৰি	kɔnamusɔɹi
কণী	kɔni
কণ্ঠ্য	kɔntʰjɔ
কথা	kɔtʰa
কন্দা	kɔnda
কন্দুৱা	kɔndua
কপাহ	kɔpaʱ
কপৌ	kɔpoʊ
কপৌফুল	kɔpoʊpʰul
কবি	kɔbi
কম	kɔm
কমলা	kɔmla
কমলা	kɔmɔla
কমা	kɔma
কমাৰ	kɔmaɹ
কমোৱা	kɔmʊa
কম্বল	kɔmbɔl
কলকাতা	kɔlkata
কলডিল	kɔldil
কলম	kɔlɔm
কলহ	kɔlɔɦ
কলাঘুমটীয়া	kɔlagʱumɔtia
কলামলা	kɔlamɔla
কলি	kɔli
কলিকতা	kɔlikɔta
কলিজা	kɔliza
কহ	kɔɦ
কহা	kɔɦa
কাঁইট	kãit
কাঁইটীয়া	kãɪtia
কাঁকৰা	kãkɔɹa
কাঁচকল	kãskɔl
কাঁচি	kãsi
কাঁটা	kãta
কাঁটাচামুচ	kãtasamus
কাঁড়	kãɹ
কাঁহ	kãɦ
কাঁহী	kãɦi
কাংকাৰা	kaŋkaɹa
কাই	kai
কাই	qai
কাউৰী	kauɹi
কাকত	kakɔt
কাকতি	kakɔti
কাক্ৰাল	kakɹal
কাগজ	kagɔz
কাচাৰী	kasaɹi
কাচি	kasi
কাচিহাড়	kasiɦaɹ
কাছ	kasɔ
কাছু	kasu
কাজ	kaz
কাজিয়া	kazia
কাট	kat
কাটা	kata
কাঠ	katʰ
কাঠফুলা	katʰpʰula
কাঠৰোকা	katʰɹʊka
কাঢ়া	kaɹa
কাঢ়া	kaɹʱa
কাণ	kan
কাদো	kadʊ
কানাই	kanaɪ
কানি	kani
কানিয়া	kania
কানীয়া	kania
কানু	kanu
কান্দ	kan
কান্দ	kand
কান্দা	kanda
কান্ধ	kandʱ
কান্ধ	kanʱ
কান্ধুলি	kandʱuli
কাপ	kap
কাপুৰ	kapuɾ
কাপুৰ	qapuɾ
কাপোৰ	kapʊɹ
কামলি	kamɔli
কামি	kami
কামিহাড়	kamiɦaɹ
কামোৰ	kamʊɹ
কামোৰা	kamʊɹa
কায়ম	kaéɔm
কাশ্মীৰ	kasmiɹ
কাষ	kakʰ
কাষ	kax
কাষলতি	kaxlɔti
কাষ্টাৰ	kastaɹ
কাহ	kaʱ
কাহা	kaɦa
কাৰখানা	kaɹkʰana
কাৰখানা	kaɹxana
কাৱৈ	kaoɪ
কি	ki
কিচমিচ	kismis
কিছু	kisu
কিছুমান	kisuman
কিতাপ	kitap
কিন	kin
কিনা	kina
কিন্তু	kintu
কিবা	kiba
কিমান	kiman
কিয়	kiɔ
কিয়েভ	kiɛbʱ
কিলাকুটি	kilakuti
কিলিপ	kilip
কিষ্ট	kistɔ
কুঁচিয়া	kũsia
কুঁজ	kũz
কুঁজা	kũza
কুঁড়	kũɹ
কুঁহিয়াৰ	kũɦiaɹ
কুঁৱৰী	kũɔɹi
কুইৰ্মা	kuimma
কুকুহা	kukuɦa
কুকুৰ	kukuɹ
কুকুৰা	kukuɹa
কুটা	kuta
কুটুম	kutum
কুঠাৰ	kutʰaɹ
কুপতি	kupti
কুপতি	kupɔti
কুবেৰ	kubɛɹ
কুমজেলুকা	kumzɛluka
কুমজেলেকুৱা	kumzɛlɛkua
কুমটি	kumɔti
কুমলীয়া	kumɔlia
কুমাৰ	kumaɹ
কুম্ভ	kumbʱɔ
কুলা	kula
কুহুম	kuɦum
কুহুমকাঁটা	kuɦumkãta
কুহুমবুলীয়া	kuɦumbulia
কুহুমসাৰ	kuɦumxaɹ
কুৰুই	kuɹui
কুৰুৱা	kuɹua
কুৱাং	kuaŋ
কৃষি	kɹixi
কৃষ্ণ	kisnɔ
কৃষ্ণ	kɹisnɔ
কেঁকো	kẽkʊ
কেঁকোসাপ	kẽkʊxap
কেঁকোৰা	kẽkʊɹa
কেঁকোৰাবিছা	kẽkʊɹabisa
কেঁচা	kẽsa
কেঁচি	kɛ̃si
কেঁচুৱা	kẽsua
কেঁটেলা	kẽtɛla
কেঁথা	kẽtʰa
কেঁহা	kẽɦa
কেও	kɛʊ
কেওট	kɛʊt
কেকোসাপ	kɛkʊxap
কেছাল’	kɛsalo
কেতিয়া	kɛtia
কেতিয়াবা	kɛtiaba
কেনে	kɛnɛ
কেনেকুৱা	kɛnɛkua
কেনেকে	kɛnɛkɛ
কেনেকৈ	kɛnɛkoɪ
কেনেবাকৈ	kɛnɛbakoɪ
কেন্দ্ৰ	kɛndɹɔ
কেপিৱাৰা	kɛpiwaɹa
কেমটাই	kɛmɔtaɪ
কেলেই	kɛle
কেলেই	kɛleɪ
কেহা	kɛɦa
কেৰাচিন	kɛɹasin
কেৰাহী	kɛɹaɦi
কেৰেলা	kɛɹɛla
কেৰেলুৱা	kɛɹɛlua
কেৰ্কেটুৱা	kɛɹkɛtua
কে’ক	kek
কোঁৱৰ	kʊ̃ɔɹ
কোওৱা	kʊʊa
কোকলোঙা	kʊklʊŋa
কোকলোঙা	kʊkɔlʊŋa
কোটি	kʊti
কোদাল	kʊdal
কোদালি	kʊdali
কোদো	kʊdʊ
কোন	kʊn
কোনোবা	kʊnʊba
কোব	kʊb
কোবোৱা	kʊbʊa
কোমোৰা	kʊmʊɹa
কোলা	kʊla
কোৰ	kʊɹ
কোৰোক	kʊɹʊk
কোৰোকা	kʊɹʊka
কোৰোণা	kʊɹʊna
কোৱা	kʊa
ক্ষ	kʰjɔ
কৰ	kɔɹ
কৰত	kɔɹɔt
কৰা	kɔɹa
কৰাই	kɔɹaɪ
কৰাহী	kɒɾaɦi
কৰোৱা	kɔɹʊa
ক‌’লা	kola
ক‌’লা	kɔla
ক‌’লা	kʊla
ক’ত	kot
ক’ৰবাত	kóɹbat
ক’ৰবালৈ	kóɹbalɔɪ
খ	kʱɔ
খং	kʰɔŋ
খং	xɔŋ
খচকা	kʰɔsɔka
খচৰা	kʰɔsɔɹa
খচৰা	xɔsɔɹa
খজুউৱা	kʰɔzua
খজুউৱা	kʰɔzuːa
খজুউৱা	xɔzua
খজুউৱা	xɔzuːa
খজুটি	kʰɔzuti
খজুটি	xɔzuti
খজুলি	kʰɔzuli
খজুলি	xɔzuli
খজুৱতি	kʰɔzuɔti
খজুৱতি	xɔzuɔti
খটখটী	kʰɔtkʰɔti
খটা	kʰɔta
খত	kʰɔt
খন্তি	kʰɔnti
খন্তি	xɔnti
খন্দা	kʰɔnda
খলিহনা	kʰɔliɦɔna
খলিহা	kʰɔliɦa
খহটা	kʰɔɦɔta
খহা	kʰɔɦa
খা	kʰa
খা	xa
খাঁটি	kʰãti
খাজুৰ	kʰazuɹ
খাজুৰ	xazuɹ
খাট	kʰat
খাটা	kʰata
খাদ্ৰি	kʰɛzuɹ
খাদ্ৰি	xɛzuɹ
খানচামা	kʰansama
খানা	kʰana
খান্দা	kʰanda
খাল	kʰal
খাহী	kʰaɦi
খাৰু	kʰaɹu
খাৱৈ	kʰawoɪ
খিৰিকী	kʰiɹiki
খিৰিকী	xiɹiki
খিৰোৱা	kʰiɹʊa
খিৰোৱা	xiɹʊa
খীৰ	kʰiɹ
খীৰ	xiɹ
খীৰোৱা	kʰiɹʊa
খীৰোৱা	xiɹʊa
খুঁটা	kʰũta
খুঁটি	kʰũti
খুঁটিয়া	kʰũtia
খুঁত	kʰũt
খুউৱা	kʰuua
খুচুৰা	kʰusuɹa
খুটা	kʰuta
খুটি	kʰuti
খুদ	kʰud
খুন্দ	kʰun
খুন্দ	kʰund
খুন্দ	xun
খুন্দ	xund
খুন্দনা	kʰundɔna
খুন্দনা	xundɔna
খুন্দনি	kʰundɔni
খুন্দনি	xundɔni
খুন্দা	kʰunda
খুন্দা	xunda
খুন্দিওৱা	kʰundiʊa
খুন্দিয়াখুন্দি	kʰundiakʰundi
খুন্দোৱা	kʰundʊa
খুন্দোৱা	xundʊa
খুল	kʰul
খুৰ	kʰuɹ
খুৰ	xuɹ
খুৰা	kʰuɹa
খুৰা	xuɹa
খুৰী	kʰuɹi
খুৰুৱা	kʰuɹua
খুৰুৱা	xuɹua
খুৰোৱা	kʰuɹʊa
খুৰোৱা	xuɹʊa
খুৱা	kʰua
খুৱা	xua
খেঁকাৰ	kʰẽkaɹ
খেজুৰ	kʰɛzuɹ
খেজুৰ	xɛzuɹ
খেতি	kʰeti
খেতি	xeti
খেতিয়ক	kʰetiɔk
খেতিয়ক	xetiɔk
খেদা	kʰɛda
খেপিওৱা	kʰɛpiʊa
খেপিওৱা	xɛpiʊa
খেলনা	kʰɛlna
খেলা	kʰɛla
খেলাবস্তু	kʰɛlabɔstu
খেলিমেলি	kʰɛlimɛli
খেলুৱৈ	kʰɛluoɪ
খেৰ	kʰɛɹ
খোঁচা	kʰʊ̃sa
খোঁচৰা	kʰʊ̃sɔɹa
খোঁট	kʰʊ̃t
খোঁপা	kʰʊ̃pa
খোওৱা	kʰʊʊa
খোজ	kʰʊz
খোজ	xʊz
খোজা	kʰʊza
খোলা	kʰʊla
খোৱা	kʰʊa
খোৱা	xʊa
খোৱাবস্তু	kʰʊabɔstu
খৰ	kʰɔɹ
খৰচ	kʰɔɹɔs
খৰচ	xɔɹɔs
খৰচী	kʰɔɹɔsi
খৰচী	xɔɹɔsi
খৰম	kʰɔɹɔm
খৰম	xɔɹɔm
খৰাং	kʰɔɹaŋ
খৰালি	kʰɔɹali
খৰি	kʰɔɹi
খৰিকটীয়া	kʰɔɹikɔtia
গ	gɔ
গঁড়	gɔ̃ɹ
গঁৰাল	gɔ̃ɹal
গংগাটোপ	gɔŋgatʊp
গঙা	gɔŋa
গঙাটোপ	gɔŋatʊp
গঙ্গাটোপ	gɔŋgatʊp
গচকা	gɔsɔka
গছ	gɔs
গজল	gɔzɔl
গজা	gɔza
গজালি	gɔzali
গড়	gɔɹ
গঢ়া	gɔɹʱa
গণ	gɔn
গণা	gɔna
গতোৱা	gɔtʊa
গধুৰ	gɔdʱuɹ
গধূলা	gɔdʱula
গধূলি	gɔdʱuli
গন্ধবিৰিণা	gɔndʱɔbiɹina
গম	gɔm
গমা	gɔma
গল	gɔl
গলা	gɔla
গলোৱা	gɔlʊa
গহনা	gɔɦɔna
গা	gaː
গাঁউ	gãu
গাঁও	gãʊ
গাঁঠি	gãtʰi
গাঁত	gãt
গাঁৰ	gãɹ
গাঁৰি	gãɹi
গাঁৰু	gãɹu
গাং	gaŋ
গাই	gaɪ
গাউ	gau
গাখীৰ	gakʰiɹ
গাখীৰ	gaxiɹ
গাখীৰজাত	gakʰiɹzat
গাখীৰদাঁত	gakʰiɹdãt
গাগিনী	gagini
গাড়ী	gaɹi
গাধ	gadʱɔɦ
গান্ধবিৰিণা	gandʱɔbiɹina
গান্ধী	gandʱi
গাভিনী	gabʱini
গাভৰু	gabʱɔɹu
গামোচা	gamʊsa
গায়ক	gajɔk
গাল	gal
গাহাম	gaɦam
গাহৰি	gaɦoɹi
গাৱাল	gawal
গিলা	gila
গিৰি	giɹi
গু	gu
গু	guː
গুঁই	gũi
গুগল	gugɔl
গুচা	gusa
গুচোৱা	gusʊa
গুটি	guti
গুড়	guɹ
গুড়া	guɹa
গুড়ি	guɹi
গুদাম	gudam
গুবৰুৱা	gubɔɹua
গুলপীয়া	gulɔpia
গুলি	guli
গুলীয়াগুলী	guliaguli
গুহা	guɦa
গুৰ	guɹ
গুৰা	guɹa
গুৰি	guɹi
গুৰিওৱা	guɹiʊa
গুৰুবাৰ	guɹubaɹ
গুৰুমুখীয়া	guɹumukʰia
গুৱাহাটী	guaɦati
গেছ	gɛs
গেছীয়	gɛsiɔ
গেছীয়া	gɛsia
গেণ্ডাৰ	gɛndaɹ
গেলা	gɛla
গেলোৱা	gɛlʊa
গেৰেজ	gɛɹɛz
গেৰোৱা	gɛɹʊa
গোছ	gʊs
গোট	gʊt
গোটা	gʊta
গোটেই	gʊte
গোটেই	gʊtɛɪ
গোটোৱা	gʊtʊa
গোধাফুটুকী	gʊdʱapʰutuki
গোবৰ	gʊbɔɹ
গোম	gʊm
গোমধান	gʊmdʱan
গোল	gʊl
গোলা	gʊla
গোসাঁই	gʊxãi
গোসাঞি	gʊxaɪ
গোহাঁই	gʊɦãi
গোৰ	gʊɹ
গোৱা	gʊa
গোৱালা	gʊala
গৌৰৱ	goʊɹɔw
গৰম	gɔɹɔm
গৰাকী	gɔɹaki
গৰাহ	gɔɹaʱ
গৰীয়া	gɔɹia
গৰু	goɾu
গৰু	gɔɹu
গৰুৱা	gɔɹua
গৰৈ	gɔɹoɪ
ঘ	gʱɔ
ঘঁহনি	gʱɔ̃ɦɔni
ঘঁহা	gʱɔ̃ɦa
ঘটা	gʱɔta
ঘড়ী	gʱɔɹi
ঘনত্ব	gʱɔnɔttɔ
ঘমা	gʱɔma
ঘা	gʱa
ঘা	gʱã
ঘাঁহ	gʱãʱ
ঘাঁহনি	gʱãɦɔni
ঘাই	gʱaɪ
ঘাউ	gʱau
ঘাম	gʱam
ঘামচি	gʱamɔsi
ঘামা	gʱama
ঘাৰ	gʱaɹ
ঘিঁউ	gʱiu
ঘিণ	gʱin
ঘুমা	gʱuma
ঘেঁহু	gʱẽɦu
ঘৈণী	gʱoɪni
ঘোঁৰা	gʱʊ̃ɹa
ঘোং	gʱʊŋ
ঘোষণা	gʱʊxɔna
ঘোৰঘোৰা	gʱʊɹgʱʊɹa
ঘৰ	gʱɔɹ
ঘৰা	gʱɔɹa
ঙ	ŋɔ
চ	sɔ
চকা	sɔka
চকী	soki
চকু	sɔku
চকুপানী	sɔkupani
চকুলো	sɔkulʊ
চকোৱা	sɔkʊa
চক্লেট	sɔklɛt
চকৰ	sɔkɔɹ
চকৰা	sɔkɔɹa
চকৰি	sɔkɔɹi
চকৰিফেঁটী	sɔkɔɹipʰẽti
চকৰী	sɔkɔɹi
চখু	sɔkʰu
চতুৰ্থ	sɔtuttʰɔ
চতুৰ্থ	sɔtuɹtʰɔ
চন	sɔn
চন্দন	sɔndɔn
চন্দুক	sɔnduk
চন্দ্ৰ	sɔndɔ
চন্দ্ৰ	sɔndɹɔ
চন্দ্ৰবিন্দু	sɔndɹɔbindu
চবতকে	sɔbɔtkɛ
চমু	sɔmu
চমুউৱা	sɔmuua
চমুকে	sɔmukɛ
চমুকৈ	sɔmukoɪ
চমুটোকা	sɔmutʊka
চলা	sɔla
চলোৱা	sɔlʊa
চল্লিছ	sɔllis
চহী	sɔɦi
চহৰ	sɔɦɔɹ
চা	sa
চাঁদ	sãd
চাংমাই	saŋmaɪ
চাইগা	saɪga
চাক	sak
চাকা	saka
চাকৈ	sakoɪ
চাজ	saz
চাদৰ	sadɔɹ
চান	san
চানেকি	sanɛki
চান্দ	san
চান্দ	sand
চাপৰ	sapɔɹ
চাবন	sabɔn
চাবাইচ	sabaɪs
চাবাচ	sabas
চাবি	sabi
চাবোন	sabʊn
চাম	sam
চায়না	saéna
চালগোম	salgʊm
চালনি	salɔni
চালা	sala
চালাক	salak
চাহ	saʱ
চাহ	saː
চাহী	saɦi
চাৰি	saɹi
চাৰিআলি	saɹiali
চিংৰা	siŋɹa
চিকমিকিয়া	sikɔmikia
চিকা	sika
চিকাৰ	sikaɹ
চিকাৰী	sikaɹi
চিকিৎসক	sikissɔk
চিকিৎসক	sikitsɔk
চিকুট	sikut
চিকুটা	sikuta
চিকৰা	sikɔɹa
চিগাৰেট	sigaɹɛt
চিঙৰা	siŋɔɹa
চিঞৰ	siɔ̃ɹ
চিঠি	sitʰi
চিত	sit
চিতল	sitɔl
চিন	sin
চিনা	sina
চিনাকি	sinaki
চিনাকী	sinaki
চিন্তা	sinta
চিপ	sip
চিম্পাঞ্জী	simpanzi
চিয়াঁহী	siãɦi
চিলাকেন্থ	silakɛntʰɔ
চিলোৱা	silʊa
চিৰতা	siɹɔta
চিৰা	siɹa
চিৰিয়াখানা	siɹiakʰana
চিৰিয়াখানা	siɹiaxana
চু	su
চুঁৱৰী	sũɔɹi
চুঙা	suŋa
চুট	sut
চুটি	suti
চুটিকে	sutikɛ
চুটিকৈ	sutikoɪ
চুটিগল্প	sutigɔlpɔ
চুফি	supʰi
চুলা	sula
চুৰিয়া	suɹia
চূণ	sun
চেঁচা	sẽsa
চেউৰী	sɛuɹi
চেনি	seni
চেপা	sɛpa
চেপেটা	sɛpɛta
চেলা	sɛla
চেলাউৰি	sɛlauɹi
চেলেক	sɛlɛk
চেলেকা	sɛlɛka
চেল্ফি	sɛlpʰi
চেহেৰা	sɛɦɛɹa
চোঁৱৰ	sʊ̃ɔɹ
চোতাল	sʊtal
চোদ	sʊd
চোফা	sʊfa
চোফা	sʊpʰa
চোফা	sʊɸa
চোবা	sʊba
চোবোৱা	sʊbʊa
চোলা	sʊla
চোৰাং	sʊɹaŋ
চোৰাংচোৱা	sʊɹaŋsʊa
চোৰাত	sʊɹat
চোৱা	sʊa
চোৱাহিলি	sʊaɦili
চৌ	soʊ
চৌক	soʊk
চৌকা	soʊka
চৌখা	soʊkʰa
চৌত্ৰিছ	soʊtɹis
চৌথা	soʊtʰa
চৌবিছ	soʊbis
চৌষষ্ঠি	soʊxɔstʰi
চৌসত্তৰ	soʊxɔttɔɹ
চৌৰান্নব্বৈ	soʊɹannɔbboɪ
চৌৰাল্লিছ	soʊɹallis
চৌৰাশী	soʊɹaxi
চৌৱন	sɔʊɔn
চৰ	sɔɹ
চৰকাৰ	sɔɹkaɹ
চৰাই	sɔɹaɪ
চৰিওৱা	sɔɹiʊa
চৰিত্ৰ	sɔɹitɹɔ
চৰু	sɔɹu
চৰ্বত	sɔɹbɔt
চৰ্বত	sɔːbɔt
চৰ্বি	sɔɹbi
চ’থা	sotʰa
চ’বতকে	sobɔtkɛ
ছ	ɕɔ
ছটিওৱা	sɔtiʊa
ছত্তীছগঢ়	sɔttisɔgɔɹʱ
ছনা	sɔna
ছবি	sɔbi
ছয়	sɔj
ছয়চল্লিছ	sɔésɔllis
ছয়ত্ৰিছ	sɔétɹis
ছয়ষষ্ঠি	sɔéxɔstʰi
ছয়সত্তৰ	sɔéxɔttɔɹ
ছয়ান্নব্বৈ	sɔéannɔbboɪ
ছয়াশী	sɔéaxi
ছলি	sɔli
ছাই	saɪ
ছাগলী	sagɔli
ছাতি	sati
ছানা	sana
ছাপন	sapɔn
ছাবিছ	sabis
ছাল	sal
ছাৱ	saw
ছাৱা	sawa
ছিগা	siga
ছিঙা	siŋa
ছিটা	sita
ছিটিকনি	sitikɔni
ছিটিকা	sitika
ছিটিকোৱা	sitikʊa
ছিপ	sip
ছু	su
ছুটি	suti
ছুৰী	suɹi
ছেকনী	sɛkɔni
ছেকা	sɛka
ছেলোৱা	sɛlʊa
ছো	sʊ
ছোৱা	sʊa
ছোৱালী	sʊali
ছৰ্পত	sɔɹpɔt
ছৰ্বত	sɔɹbɔt
ছৰ্বত	sɔːbɔt
ছৱাল	sɔwal
জ	zɔ
জঁ	zɔ̃
জঁকা	zɔ̃ka
জঁপা	zɔ̃pa
জকা	zɔka
জকাই	zɔkaɪ
জখলা	zɔkʰɔla
জখলা	zɔxɔla
জগা	zɔga
জগোৱা	zɔgʊa
জগৰ	zɔgɔɹ
জগৰীয়া	zɔgɔɹia
জঙাই	zɔŋaɪ
জনপ্ৰিয়	zɔnɔɦpiɔ
জনপ্ৰিয়	zɔnɔɦpɹiɔ
জনসংখ্যা	zɔnɔxɔŋkʰja
জনা	zɔna
জন্তু	zɔntu
জপনা	zɔpɔna
জপা	zɔpa
জপোৱা	zɔpʊa
জবকা	zɔbɔka
জল	zɔl
জলকীয়া	zɔlɔkia
জলফাই	zɔlfaɪ
জলফাই	zɔlpʰaɪ
জলফাই	zɔlɸaɪ
জলবায়ু	zɔlɔbaju
জলহুৱা	zɔlɔɦua
জলা	zɔla
জলাহ	zɔlaʱ
জলোৱা	zɔlʊa
জল্পে’	zɔlpe
জহা	zɔɦa
জহামলা	zɔɦamɔla
জহামাল	zɔɦamal
জাঁত	zãt
জাঁতমিল	zãtmil
জাঁতি	zãti
জাঁপ	zãp
জাং	zaŋ
জাংফাই	zaŋpʰaɪ
জাই	zaɪ
জাক	zak
জাকৈ	zakoɪ
জাখে’	zaqʰe
জাখে’	zaxʰe
জাখৈ	zakʰoɪ
জাখ্লা	zaxla
জাগা	zaga
জাতি	zati
জাতিলাউ	zatilau
জান	zan
জানা	zana
জানোঁ	zanʊ̃
জাপ	zap
জাপা	zapa
জাপান	zapan
জাব্ৰাং	zabɹaŋ
জাম	zam
জামু	zamu
জামুক	zamuk
জাল	zal
জালা	zala
জালুক	zaluk
জাৰ	zaɹ
জাৰা	zaɹa
জাৰু	zaɹu
জিক	zik
জিঞাঁ	zia
জিঞাঁ	zĩã
জিনা	zina
জিভা	zibʱa
জিয়াঁ	zia
জিয়াঁ	zĩã
জিলি	zili
জিলিকা	zilika
জিলী	zili
জিৰণি	ziɹɔni
জিৰাফ	ziɹapʰ
জিৰোৱা	ziɹʊa
জী	zi
জী	ziː
জীউ	ziu
জীয়	ziɔ
জীয়া	zia
জীৱ	zibɔ
জীৱ	ziβɔ
জীৱন	zibɔn
জীৱন	ziwɔn
জীৱন	ziɔn
জীৱাণু	zibanu
জীৱাণু	ziβanu
জুই	zui
জুইশলা	zuixɔla
জুইশাল	zuixal
জুটুলিপকা	zutulipɔka
জুঠা	zutʰa
জুতি	zuti
জুন	zun
জুপুৰি	zupuɹi
জুবুৰিয়া	zubuɹia
জুলা	zula
জুলীয়া	zulia
জেং	zɛŋ
জেওৰা	zɛʊɹa
জেকা	zɛka
জেগা	zɛga
জেঠা	zɛtʰa
জেঠাই	zɛtʰaɪ
জেঠী	zɛtʰi
জেঠু	zɛtʰu
জেতুকা	zɛtuka
জেপ	zɛp
জেব্ৰা	zɛbɹa
জেলুক	zɛluk
জোঁকা	zʊ̃ka
জোঁকাৰ	zʊ̃kaɹ
জোঁৱাই	zʊ̃aɪ
জোং	zʊŋ
জোক	zʊk
জোখ	zʊkʰ
জোখ	zʊx
জোখা	zʊkʰa
জোখা	zʊxa
জোতা	zʊta
জোতাঠোঁটীয়া	zʊtatʰʊ̃tia
জোন	zʊn
জোনবাই	zʊnbaɪ
জোনাক	zʊnak
জোনাকী	zʊnaki
জোপোহা	zʊpʊɦa
জোলোঙা	zʊlʊŋa
জোৱাৰ	zʊaɹ
জ্ঞান	gjan
জ্বলন	zɔlɔn
জ্বলা	zɔla
জ্বলোৱা	zɔlʊa
জ্বালা	zala
জ্বৰ	zɔɹ
জৰা	zɔɹa
জৰি	zɔɹi
জৰিগছ	zɔɹigɔs
জৰী	zɔɹi
ঝ	zʱɔ
ঝাড়ু	zaɹu
ঝাড়ু	zʱaɹu
ঝাৰা	zʱaɹa
ঝিঞা	zʱia
ঝিঞা	zʱĩã
ঝিলি	zʱili
ঝিলী	zʱili
ঞ	jɔ
ট	tɔ
টকা	tɔka
টকিঅ’	tɔkio
টনা	tɔna
টমটম	tɔmtɔm
টাকা	taka
টাকা	taqa
টানা	tana
টালিটোপোলা	talitʊpʊla
টিকা	tika
টিপা	tipa
টিভি	tibʱi
টিলা	tila
টুকুৰা	tukuɹa
টুকুৰিওৱা	tukuɹiʊa
টুট	tut
টুপী	tupi
টুল	tul
টেংকি	tɛŋki
টেঙা	tɛŋa
টেমা	tɛma
টোকা	tʊka
টোপনি	tʊpɔni
টোপাল	tʊpal
টোপোলা	tʊpʊla
টোপোলাটাপলি	tʊpʊlatapɔli
ঠ	tʱɔ
ঠগ	tʰɔg
ঠগা	tʰɔga
ঠগোৱা	tʰɔgʊa
ঠাই	tʰaɪ
ঠান	tʰan
ঠানি	tʰani
ঠাল	tʰal
ঠালি	tʰali
ঠাৰ	tʰaɹ
ঠাৰি	tʰaɹi
ঠিলা	tʰila
ঠেং	tʰɛŋ
ঠেক	tʰɛk
ঠোঁট	tʰʊ̃t
ঠোঙা	tʰʊŋa
ঠৌগা	tʰoʊga
ড	dɔ
ডঁহা	dɔ̃ɦa
ডঙ্কা	dɔŋka
ডবা	dɔba
ডল	dɔl
ডলা	dɔla
ড়	ɾɔ
ডাঁহ	dãɦ
ডাঁহী	dãɦi
ডাঁৰ	dãɹ
ডাঁৰা	dãɹa
ডাঁৰি	dãɹi
ডাউক	dauk
ডাক	dak
ডাক্তৰ	daktɔɹ
ডাঙৰ	daŋɔɹ
ডাঠ	datʰ
ডাঠুৱা	datʰua
ডাব	dab
ডাল	dal
ডালি	dali
ডালিম	dalim
ডালিমা	dalima
ডাৱৰ	daɔɹ
ডাৱৰীয়া	daɔɹia
ডিঙি	diŋi
ডিম	dim
ডিমা	dima
ডিমৰু	dimɔɹu
ডিল	dil
ডিলা	dila
ডিলামাৰি	dilamaɹi
ডুবা	duba
ডুবাৰু	dubaɹu
ডুৰি	duɹi
ডে	dɛ
ডেউকা	dɛuka
ডেকা	dɛka
ডেকেৰী	dɛkɛɹi
ডেৰা	dɛɹa
ডেৱা	dɛwa
ডোং	dʊŋ
ডোঙা	dʊŋa
ডোল	dʊl
ডোৰ	dʊɹ
ডোৰা	dʊɹa
ঢ	dʱɔ
ঢকা	dʱɔka
ঢলা	dʱɔla
ঢ়	ɾɔ
ঢাক	dʱak
ঢাকন	dʱakɔn
ঢাকনি	dʱakɔni
ঢাকনী	dʱakɔni
ঢাকা	dʱaka
ঢাপ	dʱap
ঢাপলি	dʱapɔli
ঢাপলিকা	dʱapɔlika
ঢাপৰ	dʱapɔɹ
ঢালা	dʱala
ঢুকা	dʱuka
ঢেঁকী	dʱẽki
ঢেঁৰা	dʱẽɹa
ঢোঁৰাকাউৰী	dʱʊ̃ɹakauɹi
ঢোল	dʱʊl
ঢৌ	dʱoʊ
ণ	nɔ
ত	tɔ
তই	tɔɪ
তজু	tɔzu
তত্ত্ব	tɔtttɔ
তত্ব	tɔttɔ
তথা	tɔtʰa
তথাগত	tɔtʰagɔt
তথাপি	tɔtʰapi
তপত	tɔpɔt
তপিনা	tɔpina
তবলা	tɔbɔla
তম্বু	tɔmbu
তল	tɔl
তলা	tɔla
তহঁত	tɔɦɔ̃t
তাঁত	tãt
তাঁতশাল	tãtxal
তাঁতিনী	tãtini
তাঁতী	tãti
তাই	taɪ
তাইক	taɪk
তাইৰ	taɪɹ
তাও	taʊ
তাজমহল	tazmɔɦɔl
তাজা	taza
তাত	tat
তাপ	tap
তামাম	tamam
তামীঘৰা	tamigʱɔɹa
তামোল	tamʊl
তাল	tal
তালব্য	talɔɪbbɔ
তাহুন	taɦun
তাৰিখ	taɹikʰ
তাৰিখ	taɹix
তিঁত	tit
তিঁতা	tita
তিওৱা	tiʊa
তিতা	tita
তিতাকেৰেলা	titakɛɹɛla
তিতামৰা	titamɔɹa
তিতৌ	titoʊ
তিতৰ	titɔɹ
তিনি	tini
তিমি	timi
তিয়ঁহ	tiɒ̃ʱ
তিয়াল্লিছ	tiallis
তিল	til
তিৰান্নব্বৈ	tiɹannɔbboɪ
তিৰাশী	tiɹaxi
তীখা	tikʰa
তুতাংসামোন	tutaŋxamʊn
তুমি	tumi
তুলা	tula
তুলি	tuli
তুলী	tuli
তূলী	tuli
তৃতীয়	tɹitiɔ
তেঁতেলী	tẽteli
তেইছ	tɛis
তেওঁ	tɛʊ̃
তেওঁলোক	tɛʊ̃lʊk
তেখেত	tɛkʰɛt
তেজপিয়া	tɛzpia
তেজা	tɛza
তেতিয়া	tɛtia
তেত্ৰিছ	tɛtɹis
তেনে	tɛnɛ
তেনেহলে	tɛnɛɦɔlɛ
তেনেহ’লে	tɛnɛɦolɛ
তেল	tɛl
তেলটুপি	tɛltupi
তেলাকুচা	tɛlakusa
তেলাল	tɛlal
তেলীয়া	tɛlia
তেলীয়াসাৰেং	tɛliaxaɹɛŋ
তেষষ্ঠি	tɛxɔstʰi
তেসত্তৰ	tɛxɔttɔɹ
তেৱন	tɛɔn
তোপ	tʊp
তোমালোক	tʊmalʊk
তোমাৰ	tʊmaɹ
তোমোলাক	tʊmʊlak
তোলা	tʊla
ত্ৰিছ	tɹis
তৰমুজ	tɔɹmuz
তৰা	tɔɹa
তৰামাছ	tɔɹamas
তৰোৱাল	tɔɹʊal
তৰ্জমা	tɔɹzɔma
থ	tʱɔ
থকা	tʰɔka
থপা	tʰɔpa
থপিওৱা	tʰɔpiʊa
থপৰ	tʰɔpɔɹ
থপৰিওৱা	tʰɔpɔɹiʊa
থাইলেণ্ড	tʰaɪlɛnd
থাক	tʰak
থাকা	tʰaka
থান	tʰan
থাপ	tʰap
থাপা	tʰapa
থাপ্পৰ	tʰappɔɹ
থাপৰ	tʰapɔɹ
থাম	tʰam
থাল	tʰal
থালি	tʰali
থিয়	tʰiɔ
থিৰ	tʰiɹ
থু	tʰu
থুঁতৰি	tʰũtɔɹi
থুঁপ	tʰũp
থুম	tʰum
থোঁতা	tʰʊ̃ta
থোক	tʰʊk
থোৱা	tʰʊa
দ	dɔ
দখল	dɔkʰɔl
দখল	dɔxɔl
দঙা	dɔŋa
দন্ত্য	dɔntjɔ
দফা	dɔpʰa
দবা	dɔba
দবাখেল	dɔbakʰɛl
দবাখেল	dɔbaxɛl
দমা	dɔma
দমোৱা	dɔmʊa
দমৰা	dɔmɔɹa
দলং	dɔlɔŋ
দলম’ৰা	dɔlmoɹa
দলিওৱা	dɔliʊa
দহ	dɔɦ
দা	daː
দাঁত	dãt
দাঁৰ	dãɹ
দাউদাউ	daudau
দাঙা	daŋa
দাদা	dada
দাপোণ	dapʊn
দাম	dam
দামী	dami
দালাল	dalal
দালালি	dalali
দাহ	daʱ
দাৰি	daɹi
দাৱত	daɔt
দিওৱা	diʊa
দিছপুৰ	disɔpuɹ
দিঠক	ditʰɔk
দিন	din
দিনকণা	dinkɔna
দিয়া	dia
দিল্লী	dilli
দীগ	dig
দীঘ	dig
দীঘলা	digʱɔla
দীঘলোৱা	digʱɔlʊa
দীঘা	digʱa
দীয়া	dia
দীৰ্ঘ	diɹgʱɔ
দুই	dui
দুধ	dud
দুধ	dudʱ
দুৰাকাছ	duɹakasɔ
দুৱাৰ	duaɹ
দে	dɛ
দেউতা	dɛʊta
দেউতি	dɛuti
দেওবাৰ	dɛʊbaɹ
দেখা	dɛkʰa
দেখা	dɛxa
দেতা	dɛta
দেহা	dɛɦa
দেৱ	dɛw
দেৱনাগৰী	dɛwnagɔɹi
দেৱালী	dɛwali
দৈকলা	dɔikɔla
দৈনিক	doɪnik
দোতাৰা	dʊtaɹa
দোতোৰা	dʊtʊɹa
দোলা	dʊla
দোহাৰ	dʊɦaɹ
দোৱা	dʊa
দোৱাত	dʊat
দৌৰা	doʊɹa
দ্বিতীয়	ditiɔ
দ্বীপ	dip
দৰা	dɔɹa
দৰে	dɔɹɛ
দৰ্খাস্ত	dɔɹkʰastɔ
দৰ্খাস্ত	dɔɹxastɔ
দৰ্জা	dɔɹza
দৰ্জী	dɔɹzi
দৰৱ	dɒɹɒβ
দ’তি	doti
ধ	dʱɔ
ধঁপাত	dʱɔ̃pat
ধনিয়া	dʱɔnia
ধনী	dʱɔni
ধন্যবাদ	dʱɔɪnnɔbad
ধলা	dʱɔla
ধাতু	dʱatu
ধান	dʱan
ধাননি	dʱanɔni
ধাৰ	dʱaɹ
ধুতি	dʱuti
ধুনীয়া	dʱunia
ধুন্দুলি	dʱunduli
ধুমুহা	dʱumuɦa
ধুৰা	dʱuɹa
ধূমকেতু	dʱumkɛtu
ধূলি	dʱuli
ধেমালি	dʱɛmali
ধোৱা	dʱʊa
ধৰ	dʱɔɹ
ধৰণ	dʱɔɹɔn
ধৰ্ষণ	dʱɔɹxɔn
ন	nɔ
নংচাই	nɔŋsaɪ
নউ	nɔʊ
নকল	nɔkɔl
নক্সা	nɔksa
নখ	nɔkʰ
নখপালিচ	nɔkpalis
নগাওঁ	nɔgaʊ̃
নগৰ	nɔgɔɹ
নচা	nɔsa
নতুন	nɔtun
নদী	nɔdi
ননী	nɔni
নব্বৈ	nɔbboɪ
নমা	nɔma
নমাজ	nɔmaz
নমোৱা	nɔmʊa
নম্বৰ	nɔmbɔɹ
নহয়	nɔɦɔɛ
নহৰু	nɔɦɔɹu
নহ’লে	nɔɦolɛ
নাই	nai
নাই	naɪ
নাইপিয়া	naɪpia
নাও	naʊ
নাক	nak
নাঙঠ	naŋɔtʰ
নাঙল	naŋɔl
নাচা	nasa
নাজানোঁ	nazanʊ̃
নাট	nat
নাটনি	natɔni
নাপিত	napit
নামনি	namɔni
নামা	nama
নামাজ	namaz
নাম্বাৰ	nambaɹ
নাহৰ	naɦɔɹ
নাহৰফুটুকী	naɦɔɹpʰutuki
নাৰিকল	naɪkɔl
নাৰিকল	naɹikɔl
নিংনি	niŋni
নিওৱা	niʊa
নিগনি	nigɔni
নিচা	nisa
নিচান	nisan
নিজ	niz
নিজা	niza
নিজে	nizɛ
নিজৰ	nizɔɹ
নিনাও	ninaʊ
নিমখ	nimɔkʰ
নিয়া	nia
নিয়ান্নব্বৈ	niannɔbboɪ
নিয়ৰ	niʱɹɔ
নিযুত	nizut
নিলিখা	nilikʰa
নিলিখা	nilixa
নিশাহ	nixaʱ
নীলা	nila
নুমুউৱা	numua
নুমুউৱা	numuːa
নুমুৱা	numua
নে	nɛ
নেউল	nɛul
নেকি	neki
নেকি	niki
নেগুৰ	nɛguɹ
নেজ	nɛz
নেজানোঁ	nɛzanʊ̃
নৈ	noɪ
নৰম	nɔɹɔm
নৱেম্বৰ	nɔwɛmbɔɹ
প	pɔ
পঁচপন	pɔ̃spɔn
পঁচানব্বৈ	pɔ̃sanɔbboɪ
পঁচাশী	pɔ̃saxi
পঁচিছ	pɔ̃sis
পঁয়ত্ৰিছ	pɔ̃étɹis
পঁষষ্ঠি	pɔ̃xɔstʰi
পঁসত্তৰ	pɔ̃xɔttɔɹ
পকা	pɔka
পকোৱা	pɔkʊa
পখিলা	pokʰila
পগোৱা	pɔgʊa
পঘা	pɔgʱa
পচন	pɔsɔn
পচন্দ	pɔsɔn
পচন্দ	pɔsɔnd
পচলা	pɔsɔla
পচা	pɔsa
পচোৱা	pɔsʊa
পছন্দ	pɔsɔn
পছন্দ	pɔsɔnd
পছোৱা	pɔsʊa
পঞ্চল্লিছ	pɔnsɔllis
পঞ্চাছ	pɔnsas
পঞ্জাৱ	pɔnzab
পঞ্জাৱ	pɔnzaᵇ
পটাখৰি	pɔtakʰɔɹi
পঠা	pɔtʰa
পঠিওৱা	pɔtʰiʊa
পঠোৱা	pɔtʰʊa
পঢ়া	pɔɦa
পঢ়া	pɔʴɦa
পঢ়াশালি	pɔɦaxali
পঢ়াশালি	pɔɹʱaxali
পঢ়োৱা	pɔɦʊa
পঢ়োৱা	pɔʴɦʊa
পতা	pɔta
পথালি	pɔtʰali
পথাৰ	pɔtʰaɹ
পথৰুৱা	pɔtʰɔɹua
পদূলি	pɔduli
পদূলিমুখ	pɔdulimukʰ
পনিয়ল	pɔniɔl
পনীয়া	pɔnia
পনৰ	pɒnɒɹɒ
পনৰ	pɒnɒɾɒ
পনৰু	pɔnɔɹu
পল	pɒlɔ
পল	pɔl
পলম	pɔlɔm
পলা	pɔla
পলিথিন	pɔlitʰin
পলু	pɔlu
পলোৱা	pɔlʊa
পশু	pɔxu
পহিলা	pɔɦila
পহু	poɦu
পাঁচ	pãs
পাঁজৰ	pãzɔɹ
পাঁজৰা	pãzɔɹa
পাঁতি	pãti
পাং	paŋ
পাইক	paɪk
পাইকান	paɪkan
পাইকাৰী	paɪkaɹi
পাউণ্ড	paʊn
পাউণ্ড	paʊnd
পাক	pak
পাকঘৰ	paggʱɔɹ
পাকৈত	pakoɪt
পাখি	pakʰi
পাখি	paxi
পাগ	pag
পাগলামি	pagɔlami
পাগুলা	pagula
পাগুৰি	paguɹi
পাচলি	pasɔli
পাট	pat
পাণ	pan
পাণ্ডা	panda
পাতল	patɔl
পাতিহাঁহ	patiʱãɦ
পাত্থৰ	pattʰɔɹ
পাথৰ	patʰɔɹ
পানী	pani
পানীচকু	panisɔku
পানীলাউ	panilau
পানৈ	panoɪ
পান্তি	panti
পাভ	pabʱɔ
পাল	pal
পালি	pali
পালিচ	palis
পালেং	palɛŋ
পাহ	paʱ
পাহাৰ	paɦaɹ
পাহি	paɦi
পাহৰ	paɦɔɹ
পাহৰা	paɦɔɹa
পাৰ	paɹ
পাৰ	paɹɔ
পাৰা	paɹa
পাৰাউৱা	paɾaua
পাৰোৱা	paɹʊa
পিঁজৰা	pizɔɹa
পিঁপৰ	pipɔɹ
পিঁপৰ	pipɔɾ
পিঁপৰ	pipɔː
পিঁপৰা	pipɔɹa
পিক	pik
পিকোৱা	pikʊa
পিচলা	pisɔla
পিট	pit
পিটা	pita
পিটিক	pitik
পিটিকা	pitika
পিঠা	pitʰa
পিঠি	pitʰi
পিত	pit
পিতা	pita
পিন্ধ	pindʱ
পিন্ধা	pindʱa
পিয়া	pia
পিয়াঁজ	pijas
পিয়াঁজ	pijaz
পিয়াহ	piaʱ
পিহা	piɦa
পিৰা	piɹa
পিৰানা	piɹana
পুঁওৱা	pũʊa
পুং	puŋ
পুখুৰী	pukʰuɹi
পুঠি	putʰi
পুণী	puni
পুত	put
পুতাই	putaɪ
পুতৌ	putoʊ
পুথি	putʰi
পুথিভঁৰাল	putʰibʱɔ̃ɹal
পুনু	punu
পুলি	puli
পুৰণা	puɹɔna
পুৰণি	puɹɔni
পুৰুষ	puɹux
পুৱা	pua
পূঁজ	pũz
পূৰঠ	puɹɔtʰ
পূৰ্বীয়	puɹɹiɔ
পৃথিৱী	pitʰibi
পৃথিৱী	pitʰiwi
পৃথিৱী	pɹitʰiwi
পেঁক	pɛ̃q
পেঁপা	pẽpa
পেখন	pɛkʰɔn
পেখম	pɛkʰɔm
পেঙ্গুইন	pɛŋguin
পেঙ্গুইন	pɛŋuin
পেট	pɛt
পেটাৰি	pɛtaɹi
পেটী	pɛti
পেটু	pɛtu
পেটুলা	pɛtula
পেল	pɛl
পেলা	pɛla
পেলু	pelu
পেলোৱা	pɛlʊa
পেহা	pɛɦa
পেহী	pɛɦi
পেৰা	pɛɹa
পেৰী	peɹi
পৈ	poɪ
পৈণত	poɪnɔt
পো	pʊ
পোক	pʊk
পোকৰ	pʊkɔɹ
পোত	pʊt
পোতন	pʊtɔn
পোতা	pʊta
পোন	pʊn
পোনা	pʊna
পোন্ধৰ	pʊndʱɒɹɒ
পোহা	pʊɦa
পোহাৰ	pʊɦaɹ
পোহৰ	pʊɦɔɹ
পোহৰোৱা	pʊɦɔɹʊa
পোৱাল	pʊal
পোৱালী	pʊali
প্লেটিপাছ	plɛtipas
প্ৰকৃতি	pɹɔkɹiti
প্ৰক্ৰিয়া	pɔkia
প্ৰক্ৰিয়া	pɔkɹia
প্ৰক্ৰিয়া	pɹɔkia
প্ৰক্ৰিয়া	pɹɔkɹia
প্ৰথম	pɹɔtʰɔm
প্ৰথমতে	pɔtʰɔmɔtɛ
প্ৰথমতে	pɹɔtʰɔmɔtɛ
প্ৰথমে	pɔtʰɔmɛ
প্ৰথমে	pɹɔtʰɔmɛ
প্ৰসিদ্ধ	pɹɔxiddʱɔ
প্ৰাচীন	pɹasin
প্ৰাচীৰ	pɹasiɹ
পৰ	pɔɹ
পৰম্পৰা	pɔɹɔmpɔɹa
পৰা	pɔɹa
পৰিয়াল	pɔɹial
পৰুৱা	pɔɹua
পৰ্বত	pɔɹbɔt
পৰ্বত	pɔːbɔt
ফ	fɔ
ফ	pʰɔ
ফ	ɸɔ
ফচল	pʰɔsɔl
ফটকা	pʰɔtɔka
ফটা	pʰɔta
ফটো	pʰɔtʊ
ফণি	pʰoni
ফণী	pʰoni
ফল	pʰɔl
ফলা	pʰɔla
ফাঁক	pʰãk
ফাঁকু	pʰãku
ফাঁকুৱা	pʰãkua
ফাট	pʰat
ফাটা	pʰata
ফান্দ	pʰan
ফান্দ	pʰand
ফান্দ	ɸan
ফান্দ	ɸand
ফাল	pʰal
ফালা	pʰala
ফিঙ	pʰiŋɒ
ফিঙা	pʰiŋa
ফিছা	pʰisa
ফিলিপাইন	pʰilipaɪn
ফিৰিঙটি	pʰiɹiŋɔti
ফিৰিঙতি	pʰiɹiŋɔti
ফুটা	pʰuta
ফুল	ful
ফুল	pʰul
ফুল	ɸul
ফুলনি	pʰulɔni
ফুলনিবাৰী	pʰulɔnibaɹi
ফুলবাৰী	pʰulbaɹi
ফুলা	pʰula
ফুলোৱা	pʰulʊa
ফুৰ	pʰuɹ
ফুৰা	pʰuɹa
ফেঁচা	fɛsa
ফেঁচা	pʰɛsa
ফেঁচা	ɸɛsa
ফেঁট	pʰẽt
ফেঁটী	pʰẽti
ফেঁহু	pʰẽɦu
ফেউৰা	pʰɛuɹa
ফেন	pʰɛn
ফেনা	pʰɛna
ফেৰুৱা	pʰɛɹua
ফ্লেমিংগ	pʰlɛmiŋgɔ
ফ্লেমিঙ্গ	pʰlɛmiŋgɔ
ফৰাচী	pʰɔɹasi
ফৰিং	pʰɔɹiŋ
ফৰিঙা	pʰɔɹiŋa
ব	bɔ
বঁটা	bɔ̃ta
বকলা	bɔkɔla
বকা	bɔka
বখলিওৱা	bɔkʰɔliʊa
বখলিওৱা	bɔxɔliʊa
বগ	bɔg
বগলী	bɔgɔli
বগা	bɔga
বগোৱা	bɔgʊa
বগৰী	bɔgɔɹi
বঙহ	bɔŋɔɦ
বঙাল	bɔŋal
বচা	bɔsa
বছৰ	bɔsɔɹ
বছৰি	bɔsɔɹi
বছৰেক	bɔsɔɹɛk
বছৰেকীয়া	bɔsɔɹɛkia
বজাৰ	bɔzaɹ
বজোৱা	bɔzʊa
বটল	bɔtɔl
বটা	bɔta
বঢ়োৱা	baɹʱʊa
বঢ়োৱা	bɔɦʊa
বতাহ	bɔtaʱ
বত্ৰিছ	bɔtɹis
বতৰ	bɔtɔɹ
বতৰা	bɔtɔɹa
বন	bɔn
বনোৱা	bɔnʊa
বন্দুক	bɔnduk
বন্ধ	bɔn
বন্ধ	bɔndʱ
বন্ধ	bɔndʱɔ
বন্ধনী	bɔndʱɔni
বন্ধা	bɔndʱa
বন্ধাকবি	bɔndʱakɔbi
বমি	bɔmi
বয়স	bɔjɔx
বল	bɔl
বলা	bɔla
বলাৎকাৰ	bɔlatkaɹ
বসন্ত	bɔxɔntɔ
বস্তু	bɔstu
বহ	bɔɦ
বহঁত	bɔɦɔ̃t
বহল	bɔɦɔl
বহলোৱা	bɔɦɔlʊa
বহা	bɔɦa
বহাগ	bɔɦag
বহিখোৱা	bɔɦikʰʊa
বহী	boʱi
বহোৱা	bɔɦʊa
বা	ba
বা	baː
বাঁহ	bãʱ
বাঁহগাজ	bãʱgaz
বাঁহপাতী	bãʱpati
বাঁহফুল	bãʱpʰul
বাঁহী	bãɦi
বাংকেক	baŋkɛk
বাংলাদেশ	baŋladɛx
বাঃ	baʱ
বাঃ	baː
বাই	baɪ
বাইচন	baɪsɔn
বাইছ	baɪs
বাইদেউ	baɪdó
বাইদেউ	baɪdɛʊ
বাউল	baul
বাওঁ	baʊ̃
বাওঁফাল	baʊ̃pʰal
বাওঁফাললৈ	baʊ̃pʰalɔloɪ
বাওঁফালে	baʊ̃pʰalɛ
বাকচ	bakɔs
বাকলি	bakɔli
বাকী	baki
বাগান	bagan
বাগিচা	bagisa
বাঘমাছ	bagʱɔmas
বাঙী	baŋi
বাঙ্গনা	baŋɔna
বাচ	bas
বাচন	basɔn
বাছ	bas
বাজ	baz
বাজে	bazɛ
বাট	bat
বাটি	bati
বাঢ়	baɹ
বাঢ়	baɹʱ
বাঢ়	baʱ
বাঢ়নী	baɦɔni
বাঢ়নী	baɹʱɔni
বাঢ়া	baɦa
বাঢ়া	baɹa
বাঢ়া	baɹʱa
বাঢ়ৈ	baɦoɪ
বাঢ়ৈ	baɹoɪ
বাঢ়ৈ	baɹʱoɪ
বাঢ়ৈটোকা	baɹʱoɪtʊka
বাতৰি	batɔɹi
বাতৰিকাকত	batɹikakɔt
বাদাম	badam
বাদুলি	baduli
বাধা	badʱa
বান	ban
বানপানী	banpani
বানান	banan
বান্দৰ	bandɔɹ
বান্ধ	bandʱ
বান্ধ	banʱ
বান্ধা	bandʱa
বাপ	bap
বাবা	baba
বাবুৰ্চি	babuɹsi
বাম	bam
বামী	bami
বাল	bal
বালি	bali
বালিছ	balis
বালু	balu
বাল্টি	balti
বাল্টিং	baltiŋ
বাল্য	baɪllɔ
বাল্যকাল	baɪllɔkal
বালৰ	balɔɹ
বাষষ্ঠি	baxɔstʰi
বাসত্তৰ	baxɔttɔɹ
বাসিন্দা	baxinda
বাহ	baʱ
বাহা	baɦa
বাহিৰ	baɦiɹ
বাহিৰত	baɦiɹɔt
বাহিৰা	baɦiɹa
বাহিৰে	baɦiɹɛ
বাহু	baɦu
বাৰি	baɹi
বাৰিষা	baɹixa
বাৱন	baɔn
বিক	bik
বিকা	bika
বিঘা	bigʱa
বিচ	bis
বিচনী	bisoni
বিচাৰ	bisaɹ
বিচাৰা	bisaɹa
বিচৰা	bisɔɹa
বিছ	bis
বিছনা	bisɔna
বিছা	bisa
বিজল	bizɔl
বিজুলী	bizuli
বিজ্ঞান	biggan
বিদেশী	bidɛxi
বিদ্যালয়	biiddalɔj
বিনা	bina
বিনামূলীয়া	binamulia
বিন্ধা	bindʱa
বিভগ	bibʱɔg
বিভেদ	bibʱɛd
বিমানবন্দৰ	bimanbɔndɔɹ
বিয়লি	biɔli
বিয়া	bia
বিয়ান্নব্বৈ	biannɔbboɪ
বিয়াল্লিছ	biallis
বিয়াশী	biaxi
বিল	bil
বিলগ	bilɔg
বিলা	bila
বিলাই	bilaɪ
বিলাতী	bilati
বিলাহী	bilaɦi
বিলৈ	biloɪ
বিশ্ব	bissɔ
বিশ্ববিদ্যালয়	bissɔbiiddalɔj
বিষ	bix
বিষয়	bixɔj
বিষা	bixa
বিষোৱা	bixʊa
বিহ	biʱ
বিহান	biɦan
বিহাৰ	biɦaɹ
বিহু	biɦu
বিৰলী	biɹɔli
বিৰালী	biɹali
বিৰিং	biɹiŋ
বীজাণু	bizanu
বুকু	buku
বুজা	buza
বুট	but
বুটাম	butam
বুঢ়া	bua
বুঢ়া	buɦa
বুঢ়া	buɹa
বুঢ়া	buɹʱa
বুঢ়া	buɾa
বুঢ়া	buɾɦa
বুঢ়ী	bui
বুঢ়ী	buɦi
বুঢ়ী	buɹi
বুঢ়ী	buɹʱi
বুঢ়ী	buɾi
বুঢ়ী	buɾɦi
বুধবাৰ	budbaɹ
বুধিয়ক	budʱik
বুলা	bula
বুলি	buli
বুলীয়া	bulia
বৃশ্চিক	bissik
বৃশ্চিক	bɹissik
বৃহস্পতিবাৰ	biɦɔspɔtibaɹ
বৃহস্পতিবাৰ	bɹiʱɔspɔtibaɹ
বেঁকা	bẽka
বেং	bɛŋ
বেংক	bɛŋk
বেংছটা	bɛŋsɔta
বেংছাটি	bɛŋsati
বেক্টেৰিয়া	bɛktɛɹia
বেগ	bɛg
বেঙুনীয়া	bɛgunia
বেঙুনীয়া	bɛŋunia
বেঙেনা	bɛŋɛna
বেঙ্গনা	baŋɔna
বেচ	bɛs
বেছি	besi
বেজ	bɛz
বেজাৰ	bɛzaɹ
বেজাৰ	bɛzaɾ
বেজী	bezi
বেটা	bɛta
বেটী	bɛti
বেত	bɛt
বেতাঁৰ	bɛtãɹ
বেপাৰ	bɛpaɹ
বেপাৰী	bɛpaɹi
বেপৰোৱা	bɛpɔɹʊa
বেমাৰ	bɛmaɹ
বেয়া	bɛa
বেল	bɛl
বেলা	bɛla
বেলি	beli
বেলেগ	bɛlɛg
বেলেগকৈ	bɛlɛgkoɪ
বেল্ট	bɛl
বেল্ট	bɛlt
বেহা	bɛɦa
বেহাৰ	bɛɦaɾ
বেহেলা	bɛɦɛla
বেৰ	bɛɹ
বেৰা	bɛɹa
বেৰেটি	bɛɹɛti
বৈনী	boɪni
বৈষ্ণব	boɪsnɔbɔ
বৈহাগ	boɪɦag
বৈৰ্হান	bɔɪɾɦan
বোকা	bʊka
বোজা	bʊza
বোন্দা	bʊnda
বোন্দোৰা	bʊndʊɹa
বোপা	bʊpa
বোপাই	bʊpaɪ
বোল	bʊl
বোলা	bʊla
বোৱনী	bʊni
বোৱা	bʊa
বোৱাৰী	bʊaɹi
ব্যাখ্যা	baɪkkʰa
ব্যৱহাৰ	beɔɦaɹ
ব্যৱহাৰ	bɛbɔɦaɹ
ব্ৰহ্মপুত্ৰ	bɹɔɦmɔputɹɔ
বৎচোৱানা	bɔssʊana
বৎচোৱানা	bɔtsʊana
বৰ	bɔɹ
বৰণ	bɔɹɔn
বৰণীয়া	bɔɹɔnia
বৰদিন	bɔɹdin
বৰদেউতা	bɔɹɔdɛuta
বৰদৈচিলা	bɔɹdoɪsila
বৰফ	bɔɹɔf
বৰফ	bɔɹɔpʰ
বৰফ	bɔɹɔɸ
বৰমা	bɔɹma
বৰল	bɔɹɔl
বৰশী	bɔɹɔxi
বৰষ	bɔɹɔx
বৰষ	bɔɹɔɦ
বৰষুণ	bɔɹɔxun
বৰা	bɔɹa
বৰালি	bɔɹali
বৰি	boɹi
বৰ্ণ	bɔɹnɔ
বৰ্ণমালা	bɔɹnɔmala
বৰ্ত্তা	bɔɹtta
ব’ঠা	botʰa
ব’ল	bol
ব’লক	bolɔk
ব’লা	bola
ব’হাগ	boʱag
ভ	bʱɔ
ভকত	bʱɔkɔt
ভকুৱা	bʱɔkua
ভগা	bʱɔga
ভগোৱা	bʱɔgʊa
ভঙা	bʱɔŋa
ভজা	bʱɔza
ভণ্টি	bʱɔnti
ভণ্টী	bʱɔnti
ভতাৰ	bʱɔtaɹ
ভনী	bʱoni
ভনীটি	bʱɔniti
ভবা	bʱɔba
ভয়	bʱɔe
ভয়	bʱɔj
ভহা	bʱɔɦa
ভাঁৰ	bʱãɹ
ভাই	bʱaɪ
ভাইটি	bʱaɪti
ভাওনা	bʱaʊna
ভাগ	bʱag
ভাগা	bʱaga
ভাগৰ	bʱagɔɹ
ভাঙনি	bʱaŋɔni
ভাঙা	bʱaŋa
ভাজা	bʱaza
ভাট	bʱat
ভাটৌ	bʱatoʊ
ভাত	bʱat
ভাদ	bʱadɔ
ভাপ	bʱap
ভাবা	bʱaba
ভাল	bʱal
ভালকে	bʱalkɛ
ভালকৈ	bʱalkoɪ
ভালনে	bʱalnɛ
ভালপোৱা	bʱalpʊa
ভালুক	bʱaluk
ভাষা	bʱaxa
ভাহা	bʱaɦa
ভাৰত	bʱaɹɔt
ভাৰতীয়	bʱaɹɔtiɔ
ভাৰতীয়া	bʱaɹɔtia
ভাৰী	bʱaɹi
ভিজা	bʱiza
ভিজোৱা	bʱizʊa
ভিতৰ	bʱitɔɹ
ভিতৰত	bʱitɔɹɔt
ভিতৰুৱা	bʱitɔɹua
ভিতৰুৱাল	bʱitɔɹual
ভিয়েটনাম	bʱiɛtɔnam
ভুকা	bʱuka
ভুৱা	bʱua
ভূঁই	bʱũi
ভূঁইকঁপ	bʱũikɔ̃p
ভূটীয়া	bʱutia
ভূত	bʱut
ভূৰ	bʱuɹ
ভেক	bʱɛk
ভেকোলা	bʱɛkʊla
ভেটা	bʱɛta
ভেটি	bʱɛti
ভেড়া	bʱɛɹa
ভেল	bʱɛl
ভেলা	bʱɛla
ভেলেকী	bʱɛlɛki
ভেৰা	bʱɛɹa
ভৈয়াম	bʱoɪam
ভোক	bʱʊk
ভোক্তা	bʱʊkta
ভোজ	bʱʊz
ভোট	bʱʊt
ভোবোলা	bʱʊbʊla
ভোল	bʱʊl
ভোৰ	bʱʊɹ
ভৌগোলিক	bʱoʊgʊlik
ভৌম	bɦɔumɔ
ভ্ৰুব	bʱɹubɔ
ভৰসা	bʱɔɹɔxa
ভৰা	bʱɔɹa
ভৰি	bʱoɹi
ভৰোৱা	bʱɔɹʊa
ম	mɔ
মই	mɔɪ
মইনা	mɔɪna
মকৰা	mɔkɔɹa
মগ	mɔg
মগজ	mɔgɔz
মগজু	mɔgɔzu
মগা	mɔga
মগু	mɔgu
মঙলবাৰ	mɔŋɔlbaɹ
মঙহ	mɔŋɔɦ
মঙ্গলবাৰ	mɔŋgɔlbaɹ
মঙ্গলবাৰ	mɔŋɔlbaɹ
মচলা	mɔsɔla
মচা	mɔsa
মজা	mɔza
মটীয়া	mɔtia
মঠা	mɔtʰa
মণি	mɔni
মতা	mɔta
মথাউৰি	mɔtʰauɹi
মধু	mɔdʱu
মধুকৰ	mɔdʱukɔɹ
মধুমেহ	mɔdʱumɛɦ
মধুৰি	mɔdʱuɹi
মনা	mɔna
মনিয়ৰী	mɔniɔɹi
মন্ত্ৰী	mɔnti
মন্ত্ৰী	mɔntɹi
ময়ূৰ	mɔjuɹ
ময়ূৰী	mɔjuɹi
মলি	mɔli
মস্ত	mɔstɔ
মহ	mɔɦ
মহঙা	mɔɦɔŋa
মহা	mɔɦa
মহাদেশ	mɔɦadɛx
মহাভাৰত	mɔɦabʱaɹɔt
মহাসাগৰ	mɔɦaxagɔɹ
মহিলা	mɔɦila
মহী	mɔɦi
মা	ma
মা	maː
মাঁচিয়া	mãsia
মাংস	maŋkʰɔ
মাংস	maŋkˣɔ
মাংস	maŋxɔ
মাই	maɪ
মাইকী	maɪki
মাও	maʊ
মাকৈ	makoɪ
মাকো	makʊ
মাক্ৰা	maqɾa
মাখ	makʰ
মাখন	makʰɔn
মাগা	maga
মাগুৰ	maguɹ
মাছ	mas
মাছৰোকা	masɹʊka
মাজ	maz
মাজা	maza
মাজু	mazu
মাজেদি	mazɛdi
মাজেৰে	mazɛɹɛ
মাটি	mati
মাটিকঁঠাল	matikɔ̃tʰal
মাঠা	matʰa
মাণিক	manik
মাত	mat
মাতা	mata
মাথা	matʰa
মাথোঁ	matʰʊ̃
মাথোন	matʰʊn
মান	man
মানচিত্ৰ	mansittɔ
মানচিত্ৰ	mansitɹɔ
মানা	mana
মানুহ	manuʱ
মানুহ	manɦu
মানে	manɛ
মামী	mami
মামৰ	mamɔɹ
মামৰী	mamɔɹi
মাল	mal
মালযুঁজ	malzũz
মালিক	malik
মালিকনী	malikɔni
মালিকানা	malikana
মাহ	maʱ
মাহী	maɦi
মাৰ	maɹ
মাৰা	maɹa
মাৰি	maɹi
মাৰ্বল	maɹbɔl
মিছা	misa
মিঠা	mitʰa
মিঠাতেল	mitʰatɛl
মিঠালাউ	mitʰalau
মিঠালাও	mitʰalaʊ
মিতিৰ	mitiɹ
মিস্ত্ৰী	misti
মিস্ত্ৰী	mistɹi
মিহল	miɦɔl
মিহলা	miɦɔla
মিহলি	miɦɔli
মিহলোৱা	miɦɔlʊa
মুকলি	mukoli
মুখ	mukʰ
মুখ	mux
মুচি	musi
মুচী	musi
মুজা	muza
মুজুৰা	muzuɹa
মুঠ	mutʰ
মুঠা	mutʰa
মুঠি	mutʰi
মুঢ়া	muɦa
মুঢ়া	muɹa
মুঢ়া	muɹʱa
মুদা	muda
মুনিহ	muniʱ
মুম্বাই	mumbaɪ
মুহ	muʱ
মুৰি	muɹi
মুৱা	mua
মূঢ়া	muɹʱa
মূত	mut
মূতা	muta
মূলা	mula
মূৰ	muɹ
মৃত্যু	mɹittu
মেকুৰী	mekuɹi
মেঘ	mɛg
মেঘ	mɛgʱ
মেচেকা	mɛsɛka
মেটেকা	mɛtɛka
মেঠন	mɛtʰɔn
মেঠোন	mɛtʰʊn
মেলা	mɛla
মেহ	mɛɦ
মেৰামতি	mɛɹamɔti
মেৰিওৱা	mɛɹiʊa
মে’ওনিজ	mɛʊnɪz
মৈ	moɪ
মৈটা	moɪta
মৈদাম	moɪdam
মৈধফল	moɪtʰpʰɔl
মৈলাম	moɪlam
মৈৰা	mɔiɹa
মোকল	mʊkɔl
মোকলা	mʊkɔla
মোছা	mʊsa
মোজা	mʊza
মোত	mʊt
মোন	mʊn
মোনা	mʊna
মোবাইল	mʊbaɪl
মোমাই	mʊmaɪ
মোল	mʊl
মোলা	mʊla
মোৰ	mʊɹ
মৌ	moʊ
মৌচাক	moʊsak
মৌচুমী	moʊsumi
মৌপিয়া	moʊpia
মৌসিটা	moʊxita
মৰ	mɔɹ
মৰম	mɔɹɔm
মৰমলগা	mɔɹɔmlɔga
মৰমিয়াল	mɔɹɔmial
মৰমৰ	mɔɹɔmɔɹ
মৰা	mɔɹa
মৰাঠাৰি	mɔɹatʰaɹi
মৰাপাট	mɔɹapat
মৰ্মৰ	mɔɹmɔɹ
ম’হ	moʱ
ম’ৰা	moɹa
য	zɔ
যঁতৰ	zɔ̃tɔɹ
য়	jɔ
যা	za
যাঁত	zãt
যাঁতি	zãti
যাচ	zas
যাদু	zadu
যাদুকৰ	zadukɔɹ
যাদুঘৰ	zadugʱɔɹ
যিমান	ziman
যিৰূচালেম	ziɹusalem
যীশু	zixu
যুঁজ	zũz
যুঁজা	zũza
যুঁজাৰু	zũzaɹu
যেতিয়া	zɛtia
যেনে	zɛnɛ
যোগান	zʊgan
যোগোৱা	zʊgʊa
যোনি	zʊni
যোৱা	zʊa
যোৱাকালি	zʊakali
য’ত	zot
ল	lɔ
ল'ৰা	loɹa
লং	lɔŋ
লগত	lɔgɔt
লগা	lɔga
লঘোন	lɔgʱʊn
লতা	lɔta
লতাফুটুকি	lɔtapʰutuki
লতামাকৰি	lɔtamakɔɹi
লতামেকুৰী	lɔtamɛkuɹi
লথিওৱা	lɔtʰiʊa
লনী	lɔni
লহিয়া	lɔɦia
লহুন	lɔɦun
লহৰ	lɔɦɔɹ
লহৰি	lɔɦɔɹi
লা	la
লাই	laɪ
লাইখুঁটা	laɪkʰũta
লাউ	lau
লাউখোলা	laukʰʊla
লাউখোলা	lauxʊla
লাও	laʊ
লাওখোলা	laʊkʰʊla
লাওখোলা	laʊxʊla
লাখ	lakʰ
লাখ	lax
লাগ	lag
লাগা	laga
লাজ	laz
লাজুকা	lazuka
লাজুকী	lazuki
লাথ	lat
লাথ	latʰ
লাথি	latʰi
লাভ	lab
লাভ	labʱ
লালটি	lalɔti
লাৰা	laɹa
লিচু	lisu
লিপি	lipi
লিপিষ্টিক	lipistik
লুইত	luit
লুকুউৱা	lukuua
লুকুৱা	lukua
লুটিওৱা	lutiʊa
লুথুৰী	lutʰuɹi
লেখক	lɛkʰɔk
লেচু	lɛsu
লেচেৰা	lɛsɛɹa
লেটেকু	lɛtɛku
লেতেৰা	lɛtɛɹa
লেধা	lɛdʱa
লেলাউটি	lɛlauti
লেহেম	lɛɦɛm
লেহেমীয়া	lɛɦɛmia
লো	lʊ
লোকপ্ৰিয়	lʊkɔɦpiɔ
লোকপ্ৰিয়	lʊkɔɦpɹiɔ
লোণ	lʊn
লোহা	lʊɦa
লৰা	lɔɹa
লৰোৱা	lɔɹʊa
লৱনী	lɔwɔni
লৱনু	lɔwɔnu
ল’ৰা	loɹa
ল’ৰালি	loɹali
ল’ৰালিকাল	loɹalikal
শ	s
শ	xɔ
শইচ	xɔɪs
শকত	xɔkɔt
শক্তিশালী	xɔktixali
শগুন	xɔgun
শনিবাৰ	xɔnibaɹ
শব্দ	xɔbdɔ
শল	xɔl
শলা	xɔla
শলিয়া	xɔlia
শস্য	xɔɪssɒ
শহা	xɔɦa
শহুৰ	xɔɦuɹ
শাঁক	xãk
শাঁত	xãt
শাঁতি	xãti
শাও	xaʊ
শান্ত	xantɔ
শামুক	xamuk
শাল	xal
শালি	xali
শালিকা	xalika
শাহ	xaʱ
শাহু	xaɦu
শাহোন	xaɦʊn
শাৰী	xaɹi
শিং	xiŋ
শিকলি	xikɔli
শিকোওৱা	xikʊʊa
শিকোৱা	xikʊa
শিক্ষা	xikkʰa
শিঙৰি	xiŋɔɹi
শিটা	xita
শিঠা	xitʰa
শিপা	xipa
শিপিনী	xipini
শিমলু	ximɔlu
শিমেলি	ximeli
শিয়া	xia
শিয়াল	xial
শিল	xil
শিহা	xiɦa
শিহু	xiɦu
শিহুজাহাজ	xiɦuzaɦaz
শিহৰি	xiɦɔɹi
শুঁৰ	xũɹ
শুকান	xukan
শুকুউৱা	xukua
শুকুউৱা	xukuːa
শুকুৰবাৰ	xukuɹbaɹ
শুকুৱা	xukua
শুক্ৰবাৰ	xukɹɔbaɹ
শুঙা	xuŋa
শুধ	xudʱɔɦ
শুধৰা	xudʱɔɹa
শুধৰোৱা	xudʱɔɹʊa
শুন	xun
শুনা	xuna
শুৱনি	xuɔni
শুৱলা	xuɔla
শূন্য	xuinnɔ
শেঙুন	xɛŋun
শেন	xɛn
শেলাই	xɛlaɪ
শেৱাল	xɛwal
শেৱালি	xɛwali
শৈশৱ	xoɪxɔw
শৈশৱকাল	xɔɪxɒbkal
শো	xʊ
শোৱা	xʊa
শ্ৰদ্ধা	sɹɔddʱa
শ্ৰী	sɹi
শ্ৰীলংকা	silɔŋka
শ্ৰীলংকা	siɹilɔŋka
শ্ৰীলংকা	sɹilɔŋka
শৰণাৰ্থী	xɔɹɔnaɹtʰi
শৰালি	xɔɹali
শৰৎ	xɔɹɔt
শ’ল	xol
ষ	s
ষ	xɔ
ষাঁড়	xãɹ
ষাঠি	xatʰi
স	s
স	xɔ
সঁচা	xɔ̃sa
সঁজুলি	xɔ̃zuli
সংস্কৃত	xɔŋskɹit
সকলো	xɔkɔlʊ
সকলোতকে	xɔkɔlʊtkɛ
সকলোতকৈ	xɔkɔlʊtkoɪ
সজা	xɔza
সজোৱা	xɔzʊa
সণা	xɔna
সতেজ	xɔtɛz
সত্তৰ	xɔttɔɹ
সদৰ	xɔdɔɹ
সনা	xɔna
সন্ত	xɔntɔ
সন্দেহ	xɔndɛʱ
সন্ধিয়া	xɔndʱia
সন্মান	xɔnman
সপান	xɔpan
সপোন	xɔpʊn
সবাতোকে	xɔbatʊkɛ
সবাতোকৈ	xɔbatʊkoɪ
সভা	xɔbʱa
সমকামিতা	xɔmɔkamita
সমকামী	xɔmɔkami
সমনীয়া	xɔmɔnia
সময়	xɔmɔɛ
সমান	xman
সলনি	xɔlɔni
সলা	xɔla
সলিল	xɔlil
সলোৱা	xɔlʊa
সহা	xɔɦa
সাঁকো	xãkʊ
সাঁচ	xãs
সাঁচা	xãsa
সাঁজ	xãz
সাঁফৰ	xãpʰɔɹ
সাউ	xau
সাগৰ	xagɔɹ
সাঙোৰ	xaŋʊɹ
সাজ	xaz
সাজু	xazu
সাজো	xazʊ
সাত	xat
সাতচল্লিছ	xatsɔllis
সাতত্ৰিছ	xatɔtɹis
সাতষষ্ঠি	xatxɔstʰi
সাতসত্তৰ	xatxɔttɔɹ
সাতাইছ	xataɪs
সাতান্নব্বৈ	xatannɔbboɪ
সাতাশী	xataxi
সাতাৱন	xataɔn
সাধু	xadʱu
সান	xan
সানা	xana
সাপ	xap
সাবট	xabɔt
সাবট	xaβɔt
সামৰ	xamɔɹ
সালসলনি	xalxɒlɒni
সাহ	xaʱ
সাহিত্য	xaɦiittɔ
সাহোন	xaɦʊn
সাৰ	xaɹ
সাৰেং	xaɹɛŋ
সাৱট	xaβɔt
সি	xi
সিঁচা	xisa
সিংহ	xiŋɦɔ
সিজা	xiza
সিজোৱা	xizʊa
সিটা	xita
সিঠি	xitʰi
সিদ্ধাৰ্থ	xiddʱaɹtʰɔ
সিধা	xidʱa
সিন্ধু	xindʱu
সিমান	ximan
সিহঁত	xiɦɔ̃t
সিহঁতৰ	xiʱɔ̃tɔɹ
সিৰ	xiɹ
সীওৱা	xiʊa
সীয়া	xia
সীহ	xiʱ
সুঁতি	xũti
সুকীয়া	xukia
সুখ	xukʰ
সুণীয়া	xunia
সুবিধা	xubidʱa
সুমথিৰা	xumtʰiɹa
সুহুৰি	xuɦuɹi
সূচোৱা	xusʊa
সূত	xut
সূতা	xuta
সূতাৰ	xutaɹ
সূৰুয	xuɹuz
সূৰ্য্য	xuiɹdʑɒ
সেইটো	xɛitʊ
সেউজ	xɛuz
সেউজীয়া	xɛuzia
সেওঁতা	xɛʊ̃ta
সেকা	xɛka
সেমেকা	xɛmɛka
সেৰেঙা	xɛɹɛŋa
সেৱা	xɛwa
সৈতে	xoɪtɛ
সোঁ	xʊ̃
সোঁত	xʊ̃t
সোঁতা	xʊ̃ta
সোঁফাল	xʊ̃pʰal
সোঁফালে	xʊ̃pʰalɛ
সোণ	xʊn
সোণালী	xʊnali
সোণৰ	xʊnɔɹ
সোতৰ	xʊtɔɹɔɦ
সোধা	xʊdʱa
সোনকালে	xʊnkalɛ
সোনাৰি	xʊnaɹi
সোপা	xʊpa
সোমবাৰ	xʊmbaɹ
সোমোৱা	xʊmʊa
সোৱাদ	xʊad
স্কুল	iskul
স্কুল	skul
স্পৰ্শ	spɔɹxɔ
স্পৰ্শবৰ্ণ	spɔɹxɔbɔɹnɔ
স্বতন্ত্ৰ	sɔtɔntɹɔ
স্বাধীনতা	sadʱinɔta
স্বামী	sami
স্বৰ	sɔɹ
স্বৰবৰ্ণ	sɔɹɔbɔɹnɔ
সৰ	xɔɹ
সৰস্বতী	xɔɹɔssɔti
সৰা	xɔɹa
সৰিয়হ	xoɹiɔʱ
সৰিহ	xoɹiɦɔ
সৰু	xɔɹu
হ	ɦɔ
হঁতে	ɦɔ̃tɛ
হঁয়কলি	ɦɔ̃jkɔli
হঁহা	ɦɔɦa
হগা	ɦɔga
হজম	ɦɔzɔm
হতেন	ɦɔtɛn
হনা	ɦɔna
হয়	ɦɔj
হয়	ɦɔé
হলা	ɦɔla
হলোৱা	ɦɔlʊa
হলৌ	ɦɔloʊ
হাঁওফাঁও	ɦãʊpʰãʊ
হাঁচি	ɦãsi
হাঁচিওৱা	ɦãsiʊa
হাঁঠ	ɦãtʰ
হাঁহ	ɦãɦ
হাঁহঠুঁটীয়া	ɦãɦtʰũtia
হাংগৰ	ɦaŋgɔɹ
হাইঠা	ɦaɪtʰa
হাওৰ	ɦaʊɹ
হাকিম	ɦakim
হাগা	ɦaga
হাঙাৰ	ɦaŋaɾ
হাঙৰ	ɦaŋɔɹ
হাজং	ɦazɔŋ
হাজাৰ	ɦazaɹ
হাজৰিকা	ɦazoɹika
হাট	ɦat
হাটী	ɦati
হাড়	ɦaɹ
হাড়গিলা	ɦaɹgila
হাতমোজা	ɦatmʊza
হাতী	ɦati
হাতুৰী	ɦatuɹi
হাথী	ɦatʰi
হাদং	ɦadɔŋ
হানা	ɦana
হাপা	ɦapa
হাবি	ɦabi
হামি	ɦami
হামিওৱা	ɦamiʊa
হামিয়া	ɦamia
হাল	ɦal
হালধি	halɔdʱi
হালধীয়া	ɦalɔdʱia
হালুৱা	ɦalua
হালোৱা	ɦalʊa
হাহাকাৰ	ɦaɦakaɹ
হাৰ	ɦaɹ
হাৰা	ɦaɹa
হাৱৰ	ɦaɔɹ
হিংসা	ɦiŋkʰa
হিংসা	ɦiŋxa
হিচাপ	ɦisap
হিম	ɦim
হিমালয়	ɦimalɔj
হিয়া	ɦia
হিলৈ	ɦiloɪ
হীৰা	ɦiɹa
হুলস্থূল	ɦulɔstʰul
হুৰুম	ɦuɹum
হুৱাদুৱা	ɦuadua
হেঁচা	ɦẽsa
হেঁতেন	ɦẽtɛn
হেঁপা	ɦẽpa
হেঁপাহ	ɦẽpaʱ
হেংদাং	ɦɛŋdaŋ
হেঙাৰ	ɦɛŋaɹ
হেজাৰ	ɦɛzaɹ
হেপা	ɦɛpa
হেৰুউৱা	ɦɛɹua
হেৰুউৱা	ɦɛɹuːa
হেৰোৱা	ɦɛɹʊa
হৈ	ɦoɪ
হোটেল	ɦʊtɛl
হোপা	ɦʊpa
হোম	ɦʊm
হোৱা	ɦʊa
হ্ৰস্ব	ɦɹɔssɔ
হৰা	ɦɔɹa
হৰিণ	ɦɔɹin
হৰিণা	ɦɔɹina
হৰিণাপহু	ɦɔɹinapɔɦu
ৰ	ɹɔ
ৰং	ɹɔŋ
ৰখা	ɹɔkʰa
ৰঙা	ɹɔŋa
ৰঙালাউ	ɹɔŋalau
ৰঙালাও	ɹɔŋalaʊ
ৰঙোৱা	ɹɔŋʊa
ৰচনা	ɹɔsɔna
ৰছী	ɹɔsi
ৰজা	ɹɔza
ৰন্ধা	ɹɔndʱa
ৰবিবাৰ	ɹɔbibaɹ
ৰভা	ɹɔbʱa
ৰমজান	ɹɔmzan
ৰস	ɹɔx
ৰহ	ɹɔɦ
ৰহঘৰা	ɹɔɦgʱɔɹa
ৰহণ	ɹɔɦɔn
ৰাং	ɹaŋ
ৰাংঢালী	ɹaŋdʱali
ৰাংপতা	ɹaŋpɔta
ৰাইজ	ɹaɪz
ৰাক্ষস	ɹakʰɔx
ৰাজস্থান	ɹazɔstʰan
ৰাজহাড়	ɹazɦaɹ
ৰাজ্য	ɹaɪdʑɔ
ৰাণী	ɹani
ৰাতি	ɹati
ৰাতিপুৱা	ɹatipua
ৰান্ধনি	ɹandʱɔni
ৰান্ধা	ɹandʱa
ৰামধেনু	ɹamdʱɛnu
ৰাষ্ট্ৰ	ɹastɹɔ
ৰিক্সা	ɹiksa
ৰিজোৱা	ɹizʊa
ৰিহা	ɹiɦa
ৰুটি	ɹuti
ৰুমাল	ɹumal
ৰেণু	ɹɛnu
ৰেতি	ɹɛti
ৰেহা	ɹɛɦa
ৰোক	ɹʊk
ৰোকনী	ɹʊkɔni
ৰোকা	ɹʊka
ৰোজা	ɹʊza
ৰোৱা	ɹʊa
ৰৌ	ɹoʊ
ৰ’দ	ɹod
ৰ’দোৱা	ɹodʊa
ৱ	wɔ
ৱ	βɔ
