aaffaffak	aaffaffak
aaffanniaq	aaffanniaq
aaffanniarpoq	aaffanniarpuq
aaffanniusiorpoq	aaffanniusiurpuq
aaffanniut	aaffanniut
aaffanniutaaruppoq	aaffanniutaaruppuq
aaffappoq	aaffappuq
aaffaq	aaffaq
aaffarmiippoq	aaffarmiippuq
aagiak	aagiak
aagiaq	aagiaq
aaja	aaja
aaju	aaju
aajunnguaq	aajuŋŋuaq
aak	aak
aakilliorneq	aakilliurniq
aakilliorpoq	aakilliurpuq
aalaakkak	aalaakkak
aalajavoq	aalajavuq
aalaneq	aalaniq
aalaq	aalaq
aalaqqajuppoq	aalaqqajuppuq
aalavoq	aalavuq
aali	aali
aalisagaq	aalisagaq
aalisaq	aalisaq
aalisarpaa	aalisarpaa
aalisarpoq	aalisarpuq
aalisartoq	aalisartuq
aallaat	aallaat
aalut	aalut
aamanganiaq	aamaŋaniaq
aamma	aamma
aanaa	aanaa
aanak	aanak
aanaq	aanaq
aaneq	aaniq
aani	aani
aapaalingiagaa	aapaaliŋiagaa
aap	aap
aapakaaq	aapakaaq
aapakaatsiaq	aapakaatsiaq
aapalaat	aapalaat
aapavoq	aapavuq
aappaa	aːppaː
aappalaarpoq	aappalaarpuq
aappalaartoq	aappalaartuq
aappalaat	aappalaat
aappalajaarpoq	aappalajaarpuq
aappalajappoq	aappalajappuq
aappalik	aappalik
aappallarippoq	aappallarippuq
aappallarissoq	aappallarissuq
aappalloqut	aappalluqut
aappaluarpoq	aappaluarpuq
aappalujappoq	aːppalujappɔq
aappalujattoq	aːppalujattɔq
aappalukujuppoq	aappalukujuppuq
aappalunguserpoq	aappaluŋusirpuq
aappaluppoq	aappaluppuq
aappaluttoq	aappaluttuq
aappaq	aappaq
aappariit	aappariit
aappersariaq	aappirsariaq
aappilattoq	aappilattuq
aappillerpoq	aappillirpuq
aaq	aaq
aaqanngitsoq	aaqaŋŋitsuq
aaqarpoq	aaqarpuq
aaqartarneq	aaqartarniq
aaqqat	aaqqat
aariak	aariak
aarlaat	aarlaat
aarlorpoq	aarlurpuq
aarlorussivoq	aarlurussivuq
aarluarsuk	aarluarsuk
aarluk	aarluk
a'arpoq	aɑppɔq
aasiak	aasiak
aasik	aasik
aataa	aataa
aataaliannguaq	aataaliaŋŋuaq
aataaq	aataaq
aataq	aataq
aatsaat	aatsaat
aatsippaa	aatsippaa
aatsitassaq	aatsitassaq
aattorpaa	aatturpaa
aavaa	aavaa
aavarfik	aavarfik
aavariarpoq	aavariarpuq
aavarpaa	aavarpaa
aavarpoq	aavarpuq
aaveq	aaviq
aavooq	aavuuq
aavoq	aavuq
abrikosi	aprikusi
afrikarmiu	afrikarmiu
agguaappai	agguaappai
aggu	aggu
agguaqatigiissitaq	agguaqatigiissitaq
agguarneqarsinnaasoq	agguarniqarsinnaasuq
agguarpaa	agguarpaa
aggustusi	aggustusi
agiamineq	agiaminiq
agiaq	agiaq
agiorpoq	aɣiʲɔppɔq
ajaa	ajaa
aja	aja
ajaaq	ajaaq
ajak	ajak
ajornanngilaq	ajurnaŋŋilaq
ajornarpoq	ajurnarpuq
ajornartorsiut	ajurnartursiut
ajorpaa	ajurpaa
ajorpoq	ajurpuq
ajorsaarivoq	ajursaarivuq
ajortorsuaq	ajurtursuaq
ajunaarneq	ajunaarniq
ajunngilaq	ajuŋŋilaq
ajuusaarnarpoq	ajuusaarnarpuq
ajuusaarpoq	ajuusaarpuq
akaarinnittoq	akaarinnittuq
akiitsut	akiitsut
akiliut	akiliut
akissut	akissut
akisussaaffik	akisussaaffik
akkusativi	akkusativi
akoqanngilaq	akuqaŋŋilaq
akoqarpoq	akuqarpuq
akornanni	akurnanni
aku	aku
akueraa	akuiraa
akuliuppoq	akuliuppuq
akulleq	akulliq
akunneq	akunniq
alaakkilli	alaakkilli
alanngialasoq	alaŋŋialasuq
alanngialavoq	alaŋŋialavuq
alanngoq	alaŋŋuq
aleqa	aliqa
aleqaq	aliqaq
aleqat	aliqat
aleutisut	aliutisut
aleutit	aliutit
alla	alla
allaffeqarfik	allaffiqarfik
allaffik	allaffik
allakkat	allakkat
allamoorut	allamuurut
allappoq	allappuq
allernaaraq	allirnaaraq
allernaq	allirnaq
alleroq	aɬɬɜʁɔq
allivaa	allivaa
allivoq	allivuq
allu	allu
aluu	aluu
amaasa	amaasa
amaasi	amaasi
amaroq	amaruq
ameq	amiq
amerikarmiu	amirikarmiu
amerikarmiut	amirikarmiut
amerlasuut	amirlasuut
amharisut	amharisut
amikoq	amikuq
aminnguaq	amiŋŋuaq
amma	amma
ammak	ammak
ammassak	ammassak
ammassassuaq	ammassassuʷɑq
anaana	anaːna
anaanat	anaːnat
anarnaq	anɑnnɑq
andengradsligningi	antiŋratsligniŋi
anersaaq	anirsaaq
anersaarpoq	anirsaarpuq
anersaaruluppoq	anirsaaruluppuq
angajoq	aŋajuq
angajoqqaaq	aŋajuqqaaq
angajoqqaarsiaq	aŋajuqqaarsiaq
angak	aŋak
angakkoq	aŋakkɔq
angakkoqarneq	aŋakkɔqɑnnɜq
angallanneq	aŋallanniq
angaluppoq	aŋaluppuq
angerla	aŋirla
angerlannguaq	aŋirlaŋŋuaq
angerlarpoq	aŋɜɬɬɑppɔq
angerlartoq	aŋirlartuq
angerlartunnguaq	aŋirlartuŋŋuaq
angisooq	aŋisuuq
angivoq	aŋivɔq
angoorpoq	aŋɔːppɔq
angut	aŋut
anguteqatiminoortartoq	aŋutiqatiminuurtartuq
anguteqatiminoortoq	aŋutiqatiminuurtuq
anguvoq	aŋuvuq
ani	ɛni
anigorpaa	anigurpaa
aningaasaq	aniŋaasaq
aningaasat	aniŋaasat
aningaasivik	aniŋaasivik
anisooq	anisuuq
anivoq	anivuq
annassi	annassi
anneq	anniq
annernarpoq	annirnarpuq
annerpaaq	annirpaaq
annerpoq	annirpuq
annertusisaq	annɜttusisɑq
annertusivoq	annirtusivuq
anngilik	aŋŋilik
anniarfik	anniarfik
anniarpoq	anniarpuq
anniita	anniita
annilaangavoq	annilaaŋavuq
annilaarpoq	annilaarpuq
annoraaq	annɔʁɑːq
anorersuaq	anurirsuaq
anori	anuri
anorliorpoq	anurliurpuq
aperivoq	apirivuq
appa	appa
appaliarsuk	appaliʲɑssuk
apparluk	appɑɬɬuk
appartarneq	appartarniq
appelsiina	appɜlsiːna
apusineq	apusiniq
aput	aput
aputsiaq	aputsiaq
aqaguani	aqaguani
aqagu	aqaɣu
aqerloq	aqirluq
aqerluusaq	aqirluusaq
aqisseq	ɑqissɜq
aqqalu	aqqalu
aqqaluk	aqqaluk
aqqanillit	aqqaniɬɬit
aqqusineq	aqqusiniq
aqqut	aqqut
aquppaa	aquppaa
aqutsisoq	aqutsisuq
araberisut	arapirisut
arfeq	arfiq
arfernat	ɑffɜnnat
arfersaneq	arfirsaniq
arfersanillit	ɑffɜssaniɬɬit
arfineq	ɑffinɜq
arfinillit	ɑffiniɬɬit
arfivik	ɑffivik
arlallit	arlallit
arlaq	arlaq
arnaasaq	arnaasaq
arnannguaq	arnaŋŋuaq
arnaq	arnaq
arnaqatiminoortartoq	arnaqatiminuurtartuq
arnaqatiminoortoq	arnaqatiminuurtuq
arsakoorfik	arsakuurfik
arsaq	arsaq
arsat	arsat
artornaqaaq	arturnaqaaq
asanninneq	asanninniq
aseruutaasoq	asiruutaasuq
assaat	assaːt
assagiaq	assaɣiʲɑq
assagiarsuk	assaɣiʲɑssuk
assak	assak
assaqqoq	assaqqɔq
asseqanngilaq	assiqaŋŋilaq
asseqanngitsoq	assiqaŋŋitsuq
assersuut	assirsuut
assigiissitaq	assigiissitaq
ataaseq	ataːsɜq
ataata	ataata
ataataq	ataataq
atangana	ataŋana
atasoq	atasuq
ateqarpoq	atiqarpuq
ateq	atiq
ati	ɛtsi
atisalersorpaa	atisalirsurpaa
atisaq	atisaq
ativaa	ativaa
atorneqartoq	aturniqartuq
atorpaa	aturpaa
atorpoq	aturpuq
atorsinnaanngitsoq	atursinnaaŋŋitsuq
atorsinnaavoq	atursinnaavuq
atsa	attsa
atsak	attsak
atserpaa	atsirpaa
atsiaq	atsiaq
attartorpoq	attarturpuq
atuaaneq	atuaaniq
atuagaq	atuagaq
atuakkiaq	atuakkiaq
atuaqat	atuaqat
atuarfik	atuarfik
atuarpaa	atuarpaa
atuarpoq	atuarpuq
augo	augu
australiamiu	australiamiu
australiamiut	australiamiut
avaanngunarpoq	avaaŋŋunarpuq
avannaa	avannaa
avannaarsua	avannaarsua
avannaq	avannɑq
avannarleq	avannarliq
avannarparpoq	avannarparpuq
avatannguaq	avataŋŋuaq
avataq	avataq
avgo	avgu
aviaaja	aviaaja
aviaq	aviaq
avinngaq	aviŋŋɑq
baj	baj
baskerisut	paskirisut
belgiamiu	pilgiamiu
betonngi	pituŋŋi
biilerpoq	piilirpuq
biilertoq	piilirtuq
biina	piina
bikki	pikki
biskorpi	piskurpi
blobfiski	plupfiski
bolatta	pulatta
computeri	cumputiri
dommeri	tummiri
efa	ifa
efterskole	iftirskuli
enhjørningi	eːnjœɐ̯neŋŋi
eqalugaasaq	ɜqaluɣaːsɑq
eqalugaq	ɜqaluɣɑq
eqalussuannguvoq	iqalussuaŋŋuvuq
eqalussuaq	ɜqaluʃʃuʷɑq
eqalussuarnaq	ɜqalussuʷɑnnɑq
eqalussuarsuaq	ɜqalussuʷɑrsuʷɑq
eqisaavaq	ɜqisaːvɑq
eqqaamiu	iqqaamiu
eqqaanarneq	iqqaanarniq
eqqaanarpoq	iqqaanarpuq
eqqaani	iqqaani
eqqaavaa	iqqaavaa
eqqaq	iqqaq
eqqarsarpoq	iqqarsarpuq
eqqartorpaa	iqqarturpaa
eqqartuussisoq	iqqartuussisuq
eqqoq	ɜqqɔq
eqqoqqortooq	iqquqqurtuuq
eqqortumik	iqqurtumik
eqquiniunnguaq	iqquiniuŋŋuaq
eqqumiippoq	iqqumiippuq
eqqusaq	ɜqqusɑq
equsaavaq	ɜqusaːvɑq
erfalavoq	irfalavuq
erinarsorpoq	irinarsurpuq
erinarsortartoq	irinarsurtartuq
erneeraq	irniiraq
erneq	ɜnnɜq
ernersiaq	irnirsiaq
erniaq	irniaq
errorpaa	irrurpaa
errorsivik	irrursivik
errorsivoq	irrursivuq
erruivoq	irruivuq
ersaq	irsaq
ersiut	irsiut
fabrikki	faprikki
fari	fari
filmiliorneq	filmiliurniq
filmiliorpoq	filmiliurpuq
finlandimiu	finlantimiu
finlandimiutut	finlantimiutut
fjernsyni	fjirnsyni
folketingi	fulkitiŋi
gulerodi	guliruti
guuti	guuti
guutipiluk	guutipiluk
guutipilussiorneq	guutipilussiurniq
guutipilussiorpoq	guutipilussiurpuq
iffiaq	iffiaq
igaffik	igaffik
igalaaq	igalaaq
igasoq	igasuq
igavoq	igavuq
igutsak	iɣuttsak
iguut	iguut
iguutilik	iɣuːtsilik
iigaq	iigaq
iigarpoq	iigarpuq
iipili	iːpili
iipilit	iːpilit
iisaaq	iisaaq
ikinngutigaa	ikiŋŋutsiɣaː
ikinngutigiinneq	ikiŋŋutsiɣiːnnɜq
ikinngut	ikiŋŋut
ikivoq	ikivuq
ikku	ikku
ikorpoq	ikurpuq
ikorsimmavik	ikursimmavik
ikusik	ikusik
ilaa	ilaa
ilaajunnaarsippaa	ilaajunnaarsippaa
ilaasortaq	ilaasurtaq
ilaavoq	ilaavuq
ila	ila
ilannguppaa	ilaŋŋuppaa
ilaqutaq	ilaqutaq
ilaqutariinneq	ilaqutariinniq
ilaqutariit	ilaqutariit
ilasiaq	ilasiaq
ilikkarpoq	ilikkarpuq
ilinneq	ilinniq
ilinniagassat	ilinniagassat
ilinniarnertooq	ilinniarnirtuuq
ilinniarpoq	ilinniarpuq
ilinniartitsisoq	ilinniartitsisuq
ilinniartitsivoq	ilinniartitsivuq
ilippoq	ilippuq
ilisimasassarsiorpoq	ilisimasassarsiurpuq
ilisimasassarsiortoq	ilisimasassarsiurtuq
ilisimassuseq	ilisimassusiq
ilisimatooq	ilisimatuuq
ilisimatusarfik	ilisimatusarfik
ilisimatusarneq	ilisimatusarniq
ilisimatusarpoq	ilisimatusarpuq
ilisimatusartoq	ilisimatusartuq
ilisimavaa	ilisimavaa
ilissi	ilissi
iliuuseqarneq	iliuusiqarniq
illarpoq	illarpuq
illeraq	iɬɬɜʁɑq
illerfik	illirfik
illiaq	illiaq
illillu	iɬɬiɬɬu
illit	iɬɬit
illoqarfiit	iɬɬɔqɑffiːt
illoqarfik	iɬɬɔqɑffik
illoqqortoormiut	illuqqurtuurmiut
illu	illu
illukoq	illukuq
ilti	ilti
iluaqutigaa	iluaqutigaa
iluaqut	iluaqut
iluleq	iluliq
iluliaq	iluliaq
ilumummi	ilumummi
ilungersornertooq	iluŋirsurnirtuuq
ilungersorpoq	iluŋirsurpuq
iluseq	ilusiq
imaanu	imaanu
imaappoq	imaappuq
ima	ima
imaluunniit	imaluunniit
imaneq	imaniq
imangertaq	imaŋirtaq
imaq	imaq
imeq	imiq
imeqqutaalaq	imiqqutaalaq
imeqqutak	imɜqqutak
imerajuppoq	imirajuppuq
imernaalanngitsoq	imirnaalaŋŋitsuq
imernaalasoq	imirnaalasuq
imerniartarfik	imirniartarfik
imerpoq	imirpuq
iminngerpoq	imiŋŋirpuq
immannguaq	immaŋŋuaq
immaqa	immaqa
immiaq	immiaq
immigaq	immigaq
immiit	immiit
immikkut	immikkut
imminnguaaraq	immiŋŋuaaraq
imminnguaq	immiŋŋuʷɑq
immuk	immuk
immussuaq	immussuaq
inalugalik	inaluɣalik
inalugaq	inaluɣɑq
inaluk	inaluk
inappaa	inappaa
inatsisartut	inatsisartut
inatsivoq	inatsivuq
ineriartortitsineq	iniriarturtitsiniq
inerpoq	inirpuq
inersimasoq	inirsimasuq
ingerlavoq	iŋirlavuq
ingitippaa	iŋitippaa
ini	ini
inissisimavoq	inissisimavuq
innanniut	innanniʲut
inneq	innɜq
innga	iŋːa
innuttaasoq	innuttaasuq
innuttaasut	innuttaasut
inooqatigiinneq	inuuqatigiinniq
inoqat	inuqat
intalik	intalik
inuak	inuak
inuiaat	inuiaat
inuk	inuk
inunngorpoq	inuŋŋurpuq
inunnguaq	inuŋŋuaq
inupiluk	inupiluk
inussiaq	inussiaq
inutsiaq	inutsiaq
inuttuumasoq	inuttuumasuq
inuulluaqquaa	inuulluaqquaa
inuuneq	inuuniq
inuusoq	inuusuq
inuusuppoq	inuusuppuq
inuusuttoq	inuusuttuq
inuusuttuaraq	inuusuttuaraq
inuuteq	inuutiq
inuuvoq	inuuvuq
ippassaq	ippassaq
ippat	ippat
ippeqivoq	ippɜqivɔq
ippernaaqqut	ippirnaaqqut
ippernaq	ippirnaq
ippiarsuk	ippiʲɑssuk
isaqqilavoq	isaqqilavuq
isaqqivoq	isaqqivuq
isaroq	isaruq
iseriappoq	isiriappuq
iserpaa	isirpaa
iserpoq	isirpuq
isertarfik	isirtarfik
isertugaq	isirtugaq
isigak	isiɣak
isigammaasaaraq	isigammaasaaraq
isiginnaartartut	isiginnaartartut
isiginnaartitsisarfik	isiginnaartitsisarfik
isiginnaartitsisartoq	isiginnaartitsisartuq
isiginnaartitsivoq	isiginnaartitsivuq
isi	isi
isikku	isikku
isissutissaq	isissutissaq
issiavik	issiavik
issiavoq	issiavuq
issingigassaat	issiŋigassaat
issittoq	issittɔq
issittoq	issittuq
issulipoq	issulipuq
issuusaq	issuusaq
isumaappoq	isumaappuq
isumagissaarpoq	isumagissaarpuq
isuma	isuma
isumaliorpoq	isumaliurpuq
isumaluppoq	isumaluppuq
isumaqarpoq	isumaqarpuq
isumaqatiginninniarpoq	isumaqatiginninniarpuq
isumavoq	isumavuq
isunngaq	isuŋŋɑq
isunngarsuaq	isuŋŋɑssuʷɑq
isunngarujussuaq	isuŋŋarujussuaq
italiamiu	italiamiu
iteq	itiq
itigarpoq	itigarpuq
itigartippaa	itigartippaa
ivalu	ivalu
ivigaq	ivigaq
ivik	ivik
ivinnguaq	iviŋŋuaq
jaaja	jaaja
jaappili	jaappili
januaari	januʷɑːʁi
japanimiu	japanimiu
japanimiutut	japanimiutut
jarte	jarti
jarti	jarti
jense	jinsi
jooriina	juuriina
joorsi	juursi
juaanna	juaanna
jukku	jukku
juuli	juːli
juuna	juuna
juuni	juːni
kaagi	kaagi
kaak	kaak
kaaliina	kaaliina
kaasarfik	kaasarfik
kajistiaat	kajistiaat
kajorpoq	kajurpuq
kajortoq	kajɔttɔq
kakkik	kakkik
kakkiviaq	kakkiviaq
kakkua	kakkua
kakku	kakku
kalaaleq	kalaaliq
kalaalimernit	kalaalimirnit
kalaallisut	kalaallisut
kalistat	kalistat
kalistiaat	kalistiaat
kaluliit	kaluliit
kamaginnittoq	kamaginnittuq
kamappoq	kamappuq
kamik	kamik
kamillartaat	kamiɬɬɑttaːt
kamillartartoq	kamiɬɬɑttɑttɔq
kanaaq	kanaːq
kanajoq	kanajuq
kangoq	kaŋuq
kanna	kanːa
kanngorooq	kaŋŋuruuq
kanngussak	kaŋŋussak
kapitali	kapitali
kariita	kariita
kartoffeli	kartuffili
katersugaasivik	katirsugaasivik
katersuuppoq	katirsuuppuq
katillugit	katillugit
katta	katta
kattak	kattak
kattaliit	kattaliit
kiak	kiak
kiappoq	kiappuq
kiassuseq	kiassusiq
kiffaq	kiffaq
kigut	kigut
kiinaaleeraq	kiinaaliiraq
kiinamiu	kiinamiu
kiinaq	kiːnaq
kiisalu	kiisalu
kiista	kiista
kiistat	kiistat
kiistiina	kiistiina
kikivik	kikivik
kikkik	kikkik
killeq	killiq
killilerpaa	killilirpaa
kimmernaq	kimmirnaq
kina	kina
kinamiutut	kinamiutut
kinguaaq	kiŋuaaq
kinguaassiuutit	kiŋuaassiuutit
kingullerpaaq	kiŋullirpaaq
kinguneq	kiŋuniq
kinguporsorpoq	kiŋupursurpuq
kipivaa	kipivaa
kisianni	kisianni
kisitsineq	kisitsiniq
kisitsit	kisitsit
kissaviarsuk	kissaviarsuk
kissavik	kissavik
kista	kista
kitura	kitura
klaveri	klaviri
koruuni	kuruuni
kræfti	kʁafdi
kujalleq	kujalliq
kukik	kukik
kukilik	kukilik
kukkukooq	kukkukuuq
kukkukuuaraq	kukkukuuaraq
kukkuvoq	kukkuvuq
kuluk	kuluk
kulunnguaq	kuluŋŋuaq
kumoorn	kumɔːnn
kunaat	kunaːt
kunik	kunik
kunippaa	kunippaa
kunissivoq	kunissivuq
kunngeqarfik	kuŋŋiqarfik
kunngi	kuŋŋi
kunngu	kuŋŋu
kunuk	kunuk
kusagaa	kusaɣaː
kusanarpoq	kusanɑppɔq
kutaa	kutaː
kuukkooriaasarsuaq	kuukkuuriaasarsuaq
kuukkooriarsuaq	kuukkuuriarsuaq
kuuk	kuuk
kuulti	kuulti
kuunu	kuunu
laakki	laakki
laannguaq	laaŋŋuaq
latinerisut	latinirisut
lippikka	lippikka
maaji	maːji
maajooq	maajuuq
maalat	maalat
maaliaanna	maaliaanna
maalia	maalia
maannakkut	maannakkut
maanna	maanna
maannguaq	maaŋŋuaq
maariu	maariu
maasi	maasi
makkak	makkak
makkalitta	makkalitta
makka	makka
makku	makku
malake	malaki
malamuk	malamuk
maliarsuk	maliarsuk
maliina	maliina
malillugu	malillugu
malugaa	malugaa
manna	manːa
mannarsi	mannarsi
mannik	mannik
marluk	mɑɬɬuk
marserpaa	marsirpaa
marserpoq	marsirpuq
marsi	mɑssi
martsi	martsi
masaana	masaana
masaatsiaq	masaatsiaq
masaitsiaq	masaitsiaq
masarsuk	masɑssuk
masauna	masauna
mase	masi
mate	mati
mattaliit	mattaliit
matta	matta
matuerpaa	matuirpaa
matuersaaserfik	matuirsaasirfik
matuersaat	matuirsaat
matuma	matuma
matu	matu
matumuuna	matumuuna
meeqqerivik	miiqqirivik
meeqqerivoq	miiqqirivuq
meqqusaaq	miqqusaaq
meqqut	miqqut
mersorpoq	mɜssɔppɔq
mianeraa	mianiraa
mianersoqquaa	mianirsuqquaa
mianersorpoq	mianirsurpuq
mikaali	mikaali
mikisoq	mikisuq
mikivoq	mikivuq
mikkili	mikkili
milippaa	milippaa
milippoq	milippuq
millivaa	millivaa
millivoq	millivuq
milluaasartut	milluaasartut
miloriuppaa	miluriuppaa
miluumasoq	miluumasuq
minik	minik
ministeriuneq	ministiriuniq
mippoq	mippuq
misilitsinneq	misilitsinniq
misissorpaa	misissurpaa
mitiusat	mitiusat
musaq	musaq
naagga	naagga
naajaaq	naajaaq
naaja	naaja
naajavaaq	naajavaaq
naajavaarsuk	naajavaarsuk
naalagaq	naalagaq
naalakkerpaa	naalakkirpaa
naalakkersorpaa	naalakkirsurpaa
naalakkersueriaaseq	naalakkirsuiriaasiq
naalakkersuisoq	naalakkirsuisuq
naalakkersuisut	naalakkirsuisut
naalakkersuivoq	naalakkirsuivuq
naalliuutigaa	naalliuutigaa
naalliuut	naalliuut
naamik	naamik
naamivik	naamivik
naappoq	naappuq
naaq	naːq
naartu	naartu
naartuvoq	naartuvuq
naasoq	naasuq
naassuseq	naassusiq
naasunnguaq	naasuŋŋuaq
naatsiiaq	naatsiiaq
naatsiiat	naatsiiat
naatsiivik	naatsiivik
naatsorsuineq	naatsursuiniq
naatsorsuivoq	naatsursuivuq
naggat	naggat
najaaraq	najaaraq
najak	najak
naja	naja
najannguaq	najaŋŋuaq
nakimavoq	nakimavuq
nakimmappoq	nakimmappuq
nakkuppaa	nakkuppaa
nakkutilliineq	nakkutilliiniq
nakorsaat	nakursaat
nakorsaq	nakursaq
nakuvoq	nakuvuq
naleqqiuppoq	naliqqiuppuq
naleqqiussineq	naliqqiussiniq
naliliineq	naliliiniq
nalinginnaq	naliŋinnaq
nallersuuppoq	nallirsuuppuq
nalunaaqutaq	nalunaaqutaq
nalunaaqut	nalunaaqut
nalunaaqutserpaa	nalunaaqutsirpaa
nalu	nalu
nalunaqaaq	nalunaqaaq
nalunarpoq	nalunarpuq
naluvoq	naluvuq
nammineq	namminiq
nanoq	nanuq
napaartoq	napaartuq
nappaassuaq	nappaassuaq
nappaatipiluk	nappaatipiluk
nappaat	nappaat
nappaq	nappaq
napparpaa	napparpaa
napparpoq	napparpuq
napparsimmavik	napparsimmavik
naqinneq	naqinniq
naqippaa	naqippaa
naqiterivoq	naqitirivuq
naqiterpaa	naqitirpaa
naqitigaaraq	naqitigaaraq
naqitigaq	naqitigaq
naqitsineq	naqitsiniq
naqitsivoq	naqitsivuq
narlorpoq	narlurpuq
narlumukaaq	narlumukaaq
narlusooq	narlusuuq
narsaq	narsaq
nasaq	nasaq
nassaaq	nassaaq
nassaaraa	nassaaraa
nassuk	nassuk
nataaq	nataaq
nateq	natiq
natsit	natsit
nattoralik	natturalik
nattoraliusaq	natturaliusaq
natuk	natuk
neqi	niqi
neqissaq	niqissaq
neqituumasoq	niqituumasuq
nerivaa	nirivaa
nerivoq	nirivuq
nerleq	nirliq
nerrivik	nirrivik
niaqoq	niaqoq
niisa	niisa
niisi	niisi
nikkulaat	nikkulaat
nikkuliinnguaq	nikkuliiŋŋuaq
nikkuliit	nikkuliit
nikku	nikku
nilak	nilak
nilattarpoq	nilattarpuq
nillerpoq	nillirpuq
nimeq	nimiq
nimeriaq	nimiriaq
nimeriarluk	nimiriarluk
nimissiaq	nimissiaq
nipaappoq	nipaappuq
nipersuaq	nipirsuaq
niperujoorpoq	nipirujuurpuq
nipilersoqatigiissuit	nipilirsuqatigiissuit
nipilersorpoq	nipilirsurpuq
nipilersortartoq	nipilirsurtartuq
nipilersortartut	nipilirsurtartut
nipiliuut	nipiliuut
nipi	nipi
nittaalaq	nittaalaq
niuerneq	niuirniq
niuerpoq	niuirpuq
niulu	niulu
niu	niu
niviarsiaq	niviarsiaq
niviarsiaraq	niviarsiaraq
nivikka	nivikka
nivi	nivi
niviorpaa	niviʲɔppaː
niviorpoq	niviʲɔppɔq
normu	nurmu
norsaq	nursaq
norskeq	nurskiq
nuak	nuak
nuakoorfik	nuakuurfik
nualluk	nualluk
nuannaarpoq	nuannaarpuq
nuannaraa	nuannaraa
nuannarineqartoq	nuannariniqartuq
nuannarinnittoq	nuannarinnittuq
nuannerpoq	nuannirpuq
nuappaa	nuappaa
nuappoq	nuappuq
nuarluk	nuʷɑɬɬuk
nuffarliorpoq	nuffarliurpuq
nuiaq	nuiaq
nuiavoq	nuiavuq
nuivoq	nuivuq
nukannguaq	nukaŋŋuaq
nuka	nuka
nukappiaraq	nukappiʲɑʁɑq
nukaq	nukɑq
nukarleq	nukarliq
nuliaq	nuliʲɑq
nummerplade	nummirplati
nunaat	nunaat
nunalerineq	nunaliriniq
nuna	nuna
nunarput	nunarput
nunarsuaq	nunarsuaq
nunasarneq	nunasarniq
nunasiaqarneq	nunasiaqarniq
nunasiaq	nunasiaq
nunataq	nunataq
nunavik	nunavik
nutaaq	nutaaq
nutaarsiassat	nutaarsiassat
nutserisoq	nutsirisuq
nutserivoq	nutsirivuq
nutsigaq	nutsigaq
oqaasaq	uqaasaq
oqaaseeraq	uqaasiiraq
oqaaseqarneq	uqaasiqarniq
oqaaseq	uqaasiq
oqaasersiaq	uqaasirsiaq
oqaatigaa	uqaatigaa
oqaatigiumasaq	uqaatigiumasaq
oqaatsit	uqaatsit
oqaatsoq	uqaatsuq
oqallinneq	uqallinniq
oqallipput	uqallipput
oqaluffik	uqaluffik
oqaluinnamiut	uqaluinnamiut
oqaluppoq	uqaluppuq
oqaluttuaq	uqaluttuaq
oqaluttuarpoq	uqaluttuarpuq
oqaluttuassartaq	uqaluttuassartaq
oqaluut	uqaluut
oqaq	uqaq
oqarfigaa	uqarfigaa
oqarpoq	uqarpuq
oqorutit	uqurutit
oquna	uquna
ordbogi	urtpugi
orpigaq	urpigaq
orpikkat	urpikkat
orpik	urpik
orpimmiutaq	urpimmiutaq
orpimmiutarsuaq	urpimmiutarsuaq
orpippalik	urpippalik
orpippassuit	urpippassuit
orsoq	ursuq
orsussaq	ursussaq
orto	urtu
ortu	urtu
paaliit	paaliit
paalu	paalu
paannaaq	paannaaq
paaq	paaq
paarma	paarma
paarnannguaq	paarnaŋŋuaq
paarnaq	paarnaq
paarnaqulluk	paarnaqulluk
paasissaalluanngilaq	paasissaalluaŋŋilaq
paasivaa	paasivaa
paffik	paffik
palleq	palliq
panaanneq	panaanniq
panaasalik	panaasalik
pana	pana
paneeraq	paniiraq
panik	panik
paninnguaq	paniŋŋuaq
panna	panːa
panteri	pantiri
parnuuna	parnuuna
pasillerpaa	pasillirpaa
pasivaa	pasivaa
pattalaarpaa	pattalaarpaa
peqarpoq	piqarpuq
peqqiippoq	piqqiippuq
peqqinneq	piqqinniq
peqqippoq	piqqippuq
peqqissaasoq	piqqissaasuq
pequsaavaq	pɜqusaːvɑq
periarfissippaa	piriarfissippaa
persuaq	pirsuaq
piffik	piffik
piffissaq	piffissaq
pigaa	pigaa
piita	piita
piitaq	piitaq
pikku	pikːu
pikoorfik	pikuurfik
pilappoq	pilappɔq
pilattuut	pilattuːt
pilerpoq	pilirpuq
pilikki	pilikki
pilikkiusaq	pilikkiusaq
pillammaavoq	piɬɬammaːvɔq
pillammak	piɬɬammak
pilluarit	pilluarit
pilluaritsi	pilluaritsi
pilluarpoq	pilluarpuq
pillugu	pillugu
piloqut	piluqut
pilorsuit	pilursuit
pilunnguaq	piluŋŋuaq
pilu	pilu
pilutannguaq	pilutaŋŋuaq
pilutaq	pilutaq
pineqartoq	piniqartuq
pingaarpoq	piŋaarpuq
pingaartumik	piŋaartumik
pingajuat	piŋajuat
pingasut	piŋasut
pingujak	piŋujak
pingu	piŋu
pinnga	piŋːa
pinngoqqaat	piŋŋuqqaat
pinnguarpoq	piŋŋuarpuq
pipaluk	pipaluk
pisiniarfik	pisiniarfik
pisooq	pisuuq
pisoq	pisuq
pisortaaneq	pisurtaaniq
pisortaq	pisɔttɑq
pissaavoq	pissaːvɔq
pissaq	pissɑq
pissuseq	pissusiq
pissusilerissut	pissusilirissut
pissusissamisoorpoq	pissusissamisuurpuq
pissusissamisoortoq	pissusissamisuurtuq
pissutaaqataavoq	pissutaaqataavuq
pissuteqarluarluni	pissutiqarluarluni
pissutigalugu	pissutigalugu
pissut	pissut
pisuppoq	pisuppuq
pisuujuvoq	pisuujuvuq
pitse	pitsi
pitsi	pitsi
piumassuseq	piumassusiq
piumavoq	piumavuq
poorski	puurski
portusooq	purtusuuq
portuvoq	purtuvuq
programmiliortoq	prugrammiliurtuq
pualasooq	pualasuuq
pualavoq	pualavuq
pujoorpoq	pujɔːppɔq
pujortaat	pujurtaat
pulaarpoq	pulaarpuq
pulateriaarsuk	pulatiriaarsuk
punneq	punniq
pupik	pupik
pupissoq	pupissuq
pupiutaajaat	pupiutaajaat
putooruttoq	putuuruttuq
putugoq	putuguq
putu	putu
puutinngi	puutiŋŋi
qaamaneq	qaamaniq
qaamasoq	qaamasuq
qaamavoq	qaamavuq
qaammaliaq	qaammaliaq
qaammataasaq	qaammataasaq
qaammatisiutit	qaammatisiutit
qaammat	qaammat
qaaq	qaːq
qaaqqutsiaq	qaaqqutsiaq
qaarpoq	qaarpuq
qaartartoq	qaartartuq
qaffatarneq	qaffatarniq
qajaq	qajaq
qajoq	qajuq
qalaseq	qalasɜq
qalipaat	qalipaːt
qallunaaq	qallunaaq
qallunaatut	qallunaatut
qallu	qaɬɬu
qaneq	qanɜq
qanganisaq	qaŋanisaq
qanga	qaŋa
qangatavoq	qaŋatavuq
qanik	qanik
qanittukkut	qanittukkut
qannerpoq	qannirpuq
qanoq	qanuq
qaqorpoq	qaqurpuq
qaqorteqqasut	qaqurtiqqasut
qaqortoq	qaqɔttɔq
qaqqaq	qaqqaq
qaqugu	qaqugu
qaqulluk	qaqulluk
qaqullunnaq	qaqullunnaq
qarasaasiaq	qarasaasiaq
qarasaq	qarasaq
qaratserfik	qaratsirfik
qarloq	qaɬɬɔq
qarluutitoornaq	qarluutituurnaq
qarluutitoorsuaq	qarluutituursuaq
qarmaasoq	qarmaasuq
qarsaaq	qarsaaq
qarsoq	qarsuq
qarsulivik	qarsulivik
qaserpoq	qasirpuq
qasertoq	qasɜttɔq
qasilitsut	qasilitsut
qasseersiut	qassiirsiut
qassit	qassit
qasunarpoq	qasunarpuq
qasuvoq	qasuvuq
qatanngutigaa	qataŋŋutigaa
qatanngut	qataŋŋut
qeeraasaq	qiiraasaq
qeqertaq	qiqirtaq
qeriiak	qiriiak
qeriiaq	qiriiaq
qernerpoq	qirnirpuq
qernertoq	qɜnnɜttɔq
qiiaq	qiiaq
qiiavoq	qiiavuq
qilerneq	qilirniq
qilernerusaq	qilirnirusaq
qilerpaa	qilirpaa
qillerut	qillirut
qimaasoq	qimaasuq
qimaavoq	qimaavuq
qimeriaq	qimiriaq
qimmiaraq	qimmiaraq
qimmiq	qimmiq
qimuttuarsuk	qimuttuarsuk
qimuttuarsuusannguaq	qimuttuarsuusaŋŋuaq
qimuttuitsut	qimuttuitsut
qinersineq	qinirsiniq
qingakkoorpaluk	qiŋakkuurpaluk
qingakkoorpoq	qiŋakkuurpuq
qingalissuaq	qiŋalissuaq
qingaq	qiŋɑq
qinngoq	qiŋŋɔq
qinngorpoq	qiŋŋurpuq
qinnut	qinnut
qipoqqaq	qipɔqqɑq
qipoqqarpoq	qipuqqarpuq
qipoqqat	qipɔqqat
qiteq	qitiq
qitsuk	qitsuk
qittoora	qittuura
qitura	qitura
qivioq	qiviuq
qooroq	quuruq
qoqassivaa	quqassivaa
qorsorpaluppoq	qursurpaluppuq
qorsuk	qɔssuk
q	q
quiasaarneq	quiasaarniq
quiasaarpoq	quiasaarpuq
quiasaartartoq	quiasaartartuq
quiasaarut	quiasaarut
quiasuppoq	quiasuppuq
qujaaannarpunga	qujaaannarpuŋa
qujanaq	qujanaq
qujanarsuaq	qujanarsuaq
qujanarujussuaq	qujanarujussuaq
qulaaluat	qulaaluat
qulaappaa	qulaappaa
qulingat	quliŋat
qulingiluaat	quliŋiluaːt
qulingiluat	quliŋiluat
qulisimavoq	qulisimavuq
qulit	qulit
qulleq	qulliq
qulutak	qulutak
qulutana	qulutana
qulutannguaq	qulutaŋŋuaq
qulutaq	qulutaq
qunaaq	qunaaq
qunerseeq	qunirsiiq
qungaseq	quŋasiq
qupanuk	qupanuk
qussuk	qussuk
quttoraq	quttɔʁaq
ĸ	q
raajaleriffik	raajaliriffik
raajaqarfik	raajaqarfik
raajarniarneq	raajarniarniq
raajarniut	raajarniut
raajarpoq	raajarpuq
rabarberi	raparpiri
republikki	ripuplikki
riikki	riikki
rikki	rikki
russeq	russiq
russisut	russisut
ruusa	ruusa
saalat	saalat
saalu	saalu
saamerleq	saamirliq
saamisut	saamisut
saamua	saamua
saamu	saamu
saaneq	saːnɜq
saaniluk	saːniluk
saarannguaq	saaraŋŋuaq
saarullik	saarullik
sajunneq	sajunniq
sajuppoq	sajuppuq
sakavoq	sakavuq
sakiatsiaariipput	sakiatsiaariipput
sakissat	sakissat
sakkak	sakkak
sakka	sakka
sakkortussuseq	sakkurtussusiq
sakkortuvoq	sakkurtuvuq
salik	salik
saluttoq	saluttuq
samisut	samisut
sanaaq	sanaaq
sanasoq	sanasuq
sanguvoq	saŋuvuq
saniatigut	saniatigut
sanikoorfik	sanikuurfik
sanik	sanik
sanimukaarpoq	sanimukaarpuq
sanna	sanːa
sapernarpoq	sapirnarpuq
sapernassuseq	sapirnassusiq
saperpaa	sapirpaa
saqqaq	saqqaq
saqqummerpoq	saqqummirpuq
sarsuppoq	sarsuppuq
savaaraq	savaaraq
savaasaaraq	savaasaaraq
savaasaq	savaasaq
savalimmiormioq	savalimmiurmiuq
savalimmiormiutut	savalimmiurmiutut
savik	savik
savimineq	saviminiq
seeqqoq	sɜːqqɔq
seeri	siiri
seernaaraq	siirnaaraq
seernaasat	siirnaasat
sekstanti	sikstanti
seqineq	siqiniq
seqinnerfiusoq	siqinnirfiusuq
seqinnerpoq	siqinnirpuq
serminnguaq	sirmiŋŋuaq
sialoorta	sialuurta
sianeq	sianiq
sigguit	sixxuit
siggukitsoq	siggukitsuq
sigguk	sixxuk
siimuut	siimuut
siina	siina
siivali	siivali
siiva	siiva
sikkerneq	sikkirniq
sikkerninnguaq	sikkirniŋŋuaq
sikkersoq	sikkirsuq
sikkilerpoq	sikkilirpuq
sikuijuitsoq	sikuijuitsuq
sikuiuitsoq	sikuiuitsuq
siku	siku
silaannaq	silaannaq
silarsuaq	silarsuaq
sila	sila
sineriak	sinɜʁiʲak
singerneq	siŋɜnnɜq
sinik	sinik
sinilluarna	sinilluarna
sininnartoq	sininnartuq
sinippoq	sinippuq
siornatigut	siurnatigut
sisamaat	sisamaːt
sisamat	sisamat
sissaq	sissɑq
sissarmiutaq	sissarmiutaq
siulequt	siuliqut
siulittaasoq	siulittaasuq
siulittuutigaa	siulittuutigaa
siulleq	siuɬɬɜq
siullermik	siullirmik
siumut	siumut
siut	siut
sivikigaa	sivikigaa
sivikippoq	sivikippuq
sivisuumik	sivisuumik
sivisuvoq	sivisuvuq
sodavandi	sutavanti
sooq	suuq
soorunami	suurunami
soqutigaa	suqutigaa
soqutiginartoq	suqutiginartuq
soqutiginnippoq	suqutiginnippuq
soqutiginnittoq	suqutiginnittuq
sorleq	sɔɬɬɜq
sorluk	sɔɬɬuk
sorsunneq	sursunniq
sorsuppaa	sursuppaa
sorsuppoq	sursuppuq
spaniamiu	spaniamiu
spaniamiutut	spaniamiutut
suersaq	suirsaq
suiaassuseq	suiaassusiq
suiaqatinoortoq	suiaqatinuurtuq
suiaqatinoortuuneq	suiaqatinuurtuuniq
sukkassuseq	sukkassusiq
sukkavoq	sukkavuq
sukkulaaq	sukkulaaq
sukkulaat	sukkulaat
sukuluit	sukuluit
suleqatigiipput	suliqatigiipput
suleqat	suliqat
suliaq	suliʲɑq
suliaraa	suliaraa
suliassiissut	suliassiissut
suliassiivoq	suliassiivuq
suliassippaa	suliassippaa
suliffeqarfik	suliffɜqɑffik
suliffeqarfissuaq	suliffiqarfissuaq
suliffik	suliffik
suli	suli
sulivoq	sulivɔq
sullivik	suɬɬivik
suluppaagaq	suluppaagaq
sunaaffa	sunaaffa
suna	suna
sungaaqeq	suŋaaqiq
sungaarpoq	suŋaarpuq
sungaartoq	suŋɑttɔq
sungaq	suŋaq
sungiusaasoq	suŋiusaasuq
susalik	susalik
susaqanngitsoq	susaqaŋŋitsuq
susaq	susaq
susoq	susuq
su	su
suusaat	suusaat
suussuseq	suussusiq
suu	suu
taaguut	taaguut
taamaalivoq	taamaalivuq
taamaallaat	taamaallaat
taamaappoq	taamaappuq
taamaattumik	taamaattumik
taamaattummi	taamaattummi
taaneq	taaniq
taanna	taanna
taasaq	taasaq
taasineq	taasiniq
taasivoq	taasivuq
taa	taa
taatsiannguaq	taatsiaŋŋuaq
taatsiaq	taatsiaq
taavaa	taavaa
tagiut	tagiut
takivoq	takivuq
takornariaq	takurnariaq
takuaa	takuaa
takuneq	takuniq
takusaq	takusaq
takusarpaa	takusarpaa
takussutissaq	takussutissaq
taleq	talɜq
talerpik	talirpik
tallimaat	taɬɬimaːt
tallimat	taɬɬimat
tallivaa	tallivaa
tallivoq	tallivuq
talloq	taɬɬɔq
tamakku	tamakku
tamaq	tamaq
tamarmik	tamarmik
tarajoq	tarajuq
tarajorpaa	tarajurpaa
taratsut	taratsut
tarnut	tarnut
tarraleqisaaq	tarraliqisaaq
tarrarsuut	tarrarsuut
taseq	tasiq
tasiilaq	tasiilaq
tasmaniamiu	tasmaniamiu
tassaarpoq	tassaarpuq
tassaavoq	tassaavuq
tassami	tassami
ta	ta
tattak	tattak
tattattooq	tattattɔːq
taxa	taxa
teknikeri	tiknikiri
tiguaa	tiguaa
tigumiarpaa	tigumiarpaa
tiinasi	tiinasi
tiingavoq	tiiŋavuq
tii	tii
tiitorfik	tiiturfik
tikeqqammeq	tikiqqammiq
tikilluarit	tikilluarit
tikippoq	tikippuq
timi	timi
timmiakuluk	timmiakuluk
timmiaq	timmiaq
timmik	timmik
timmisartoq	timmisartuq
timmisartuusaarneq	timmisartuusaarniq
timmivoq	timmivuq
tingajuk	tiŋajuk
tingi	tiŋi
tingivoq	tiŋivuq
tinupasoq	tinupasuq
tinuvoq	tinuvuq
tissappoq	tissappuq
tissassarpaa	tissassarpaa
titartaaneq	titartaaniq
tooq	tuuq
toornaarsuk	tuurnaarsuk
toornarsuk	tuurnarsuk
toorneq	tuurniq
toqqarpaa	tuqqarpaa
toqunartoq	tuqunartuq
toquppaa	tuquppaa
toqu	tuqu
toquvoq	tuquvuq
torloraat	turluraat
torlorpaa	turlurpaa
torluk	turluk
transeksueli	transiksuili
tui	tui
tukattoq	tukattuq
tukummeq	tukummiq
tulleq	tuɬɬɜq
tullerunnaq	tullirunnaq
tulliani	tuɬɬiani
tulluuppoq	tulluuppuq
tuloruseq	tulurusiq
tuluk	tuluk
tumaasaavoq	tumaasaavuq
tungaannarsiut	tuŋaannarsiut
tungujorpoq	tuŋujurpuq
tungujortoq	tuŋujɔttɔq
tungutsorissoq	tuŋutsɔʁissɔq
tungu	tuŋu
tunguusaq	tuŋuusaq
tuniniarpaa	tuniniarpaa
tunngasoq	tuŋŋasuq
tunngavoq	tuŋŋavuq
tunumioq	tunumiuq
tunumiusut	tunumiusut
tunusuk	tunusuk
tunu	tunu
tupaarnaq	tupaarnaq
tupilak	tupilak
tupissut	tupissut
tuppia	tuppia
tuppi	tuppi
tusarfik	tusarfik
tusarnaarpoq	tusarnaarpuq
tusarnaartitsineq	tusarnaartitsiniq
tusarpaa	tusarpaa
tuttunniarfik	tuttunniʲɑffik
tuttunniarpoq	tuttunniʲɑppɔq
tuttu	tuttu
tuugaalik	tuːɣaːlik
tuugaaq	tuugaaq
tuullik	tuullik
uaguk	uaguk
uagut	uʷaɣut
uanga	uaŋa
uffarfik	uffarfik
uffarpaa	uffarpaa
uffarpoq	uffarpuq
uiloq	uiluq
uisorerpoq	uisurirpuq
ui	uʷi
ujarak	ujarak
ujoorsi	ujuursi
ujuaanna	ujuaanna
ujukku	ujukku
ukamarpoq	ukamarpuq
ukiaq	ukiaq
ukioqarpoq	ukiuqarpuq
ukioq	ukiuq
ukiortaaq	ukiurtaaq
uku	uku
ulapippoq	ulapippɔq
ulapisaat	ulapisaːt
ullaakkorsiutit	ullaakkursiutit
ulloq	ulluq
ulloriaq	ulluriaq
ullujuersaaq	ullujuirsaaq
ullumi	ullumi
ulorianartoq	ulurianartuq
uluak	uluak
umiaq	umiaq
umiarsuaaraq	umiarsuaaraq
umiarsualivik	umiarsualivik
umiarsuaq	umiarsuaq
umiartortoq	umiarturtuq
umik	umik
una	una
ungaloq	uŋaluq
uniaaluk	uniaaluk
uniorpaa	uniurpaa
universiteti	univirsititi
unnuaq	unnuʷɑq
unnuivoq	unnuʷivɔq
unnukkorsiutit	unnukkursiutit
unnuk	unnuk
uppik	uppik
uppippoq	uppippuq
urdutut	urtutut
usuk	usuk
uterpoq	utirpuq
utertippaa	utirtippaa
utertoq	utirtuq
utertunnguaq	utirtuŋŋuaq
utimut	utimut
utsuk	utsuk
uugaq	uugaq
uularik	uularik
uumasoq	uumasuq
uumassuseq	uumassusiq
uumassusilik	uumassusilik
uuma	uuma
uumavoq	uumavuq
uuminaq	uuminaq
uummat	uummat
uunarpoq	uunarpuq
uunnappaa	uunnappaa
vaataparsi	vaataparsi
veerti	viirti
vuggestue	vuggistui
