абдулла	ɑbduɫːɑ
абруй	ɑbruj
абруйлы	ɑbɾojɫɯ̞
абыстай	ɑbɯ̞stɑj
абыстай	ɑβɯ̞stɑj
австралия	äfsträlʲijä
автобус	afto̞bus
автономиялы	äftänomʲijäɫɯ̞
ағай	ɑʁɑj
ағас	ɑʁɑs
ағиҙел	äʁɪ̈iðɪ̞l
ағым	ɑʁɯ̞m
ағыу	ɑʁɯ̞w
ағыш	ɑʁɯ̞ʂ
адрес	ädrʲɪs
аҙаҡ	ɑðɑq
аҙаҡҡы	ɑðɑqːɯ̞
аҙан	ɑðɑn
аҙаш	ɑðɑʂ
аҙбар	ɑðbɑɾ
аҙған	ɑðʁɑn
аҙна	ɑðnɑ
аҙналыҡ	ɑðnɑɫɯ̞q
аҙыҡ	ɑðɯ̞q
аҙым	ɑðɯ̞m
аждаһа	ɑʐdɑhɑ
азамат	ɑzɑmɑt
азия	äzʲijä
азия	äzʲiʲä
ай	ɑj
айбулат	ɑjbuɫɑt
айгөл	äjgʏ̞l
айғолаҡ	ɑjʁʊ̞ɫɑq
айғыр	ɑjʁɯ̞r
айҙар	ɑjðɑr
айнур	ɑjnur
айныҡ	ɑjnɯ̞q
айран	ajran
айрат	ɑjrɑt
айтуған	ɑjtuʁɑn
айһылыу	ɑjhɯ̞ɫɯ̞w
айыҡ	ɑjɯ̞q
айырма	ɑjɯ̞rmɑ
айырым	ɑjɯ̞ɾɯ̞m
айырыуса	ɑjɯ̞rɯ̞wsɑ
актёр	aktʲɵr
аҡ	ɑq
аҡбуҙ	ɑqboð
аҡбуҙат	ɑqbuðɑt
аҡбур	ɑqbur
аҡҡош	ɑqːʊ̞ʂ
аҡлан	ɑqɫɑn
аҡрын	ɑqrɯ̞n
аҡрын	ɑqɯ̞rɯ̞n
аҡса	ɑqsɑ
аҡсарлаҡ	ɑqsɑrɫɑq
аҡһаҡ	ɑqhɑq
аҡһаҡал	ɑqhɑqɑɫ
аҡһым	ɑqhɯ̞m
аҡш	ɑqɯ̞ʂ
аҡыл	ɑqɯ̞ɫ
аҡыллы	ɑqɯ̞ɫːɯ̞
ал	ɑɫ
алабуға	ɑɫɑbuʁɑ
алабута	ɑɫɑbutɑ
алға	ɑɫʁɑ
алдаҡсы	ɑɫdɑqsɯ̞
алдау	ɑɫdɑw
алдынғы	ɑɫdɯ̞ŋɢɯ̞
алйырҙан	ɑɫjɯ̞rðɑn
алҡа	ɑɫqɑ
алҡыш	ɑɫqɯ̞ʂ
алла	ɑɫːɑ
алма	ɑɫmɑ
алмағас	ɑɫmɑʁ̞ɑs
алмас	ɑɫmɑs
алмаш	ɑɫmɑʂ
алтау	ɑɫtaw
алты	ɑɫtɯ̞
алтын	ɑɫtɯ̞n
алһыу	ɑɫhɯ̞w
алъяпҡыс	ɑɫjɑpqɯ̞s
алыҫ	ɑɫɯ̞θ
аманат	ɑmɑnɑt
андорра	ando̞rːa
андорра	ando̞ra
андыҙ	ɑndɯ̞ð
ант	ɑnt
аныҡ	ɑnɯ̞q
аң	ɑŋ
апай	ɑpɑj
ара	ɑɾa
араҡы	ɑrɑqɯ̞
арауыҡ	ɑrɑwɯ̞q
арба	ɑrβɑ
арзан	ɑɾzɑn
арҡа	ɑrqɑ
арҡан	ɑrqɑn
арҡаһында	arqɑhɯ̞ndɑ
арпа	ɑrpɑ
арт	ɑrt
артабан	ɑrtɑβɑn
артыҡ	ɑrtɯ̞q
артылыш	ɑrtɯ̞ɫɯ̞ʂ
арыҫлан	ɑrɯ̞θɫɑn
арыш	ɑrɯ̞ʂ
ас	ɑs
асҡыс	ɑsqɯ̞s
аслыҡ	ɑsɫɯ̞q
асы	ɑsɯ̞
асыҡ	ɑsɯ̞q
асыу	ɑsɯ̞w
аҫҡа	ɑθqɑ
аҫтыртын	ɑθtɯ̞ɾtɯ̞n
ат	ɑt
атай	ätäj
атай	ɑtɑj
атама	ɑtɑmɑ
ау	ɑw
аурупа	ɑwɾopɑ
ауһаҡ	ɑwhɑq
ауыҙ	ɑwɯ̞ð
ауыл	ɑwɯ̞ɫ
ауырыу	ɑwɾɯ̞w
ауырыу	ɑwɯ̞ɾɯ̞w
афарин	ɑfɑrʲïn
ахыры	ɑχɯ̞rɯ̞
ахырызаман	ɑχɯ̞rɯ̞zɑmɑn
аш	ɑʂ
аша	ɑʂɑ
ашҡаҙан	ɑʂqɑðɑn
ашхана	ɑʂχɑnɑ
ашъяулыҡ	ɑʂjɑwɫɯ̞q
ашыу	ɑʂɯ̞w
аяҙ	ɑjɑð
аяҡ	ɑjɑq
аят	ɑjɑt
аяуһыҙ	ɑjɑwhɯ̞ð
әбей	æbiʲ
әбей	æβɪj
әгәр	ægær
әҙ	æð
әҙәбиәт	æðæbʲijæt
әҙәм	æðæm
әҙәм	æðæm
әҙер	æðɪ̞r
әҙһәм	æðhæm
әжәл	æʒæl
әйбер	æjβɪ̞r
әйтәгүр	æjtægʏr
әйтәгүр	æjtæɣʏr
әйтелеш	æjtɪ̞lɪ̞ʃ
әйткәндәй	æjtkændæj
әйүп	æjup
әкиәт	ækʲiʲæt
әлбиттә	ælbʲitːæ
әлморон	ælmʊ̞rʊ̞n
әлфиә	ælfʲiʲæ
әмер	æmɪ̞r
әнүәр	ænwær
әңгәмә	æŋgæmæ
әрем	ærɪ̞m
әрмән	ærmæn
әрмәнстан	ærmænstän
әсәй	æsæj
әссәләмәғәләйкүм	æsːælæmæʁælæjkʏm
әстерхан	æstɪ̞rχän
әҫәр	æθær
әтәс	ætæs
әүҙем	æwðɪ̞m
әүҙемлек	æwðɪ̞mlɪ̞k
әүлиә	æwlʲijæ
әфәнде	æfændɪ̞
әхирәт	æχɨiɾæt
әхмәт	æχmæt
әһәмиәт	æhæmʲiʲæt
әшнә	æʃ̟næ
бабай	bɑβɑj
баған	bɑʁɑn
бағана	bɑʁɑnɑ
баҙар	bɑðɑr
баҙыян	bɑðɯ̞jɑn
бажа	bɑʒɑ
бай	bɑj
байлыҡ	bɑjɫɯ̞q
байраҡ	bɑjrɑq
байрам	bɑjrɑm
байрамбикә	bäjrämbʲekæ
байрас	bɑjrɑs
байтаҡ	bɑjtɑq
байтал	bɑjtɑɫ
баҡа	bɑqɑ
баҡса	bɑqsɑ
баҡсасы	bɑqsɑsɯ̞
баҡтиһәң	bɑqtʲihæŋ
баҡһаң	bɑqhɑŋ
баҡыр	bɑqɯ̞r
бал	bɑɫ
бала	bɑɫɑ
балаҡ	bɑɫɑq
балан	bɑɫɑn
балаҫ	bɑɫɑθ
балауыҙ	bɑɫɑwɯ̞ð
балға	bɑɫʁɑ
балдаҡ	bɑɫdɑq
балдар	bɑɫdɑr
балсыҡ	bɑɫsɯ̞q
балта	bɑɫtɑ
балтырған	bɑɫtɯ̞rʁɑn
балыҡ	bɑɫɯ̞q
балыҡсы	bɑɫɯ̞qsɯ̞
баныу	bɑnɯ̞w
бар	bɑɾ
барабан	bäräbän
барабансы	bäräbänsɯ̞
бармаҡ	bɑrmɑq
барыбер	bɑrɯ̞βɯ̞r
баҫҡыс	bɑθqɯ̞s
баҫма	bɑθmɑ
баҫым	bɑθɯ̞m
баҫыу	bɑθɯ̞w
бата	bɑtɑ
батҡаҡ	bɑtqɑq
батмус	bɑtmus
батша	bɑtʂɑ
батыр	bɑtɯ̞ɾ
батырлыҡ	bɑtɯ̞rɫɯ̞q
бау	bɑw
бауыр	bɑwɯ̞r
бауырһаҡ	bɑwɯ̞rhɑq
бахыр	bɑχɯ̞ɾ
баһа	bɑhɑ
баш	bɑʂ
башаҡ	bɑʂɑq
башватҡыс	bɑʂwɑtqɯ̞s
башҡа	bɑʂqɑ
башҡала	bɑʂqɑɫɑ
башҡорт	bɑʂqʊ̞ɾt
башҡортостан	bɑʂqʊ̞rtʊ̞stɑn
башланғыс	bɑʂɫɑŋɢɯ̞s
башлыҡ	bɑʂɫɯ̞q
башлыса	bɑʂɫɯ̞sɑ
башмаҡ	bɑʂmɑq
бәйге	bæjgɪ̞
бәйғәмбәр	bæjʁæmbæɾ
бәйләнеш	bæjlænɪ̞ʃ
бәйләүес	bæjlæwɪ̞s
бәке	bækɪ̞
бәлә	bælæ
бәләкәй	bælækæj
бәлеш	bælɪ̞ʃ
бәлки	bælkʲi
бәндә	bændæ
бәпәй	bæpæj
бәпембә	bæpɪ̞mbæ
бәпес	bæpɪ̞s
бәпкә	bæpkæ
бәрәкәт	bærækæt
бәрәңге	bæræŋgɪ̞
бәрәс	bæræs
бәрҙе	bærðɪ̞
бәүел	bæwɪ̞l
бәхәс	bæχæs
бәхет	bæχɪ̞t
бәшмәк	bæʃmæk
беҙ	bɪ̞ð
беҙгә	bɪ̞ðgæ
беҙҙә	bɪ̞ðːæ
беҙҙән	bɪ̞ðːæn
беҙҙе	bɪ̞ðːɪ̞
беҙҙең	bɪ̞ðːɪ̞ŋ
бей	bɪ̞j
бейә	bɪ̞jæ
бейәләй	bɪ̞jælæj
бейек	bɪ̞jɪ̞k
бейеүсе	bɪ̞jɪ̞wsɪ̞
беләҙек	bɪ̞læðɪ̞k
белгес	bɪ̞lgɪ̞s
белем	bɪ̞lɪ̞m
бер	bɪ̞ɾ
берәмек	bɪ̞ræmɪ̞k
берәү	bɪ̞ræw
бергә	bɪ̞rgæ
берҙәм	bɪ̞rðæm
беренсенән	bɪ̞rɪ̞nsɪ̞næn
бесәй	bɪ̞sæj
бесән	bɪ̞sæn
бет	bɪ̞t
бетеү	bɪ̞tɪ̞w
бигерәк	bʲigɪ̞ræk
биҙ	bʲið
биҙәк	bʲiðæk
биҙгәк	bʲiðgæk
биҙрә	bʲiðræ
бик	bʲek
бикә	bʲekæ
бикбулат	bʲikbuɫät
бикле	bʲeklɪ̞
бикте	bʲektɪ̞
бил	bʲil
билдә	bildæ
билдәләмә	bildælæmæ
бирсәткә	bʲirsætkæ
бисә	bʲesæ
бисмилла	bʲismʲiɫä
бит	bʲet
бит	bʲit
бит	βit
битлек	bʲetlɪ̞k
биш	bʲiʃ
бишәү	bʲiʃæw
бишек	bʲeʃɪ̞k
боҙ	bʊ̞ð
боҙбармаҡ	bʊ̞ðbɑrmɑq
боҙлауыҡ	bʊ̞ðɫɑwɯ̞q
боҙоҡ	bʊ̞ðʊ̞q
бойҙай	bʊ̞jðɑj
бойоҡ	bʊ̞jʊ̞q
бойондороҡһоҙ	bʊ̞jʊ̞ndʊ̞rʊ̞qhʊ̞ð
бойондороҡһоҙлоҡ	bʊ̞jʊ̞ndʊ̞rʊ̞qhʊ̞ðɫʊ̞q
бойороҡ	bʊ̞jʊ̞rʊ̞q
болан	bʊ̞ɫɑn
болғау	bʊ̞ɫʁɑw
болон	bʊ̞ɫʊ̞n
борғаҡ	bʊ̞rʁɑq
борғо	bʊ̞rʁʊ̞
борон	bʊ̞rʊ̞n
боронғо	bʊ̞rʊ̞ŋɢʊ̞
борос	bʊ̞rʊ̞s
борсаҡ	bʊ̞rsɑq
боҫ	bʊ̞θ
ботаҡ	bʊ̞tɑq
бохара	bʊ̞χɑrɑ
бөгөн	bʏ̞gʏ̞n
бөҙрә	bʏ̞ðræ
бөжәк	bʏ̞ʒæk
бөйө	bʏ̞jʏ̞
бөйөк	bʏ̞jʏ̞k
бөйөр	bʏ̞jʏ̞r
бөркөт	bʏ̞rkʏ̞t
бөрлөгән	bʏ̞rlʏ̞gæn
бөрө	bʏ̞rʏ̞
бөрсә	bʏ̞rsæ
бөртөк	bʏ̞rtʏ̞k
бөтә	bʏ̞tæ
бөтөн	bʏ̞tʏ̞n
бөтөнләй	bʏ̞tʏ̞nlæj
буға	buʁɑ
буйҙаҡ	bojðɑq
буйынса	bujɯ̞nsɑ
буҡ	buq
булараҡ	buɫɑrɑq
булат	buɫät
бур	bur
бура	boɾɑ
бураҙна	burɑðnɑ
буран	boɾɑn
буранка	buränkä
бурһыҡ	burhɯ̞q
бурһыҡ	burɦɯ̞q
бурыс	burɯ̞s
буҫаға	buθɑʁɑ
буҫтау	buθtɑw
бутҡа	butqɑ
буш	boʂ
бушлай	buʂɫɑj
бүҙәнә	bɵðænæ
бүкән	bʏkæn
бүләк	bɵlæk
бүлек	bʏlɪ̞k
бүрәнә	bʏrænæ
бүре	bʏrɪ̞
бүрек	bʏrɪ̞k
бүҫер	bʏθɪr
бүтән	bɵtæn
бығау	bɯ̞ʁɑw
быҙау	bɯ̞ðɑw
быйма	bɯ̞jmɑ
был	bɯ̞ɫ
былау	bɯ̞ɫɑw
былбыл	bɯ̞ɫbɯ̞ɫ
былтыр	bɯ̞ɫtɯ̞r
бырау	bɯ̞rɑw
бысаҡ	bɯ̞sɑq
бысҡы	bɯ̞sqɯ̞
бысраҡ	bɯ̞srɑq
быу	bɯ̞w
быуа	bɯ̞wɑ
быуай	bɯ̞wɑj
быуат	bɯ̞wɑt
быяла	bɯ̞jɑɫɑ
вагон	vägo̞n
вазифа	wäzʲïfä
ваҡ	waq
ваҡиға	wäqɯ̽ɪ̈ʁä
ваҡыт	wɑqɯ̞t
ваҡытында	wɑqɯ̞tɯ̞ndɑ
ватан	vɑtɑn
ватан	wɑtɑn
ватандаш	vɑtɑndɑʂ
ватандаш	wɑtɑndɑʂ
вәғәҙә	wæʁæðæ
вәкил	wækʲil
википедия	vʲikʲpʲedʲijä
вилдан	vʲildän
вилдан	wi̠ɫdɑn
выждан	wɯ̞ʐdɑn
вьетнам	wjĕtnɑm
гармун	gärmun
гармунсы	gärmunsɯ̞
гәзит	gæzʲit
гәрәбә	gæræbæ
гәрәбә	gæræβæ
гәүһәр	gæwhær
гел	gɪ̞l
германия	gʲirmänʲijä
гонаһ	gʊ̞nɑh
гонаһ	gʊ̞nɑχ
гонаһ	ɢʊ̞nɑχ
гонаһ	ʁʊ̞nɑχ
гөбөргәйел	gʏ̞βʏ̞rgæjɪ̞l
гөл	gʏ̞l
гөлбаныу	gʏ̞lbänɯ̞w
гөлйемеш	gʏ̞ljɪ̞mɪ̞ʃ
гөлназ	gʏlnäz
граждан	gräʐdän
греция	grʲetsɨ̞jä
гүзәл	gɵzæl
гүзәл	gʏzæl
гүр	gɵɾ
ғабдулла	ɢɑbduɫːɑ
ғабдулла	ʁɑbduɫːɑ
ғазраил	ɢɑzɾɑïɫ
ғазраил	ɢɑzɾɑjɯ̞ɫ
ғазраил	ʁɑzɾɑïɫ
ғазраил	ʁɑzɾɑjɯ̞ɫ
ғаилә	ɢäjlæ
ғайса	ɢɑjsɑ
ғайса	ʁɑjsɑ
ғалим	ɢɑlʲïm
ғалим	ʁɑlʲïm
ғариза	ɢärʲizä
ғасыр	ɢɑsɯ̞r
ғасыр	ʁɑsɯ̞r
ғауға	ɢɑwɢɑ
ғауға	ɢɑwʁɑ
ғашиҡ	ɢäɕi̠q
ғашиҡ	ɢäʃi̠q
ғашиҡ	ʁäɕi̠q
ғашиҡ	ʁäʃi̠q
ғәҙәт	ɢæðæt
ғәҙәт	ʁæðæt
ғәҙәттә	ɢæðætːæ
ғәҙел	ɢæðɪ̞l
ғәжәп	ɢæʒæp
ғәжәп	ʁæʒæp
ғәйбәт	ɢæjβæt
ғәйбәт	ʁæjbæt
ғәйбәт	ʁæjβæt
ғәйеп	ɢæjɪ̞p
ғәйеп	ʁæjɪ̞p
ғәйшә	ɢæjʃæ
ғәйшә	ʁæjʃæ
ғәләм	ɢælæm
ғәли	ʁælɪj
ғәлиәссәләм	ɢælʲiæsːælæm
ғәмәл	ʁæmæl
ғәрәп	ɢæræp
ғәрәп	ʁæræp
ғәскәр	ɢæskær
ғәскәр	ʁæskær
ғибәҙәт	ɢɨ̯ibæðæt
ғибәҙәтхана	ɢɨ̯ibæðætχänä
ғинуар	ʁïnwär
ғорур	ʁʊ̞rur
ғөбәйҙулла	ʁʏ̞βæjðuɫːɑ
ғөмүмән	ɢʏ̞mʏmæn
ғөмүмән	ʁʏ̞mʏmæn
ғүмәр	ʁɵmæɾ
ғүмер	ʁ̝ɵmɪ̞ɾ
ғүмерлек	ʁ̝ʏmɪ̞rlɪ̞k
даға	dɑʁɑ
дағстан	dɑʁɯ̞̆stɑn
даими	dɑimʲi
даирә	däi̯ræ
дала	dɑɫɑ
дана	dɑnɑ
дарыу	dɑrɯ̞w
дарыухана	dɑrɯ̞wχɑnɑ
дауа	dɑwɑ
дауам	dɑwɑm
дауахана	dɑwɑχɑnɑ
дауыл	dɑwɯ̞ɫ
дауыт	dɑwɯ̞t
даян	dɑjɑn
дәғүә	dæʁwæ
дәлил	dælʲil
дәрәжә	dæræʒæ
дәрес	dærɪ̞s
дәүер	dæwɪ̞r
дәүләт	dæwlæt
дәфтәр	dæftær
двигатель	dvʲigatʲilʲ
дебет	dɪ̞βɪ̞t
дилбәр	dʲilbær
дилбәр	dʲilβær
дилбегә	dʲilbɪ̞gæ
дилбегә	dʲilβɪ̞ɣæ
дим	dʲim
дин	dʲin
диңгеҙ	dʲiŋgɪ̞ð
диуана	dʲewɑnɑ
диуар	dʲiwär
доға	dʊ̞ʁɑ
донъя	dʊ̞njɑ
дошман	dʊ̞ʂmɑn
дөгө	dʏ̞gʏ̞
дөйә	dʏ̞jæ
дөйөм	dʏ̞jʏ̞m
дөрөҫ	dʏ̞rʏ̞θ
дуңғыҙ	duŋɢɯ̞ð
дуҫ	duθ
дуҫлыҡ	duθɫɯ̞q
дүрт	dɵɾt
дүртәү	dɵɾtæw
дүшәмбе	dʏʃæmbɪ̞
дым	dɯ̞m
дымлылыҡ	dɯ̞mɫɯ̞ɫɯ̞q
ҙур	ður
ҙурлыҡ	ðurɫɯq
ё	jo
ё	ʲo
ё	jɵ
ё	ʲɵ
ебәк	jɪ̞bæk
европа	je̞vro̞pa
егәр	jɪ̞gær
егәрле	jɪ̞gærlɪ̞
егет	jɪ̞gɪ̞t
егет	jɪ̞ɣɪ̞t
еҙ	jɪ̞ð
еҙнә	jɪ̞ðnæ
ейән	jɪ̞jæn
ейәнсәр	jɪ̞jænsær
еләк	jɪ̞læk
елек	jɪ̞lɪ̞k
елем	jɪlɪ̞m
елен	jɪ̞lɪ̞n
елкә	jɪ̞lkæ
елкән	jɪ̞lkæn
емеш	jɪ̞mɪ̞ʃ
емтек	jɪ̞mtɪ̞k
енәйәт	jɪ̞næjæt
ең	jɪ̞ŋ
еңгә	jɪ̞ŋgæ
еңел	jɪŋɪ̞l
еңеүсе	jɪ̞ŋɪ̞wsɪ̞
ер	jɪ̞r
ерек	jɪ̞rɪ̞k
еҫ	jɪ̞θ
етәксе	jɪ̞tæksɪ̞
етәр	jɪ̞tær
етәү	jɪ̞tæw
етди	jɪ̞dʲːi
ете	jɪ̞tɪ̞
етегән	jɪ̞tɪ̞gæn
етем	jɪ̞tɪ̞m
етешһеҙлек	jɪ̞tɪ̞ʃhɪ̞ðlɪ̞k
етмәһә	jɪ̞tmæhæ
еүеш	jɪ̞wɪ̞ʃ
журнал	ʐurnäɫ
заман	zɑmɑn
замана	zɑmɑnɑ
заһир	zɑhïr
зәйнәб	zæjnæp
зәйнәп	zæjnæp
зәйтүнә	zæjtʏnæ
зәңгәр	zæŋgær
зифа	zʲefɑ
зифа	zʲïfä
зөләйха	zʏ̞læjχa
зөләйха	zʏ̞læjχæ
зөләйхә	zʏ̞læjχæ
зөлфиә	zʏ̞lfʲiʲæ
зөлхизә	zʏ̞lχɨ̯izæ
зөфәр	zʏ̞fær
зөһрә	zʏ̞hræ
зыян	zɯ̞jɑn
зыярат	zɯ̞jɑrɑt
иблис	iblʲis
ибраһим	ɪbɾɑhɪm
игәү	igæw
игеҙәк	igɪ̞ðæk
игеҙәктәр	igɪ̞ðæktær
иген	igɪ̞n
иғлан	ïʁɫɑn
иғтибар	eχtɪbär
иғтибар	eχtɪbɑr
иҙән	iðæn
иҙел	iðɪ̞l
ижад	i̠ʐät
ижек	eʒɪ̞k
изге	izgɪ̞
икәү	ekæw
ике	ekɪ̞
икенде	ekɪ̞ndɪ̞
икмәк	ikmæk
иҡтисад	i̠qtʲi̠sät
ил	il
иләк	elæk
иләү	elæw
илдар	ildär
илнур	elnuɾ
илһам	ilhäm
илһам	iɫhɑm
ильяс	ɪljɑs
иман	ïmɑn
имән	imæn
имза	ïmzä
имза	ïmzɑ
имсәк	imsæk
имтихан	i̠mtʲi̠χän
имшеү	imʃɪ̞w
инәй	inæj
инсан	ïnsän
интернет	intɤrnɛt
интернет	intɨrnɛt
инша	i̠nʂä
иншалла	ïnʂäɫːä
иң	iŋ
ипләп	iplæp
иптәш	iptæʃ
ир	ir̥
ир	irĕ
ирек	irɪ̞k
ирекле	irɪ̞klɪ̞
ирекмән	irɪ̞kmæn
ирен	irɪ̞n
иркә	irkæ
иркәк	irkæk
ирлән	irlæn
ирмәк	irmæk
иртә	irtæ
иртәгә	irtægæ
иртән	irtæn
иртәнсәк	irtænsak
исем	esɪ̞m
исемлек	isɪ̞mlɪ̞k
искәндәр	iskændær
искәндәриә	iskændærijæ
ислам	i̠sɫɑm
исмаһам	esmähäm
исрафил	ïsɾɑfʲïɫ
иҫ	iθ
иҫән	iθæn
иҫәп	iθæp
иҫерек	iθɪ̞rɪ̞k
иҫкәртмә	iθkærtmæ
иҫке	iθkɪ̞
иҫтәлек	iθtælɪ̞k
итәк	itæk
итек	itɪ̞k
ихтилал	ïχtʲïɫɑɫ
ихтирам	ïχtʲïrɑm
ихтыяж	ïχtɯ̞jɑʐ
ихтыяр	ïχtɯ̞jɑr
ишәк	eʃæk
ишек	iʃɪ̞k
ишкәк	iʃkæk
йә	jæ
йәғни	jæʁnʲi
йәғрәфиә	jæʁɾæfijæ
йәй	jæj
йәйә	jæjæ
йәйәү	jæjæw
йәйғор	jæjʁʊ̞r
йәйен	jæjɪ̞n
йәки	jækʲi
йәкшәмбе	jækʃæmbɪ̞
йәл	jæl
йәм	jæm
йәмил	jæmʲil
йәмилә	jæmʲilæ
йән	jæn
йәнә	jænæ
йәннәт	jænːæt
йәнһүрәт	jænhʏræt
йәрәхәт	jæræχæt
йәрминкә	jærmʲinkæ
йәтим	jætʲim
йәүҙәт	jæwðæt
йәһәннәм	jæhænːæm
йәһүд	jæhut
йәш	jæʃ
йәшәйеш	jæʃæjɪ̞ʃ
йәшел	jæʃɪ̞l
йәшелсә	jæʃɪ̞lsæ
йәшен	jæʃɪ̞n
йәшерен	jæʃɪ̞rɪ̞n
йәшник	jæʃnʲik
йәштәр	jæʃtæɾ
йоғошло	jʊ̞ʁʊ̞ʂɫʊ̞
йоҙаҡ	jʊ̞ðɑ̹q
йоҙроҡ	jʊ̞ðrʊq
йоҡа	jʊ̞qɑ
йоҡо	jʊ̞qʊ̞
йола	jʊ̞ɫɑ
йома	jʊ̞mɑ
йомабай	jʊ̞mɑbɑj
йомабикә	jʊ̞mɑbʲekæ
йомағара	jụmɑɣɑrɑ
йомаҡ	jʊ̞mɑq
йомарт	jʊ̞mɑɾt
йомғаҡ	jʊ̞mʁɑq
йомортҡа	jʊ̞mʊ̞rtqɑ
йомош	jʊ̞mʊ̞ʂ
йомран	jʊ̞mrɑn
йомро	jʊ̞mɾʊ̞
йомшаҡ	jʊ̞mʂɑq
йондоҙ	jʊ̞ndʊ̞ð
йондоҙнамә	jʊ̞ndʊ̞ðnämæ
йорт	jʊ̞rt
йосоп	jʊ̞sʊ̞p
йөҙ	jʏ̞ð
йөҙөк	jʏ̞ðʏ̞k
йөҙтүбән	jʏ̞ðtʏbæn
йөҙтүбән	jʏ̞ðtʏβæn
йөк	jʏ̞k
йөкмәтке	jʏ̞kmætkɪ̞
йөн	jʏ̞n
йөрәк	jʏ̞ræk
йүгән	jʏgæn
йүкә	jɵkæ
йүнәлеш	jʏnælɪ̞ʃ
йүргәк	jʏrgæk
йүтәл	jʏtæl
йыл	jɯ̞ɫ
йылан	jɯ̞ɫɑn
йылға	jɯ̞ɫʁɑ
йылъяҙма	jɯ̞ɫjɑðmɑ
йылы	jɯ̞ɫɯ̞
йылымыс	jɯ̞ɫɯ̞mɯ̞s
йыназа	jɯ̞nɑzɑ
йыр	jɯ̞r
йыраҡ	jɯ̞ɾɑq
йырсы	jɯ̞rsɯ̞
йыртҡыс	jɯ̞rtqɯ̞s
йыуа	jɯ̞wɑ
йыуан	jʊwɑn
йыуаса	jɯ̞wɑsɑ
йыһан	jɯ̞hɑn
йыш	jɯ̞ʂ
йышҡы	jɯ̞ʂqɯ̞
кавказ	käfkäz
карап	käräp
карта	karta
картуф	kɑrtuf
каруан	kärwän
каса	kasa
кафыр	kæfɪ̞ɾ
кафыр	käfɪ̈ɾ
кәбән	kæb̪æn
кәбән	kæβæn
кәбеҫтә	kæbɪ̞θtæ
кәбеҫтә	kæβɪ̞θtæ
кәзә	kæzæ
кәйеф	kæjɪ̞f
кәкре	kækɪ̞ɾɪ̞
кәкре	kækɾɪ̞
кәкүк	kækʏk
кәләш	kælæʃ
кәм	kæm
кәмә	kæmæ
кәмендә	kæmɪ̞ndæ
кәмеү	kæmɪ̞w
кәнфит	kænfʲit
кәңәш	kæŋæʃ
кәңәшмә	kæŋæʃmæ
кәңәшсе	kæŋæʃsɪ̞
кәрәк	kæræk
кәрт	kæɾt
кәртә	kæɾtæ
кәсер	kæsɪ̞r
кәстрүл	kæstrʏl
кәтмән	kætmæn
кәүҙә	kæwðæ
кәшәнә	kæʃænæ
кәштә	kæʃtæ
квартал	kvärtäɫ
кг	kʲiɫä
кг	kʲiɫägräm
кейәү	kɪ̞jæw
кейеҙ	kɪ̞jɪ̞ð
кейем	kɪ̞jɪ̞m
келәм	kɪ̞læm
кем	kɪ̞m
кендек	kɪ̞ndɪ̞k
кер	kɪ̞r
керпек	kɪ̞rpɪ̞k
кесаҙна	kɪ̞säðnä
кесерткән	kɪ̞sɪ̞rtkæn
кескәй	kɪ̞skæj
кеҫә	kɪ̞θæ
кеҫәртке	kɪ̞θærtkɪ̞
кеше	kɪ̞ʃɪ̞
кешелек	kɪ̞ʃɪ̞lɪ̞k
киев	kʲijɨ̞f
киләсәк	kʲilæsæk
киләһе	kʲelæhɪ̞
киле	kʲilɪ̞
килейек	kʲilɪ̞jɪ̞k
килен	kʲelɪ̞n
килеш	kilɪ̞ʃ̟
килмешәк	kʲilmɪ̞ʃæk
килограмм	kʲiɫägräm
кимәл	kʲimæl
кимереүсе	kʲimɪ̞rɪ̞wsɪ̞
кинәт	kʲinæt
киндер	kʲindɪ̞r
кинйә	kʲinjæ
киң	kʲeŋ
киңлек	kʲiŋlɪ̞k
кирбес	kʲirbɪ̞s
кире	kʲeɾɪ̞
киреһенсә	kʲirɪ̞hɪ̞nsæ
кис	kʲis
кисә	kʲisæ
кисеү	kʲisɪ̞w
китапхана	kʲitäpχänä
кишер	kʲeʃɪ̞ɾ
корея	korĕjɑ
көҙ	kʏ̞ð
көҙән	kʏ̞ðæn
көҙән	kʏ̞ðɶ̟n
көҙгө	kʏ̞ðgʏ̞
көй	kʏ̞j
көйә	kʏ̞jæ
көйәнтә	kʏ̞jæntæ
көйөнсә	kʏ̞jʏ̞nsæ
көкөрт	kʏ̞kʏ̞rt
көл	kʏ̞l
көмбәҙ	kʏ̞mbæð
көмөш	kʏ̞mʏ̞ʃ
көнбағыш	kʏ̞nbɑʁɯ̞ʂ
көнбайыш	kʏ̞nbɑjɯ̞ʂ
көндәлек	kʏ̞ndælɪ̞k
көнкүреш	kʏ̞nkɵrɪ̞ʃ
көнсығыш	kʏ̞nsɯ̞ʁɯ̞ʂ
көньяҡ	kʏ̞njɑq
көрәк	kʏ̞ræk
көрән	kʏɾæn
көрәш	kʏ̞ræ̹ʃ
көрсөк	kʏ̞rsʏ̞k
көрт	kʏ̞rt
көртмәле	kʏ̞rtmælɪ̞
көс	kʏ̞s
көслө	kʏ̞slʏ̞
көсөк	kʏ̞sʏ̞k
көстө	kʏ̞stʏ̞
көтмәгәндә	kʏ̞tmægændæ
көтөү	kɪ̞tɪ̞w
көтөү	kʏ̞tʏ̞w
көтөүсе	kɪ̞tɪ̞wsɪ̞
куба	kubä
кукуруз	kukuruz
күбәләк	kʏβælæk
күбек	kʏβɪ̞k
күгәрсен	kɵgærsɪ̞n
күгәүен	kʏgæwɪ̞n
күҙәнәк	kʏðænæk
күҙәтеү	kʏðætɪ̞w
күҙлек	kʏðlɪ̞k
күк	kɵk
күкәй	kʏkæj
күл	kʏl
күләгә	kʏlægæ
күләм	kʏlæm
күләүек	kʏlæwɪ̞k
күлдәк	kʏldæk
күмер	kɵmɪ̞ɾ
күңел	kɵŋɪ̞l
күңелле	kɵŋɪ̞lːɪ̞
күңелһеҙ	kɵŋɪ̞hɪ̞ð
күңелһеҙ	kɵŋɪ̞ɦɪ̞ð
күп	kɵp
күпер	kʏpɪ̞r
күпме	kʏpmɪ̞
күпселек	kʏpsɪ̞lɪ̞k
күрек	kʏrɪ̞k
күренеш	kʏrɪ̞nɪ̞ʃ
күркә	kɵɾkæ
күрһәткес	kʏrhætkɪ̞s
күрше	kɵɾʃɪ̞
күсәр	kʏsær
күскен	kʏskɪ̞n
күстәнәс	kʏstænæs
күт	kɵt
ҡабат	qɑβɑt
ҡабатлау	qɑβɑtɫɑw
ҡабыҡ	qɑβɯ̞q
ҡабырға	qɑβɯ̞rʁɑ
ҡабырсаҡ	qɑβɯ̞rsɑq
ҡағиҙә	qäʁɨ̯iðæ
ҡағыҙ	qɑʁɯ̞ð
ҡаҙ	qɑð
ҡаҙағстан	qɑðɑʁɯ̞̆stɑn
ҡаҙаҡ	qɑðɑq
ҡаҙан	qɑðɑn
ҡаҙаныш	qɑðɑnɯ̞ʂ
ҡаҙы	qɑðɯ̞
ҡайғы	qɑjʁɯ̞
ҡайҙа	qɑjðɑ
ҡайҙан	qɑjðɑn
ҡаймаҡ	qɑjmɑq
ҡайнатма	qɑjnɑtmɑ
ҡайсы	qɑjsɯ̞
ҡайһы	qɑjhɯ̞
ҡайын	qɑjɯ̞n
ҡайыш	qɑjɯ̞ʂ
ҡаҡырыҡ	qɑqɯ̞rɯ̞q
ҡала	qɑɫɑ
ҡалай	qɑɫɑj
ҡалдыҡ	qɑɫdɯ̞q
ҡалҡан	qɑɫqɑn
ҡалын	qɑɫɯ̞n
ҡалып	qɑɫɯ̞p
ҡама	qɑmɑ
ҡамғаҡ	qɑmʁɑq
ҡамыр	qɑmɯ̞r
ҡамыт	qɑmɯ̞t
ҡамыш	qɑmɯ̞ʂ
ҡан	qɑn
ҡанат	qɑnɑt
ҡандала	qɑndɑɫɑ
ҡанун	qɑnun
ҡапҡа	qɑpqɑ
ҡапҡас	qɑpqɑs
ҡапсыҡ	qapsɯ̞q
ҡапыл	qɑpɯ̞ɫ
ҡар	qɑr
ҡара	qɑɾɑ
ҡарабойҙай	qɑrɑbʊ̞jðɑj
ҡарағай	qɑrɑʁɑj
ҡарағанда	qɑrɑʁɑndɑ
ҡарағас	qɑrɑʁɑs
ҡарағат	qɑrɑʁɑt
ҡараҡ	qɑrɑq
ҡарама	qɑrɑmɑ
ҡарамаҫтан	qɑrɑmɑθtɑn
ҡараңғы	qɑɾɑɴɢɯ̞
ҡарасҡы	qɑrɑsqɯ̞
ҡарата	qɑrɑtɑ
ҡарға	qɑrʁɑ
ҡарғыш	qɑrʁɯ̞ʂ
ҡарлуғас	qɑɾɫʊʁɑs
ҡармаҡ	qɑrmɑq
ҡарсыға	qɑrsɯ̞ʁɑ
ҡарсыҡ	qɑɾsɯ̞q
ҡарт	qɑɾt
ҡарһылыу	qɑrhɯ̞ɫɯ̞w
ҡаршы	qɑɾʂɯ̞
ҡарыш	qɑrɯ̞ʂ
ҡасан	qɑsɑn
ҡасҡын	qɑsqɯ̞n
ҡат	qɑt
ҡатнашыусы	qɑtnɑʂɯ̞wsɯ̞
ҡаты	qɑtɯ̞
ҡатыҡ	qɑtɯ̞q
ҡатын	qɑtɯ̞n
ҡатырға	qɑtɯ̞rʁɑ
ҡауаҡ	qɑwɑq
ҡауҙы	qɑwðɯ̞
ҡаурый	qɑwrɯ̞j
ҡауын	qɑwɯ̞n
ҡауырһын	qɑwɯ̞rhɯ̞n
ҡаш	qɑʂ
ҡашығаяҡ	qɑʂɯ̞ʁɑjɑq
ҡая	qɑjɑ
ҡәбер	qæbɪ̞ɾ
ҡәбилә	qæbilæ
ҡәғбә	qæʁbæ
ҡәҙәр	qæðær
ҡәҙер	qæðɪ̞r
ҡәйнә	qæjnæ
ҡәләм	qælæm
ҡәләмфер	qælæmfɪ̞r
ҡәнәғәт	qænæʁæt
ҡәнәфер	qænæfɪ̞r
ҡәрҙәш	qæɾðæʃ
ҡәһүә	qæhwæ
ҡибла	qɨ̯ibɫä
ҡиммәт	qɪmːæt
ҡиммәт	qɨ̯imːæt
ҡиммәтле	qɪmːætlɪ̞
ҡиммәтле	qɨ̯imːætlɪ̞
ҡитға	qɯ̽ɪ̈tʁä
ҡоҙғон	qʊ̞ðʁʊ̞n
ҡоҙоҡ	qʊ̞ðʊ̞q
ҡойма	qʊ̞jmɑ
ҡоймаҡ	qʊ̞jmɑq
ҡойо	qʊ̞jʊ̞
ҡойроҡ	qʊ̞jrʊ̞q
ҡол	qʊ̞ɫ
ҡолаҡ	qʊ̞ɫɑq
ҡом	qʊ̞m
ҡомағай	qʊ̞mɑʁɑj
ҡомалаҡ	qʊ̞mɑɫɑq
ҡомартҡы	qʊ̞mɑrtqɯ̞
ҡомһоҙ	qʊ̞mhʊ̞ð
ҡондоҙ	qʊ̞ndʊ̞ð
ҡоно	qʊ̞nʊ̞
ҡорал	qʊ̞rɑɫ
ҡорбан	qʊ̞ɾβɑn
ҡоро	qʊ̞ɾʊ̞
ҡороҡ	qʊ̞rʊ̞q
ҡоролма	qʊ̞rʊ̞ɫmɑ
ҡоролоҡ	qʊ̞rʊ̞ɫʊ̞q
ҡоролтай	qʊ̞rʊ̞ɫtɑj
ҡором	qʊ̞rʊ̞m
ҡорос	qʊ̞rʊ̞s
ҡорот	qʊ̞rʊ̞t
ҡоротҡос	qʊ̞rʊ̞tqʊ̞s
ҡорт	qʊ̞rt
ҡосаҡ	qʊ̞sɑq
ҡот	qʊ̞t
ҡотоҡ	qʊ̞tʊ̞q
ҡош	qʊ̞ʂ
ҡояш	qʊ̞jɑʂ
ҡуҙғалаҡ	quðʁɑɫɑq
ҡуҙы	quðɯ̞
ҡуйы	qojɯ̞
ҡул	qoɫ
ҡулаҡса	quɫɑqsɑ
ҡулланыусы	quɫɫɑnɯ̞wsɯ̞
ҡултамға	quɫtɑmʁɑ
ҡултыҡ	qoɫtɯ̞q
ҡулъяҙма	qoɫjɑðmɑ
ҡулъяулыҡ	quɫjɑwɫɯ̞q
ҡумта	qumtɑ
ҡумыҙ	qumɯ̞ð
ҡунаҡ	qonɑq
ҡунаҡсыл	qonɑqsɯ̞ɫ
ҡунаҡхана	qonɑqχɑnɑ
ҡуңыҙ	qoɴɯ̞ð
ҡурай	qurɑj
ҡурайсы	qurɑjsɯ̞
ҡурғаш	qurʁɑʂ
ҡурҡаҡ	qoɾqɑq
ҡурсаҡ	qursɑq
ҡуртым	qurtɯ̞m
ҡусты	qustɯ̞
ҡутаҡ	qutɑq
ҡутыр	qutɯ̞r
ҡушамат	quʂɑmɑt
ҡуян	qujɑn
ҡыҙ	qɯ̞ð
ҡыҙ	qɯ̞ð
ҡыҙыҡ	qɯ̞ðɯ̞q
ҡыҙыл	qɯ̞ðɯ̞ɫ
ҡыҙылса	qɯ̞ðɯ̞ɫsɑ
ҡыҙылтүш	qɯ̞ðɯ̞ɫtʏʃ
ҡыҙыу	qɯ̞ðɯ̞w
ҡыйбат	qɯ̞jβɑt
ҡыйын	qɯ̞jɯ̞n
ҡыйыу	qɯ̞jɯ̞w
ҡыл	qɯ̞ɫ
ҡылған	qɯ̞ɫʁɑn
ҡылым	qɯ̞ɫɯ̞m
ҡылыс	qɯ̞ɫɯ̞s
ҡымыҙ	qɯ̞mɯ̞ð
ҡымыҙлыҡ	qɯ̞mɯ̞ðɫɯ̞q
ҡын	qɯ̞n
ҡына	qɯ̞nɑ
ҡыңғырау	qɯ̞ŋʁɯ̞rɑw
ҡыпсыуыр	qɯ̞psɯ̞wɯ̞r
ҡыпһыуыр	qɯ̞phɯ̞wɯ̞r
ҡырағай	qɯ̞ɾɑʁɑj
ҡырау	qɯ̞rɑw
ҡырғыҙ	qɯ̞rʁɯ̞ð
ҡырғыҙстан	qɯ̞rɢ̞ɯ̞ðstɑn
ҡырғыс	qɯ̞rʁɯ̞s
ҡырмыҫҡа	qɯ̞rmɯ̞θqɑ
ҡыртыш	qɯ̞rtɯ̞ʂ
ҡырым	qɯ̞rɯ̞m
ҡырыҫ	qɯ̞ɾɯ̞θ
ҡыҫала	qɯ̞θɑɫɑ
ҡыҫҡа	qɯ̞θqɑ
ҡыҫҡаһы	qɯ̞θqɑhɯ̞
ҡытай	qɯ̞tɑj
ҡыуаҡ	qɯ̞wɑq
ҡыуыш	qʊwɯ̞ʂ
ҡыш	qɯ̞ʂ
ләйсән	læjsæn
мажара	mɑʒɑrɑ
майҙан	mɑjðɑn
майҙансыҡ	mɑjðɑnsɯ̞q
маймыл	mɑjmɯ̞ɫ
маҡсат	mɑqsɑt
маҡтансыҡ	mɑqtɑnsɯ̞q
маладис	mɑɫɑdʲïs
мамыҡ	mɑmɯ̞q
манара	mɑnɑrɑ
манга	manga
маңдай	mɑŋdɑj
маңҡа	mɑŋqɑ
маңлай	mɑɴɫɑj
матбуғат	mɑtbuʁɑt
матдә	mädːæ
матдә	mædːæ
матур	mɑtʊɾ
махсус	mɑχsus
машина	mäʂɯ̞nä
машина	mäʃinä
мә	mæ
мәғәнә	mæʁænæ
мәғлүмәт	mæʁlʏmæt
мәҙәниәт	mæðænʲiʲæt
мәҙинә	mæðinæ
мәҙрәсә	mæðɾæsæ
мәжүси	mæʒʏsʲi
мәжүсилек	mæʒʏsʲilɪ̞k
мәйет	mæjɪ̞t
мәккә	mækːæ
мәктәп	mæktæp
мәҡәл	mæqæl
мәҡәлә	mæqælæ
мәл	mæl
мәмерйә	mæmɪ̞rjæ
мәней	mænɪ̞j
мәнфәғәт	mænfæʁæt
мәңге	mæŋgɪ̞
мәңгелек	mæŋgɪ̞lɪ̞k
мәргән	mærgæn
мәрйәм	mærjæm
мәрйен	mærjɪ̞n
мәрмәр	mærmær
мәртәбә	mærtæβæ
мәрхүм	mærχʏm
мәсет	mæsɪ̞t
мәскәү	mæskæw
мәсьәлә	mæsælæ
мәсьәлә	mæsʔælæ
мәҫәл	mæθæl
мәҫәлән	mæθælæn
мәхмүт	mæχmʏt
мәшәҡәт	mæʃæqæt
мейе	mɪ̞jɪ̞
мейес	mɪ̞jɪ̞s
менәүрә	mɪ̞næwræ
мендәр	mɪ̞ndær
мең	mɪ̞ŋ
миҙал	mʲiðäɫ
миҙгел	mʲiðgɪ̞l
миләүшә	mʲilæwʃæ
миләш	mʲilæʃ
милләт	mʲilːæt
милләтсе	mʲilːætsɪ̞
милләтсел	mʲilːætsɪ̞l
мин	mʲen
минән	mʲinæn
миндә	mʲindæ
миндек	mʲindɪ̞k
мине	mʲinɪ̞
минең	mʲenɪ̞ŋ
министр	mʲinʲistɯ̞r
министрлыҡ	mʲinʲistɯ̞rɫɯ̞q
минут	mʲinut
миң	mʲeŋ
миңә	mʲiŋæ
мираҫ	mʲirɑθ
миҫал	mʲi̠θɑɫ
моғайын	mʊ̞ʁɑjɯ̞n
моң	mʊ̞ŋ
морон	mʊ̞rʊ̞n
мосолман	mʊ̞sʊ̞ɫmɑn
мотлаҡ	mʊ̞tɫɑq
мотоцикл	mätätsɯ̞kɯ̆ɫ
мөгөҙ	mʏ̞gʏ̞ð
мөғжизә	mʏ̞ʁʑizæ
мөғжизә	mʏ̞ʁʒizæ
мөҙҙәт	mʏ̞ðːæt
мөйөш	mʏ̞jʏ̞ʃ
мөмкин	mʏ̞mkʲin
мөмкинлек	mʏ̞mkʲinlɪ̞k
мөмкинселек	mʏ̞mkʲinsɪ̞lɪ̞k
мөрйә	mʏ̞rjæ
мөртәт	mʏ̞ɾtæt
мөхәббәт	mʏ̞χæbːæt
мөхәммәт	mʏχæmːæt
мөхәррир	mʏ̞χærʲːir
мөхәрририәт	mʏ̞χærʲːirʲiʲæt
мөхит	mʏ̞χɨ̯it
мөһим	mʏ̞hɪm
мөьмин	mʏ̞ʔmin
муйыл	mujɯ̞ɫ
муйын	mujɯ̞n
мул	muɫ
мулла	moɫːɑ
мунса	monsɑ
муса	musɑ
мусиҡа	musiqä
мүзә	mɵzæ
мүк	mʏk
мыжыҡ	mɯ̞ʐɯ̞q
мыйыҡ	mɯ̞jɯ̞q
мылтыҡ	mɯ̞ɫtɯ̞q
мырҙа	mɯ̞rðɑ
мысыр	mɯ̞sɯ̞ɾ
мышар	mɯ̞ʂɑr
мышы	mɯ̞ʂɯ̞
на	nɑ
наҙан	nɑðɑn
намаҙ	nɑmɑð
намаҙлыҡ	nɑmɑðɫɯ̞q
намыҫ	nɑmɯ̞θ
насар	nɑsɑr
науруз	nɑwruz
науруз	nɑwrɯ̞z
нәҙек	næðɪ̞k
нәжибә	næʑiβæ
нәжип	næʑip
нәмә	næmæ
нәркәс	nærkæs
нәсихәт	næsʲiχæt
нәтижә	nætʲiʒæ
нәфрәт	næfræt
нәшриәт	næʃrʲiʲæt
ниәт	nɪ̞jæt
ниәт	nʲiʲæt
нигеҙ	nʲigɪ̞ð
ниғмәт	nʲiʁmæt
ниғмәтулла	nʲiʁmætuɫːä
нимә	nʲimæ
ниндәй	nʲindæj
нисә	nʲesæ
нисәнсе	nʲesænsɪ̞
нисбәт	nʲisbæt
нисек	nʲisɪ̞k
ниһәйәт	nʲihæjæt
норма	no̞rmä
нөктә	nʏ̞ktæ
нур	nur
нух	nuχ
оҙаҡ	ʊ̞ðɑq
оҙон	ʊ̞ðʊ̞n
оҙонлоҡ	ʊ̞ðʊ̞nɫʊ̞q
ожмах	ʊ̞ʐmɑχ
ойоҡ	ʊ̞jʊ̞q
ойошма	ʊ̞jʊ̞ʂmɑ
ойоштороусы	ʊ̞jʊ̞ʂtʊ̞rʊ̞wsɯ̞
ойоштороусы	ʊ̞jʊ̞ʂtʊ̞rʊ̞wsʊ̞
оҡшаш	ʊ̞qʂɑʂ
оло	ʊ̞ɫʊ̞
олон	ʊ̞ɫʊ̞n
олтораҡ	ʊ̞ɫtʊ̞rɑq
ондатра	ändäträ
опто	ʊ̞ptʊ̞
орҙоҡ	ʊ̞rðʊ̞q
орлоҡ	ʊ̞rɫʊ̞q
оро	ʊ̞rʊ̞
орсоҡ	ʊ̞rsʊ̞q
ос	ʊ̞s
осҡон	ʊ̞sqʊ̞n
осор	ʊ̞sʊ̞r
осраҡ	ʊ̞srɑ̹q
осраҡлы	ʊ̞srɑ̹qɫɯ̞
остаз	ʊ̞stɑz
осһоҙ	ʊ̞shʊ̞ð
оҫта	ʊ̞θtɑ
офоҡ	ʊ̞fʊ̞q
оя	ʊ̞jɑ
оят	ʊ̞jɑt
өгөт	ʏ̞gʏ̞t
өҙәңге	ʏ̞ðæŋgɪ̞
өҙәңге	ʏ̞ðæ̹ŋgʏ̞
өҙөк	ʏ̞ðʏ̞k
өҙөмтә	ʏ̞ðʏ̞mtæ
өй	ʏ̞j
өйөр	ʏ̞jʏ̞r
өйрәк	ʏ̞jræk
өйрәкморон	ʏ̞jrækmʊ̞rʊ̞n
өйрәнсек	ʏ̞jrænsɪ̞k
өйрәнсек	ʏ̞rænsɪ̞k
өкө	ʏ̞kʏ̞
өлгө	ʏ̞lgʏ̞
өлкә	ʏlkɛ
өлкән	ʏ̞lkæn
өлкәр	ʏ̞lkær
өлөш	ʏ̞lʏ̞ʃ
өмә	ʏ̞mæ
өмөт	ʏ̞mʏ̞t
өн	ʏ̞n
өрөк	ʏ̞rʏ̞k
өс	ʏ̞s
өсәү	ʏ̞sæw
өсмөйөш	ʏ̞sm̟ʏ̞jʏ̞ʃ
өҫкә	ʏ̞θkæ
өҫтәл	ʏ̞θtæ̹l
өтөр	ʏ̞tʏ̞r
өфө	ʏ̞fʏ̞
пәйғәмбәр	pæjʁæmbæɾ
пәрҙә	pærðæ
поезд	pojɪz
поезд	pojɪzd
поезд	pojɯ̞z
поезд	pojɯ̞zd
помидор	pämʲidɔr
проблема	präblʲemä
проблема	prɐblʲemə
процент	prätsɛnt
процент	prɐtsɛnt
раббы	ɾɑbːɯ̞
рашҡы	rɑʂqɯ̞
рәйхана	ræjχänä
рәҡәғәт	ɾæqæʁæt
рәмил	ræmʲil
рәсәй	ræsæj
рәсем	ræsɪ̞m
рәсимә	ræsʲimæ
рәсми	ræsmʲi
рәссам	ræsːæm
рәссам	ræsːäm
рәссам	rasːäm
рәт	ræt
рәүеф	ræwɪ̞f
рәүеш	ræwɪ̞ʃ
рәхмәт	ɾæχmæt
редакция	rʲɪdaktsɨjə
редакция	rʲɪdäktsɯjä
республика	rʲispublʲikä
риза	rʲezɑ
ринат	rʲinät
риүәйәт	rʲiwæjæt
рифҡәт	rʲifqæt
ришат	rʲiʂät
ришүәт	rʲiʃwæt
ришүәтсе	rʲiʃwætsɪ̞
рөстәм	rʏ̞stæm
рөхсәт	rʏ̞χsæt
рух	ruχ
сабата	sɑβɑtɑ
сабира	sɑbʲirɑ
сабый	sɑβɯ̞j
сабыр	sɑbɯ̞r
саҡ	sɑq
саҡрым	sɑqrɯ̞m
салауат	sɑɫɑwɑt
салбар	sɑɫβɑr
салғы	sɑɫʁɯ̞
сама	sɑmɑ
самауыр	sɑmɑwɯ̞r
самолёт	sämälʲɵt
самолёт	sɐmɐlʲɵt
самолёт	səmɐlʲɵt
самрау	sɑmrɑw
сана	sɑnɑ
сания	sɑnʲijɑ
саң	sɑŋ
саңғы	sɑŋɢɯ̞
сара	sɑrɑ
сара	sɑɾɑ
сатыр	sɑtɯ̞r
сауап	sɑwɑp
сауҙа	sɑwðɑ
саян	sɑjɑn
сәбәп	sæβæp
сәғәт	sæʁæt
сәғит	sæʁit
сәй	sæj
сәйәсәт	sæjæsæt
сәйәхәт	sæjæχæt
сәйер	sæjɪ̞ɾ
сәйет	sæjɪ̞t
сәйнүк	sæjnuk
сәйхана	sæjχänä
сәкинә	sækʲinæ
сәләм	sælæm
сәлимә	sælʲimæ
сәмреғош	sæmrɪ̞ʁʊ̞ʂ
сәнәғәт	sænæɢæt
сәнғәт	sænɢæt
сәнғәт	sæŋɢæt
сәнске	sænskɪ̞
сәңгелдәк	sæŋgɪ̞ldæk
сәркәтип	særkætʲip
сәс	sæs
сәсән	sæsæn
сәскә	sæskæ
сәтләүек	sætlæwɪ̞k
сәүкә	sæwkæ
сәхнә	sæχnæ
светофор	sᵊvʲitäfor
себен	sɪ̞βɪ̞n
себер	sɪ̞βɪ̞r
себеш	sɪ̞βɪ̞ʃ
сей	sɪ̞j
сейә	sɪ̞jæ
сеймал	sɪ̞jmɑɫ
секунд	sʲikunt
селән	sɪ̞læn
селәүсен	sɪ̞læwsɪ̞n
селдә	sɪ̞ldæ
селлә	sɪ̞lːæ
селтәр	sɪ̞ltær
сепрәк	sɪ̞præk
сер	sɪ̞r
серәкәй	sɪ̞rækæj
серек	sɪ̞rɪ̞k
сибәр	sʲebæɾ
сибәр	sʲeβæɾ
сиған	sʲïʁän
сиған	sʲïʁɑn
сик	sik
сикә	sʲikæ
силәбе	sʲilæbɪ̞
силәбе	sʲilæβɪ̞
симешкә	sʲimɪ̞ʃkæ
синыф	sʲi̠nɯ̞f
сиңерткә	sʲiŋɪ̞rtkæ
сипарат	sʲïpärät
сипарат	sʲïpɑrɑt
сирек	sʲeɾɪ̞k
сиркәү	sʲeɾkæw
сит	sʲit
ситлек	sʲitlɪ̞k
сифат	sʲi̠fät
сихыр	sʲïχɯ̞r
сихырлы	sʲïχɯ̞rɫɯ̞
сихырсы	sʲïχɯ̞rsɯ̞
совет	sävʲet
соҡор	sʊ̞qʊ̞r
солан	sʊ̞ɫɑn
солоҡ	sʊ̞ɫʊ̞q
социаль	sätsɯälʲ
социаль	sɐtsɨalʲ
сөгөлдөр	sʏ̞gʏ̞ldʏ̞ɾ
сөй	sʏ̞j
сөнки	sʏ̞nkʲi
сөсө	sʏ̞sʏ̞
суйын	sujɯ̞n
суҡмар	suqmɑr
сулпан	soɫpɑn
сумаҙан	sumɑðɑn
суртан	surtɑn
сусҡа	susqɑ
сутый	sutɯ̞j
суфиян	sufijɑn
суфыйсылыҡ	sufɯ̞jsɯ̞ɫɯ̞q
сүкеш	sʏkɪ̞ʃ
сүл	sʏl
сүллек	sʏllɪ̞k
сүмес	sʏmɪ̞s
сүп	sʏp
сүрә	suɾæ
сүриә	sʏriʲæ
сүс	sʏs
сыбар	sɯ̞βɑr
сыбыҡ	sɯ̞βɯ̞q
сыбыртҡы	sɯ̞βɯ̞rtqɯ̞
сығанаҡ	sɯ̞ʁɑnɑq
сыйырсыҡ	sɯ̞jɯ̞rsɯ̞q
сылбыр	sɯ̞ɫbɯ̞r
сылбыр	sɯ̞ɫβɯ̞r
сынйыр	sɯ̞njɯ̞r
сыңғыҙ	sɯ̞ŋɢɯ̞ð
сыр	sɯ̞r
ҫупайҙы	θupɑjðɯ
таба	tɑbɑ
таба	tɑβɑ
табаҡ	tɑbɑq
табаҡ	tɑβɑq
табут	tɑβut
тағы	tɑʁɯ̞
таҙа	tɑðɑ
таж	tɑʒ
тайғаҡ	tɑjʁɑq
тайфур	tɑjfur
таҡмаҡ	tɑqmɑq
таҡта	tɑqtɑ
таҡтаташ	tɑqtɑtɑʂ
таҡыр	tɑqɯ̞r
таҡырбаш	tɑqɯ̞rbɑʂ
тал	tɑɫ
талаҡ	tɑɫɑq
талап	tɑɫɑp
талапсан	tɑɫɑpsɑn
талғат	tɑɫʁɑt
талпан	tɑɫpɑn
талха	tɑɫχɑ
тамаҡ	tɑmɑq
тамам	tɑmɑm
тамаша	tɑmɑʂɑ
тамашасы	tɑmɑʂɑsɯ̞
тамға	tɑmʁɑ
тамсы	tɑmsɯ̞
тамуҡ	tɑmuq
танау	tɑnɑw
тантана	tɑntɑnɑ
таныш	tɑnɯ̞ʂ
таңсулпан	tɑŋsuɫpɑn
таңһылыу	tɑŋhɯ̞ɫɯ̞w
тап	tɑp
тапҡыр	tɑpqɯ̞r
тапшырыу	tɑpʂɯ̞rɯ̞w
тар	tɑr
тараҡ	tɑrɑq
тараҡан	tɑrɑqɑn
тараф	tɑrɑf
тарафынан	tɑrɑfɯ̞nɑn
тарихи	tärʲiχïi
тарма	tɑrmɑ
тармаҡ	tɑrmɑq
тартма	tɑrtmɑ
тартынҡы	tartɯ̞ŋqɯ̞
тары	tɑrɯ̞
таҫма	tɑθmɑ
таҫтамал	tɑθtɑmɑɫ
татыу	tɑtɯ̞w
татыулыҡ	tɑtɯ̞wɫɯ̞q
тауар	tɑwɑr
тауис	täwïs
тауыҡ	tɑwɯ̞q
тауыш	tɑwɯ̞ʂ
таһир	tähïr
таш	tɑʂ
ташбаш	tɑʂbɑʂ
ташҡын	tɑʂqɯ̞n
ташлама	tɑʂɫɑmɑ
таяҡ	tɑjɑq
тәбиғәт	tæβiʁæt
тәбиғи	tæβiʁïi
тәгәрмәс	tægærmæs
тәғлимәт	tæʁlʲimæt
тәҙрә	tæðræ
тәжрибә	tæʒrʲibæ
тәкә	tækæ
тәкәббер	tækæbːɪ̞r
тәҡдим	tæqdʲim
тәҡдир	tæqdʲir
тәлғәт	tælʁæt
тәм	tæm
тәмәке	tæmækɪ̞
тәмле	tæmlɪ̞
тәмһеҙ	tæmhɪ̞ð
тәнәфес	tænæfɪ̞s
тәнҡит	tæŋqit
тәңкә	tæŋkæ
тәңре	tæŋrɪ̞
тәпәш	tæpæʃ
тәпке	tæpkɪ̞
тәрән	tæræn
тәрбиә	tærbʲiʲæ
тәре	tæɾɪ̞
тәржемә	tærʒɪ̞mæ
тәржемәсе	tærʒɪ̞mæsɪ̞
тәрилкә	tærʲilkæ
тәртешкә	tærtɪ̞ʃkæ
тәртип	tærtʲip
тәсбих	tæsbʲiχ
тәте	tætɪ̞
тәү	tæw
тәүге	tæwgɪ̞
тәүҙә	tæwðæ
тәүлек	tæwlɪ̞k
тәүтормош	tæwtʊ̞rmʊ̞ʂ
тәхет	tæχɪ̞t
тәһәрәт	tæhæɾæt
театр	tʲiätər
театр	tʲiätrɯ̞
тегенсе	tɪ̞gɪ̞nsɪ̞
тейен	tɪ̞jɪ̞n
тейеш	tɪ̞jɪ̞ʃ
текә	tɪ̞kæ
тел	tɪ̞l
теләк	tɪ̞læk
телевизор	tʲilʲivʲizɯ̞r
телефон	tʲilʲifo̞n
телмәр	tɪ̞lmær
терәк	tɪ̞ræk
тере	tɪ̞rɪ̞
терегөмөш	tɪ̞rɪ̞gʏ̞mʏ̞ʃ
тереклек	tɪ̞rɪ̞klɪ̞k
теркәүес	tɪ̞rkæwɪ̞s
терпе	tɪ̞rpɪ̞
терһәк	tɪ̞rhæk
теүәл	tɪ̞wæl
теш	tɪ̞ʃ
тибет	tʲibʲe̞t
тигән	tʲigæn
тигеҙ	tʲigɪ̞ð
тиҙ	tʲeð
тиҙәк	tʲiðæk
тиҙлек	tʲeðlɪ̞k
тимәк	tʲimæk
тимер	tʲimɪ̞r
тимерсыбыҡ	tʲimɪ̞rsɯ̞βɯ̞q
тин	tʲen
тиң	tʲeŋ
тир	tʲir
тирәк	tʲiræk
тире	tʲirɪ̞
тиреҫ	tʲirɪ̞θ
тирмә	tʲirmæ
тирмән	tʲirmæn
тирмәнсе	tʲirmænsɪ̞
тиҫбе	tʲeθbɪ̞
тиҫтә	tiθtæ
тиҫтер	tʲiθtɪ̞r
тишек	tʲiʃɪ̞k
тоғро	tʊ̞ʁɾʊ̞
тоҙ	tʊ̞ð
тоҙаҡ	tʊ̞ðɑq
тойғо	tʊ̞jʁʊ̞
тоҡ	tʊ̞q
тоҡом	tʊ̞qʊ̞m
тоҡор	tʊ̞qʊ̞r
тоҡсай	tʊ̞qsɑj
тол	tʊ̞ɫ
толом	tʊ̞ɫʊ̞m
толпар	tʊɫpɑr
томан	tʊ̞mɑn
томбойоҡ	tʊ̞mbʊ̞jʊ̞q
торлаҡ	tʊ̞rɫɑq
тормош	tʊ̞rmʊ̞ʂ
тормошсан	tʊ̞rmʊ̞ʂsɑn
торна	tʊ̞rnɑ
торош	tʊ̞rʊ̞ʂ
тотҡа	tʊ̞tqɑ
тояҡ	tʊ̞jɑq
төбәк	tʏ̞βæk
төҙ	tʏ̞ð
төҙөүсе	tʏ̞ðʏ̞wsɪ̞ᵝ
төймә	tʏ̞jmæ
төйөн	tʏ̞jʏ̞n
төкөрөк	tʏ̞kʏ̞rʏ̞k
төлкө	tʏ̞lkʏ̞
төмән	tʏ̞mæn
төн	tʏ̞n
төнәтмә	tʏ̞nætmæ
төндөк	tʏ̞ndʏ̞k
төньяҡ	tʏ̞njɑq
төп	tʏ̞p
төр	tʏ̞r
төрҙө	tʏ̞rðʏ̞
төркиә	tʏ̞rkʲiʲæ
төркөм	tʏ̞rkʏ̞m
төрлө	tʏ̞rlʏ̞
төрмә	tʏ̞rmæ
төрөк	tʏ̞rʏ̞k
төрөкмәнстан	tʏ̞rʏ̞kmænstän
төрткө	tʏ̞rtkʏ̞
төҫ	tʏ̞θ
төтөн	tʏ̞tʏ̞n
төш	tʏ̞ʃ
төшөнсә	tʏ̞ʃʏ̞nsæ
төшөрөү	tʏ̞ʃʏ̞r
төшөрөү	tʏ̞ʃʏ̞ɾ
тубыҡ	tuβɯ̞q
тубырсыҡ	tuβɯ̞rsɯ̞q
туғай	tuʁɑj
туғыҙ	tuʁɯ̞ð
туҙ	tuð
туҙан	tuðɑn
туй	tuj
туҡ	tuq
туҡал	tuqɑɫ
туҡталыш	tuqtɑɫɯ̞ʂ
туҡыма	tuqɯ̞mɑ
тулҡын	tuɫqɯ̞n
тулы	tuɫɯ̞
тумыртҡа	tumɯ̞rtqɑ
тун	tun
туң	tuŋ
туңдырма	tuŋdɯ̞rmɑ
туп	tʊp
тупраҡ	tuprɑq
тупһа	tuphɑ
тура	toɾɑ
тураһында	turɑhɯ̞ndɑ
турғай	turʁɑj
тут	tot
тутыйғош	tutɯ̞jʁʊ̞ʂ
туфан	tufɑn
түбән	tʏbæn
түбән	tʏβæn
түгел	tɵgɪ̞l
түҙемлек	tʏðɪ̞mlɪ̞k
түләүле	tʏlæwlɪ̞
түңәрәк	tʏŋæræk
түр	tʏr
түрә	tʏræ
түтәл	tɵtæl
түш	tʏʃ
түшәм	tʏʃæm
тығыҙ	tɯ̞ʁɯ̞ð
тыҡрыҡ	tɯ̞qrɯ̞q
тылсым	tɯ̞ɫsɯ̞m
тылсымлы	tɯ̞ɫsɯ̞mɫɯ̞
тылсымсы	tɯ̞ɫsɯ̞msɯ̞
тымау	tɯ̞mɑw
тынсыу	tɯ̞nsɯ̞w
тыныс	tɯ̞nɯ̞s
тыныслыҡ	tɯnɯ̞sɫɯ̞q
тырма	tɯ̞rmɑ
тырнаҡ	tɯ̞rnɑq
тырыш	tɯ̞rɯ̞ʂ
тышау	tɯ̞ʂɑw
уға	uʁɑ
уғры	u̞ʁrɯ̞
ужым	uʐɯ̞m
уй	oj
уймаҡ	ujmɑq
уйылдан	ujɯ̞ɫdɑn
уйын	ujɯ̞n
уйынсыҡ	ujɯ̞nsɯ̞q
украина	ukraina
уҡ	uq
уҡлау	uqɫɑw
уҡсы	uqsɯ̞
уҡытыусы	uqɯ̞tɯ̞wsɯ̞
уҡыусы	uqɯ̞wsɯ̞
ул	oɫ
улар	uɫɑr
ултырғыс	uɫtɯ̞rʁɯ̞s
ултырғыс	utɯ̞rʁɯ̞s
умарта	umɑrtɑ
умырзая	umɯ̞rzɑjɑ
ун	un
унан	unɑn
унау	unaw
унда	undɑ
уны	unɯ̞
уның	unɯ̞ŋ
уң	uŋ
уңайҙы	uŋɑjðɯ̞
уңайлы	uŋɑjɫɯ̞
уңыш	uŋɯ̞ʂ
упҡын	upqɯ̞n
ураҡ	urɑq
урал	oɾɑɫ
урам	oɾɑm
урман	urmɑn
урта	urtɑ
уртаҡ	urtɑq
уртаса	urtɑsɑ
урын	urɯ̞n
урынбаҫар	urɯ̞nbɑθɑr
урынлы	urɯ̞nɫɯ̞
урыҫ	urɯ̞θ
ус	us
усаҡ	usɑq
уҫаҡ	uθɑq
уҫал	uθɑɫ
ут	ot
утҡойроҡ	utqʊ̞jrʊ̞q
утрау	utrɑw
утын	utɯ̞n
үгәй	ʏgæj
үгеҙ	ʏgɪ̞ð
үҙ	ʏð
үҙаң	ʏðäŋ
үҙаң	ʏðʔäŋ
үҙәк	ʏðæk
үҙгәреш	ʏðgærɪ̞ʃ
үзбәк	ʏzbæk
үзбәкстан	ʏzbækstɑn
үксә	ʏksæ
үләкһә	ʏlækhæ
үлән	ʏlæn
үлем	ɵlɪ̞m
үлсәү	ʏlsæw
үпкә	ɵpkæ
үрге	ʏrgɪ̞
үрҙәк	ʏrðæk
үркәс	ʏrkæs
үрмәксе	ʏrmæksɪ̞
үрнәк	ʏrnæk
үрт	ʏrt
үс	ʏs
үҫемлек	ʏθɪ̞mlɪ̞k
үҫенте	ʏθɪ̞ntɪ̞
үҫеш	ʏθɪ̞ʃ
үҫмер	ɵθmɪ̞ɾ
үт	ʏt
үтек	ʏtɪ̞k
үткән	ʏtkæn
үткер	ɵtkɪ̞ɾ
үтмәҫ	ʏtkɪ̞r
фажиғә	faʑiʁæ
фажиғә	faʒïʁæ
файҙа	fɑjðɑ
фарман	fɑrmɑn
фатима	fätʲi̠mä
фатир	fätʲïr
фатиха	fätʲïχä
фәлән	fælæn
фәлсәфә	fælsæfæ
фәлсәфәүи	fælsæfæwi
фән	fæn
фәрештә	færɪ̞ʃtæ
фәриҙә	færʲiðæ
фәрит	færʲit
фекер	fɪ̞kɪ̞ɾ
фил	fʲil̠
филтә	fʲiltæ
фирғәүен	fʲiɾʁæwɪ̞n
форсат	fʊ̞rsɑt
хаж	χɑʐ
хазина	χäzʲïnä
хаким	χäkʲi̠m
хаҡ	χɑq
хаҡына	χɑqɯ̞nɑ
хаҡында	χɑqɯ̞ndɑ
халыҡ	χɑɫɯ̞q
ханым	χɑnɯ̞m
хас	χäs
хас	χɑs
хата	χɑtɑ
хатта	χɑtːɑ
хәбәр	χæβær
хәбәрсе	χæβærsɪ̞
хәҙер	χæðɪ̞r
хәйер	χæjɪ̞r
хәйерсе	χæjɪ̞rsɪ̞
хәҡиҡәт	χæqɨ̯iqæt
хәл	χæl
хәмзә	χæmzæ
хәрәкәт	χærækæt
хәрби	χærbʲi
хәрби	χærbʲij
хәреф	χærɪ̞f
хәсән	χæsæn
хәтер	χætɪ̞r
хеҙмәт	χɪ̞ðmæt
хикәйә	χɨ̯ikæjæ
хис	χɨ̯is
хисап	iθæp
хоҙай	χʊ̞ðɑj
хоҡуҡ	χʊ̞quq
хөкүмәт	χʏ̞kumæt
хөрәфәт	χʏ̞ræfæt
хөрмәт	χʏ̞rmæt
хөрмәтенә	χʏ̞rmætɪ̞næ
хөсәйен	χʏ̞sæjɪ̞n
хужа	χuʐɑ
хужабикә	χoʐɑbʲekæ
хужалыҡ	χuʐɑɫɯ̞q
хуш	χuʂ
хыял	χɯ̞jɑɫ
һабаҡ	hɑβɑq
һабын	hɑβɯ̞n
һағаҡ	hɑʁɑq
һағыҙ	hɑʁɯ̞ð
һағыҙаҡ	hɑʁɯ̞ðɑq
һаҙ	hɑð
һаҙағай	hɑðɑʁɑj
һаҙаҡ	hɑðɑq
һай	hɑj
һайыҫҡан	hɑjɯ̞θqɑn
һаҡ	hɑq
һаҡал	hɑqɑɫ
һаҡау	hɑqɑw
һаҡсы	hɑqsɯ̞
һал	hɑɫ
һалам	hɑɫɑm
һалдат	hɑɫdɑt
һалҡын	haɫqɯ̞n
һалмауыр	hɑɫmɑwɯ̞r
һалым	hɑɫɯ̞m
һалыу	hɑɫɯ̞w
һаман	hɑmɑn
һамар	hɑmɑr
һан	hɑn
һандуғас	hɑnduʁɑs
һандыҡ	hɑndɯ̞q
һаңғырау	hɑŋɢɯ̞rɑw
һарай	hɑrɑj
һаралйын	hɑɾɑɫjɯ̞n
һаран	hɑrɑn
һары	hɑɾɯ̞
һарығош	hɑrɯ̞ʁʊ̞ʂ
һарыҡ	hɑrɯ̞q
һарымһаҡ	hɑrɯ̞mhɑq
һарытау	hɑrɯ̞tɑw
һаҫыҡ	hɑθɯ̞q
һатыусы	hɑtɯ̞wsɯ̞
һау	hɑw
һауа	hɑwɑ
һауа	hɑwɑ
һауап	hɑwɑp
һаулыҡ	hɑwɫɯ̞q
һауынсы	hɑwɯ̞nsɯ̞
һауыт	hɑwɯ̞t
һәйбәт	hæjβæt
һәйкәл	hæjkæl
һәләт	hælæt
һәм	hæm
һәнәк	hænæk
һәр	hær
һәүәҫкәр	hæwæθkær
һеҙ	hɪ̞ð
һеҙ	ɦɪ̞ð
һеҙгә	hɪ̞ðgæ
һеҙҙә	hɪ̞ðːæ
һеҙҙән	hɪ̞ðːæn
һеҙҙе	hɪ̞ðːɪ̞
һеҙҙең	hɪ̞ðːɪ̞ŋ
һейҙек	hɪ̞jðɪ̞k
һеләгәй	hɪ̞lægæj
һеләүһен	hɪ̞læwhɪ̞n
һемәк	hɪ̞mæk
һепертке	hɪ̞pɪ̞rtkɪ̞
һеркә	hɪ̞rkæ
һигеҙ	higɪ̞ð
һигеҙ	hiɣɪ̞ð
һигеҙгүҙ	higɪ̞ðgʏð
һике	hikɪ̞
һимеҙ	hemɪ̞ð
һин	hʲen
һинән	hinæn
һинд	hʲend
һиндә	hindæ
һине	hinɪ̞
һинең	hinɪ̞ŋ
һиңә	hiŋæ
һипкел	hipkɪ̞l
һиптергес	hiptɪ̞rgɪ̞s
һирәк	heɾæk
һоло	hʊ̞ɫʊ̞
һорау	hʊ̞rɑw
һоро	hʊ̞ɾʊ̞
һоҫҡо	hʊ̞θqʊ̞
һөҙәк	hʏ̞ðɶ̟k
һөҙөмтә	hʏ̞ðʏ̞mtœ̟
һөҙһөт	hʏ̞ðhʏ̞t
һөжүм	hʏ̞ʒʏm
һөйәк	hʏ̞jæk
һөйәл	hʏ̞jæl
һөйкәлеш	hʏ̞jkælɪ̞ʃ
һөйләм	hʏ̞jlæm
һөйөнсө	hʏ̞jʏ̞nsʏ̞
һөйөү	hʏ̞jʏ̞w
һөлдә	hʏ̞ldæ̹
һөлөк	hʏ̞lʏ̞k
һөнәр	hʏ̞nær
һөңгө	hʏ̞ŋgʏ̞
һөргөн	hʏ̞rgʏ̞n
һөт	hʏ̞t
һуған	huʁɑn
һуғыш	huɢ̞ɯ̞ʂ
һуҙынҡы	huðɯ̞ŋqɯ̞
һуҡмаҡ	huqmɑq
һуҡыр	huqɯ̞r
һул	huɫ
һулаҡай	huɫɑqɑj
һум	hom
һунар	hunɑr
һунарсы	hunɑrsɯ̞
һуңғы	huŋɢɯ̞
һупайҙы	hopɑjðɯ̞
һупылдаҡ	hopɯ̞ɫdɑq
һурпа	hurpɑ
һүҙ	hʏð
һүҙлек	hʏðlɪ̞k
һүрәт	hʏræt
һыҙат	hɯ̞ðɑt
һыҙыҡ	hɯ̞ðɯ̞q
һыҙыҡса	hɯ̞ðɯ̞qsɑ
һыйыр	hɯ̞jɯ̞r
һылтанма	hɯɫtɑnmɑ
һылыу	hɯ̞ɫɯ̞w
һыра	hɯ̞rɑ
һырға	hɯ̞rʁɑ
һыртлан	hɯ̞rtɫɑn
һыу	hɯ̞w
һыуғояр	hɯ̞wʁʊ̞jɑr
һыуһар	hɯ̞whɑr
һыуыҡ	hɯ̞wɯ̞q
һыуыр	hɯ̞wɯ̞r
һыуытҡыс	hɯ̞wɯ̞tqɯ̞s
шағир	ʂäʁɪɾ
шағирә	ʂäʁi̠ræ
шайтан	ʂɑjtɑn
шайыҡ	ʂɑjɯ̞q
шаҡмаҡ	ʂɑqmɑq
шалҡан	ʂɑɫqɑn
шама	ʂɑmɑ
шарап	ʂɑrɑp
шарлауыҡ	ʂɑrɫɑwɯ̞q
шарт	ʂɑrt
шаршамбы	ʂɑrʂɑmbɯ̞
шаршау	ʂɑrʂɑw
шат	ʂɑt
шаһит	ʂɑhït
шаян	ʂɑjɑn
шәжәрә	ʃæʒæræ
шәкәр	ʃækær
шәкерт	ʃækɪ̞ɾt
шәл	ʃæl
шәм	ʃæm
шәмбе	ʃæmbɪ̞
шәп	ʃæp
шәрә	ʃæræ
шәрәлек	ʃærælɪ̞k
шәреҡ	ʂærɪ̞q
шәриғәт	ʃæɾʲiʁæt
шәүрә	ʃæwræ
шәхес	ʃæχɪ̞s
шәхсән	ʃæχsæn
шәхси	ʃæχsʲi
шәшке	ʃæʃkɪ̞
шеләгәй	ʃɪ̞lægæj
шешә	ʃɪ̞ʃæ
шиғри	ɕeʁɾɪj
шиғриәт	ɕiʁriʲæt
шиғыр	ɕeʁɯ̞ɾ
шиғыр	ʃeʁɯ̞ɾ
шик	ɕik
шик	ʃik
шифа	ɕifä
шифа	ʃifä
шифахана	ʃifäχänä
шифахана	ʃifɑχɑnɑ
шишә	ɕiʃæ
шишәмбе	ɕeʃæmbɪ̞
шишәмбе	ʃeʃæmbɪ̞
шишмә	ʃiʃmæ
шоңҡар	ʂʊ̞ŋqɑr
шөғөл	ʃʏ̞ʁʏ̞l
штат	ʂtɑt
шул	ʃuɫ
шур	ʂur
шүлгән	ʃɵlgæn
шыйыҡ	ʂɯ̞jɯ̞q
шым	ʂɯ̞m
шыма	ʂɯ̞mɑ
шына	ʂɯ̞nɑ
шырау	ʂɯ̞rɑw
шырпы	ʂɯ̞rpɯ̞
шыршы	ʂɯ̞rʂɯ̞
ылаҡ	ɯ̞ɫɑq
ыласын	ɯ̞ɫɑsɯ̞n
ым	ɯ̞m
ымлыҡ	ɯ̞mɫɯ̞q
ынйы	ɯ̞njɯ̞
ынтылыш	ɯ̞ntɯ̞ɫɯ̞ʂ
ыңғай	ɯ̞ŋɢɑj
ырғаҡ	ɯ̞rɢɑq
ырғаҡ	ɯ̞rʁɑq
ырым	ɯ̞rɯ̞m
ырымбур	ɯ̞rɯ̞mbur
ырыу	ɯ̞rɯ̞w
ысул	ɯ̞suɫ
ысыҡ	ɯ̞sɯ̞q
ысын	ɯ̞sɯ̞n
ысынбарлыҡ	ɯ̞sɯ̞nbɑrɫɯ̞q
ыуыҙ	ɯ̞wɯ̞ð
ыуылдырыҡ	ɯ̞wɯ̞ɫdɯ̞rɯ̞q
ышаныс	ɯ̞ʂɑnɯ̞s
ышаныслы	ɯ̞ʂɑnɯ̞sɫɯ̞
эҙ	ɪ̞ð
эйә	ɪ̞jæ
эйәк	ɪ̞jæk
эйәр	ɪ̞jær
эйе	ɪ̞jɪ̞
элек	ɪ̞lɪ̞k
энә	ɪ̞næ
эне	ɪ̞nɪ̞
эңер	ɪ̞ŋɪ̞r
эре	ɪ̞rɪ
эремсек	i̞ri̞msi̞k
эрен	ɪ̞rɪ̞n
эсәк	ɪ̞sæk
эсемлек	ɪ̞sɪ̞mlɪ̞k
эскәмйә	ɪ̞skæmjæ
эскесе	ɪ̞skɪ̞sɪ̞
эстәлек	ɪ̞stælɪ̞k
эҫе	ɪ̞θɪ̞
эт	ɪ̞t
этморон	ɪ̞tmʊ̞rʊ̞n
эш	ɪ̞ʃ
эшҡыуар	ɪ̞ʃqɯ̞wɑr
эшҡыуарлыҡ	ɪ̞ʃqɯ̞wɑrɫɯ̞q
эшләпә	ɪ̞ʃlæpæ
эшмәкәр	ɪ̞ʃmækær
эшсе	ɪ̞ʃsɪ̞
юғары	juʁɑrɯ̞
юйғыс	jujʁɯ̞s
юҡ	juq
юл	joɫ
юлай	juɫɑj
юлбарыҫ	juɫbɑrɯ̞θ
юлбаҫар	joɫbɑθɑr
юлбашсы	joɫbɑʂsɯ̞
юлдаш	joɫdɑʂ
юрға	jurʁɑ
юрған	jurʁɑn
ябай	jɑβɑj
ябыҡ	jɑβɯ̞q
яға	jɑʁɑ
яғалбай	jɑʁɑɫbɑj
яғыулыҡ	jɑʁɯ̞wɫɯ̞q
яҙ	jɑð
яҙма	jɑðmɑ
яҙмыш	jɑðmɯ̞ʂ
яҙыҡ	jɑðɯ̞q
яҙылыусы	jɑðɯ̞ɫɯ̞wsɯ̞
яҙыусы	jɑðɯ̞wsɯ̞
яй	jɑj
яҡ	jɑq
яҡа	jɑqɑ
яҡты	jɑqtɯ̞
яҡуп	jɑqʊp
яҡшы	jɑqʂɯ̞
яҡшылап	jɑqʂɯ̞ɫɑp
яҡын	jɑqɯ̞n
ял	jɑɫ
ялағай	jɑɫɑʁɑj
ялан	jɑɫɑn
яланғас	jɑɫɑŋɢɑs
ялбыр	jɑɫβɯ̞r
ялған	jɑɫʁɑn
ялҡау	jɑɫqɑw
ялҡаулыҡ	jɑɫqɑwɫɯ̞q
ялҡын	jɑɫqɯ̞n
ялтыр	jɑɫtɯ̞r
ялыу	jɑɫɯ̞w
яман	jɑmɑn
ямау	jɑmɑw
ямғыр	jɑmʁɯ̞r
янғын	jɑnʁɯ̞n
янғын	jɑŋɢɯ̞n
янсыҡ	jɑnsɯ̞q
яңаҡ	jɑŋɑq
яңғыҙ	jɑŋɢɯ̞ð
яңы	jɑŋɯ̞
яңылыҡ	jɑŋɯ̞ɫɯ̞q
яңылыш	jɑŋɯ̞ɫɯ̞ʂ
яңынан	jɑŋɯ̞nɑn
япония	jäpo̞nʲijä
япраҡ	jɑprɑq
яр	jɑr
яра	jɑrɑ
ярай	jɑrɑj
ярамай	jɑrɑmɑj
ярар	jɑrɑr
ярғанат	jɑrʁɑnɑt
ярҙам	jɑrðɑm
ярҙамсы	jɑrðɑmsɯ̞
ярлы	jɑrɫɯ̞
ярма	jɑrmɑ
ярсыҡ	jɑrsɯ̞q
ярты	jɑrtɯ̞
яры	jɑrɯ̞
ярыҡ	jɑrɯ̞q
ярым	jɑrɯ̞m
ярымутрау	jɑrɯ̞mutrɑw
ярыш	jɑrɯ̞ʂ
яҫмыҡ	jɑθmɯ̞q
ят	jɑt
яуап	jɑwɑp
яуаплы	jɑwɑpɫɯ̞
яуаплылыҡ	jɑwɑpɫɯ̞ɫɯ̞q
яулыҡ	jɑwɫɯ̞q
яурын	jɑwrɯ̞n
яхин	jäxʲin
яхъя	jɑχjɑ
