a	a
aba	aβ̞a
ababor	aβ̞aβ̞or
abade	aβ̞að̞e
abadegai	aβ̞að̞eɣ̞ai̯
abadegintza	aβ̞að̞eɣ̞ĩnts̻a
abadeki	aβ̞að̞eki
abadesa	aβ̞að̞es̺a
abadetar	aβ̞að̞et̪ar
abadetasun	aβ̞að̞et̪as̺ũn
abadetu	aβ̞að̞et̪u
abadetza	aβ̞að̞ets̻a
abadia	aβ̞að̞ia
abadiano	aβ̞að̞iano
abadot	aβ̞að̞ot̪
abagune	aβ̞aɣ̞une
abaila	aβ̞ai̯la
abaila	aβ̞aʎa
abail	aβ̞ai̯l
abaildu	aβ̞ai̯l̪d̪u
abaildura	aβ̞ai̯l̪d̪uɾa
abakando	aβ̞akãn̪d̪o
abako	aβ̞ako
abalatu	aβ̞alat̪u
abal	aβ̞al
abaldun	aβ̞al̪d̪ũn
abalkide	aβ̞alkið̞e
abandonatu	aβ̞ãn̪d̪onat̪u
abandonu	aβ̞ãn̪d̪o̞nu
abangoardia	aβ̞ãŋɡo̞arð̞ia
abangoardismo	aβ̞aŋɡoarð̞iz̺mo
abangoardista	aβ̞aŋɡoarð̞is̺t̪a
abantada	aβ̞ãn̪t̪að̞a
abantaila	aβ̞ãn̪t̪ai̯la
abantaila	aβ̞ãn̪t̪aʎa
abantailatsu	aβ̞ãn̪t̪ai̯lats̺u
abantailatsu	aβ̞ãn̪t̪aʎats̺u
abantailatsu	aβ̞ãn̪t̪aʎats̻u
abantailatu	aβ̞ãn̪t̪ai̯lat̪u
abantailatu	aβ̞ãn̪t̪aʎat̪u
abantailatuki	aβ̞ãn̪t̪ai̯lat̪uki
abantailatuki	aβ̞ãn̪t̪aʎat̪uki
abantailos	aβ̞ãn̪t̪ai̯los̺
abantailos	aβ̞ãn̪t̪aʎos̺
abantailoski	aβ̞ãn̪t̪ai̯los̺ki
abantailoski	aβ̞ãn̪t̪aʎos̺ki
abantari	aβ̞ãn̪t̪aɾi
abant	aβ̞ãn̪t̪
abantean	aβ̞ãn̪t̪eãn
abantzamendu	aβ̞ãnts̻amẽn̪d̪u
abantzatu	aβ̞ãnts̻at̪u
abantzu	aβ̞ãnts̻u
abantzuño	aβ̞ãnts̻uɲo
abao	aβ̞ao̞
abaraska	aβ̞aɾas̺ka
abar	aβ̞ar
abaritz	aβ̞aɾits̻
abarizia	aβ̞aɾis̺ia
abarizia	aβ̞aɾis̻ia
abarizti	aβ̞aɾis̺t̪i
abarizti	aβ̞aɾis̻t̪i
abarka	aβ̞arka
abarkadun	aβ̞arkað̞ũn
abarkagile	aβ̞arkaɣ̞ile
abarkagile	aβ̞arkaɣ̞iʎe
abarkagin	aβ̞arkaɣ̞ĩn
abarkagintza	aβ̞arkaɣ̞ĩnts̻a
abarkari	aβ̞arkaɾi
abarketa	aβ̞arket̪a
abarketari	aβ̞arket̪aɾi
abaro	aβ̞aɾo
abarotsu	aβ̞aɾots̺u
abarotsu	aβ̞aɾots̻u
abarrakitu	aβ̞arakit̪u
abarreria	aβ̞areɾia
abarreztatu	aβ̞ares̺t̪at̪u
abarreztatu	aβ̞ares̻t̪at̪u
abarrots	aβ̞arots̺
abarrots	aβ̞arots̻
abartegi	aβ̞art̪eɣ̞i
abartsu	aβ̞arts̺u
abartsu	aβ̞arts̻u
abartu	aβ̞art̪u
abata	aβ̞at̪a
abatari	aβ̞at̪aɾi
abatz	aβ̞ats̻
abdikatu	aβ̞ð̞ikat̪u
abdikazio	aβ̞ð̞ikas̺io
abdikazio	aβ̞ð̞ikas̻io
abdomen	aβ̞ð̞omẽn
abdukzio	aβ̞ð̞uks̺io
abdukzio	aβ̞ð̞uks̻io
abegi	aβ̞eɣ̞i
abegikor	aβ̞eɣ̞ikor
abegitsu	aβ̞eɣ̞its̺u
abegitsu	aβ̞eɣ̞its̻u
abelazkuntza	aβ̞elas̺kũnts̻a
abelazkuntza	aβ̞elas̻kũnts̻a
abelbide	aβ̞elβ̞ið̞e
abelburu	aβ̞elβ̞uɾu
abeldar	aβ̞el̪d̪ar
abeldun	aβ̞el̪d̪ũn
abeletxe	aβ̞eletʃe
abelgorri	aβ̞elɣ̞ori
abelgorriki	aβ̞elɣ̞oriki
abeltegi	aβ̞el̪t̪eɣ̞i
abeltzainak	aβ̞elts̻ai̯nak
abeltzainak	aβ̞elts̻aɲak
abeltzain	aβ̞elts̻ãĩ̯n
abeltzaini	aβ̞elts̻ai̯ni
abeltzaini	aβ̞elts̻aɲi
abeltzainik	aβ̞elts̻ai̯nik
abeltzainik	aβ̞elts̻aɲik
abeltzaintza	aβ̞elts̻ãĩ̯nts̻a
abemaria	aβ̞emaɾia
abemarietako	aβ̞emaɾiet̪ako
abendualdi	aβ̞ẽn̪d̪ual̪d̪i
abendu	aβ̞ẽn̪d̪u
abenka	aβ̞eŋka
abentura	aβ̞ẽn̪t̪uɾa
abenturazale	aβ̞ẽn̪t̪uɾas̺ale
abenturazale	aβ̞ẽn̪t̪uɾas̻ale
aberasbide	aβ̞eɾaz̺β̞ið̞e
aberasgarri	aβ̞eɾaz̺ɣ̞ari
aberaskeria	aβ̞eɾas̺keɾia
aberasketa	aβ̞eɾas̺ket̪a
aberaski	aβ̞eɾas̺ki
aberaskume	aβ̞eɾas̺kume
aberastasun	aβ̞eɾas̺t̪as̺ũn
aberaste	aβ̞eɾas̺t̪e
aberastu	aβ̞eɾas̺t̪u
aberats	aβ̞eɾats̺
aberats	aβ̞eɾats̻
abere	aβ̞eɾe
aberekeria	aβ̞eɾekeɾia
abereki	aβ̞eɾeki
aberekoi	aβ̞eɾekoi̯
aberetasun	aβ̞eɾet̪as̺ũn
aberetiar	aβ̞eɾet̪iar
aberetu	aβ̞eɾet̪u
aberetzar	aβ̞eɾets̻ar
aberezale	aβ̞eɾes̺ale
aberezale	aβ̞eɾes̻ale
aberezko	aβ̞eɾes̺ko
aberezko	aβ̞eɾes̻ko
aberrazio	aβ̞e̞ras̻io̞
aberri	aβ̞eri
aberrigabe	aβ̞eriɣ̞aβ̞e
aberriratu	aβ̞eriɾat̪u
abertzale	aβ̞erts̻ale
abertzalego	aβ̞erts̻aleɣ̞o
abertzalekeria	aβ̞erts̻alekeɾia
abertzaletasun	aβ̞erts̻alet̪as̺ũn
abertzaletu	aβ̞e̞rts̻ale̞t̪u
abes	aβ̞es̺
abesbatza	aβ̞e̞z̺β̞ats̻a
abeslari	aβ̞ez̺laɾi
abestalde	aβ̞es̺t̪al̪d̪e
abestaldi	aβ̞es̺t̪al̪d̪i
abeste	aβ̞es̺t̪e
abesten	aβ̞es̺t̪ẽn
abesti	aβ̞es̺t̪i
abestu	aβ̞es̺t̪u
abestuko	aβ̞es̺t̪uko
abia	aβ̞ia
abiaburu	aβ̞iaβ̞uɾu
abiada	aβ̞iað̞a
abiadan	aβ̞iað̞ãn
abiadura	aβ̞iað̞uɾa
abiagailu	aβ̞iaɣ̞ai̯lu
abiagailu	aβ̞iaɣ̞aʎu
abiagune	aβ̞iaɣ̞une
abialdi	aβ̞ial̪d̪i
abiamen	aβ̞iamẽn
abian	aβ̞iãn
abiapuntu	aβ̞iapũn̪t̪u
abiarazi	aβ̞iaɾas̺i
abiarazi	aβ̞iaɾas̻i
abiarazle	aβ̞iaɾaz̺le
abiarazle	aβ̞iaɾaz̻le
abiasari	aβ̞ias̺aɾi
abiatu	aβ̞iat̪u
abiatzaile	aβ̞iats̻ai̯le
abiatzaile	aβ̞iats̻aʎe
abiazio	aβ̞ias̻io̞
abil	aβ̞il
abildu	aβ̞il̪d̪u
abilezia	aβ̞ile̞s̻ia
abilidade	aβ̞ilið̞að̞e
abilki	aβ̞ilki
abiltasun	aβ̞il̪t̪as̺ũn
abio	aβ̞io̞
abioneta	aβ̞io̞ne̞t̪a
abisal	aβ̞is̺al
abisatu	aβ̞is̺at̪u
abisu	aβ̞is̺u
abitu	aβ̞it̪u
abixoi	aβ̞iʃoi̯
abizari	aβ̞is̺aɾi
abizari	aβ̞is̻aɾi
abizen	aβ̞is̻ẽ̞n
abkhazera	aβ̞kas̻eɾa
abkhazera	aβ̞xas̺eɾa
abkhazera	aβ̞xas̻eɾa
abkhazia	aβ̞kas̻ia
abkhazia	aβ̞xas̺ia
abkhazia	aβ̞xas̻ia
abkhaziar	aβ̞xas̻iar
abkhaziera	aβ̞kas̻ieɾa
abkhaziera	aβ̞xas̺ieɾa
abkhaziera	aβ̞xas̻ieɾa
ablatibo	aβ̞lat̪iβ̞o
ablazio	aβ̞las̻io̞
aboatu	aβ̞oat̪u
aboitiz	aβ̞o̞i̯t̪is̻
abokatu	aβ̞o̞kat̪u
abokatuk	aβ̞okat̪uk
abokaturik	aβ̞okat̪uɾik
abokatutza	aβ̞okat̪uts̻a
abolitu	aβ̞olit̪u
abolizio	aβ̞o̞lis̻io̞
abolizionismo	aβ̞o̞lis̻io̞niz̺mo̞
abolizionista	aβ̞olis̺ionis̺t̪a
abolizionista	aβ̞olis̻ionis̺t̪a
abonamendu	aβ̞onamẽn̪d̪u
abonatu	aβ̞onat̪u
abondo	aβ̞õ̞n̪d̪o̞
abonitu	aβ̞onit̪u
abonu	aβ̞onu
abordatu	aβ̞orð̞at̪u
abordatze	aβ̞orð̞ats̻e
aborigen	aβ̞oɾiɣ̞ẽn
aborin	aβ̞oɾĩn
aborritu	aβ̞orit̪u
abortatu	aβ̞o̞rt̪at̪u
abortatze	aβ̞ort̪ats̻e
abortu	aβ̞o̞rt̪u
abortza	aβ̞orts̻a
abrasio	aβ̞ras̺io̞
abrigo	aβ̞riɣ̞o
abrigu	aβ̞riɣ̞u
abrikot	aβ̞rikot̪
abrikotondo	aβ̞rikot̪õn̪d̪o
abruska	aβ̞rus̺ka
absente	aβ̞s̺ẽn̪t̪e
absentismo	aβ̞s̺ẽ̞n̪t̪iz̺mo̞
absentzia	aβ̞s̺ẽnts̻ia
abside	aβ̞s̺ið̞e
absolbitu	aβ̞s̺o̞lβ̞it̪u
absolutibo	aβ̞s̺o̞lut̪iβ̞o̞
absolutismo	aβ̞s̺olut̪iz̺mo
absolutista	aβ̞s̺o̞lut̪is̺t̪a
absolutu	aβ̞s̺olut̪u
absolutuki	aβ̞s̺olut̪uki
absolututasun	aβ̞s̺olut̪ut̪as̺ũn
absoluzio	aβ̞s̺o̞lus̻io̞
absorbatu	aβ̞s̺o̞rβ̞at̪u
absortzio	aβ̞s̺o̞rts̻io̞
abstenitu	aβ̞s̺t̪e̞nit̪u
abstentzio	aβ̞s̺t̪ẽ̞nts̻io̞
abstinentzia	aβ̞s̺t̪inẽ̞nts̻ia
abstinentzia	aβ̞s̺t̪iɲẽ̞nts̻ia
abstraitu	aβ̞s̺t̪rai̯t̪u
abstraktu	aβ̞s̺t̪rakt̪u
abstrakzio	aβ̞s̺t̪raks̺io
abstrakzio	aβ̞s̺t̪raks̻io
absurdo	aβ̞s̺urð̞o
abu	aβ̞u
abundi	aβ̞ũn̪d̪i
abundio	aβ̞ũn̪d̪jo̞
aburna	aβ̞urna
aburu	aβ̞uɾu
aburukide	aβ̞uɾukið̞e
aburumenka	aβ̞uɾumeŋka
aburuz	aβ̞uɾus̺
aburuz	aβ̞uɾus̻
abusatu	aβ̞us̺at̪u
abusu	aβ̞us̺u
abuztu	aβ̞us̺t̪u
abuztu	aβ̞us̻t̪u
abzesu	aβ̞s̺es̺u
abzesu	aβ̞s̻es̺u
abzisa	aβ̞s̺is̺a
abzisa	aβ̞s̻is̺a
accesit	aks̺es̺it̪
accesit	aks̻es̺it̪
adabaki	að̞aβ̞aki
adabakitu	að̞aβ̞akit̪u
adabatu	að̞aβ̞at̪u
adabegi	að̞aβ̞eɣ̞i
adabegitsu	að̞aβ̞eɣ̞its̺u
adabegitsu	að̞aβ̞eɣ̞its̻u
adabeso	að̞aβ̞es̺o
adaburu	að̞aβ̞uɾu
adaburutu	að̞aβ̞uɾut̪u
adagio	að̞aɣ̞io
adaje	að̞axe
adaje	að̞aʒe
adakera	að̞akeɾa
adaki	að̞aki
adakitu	að̞akit̪u
adaptatu	að̞apt̪at̪u
adar	að̞ar
adarbakar	að̞arβ̞akar
adarbakoitz	að̞arβ̞akoi̯ts̻
adardun	að̞arð̞ũn
adargabe	að̞arɣ̞aβ̞e
adarjotzaile	að̞ardʒots̻aʎe
adarjotzaile	að̞arjots̻aʎe
adarjotzaile	að̞arɟots̻ai̯le
adarjotzaile	að̞arxots̻aʎe
adarjotze	að̞ardʒots̻e
adarjotze	að̞arjots̻e
adarjotze	að̞arɟots̻e
adarjotze	að̞arxots̻e
adarka	að̞arka
adarkada	að̞arkað̞a
adarkadura	að̞arkað̞uɾa
adarkari	að̞arkaɾi
adarkatu	að̞arkat̪u
adarki	að̞arki
adarmotz	að̞armots̻
adaro	að̞aɾo
adarreko	að̞areko
adarrondo	að̞arõn̪d̪o
adarrondotsu	að̞arõn̪d̪ots̺u
adarrondotsu	að̞arõn̪d̪ots̻u
adartsu	að̞arts̺u
adartsu	að̞arts̻u
adartu	að̞art̪u
adarzabal	að̞ars̺aβ̞al
adarzabal	að̞ars̻aβ̞al
adasdun	að̞az̺ð̞ũn
adastu	að̞as̺t̪u
adats	að̞ats̺
adats	að̞ats̻
adausi	að̞au̯s̺i
adausika	að̞au̯s̺ika
adaxka	að̞aʃka
adberbial	að̞β̞erβ̞ial
adberbio	að̞β̞e̞rβ̞io̞
adegi	að̞eɣ̞i
adei	að̞ei̯
adeitasun	að̞ei̯t̪as̺ũn
adeitasunez	að̞ei̯t̪as̺unes̺
adeitasunez	að̞ei̯t̪as̺unes̻
adeitasunezko	að̞ei̯t̪as̺unes̺ko
adeitasunezko	að̞ei̯t̪as̺unes̻ko
adeitsu	að̞ei̯ts̺u
adeitsu	að̞ei̯ts̻u
adeitsuki	að̞ei̯ts̺uki
adeitsuki	að̞ei̯ts̻uki
adelatu	að̞e̞lat̪u
adelazale	að̞e̞las̻ale̞
adelu	að̞elu
adenina	að̞enina
adia	að̞ia
adiabatiko	að̞iaβ̞at̪iko
adi	að̞i
adiagile	að̞iaɣ̞ile
adiagile	að̞iaɣ̞iʎe
adiaka	að̞iaka
adiakari	að̞iakaɾi
adiakatu	að̞iakat̪u
adian	að̞iãn
adibide	að̞iβ̞ið̞e
adibidetegi	að̞iβ̞ið̞et̪eɣ̞i
adibidez	að̞iβ̞ið̞es̺
adibidez	að̞iβ̞ið̞es̻
adiera	að̞ieɾa
adierabakar	að̞ieɾaβ̞akar
adierazezin	að̞ieɾas̺es̺ĩn
adierazezin	að̞ieɾas̻es̻ĩn
adierazgarri	að̞ieɾaz̺ɣ̞ari
adierazgarri	að̞ieɾaz̻ɣ̞ari
adierazgarritasun	að̞ieɾaz̺ɣ̞arit̪as̺ũn
adierazgarritasun	að̞ieɾaz̻ɣ̞arit̪as̺ũn
adierazi	að̞ieɾas̺i
adierazi	að̞ieɾas̻i
adierazkaitz	að̞ieɾas̺kai̯ts̻
adierazkaitz	að̞ieɾas̻kai̯ts̻
adierazkizun	að̞ieɾas̺kis̺ũn
adierazkizun	að̞ieɾas̻kis̻ũn
adierazkor	að̞ieɾas̺kor
adierazkor	að̞ieɾas̻kor
adierazkortasun	að̞ieɾas̺kort̪as̺ũn
adierazkortasun	að̞ieɾas̻kort̪as̺ũn
adierazle	að̞ieɾaz̺le
adierazle	að̞ieɾaz̻le
adierazmolde	að̞ieɾaz̺mol̪d̪e
adierazmolde	að̞ieɾaz̻mol̪d̪e
adierazpen	að̞ieɾas̺pẽn
adierazpen	að̞ieɾas̻pẽn
adierazpide	að̞ieɾas̺pið̞e
adierazpide	að̞ieɾas̻pið̞e
adierazte	að̞ieɾas̺t̪e
adierazte	að̞ieɾas̻t̪e
adierraz	að̞ieras̺
adierraz	að̞ieras̻
adierraztasun	að̞ieras̺t̪as̺ũn
adierraztasun	að̞ieras̻t̪as̺ũn
adiezin	að̞ies̺ĩn
adiezin	að̞ies̻ĩn
adigabe	að̞iɣ̞aβ̞e
adigabetu	að̞iɣ̞aβ̞et̪u
adigai	að̞iɣ̞ai̯
adigaitz	að̞iɣ̞ai̯ts̻
adigaiztasun	að̞iɣ̞ai̯s̺t̪as̺ũn
adigaiztasun	að̞iɣ̞ai̯s̻t̪as̺ũn
adigalkor	að̞iɣ̞alkor
adigarri	að̞iɣ̞ari
adigarritasun	að̞iɣ̞arit̪as̺ũn
adigogor	að̞iɣ̞oɣ̞or
adiguri	að̞iɣ̞uɾi
adiguritsu	að̞iɣ̞uɾits̺u
adiguritsu	að̞iɣ̞uɾits̻u
adikatu	að̞ikat̪u
adikor	að̞ikor
adikune	að̞ikune̞
adimen	að̞imẽn
adimendu	að̞imẽn̪d̪u
adimendun	að̞imẽn̪d̪ũn
adimengabe	að̞imeŋɡaβ̞e
adimentsu	að̞imẽnts̺u
adimentsu	að̞imẽnts̻u
adin	að̞ĩn
adiskide	að̞is̺kið̞e
adiskidetasun	að̞is̺kið̞et̪as̺ũn
aditu	að̞it̪u
aditz	að̞its̻
aditzondo	að̞its̻õn̪d̪o
adizki	að̞is̺ki
adizki	að̞is̻ki
adizkitegi	að̞is̺kit̪eɣ̞i
adizkitegi	að̞is̻kit̪eɣ̞i
administratzaile	að̞minis̺t̪rats̻ai̯le
administratzaile	að̞minis̺t̪rats̻aʎe
adolba	að̞o̞lβ̞a
adore	að̞oɾe
ados	að̞os̺
adoste	að̞os̺t̪e
adosten	að̞os̺t̪ẽn
adostu	að̞os̺t̪u
adostuko	að̞os̺t̪uko
adreilu	að̞rei̯lu
adreilu	að̞reʎu
aerobik	aeɾoβ̞ik
aerobiko	ae̞ɾo̞β̞iko̞
aerobio	aeɾoβ̞io
aerodinamika	aeɾoð̞inamika
aerodinamiko	aeɾoð̞inamiko
aerodromo	aeɾoð̞romo
aeroespazial	ae̞ɾo̞e̞s̺pas̻ial
aeroklub	ae̞ɾo̞kluβ̞
aerolabaingailu	aeɾolaβ̞ai̯ŋɡai̯lu
aerolabaingailu	aeɾolaβ̞ai̯ŋɡaʎu
aerolito	aeɾolit̪o
aerometro	aeɾomet̪ro
aeromodelismo	aeɾomoð̞eliz̺mo
aeronauta	aeɾonau̯t̪a
aeronautika	aeɾonau̯t̪ika
aeronautiko	aeɾonau̯t̪iko
aeroplano	aeɾoplano
aerosol	aeɾos̺ol
aerosorgailu	ae̞ɾo̞s̺o̞rɣ̞ai̯lu
aerosorgailu	ae̞ɾo̞s̺o̞rɣ̞aʎu
aerostatika	aeɾos̺t̪at̪ika
aerostato	aeɾos̺t̪at̪o
afaitatu	afai̯t̪at̪u
afalaitzin	afalai̯ts̻ĩn
afalaurre	afalau̯re
afaldu	afal̪d̪u
afari	afaɾi
afariketa	afaɾiket̪a
afganistan	afɣ̞anis̺t̪ãn
afganistandar	afɣ̞anis̺t̪ãn̪d̪ar
afganistanek	afɣ̞anis̺t̪anek
agate	aɣ̞at̪e̞
ageriko	aɣ̞eɾiko
agerkunde	aɣ̞erkũn̪d̪e
agertoki	aɣ̞ert̪oki
agertu	aɣ̞ert̪u
aginpide	aɣ̞ĩmpið̞e
agirre	aɣ̞ire̞
agoitz	aɣ̞oi̯ts̻
agor	aɣ̞or
agorril	aɣ̞oril
agortu	aɣ̞ort̪u
agur	aɣ̞ur
agure	aɣ̞uɾe
ahabia	ahaβ̞ia
ahabia	aβ̞ia
ahai	ãh̃ãĩ
ahal	ahal
ahal	al
ahaldun	ahal̪d̪ũn
ahaldun	al̪d̪ũn
ahalke	ahalke
ahalke	alke
ahari	ahaɾi
ahari	aɾi
ahate	ahat̪e
ahate	ãh̃ãte
ahate	at̪e
ahatebeltz	ahat̪eβ̞elts̻
ahatebeltz	at̪eβ̞elts̻
ahateki	ahat̪eki
ahateki	at̪eki
ahatekume	ahat̪ekume
ahatekume	at̪ekume
ahatettipi	ahat̪ecipi
ahatettipi	at̪ecipi
ahatetxo	aɦat̪e̞tʃo̞
ahatetxo	at̪e̞tʃo̞
ahatz	ahats̻
ahatz	ats̻
ahazte	ahas̻t̪e
ahazte	as̺t̪e
ahazte	as̻t̪e
ahazten	ahas̻t̪ẽn
ahazten	as̺t̪ẽn
ahazten	as̻t̪ẽn
ahaztu	ahas̻t̪u
ahaztu	as̺t̪u
ahaztu	as̻t̪u
ahaztuko	ahas̻t̪uko
ahaztuko	as̺t̪uko
ahaztuko	as̻t̪uko
ahizpa	aɦis̻pa
ahizpa	ai̯s̻pa
aho	aɦo̞
aho	ao̞
ahobero	ahoβ̞eɾo
ahobero	aoβ̞eɾo
ahul	ahul
ahul	au̯l
ahuldu	ahul̪d̪u
ahuldu	au̯l̪d̪u
ahuntz	aɦũnts̻
ahuntz	ãũ̯nts̻
aihen	ai̯ẽ̞n
aihen	ai̯ɦẽ̞n
aiherkunde	ai̯erkũn̪d̪e
aiherkunde	ai̯herkũn̪d̪e
ainara	ai̯naɾa
ainarba	ai̯narβ̞a
ainarba	aɲarβ̞a
aingeru	ãĩ̯ŋɡe̞ɾu
aingira	ãĩ̯ŋɡiɾa
aingura	ai̯ŋɡuɾa
ainhoa	ai̯no̞a
aintzane	ãĩ̯nts̻ane̞
aintzira	ãĩ̯nts̻iɾa
aire	ai̯ɾe̞
aireportu	ai̯ɾeport̪u
aireratu	ai̯ɾeɾat̪u
aise	ai̯s̺e̞
aita	ai̯t̪a
aitaginarreba	ai̯t̪aɣ̞inareβ̞a
aitaginarreba	ai̯t̪aɣ̞iɲareβ̞a
aitaginarrebakide	ai̯t̪aɣ̞inareβ̞akið̞e
aitaginarrebakide	ai̯t̪aɣ̞iɲareβ̞akið̞e
aitaorde	ai̯t̪aorð̞e
aitatasun	ai̯t̪at̪as̺ũn
aitatxi	ai̯t̪atʃi
aitona	ai̯t̪ona
aitor	ai̯t̪o̞r
aitzur	ai̯ts̻ur
aizkolari	ai̯s̺kolaɾi
aizkolari	ai̯s̻kolaɾi
aizkora	ai̯s̺koɾa
aizkora	ai̯s̻koɾa
aizto	ai̯s̺t̪o
aizto	ai̯s̻t̪o
aizu	ai̯s̺u
aizu	ai̯s̻u
akabatu	akaβ̞at̪u
akain	akãĩ̯n
akelarre	ake̞lare̞
aker	ake̞r
akordeoi	ako̞rð̞e̞o̞i̯
akrobata	akro̞β̞at̪a
aktiba	akt̪iβ̞a
aktibatu	akt̪iβ̞at̪u
aktibatuko	akt̪iβ̞at̪uko
aktibatze	akt̪iβ̞ats̻e
aktibatzen	akt̪iβ̞ats̻ẽn
aktore	akt̪o̞ɾe̞
akura	akuɾa
akuratu	akuɾat̪u
ala	ala
alaba	alaβ̞a
alai	alai̯
al	al
albaitari	alβ̞ai̯t̪aɾi
albania	alβ̞ania
albaniar	alβ̞aniar
albaniera	alβ̞anieɾa
albarikoke	alβ̞aɾikoke
alboroke	alβ̞oɾoke
alda	al̪d̪a
aldaketa	al̪d̪aket̪a
aldapa	al̪d̪apa
aldatu	al̪d̪at̪u
aldatuko	al̪d̪at̪uko
aldatze	al̪d̪ats̻e
aldatzen	al̪d̪ats̻ẽn
alde	al̪d̪e
aldetik	al̪d̪et̪ik
aldeztu	al̪d̪e̞s̻t̪u
aldizkari	al̪d̪is̻kaɾi
aleman	ale̞mãn
alemanera	alemaneɾa
alemania	alemania
alemaniar	ale̞maniar
aletegi	alet̪eɣ̞i
algara	alɣ̞aɾa
alienatu	alie̞nat̪u
aljeria	alxeɾia
aljeria	alʒeɾia
alkandora	alkãn̪d̪oɾa
alkandorak	alkãn̪d̪o̞ɾak
alkandorek	alkãn̪d̪o̞ɾe̞k
alkate	alkat̪e̞
alkohola	alko̞ɦo̞la
alkohola	alko̞la
alkohol	alko̞ɦo̞l
alkohol	alko̞l
alkoholan	alko̞ɦo̞lãn
alkoholan	alko̞lãn
alkoholen	alko̞ɦo̞lẽ̞n
alkoholen	alko̞lẽ̞n
alkoholi	alko̞ɦo̞li
alkoholi	alko̞li
alkoholik	alkoholik
alkoholik	alkolik
alokatu	alokat̪u
alta	al̪t̪a
altsasu	alts̺as̺u
altsasu	alts̻as̺u
altu	al̪t̪u
altxaprima	alʲtʃaprima
altxatu	alʲtʃat̪u
altxoin	alʲtʃõ̞ĩ̯n
altxor	alʲtʃo̞r
altzaga	alts̻aɣ̞a
aluminio	aluminio
ama	ama
amaginarreba	amaɣ̞inareβ̞a
amaginarreba	amaɣ̞iɲareβ̞a
amaginarrebakide	amaɣ̞inareβ̞akið̞e
amaginarrebakide	amaɣ̞iɲareβ̞akið̞e
amaia	amai̯a
amai	amai̯
amaiera	amai̯eɾa
amaitu	amai̯t̪u
amama	amama
amaraun	amaɾãũ̯n
amatasun	amat̪as̺ũn
amatatu	amat̪at̪u
amerikano	ame̞ɾikano̞
amesgaizto	amez̺ɣ̞ai̯s̺t̪o
amesgaizto	amez̺ɣ̞ai̯s̻t̪o
amestu	ame̞s̺t̪u
amets	ame̞ts̺
ametz	amets̻
amildu	amil̪d̪u
amodio	amoð̞io
amona	amona
amore	amoɾe
amorratu	amorat̪u
anabasa	anaβ̞as̺a
anagrama	anaɣ̞rama
anaia	anai̯a
anana	anana
andaia	ãn̪d̪ai̯a
andaluzia	ãn̪d̪alus̻ia
andeatu	ãn̪d̪e̞at̪u
ander	ãn̪d̪e̞r
andere	ãn̪d̪eɾe
andereño	ãn̪d̪eɾeɲo
andoain	ãn̪d̪oãĩ̯n
andorra	ãn̪d̪ora
andorratar	ãn̪d̪o̞rat̪ar
andorratarra	ãn̪d̪o̞rat̪ara
andorratarrak	ãn̪d̪o̞rat̪arak
andorratarraren	ãn̪d̪o̞rat̪araɾẽ̞n
andorratarrari	ãn̪d̪o̞rat̪araɾi
andorratarrei	ãn̪d̪o̞rat̪are̞i
andorratarrek	ãn̪d̪o̞rat̪are̞k
andorratarren	ãn̪d̪o̞rat̪arẽ̞n
andorratarri	ãn̪d̪o̞rat̪ari
andre	ãn̪d̪re
andregai	ãn̪d̪reɣ̞ai̯
angelu	aŋɡelu
angola	aŋɡola
angurri	aŋɡuri
animalia	animalia
animatu	animat̪u
anime	anime
anker	ãŋke̞r
antartika	ãn̪t̪art̪ika
antigua	ãn̪t̪iɣ̞wa
antiheroi	ãn̪t̪ieɾoi̯
antiheroi	ãn̪t̪iheɾoi̯
antimikrobiar	ãn̪t̪imikro̞β̞iar
antolakunde	ãn̪t̪olakũn̪d̪e
antropologia	ãn̪t̪ropoloɣ̞ia
antsoain	ãnts̺oãĩ̯n
antsoain	ãnts̻oãĩ̯n
antton	ãnʲtʃõ̞n
antton	ãɲcõ̞n
antxeta	ãnʲtʃe̞t̪a
antxieta	ãnʲtʃje̞t̪a
antxoa	ãnʲtʃoa
antzara	ãnts̻aɾa
antzeratu	ãnts̻e̞ɾat̪u
apaiz	apai̯s̺
apaiz	apai̯s̻
apaizgai	apai̯z̺ɣ̞ai̯
apaizgai	apai̯z̻ɣ̞ai̯
apal	apal
apaldu	apal̪d̪u
apar	apar
apez	apes̺
apez	apes̻
apezpiku	ape̞s̻piku
apiril	apiɾil
apo	apo̞
aporofobia	apoɾofoβ̞ia
aprobetxategi	apro̞β̞e̞tʃat̪e̞ɣ̞i
araba	aɾaβ̞a
arabera	aɾaβ̞e̞ɾa
arabiera	aɾaβ̞ie̞ɾa
arabisagar	aɾaβ̞is̺aɣ̞ar
aragoiera	aɾaɣ̞oi̯eɾa
aramu	aɾamu
aran	aɾãn
aranondo	aɾanõn̪d̪o
arantzazu	aɾãnts̻as̺u
arantzazu	aɾãnts̻as̻u
arazi	aɾas̻i
arbola	arβ̞o̞la
arbona	arβ̞ona
ardi	arð̞i
ardo	arð̞o
ardura	arð̞uɾa
arduratu	arð̞uɾat̪u
are	aɾe
arellano	aɾeʎano
argazki	arɣ̞as̺ki
argazki	arɣ̞as̻ki
argazkigintza	arɣ̞as̺kiɣ̞ĩnts̻a
argazkigintza	arɣ̞as̻kiɣ̞ĩnts̻a
argazkilari	arɣ̞as̺kilaɾi
argazkilari	arɣ̞as̻kilaɾi
argazkilaritza	arɣ̞as̺kilaɾits̻a
argazkilaritza	arɣ̞as̻kilaɾits̻a
argi	arɣ̞i
argitsu	arɣ̞its̺u
argitsu	arɣ̞its̻u
arin	aɾĩn
aristotele	aɾis̺t̪o̞t̪e̞le̞
aritz	aɾits̻
arkume	arkume
armairu	armai̯ɾu
armenia	armenia
armeniar	arme̞niar
armeniera	armenieɾa
armiarma	armiarma
arnegu	arneɣ̞u
aro	aɾo
arotz	aɾots̻
aroztegi	aɾos̺t̪eɣ̞i
aroztegi	aɾos̻t̪eɣ̞i
arpoi	arpoi̯
arrain	arãĩ̯n
arrangoitze	araŋɡoi̯ts̻e
arrano	arano
arranotegi	aranot̪eɣ̞i
arrantzale	arãnts̻ale
arraro	araɾo
arrasate	aras̺at̪e
arrastatu	aras̺t̪at̪u
arratoi	arat̪o̞i̯
arraun	arãũ̯n
arrautza	arau̯ts̻a
arrautzopil	arau̯ts̻opil
arraza	aras̺a
arraza	aras̻a
arrazoi	aras̺oi̯
arrazoi	aras̻oi̯
arreba	are̞β̞a
arrieta	ariet̪a
arrigorriaga	ariɣ̞o̞riaɣ̞a
arriskatu	aris̺kat̪u
arrisku	aris̺ku
arriskutsu	aris̺kuts̺u
arriskutsu	aris̺kuts̻u
arroda	aro̞ð̞a
arropa	aro̞pa
arrosa	aro̞s̺a
arrotz	arots̻
arroz	aros̺
arroz	aros̻
arrunt	arũn̪t̪
artaburu	art̪aβ̞uɾu
arte	art̪e
artifizial	art̪ifis̺ial
artifizial	art̪ifis̻ial
artile	art̪ile
artile	art̪iʎe
artillari	art̪iʎaɾi
artisau	art̪is̺au̯
artista	art̪is̺t̪a
artizar	art̪is̻ar
artizarra	art̪is̻ara
arto	art̪o̞
artseniko	arts̺e̞niko̞
artxipelago	artʃipelaɣ̞o
artzain	arts̻ãĩ̯n
asaba	as̺aβ̞a
asaldatu	as̺al̪d̪at̪u
askatasun	as̺kat̪as̺ũn
askatu	as̺kat̪u
aske	as̺ke̞
aski	as̺ki
asko	as̺ko̞
asmatu	az̺mat̪u
asmo	az̺mo̞
asperkunde	as̺perkũn̪d̪e
aspertu	as̺pert̪u
aspertuta	as̺pert̪ut̪a
astearte	as̺t̪e̞art̪e̞
aste	as̺t̪e̞
asteazken	as̺t̪e̞as̻kẽ̞n
asteburu	as̺t̪e̞β̞uɾu
astelehen	as̺t̪e̞le̞ɦẽ̞n
astelehen	as̺t̪e̞lẽ̞n
asteroide	as̺t̪eɾoi̯ð̞e
astindu	as̺t̪ĩn̪d̪u
asto	as̺t̪o̞
astronomia	as̺t̪ronomia
asturiera	as̺t̪uɾie̞ɾa
asun	as̺ũn
atari	at̪aɾi
atariko	at̪aɾiko̞
ate	at̪e
atena	at̪e̞na
atera	at̪eɾa
aterpe	at̪erpe
atoi	at̪o̞i̯
atorra	at̪ora
atso	ats̺o
atso	ats̻o
atsokeria	ats̺okeɾia
atsokeria	ats̻okeɾia
atsotitza	ats̺ot̪its̻a
atsotitza	ats̻ot̪its̻a
atsotitz	ats̺ot̪its̻
atsotitz	ats̻ot̪its̻
atsotitzik	ats̺ot̪its̻ik
atsotitzik	ats̻ot̪its̻ik
atsotizlari	ats̺ot̪iz̻laɾi
atsotizlari	ats̻ot̪iz̺laɾi
atsotu	ats̺ot̪u
atsotu	ats̻ot̪u
atxeki	atʃe̞ki
atxekiko	atʃekiko
atxekitze	atʃekits̻e
atxekitzen	atʃekits̻ẽn
atxilotu	atʃilot̪u
atxilotu	atʃiʎot̪u
atzamar	ats̻amar
atzapar	ats̻apar
atzealde	ats̻e̞al̪d̪e̞
atzean	ats̻e̞ãn
atze	ats̻e
atzelari	ats̻elaɾi
atzera	ats̻eɾa
atzo	ats̻o
atzodanik	ats̻oð̞anik
atzoko	ats̻oko
atzotik	ats̻ot̪ik
auhen	au̯ẽn
auhen	au̯hẽn
auhendatu	au̯ẽn̪d̪at̪u
auhendatu	au̯hẽn̪d̪at̪u
aukera	au̯keɾa
aukeraketa	au̯keɾaket̪a
aukeratu	au̯keɾat̪u
aukeratuko	au̯keɾat̪uko
aukeratze	au̯keɾats̻e
aukeratzen	au̯keɾats̻ẽn
aulki	au̯lki
aupa	au̯pa
aurka	au̯rka
aurki	au̯rki
aurkikunde	au̯rkikũn̪d̪e
aurkitu	au̯rkit̪u
aurkituko	au̯rkit̪uko
aurkitze	au̯rkits̻e
aurkitzen	au̯rkits̻ẽn
aurpegi	au̯rpe̞ɣ̞i
aurre	au̯re̞
aurrera	au̯re̞ɾa
aurten	au̯rt̪ẽ̞n
ausart	au̯s̺art̪
ausartu	au̯s̺art̪u
auskalo	au̯s̺kalo
australia	au̯s̺t̪ralia
austria	au̯s̺t̪ria
austriar	au̯s̺t̪riar
autismo	au̯t̪iz̺mo
auto	au̯t̪o
autobide	au̯t̪oβ̞ið̞e
automatiko	au̯t̪omat̪iko
auzo	au̯s̻o̞
azal	as̻al
azaldu	as̻al̪d̪u
azalpen	as̺alpẽn
azalpen	as̻alpẽn
azaro	as̻aɾo̞
azazkal	as̻as̻kal
azenario	as̺enaɾio
azenario	as̻enaɾio
azerbaijan	as̺erβ̞ai̯dʒãn
azerbaijan	as̻erβ̞ai̯jãn
azerbaijan	as̻erβ̞ai̯ɟãn
azerbaijandar	as̻e̞rβ̞ai̯jãn̪d̪ar
azerbaijanera	as̺erβ̞ai̯dʒaneɾa
azerbaijanera	as̻erβ̞ai̯janeɾa
azerbaijanera	as̻erβ̞ai̯ɟaneɾa
azeri	as̺eɾi
azeri	as̻eɾi
azerikeria	as̺eɾikeɾia
azerikeria	as̻eɾikeɾia
azeriki	as̺eɾiki
azeriki	as̻eɾiki
azerikume	as̺eɾikume
azerikume	as̻eɾikume
azeritegi	as̺eɾit̪eɣ̞i
azeritegi	as̻eɾit̪eɣ̞i
azido	as̻ið̞o̞
azkar	as̺kar
azkar	as̻kar
azkarate	as̺kaɾat̪e
azkarate	as̻kaɾat̪e
azkarraga	as̻karaɣ̞a
azkarregi	as̺kareɣ̞i
azkarregi	as̻kareɣ̞i
azken	as̻kẽ̞n
azkoitia	as̺koi̯t̪ia
azkoitia	as̻koi̯t̪ia
azkonar	as̻ko̞nar
azoka	as̻o̞ka
azpeitia	as̺pei̯t̪ia
azpeitia	as̻pei̯t̪ia
azpian	as̻piãn
azpi	as̻pi
azpiegitura	as̺pieɣ̞it̪uɾa
azpiegitura	as̻pieɣ̞it̪uɾa
azpimarratu	as̺pimarat̪u
azpimarratu	as̻pimarat̪u
azpititulu	as̻pit̪it̪ulu
aztarna	as̺t̪arna
aztarna	as̻t̪arna
aztertu	as̺t̪ert̪u
aztertu	as̻t̪ert̪u
aztertzaile	as̻t̪erts̻ai̯le
aztertzaile	as̺t̪erts̻aʎe
aztertzaile	as̻t̪erts̻aʎe
azti	as̺t̪i
azti	as̻t̪i
azukre	as̻ukre̞
ba	ba
baba	baβ̞a
babazorro	baβ̞as̻o̞ro̞
babestu	baβ̞es̺t̪u
badadi	bað̞að̞i
badaitez	bað̞ai̯t̪es̺
badaitez	bað̞ai̯t̪es̻
badeza	bað̞es̺a
badeza	bað̞es̻a
badezagu	bað̞es̺aɣ̞u
badezagu	bað̞es̻aɣ̞u
badezak	bað̞es̺ak
badezak	bað̞es̻ak
badezan	bað̞es̺ãn
badezan	bað̞es̻ãn
badezat	bað̞es̺at̪
badezat	bað̞es̻at̪
badezate	bað̞es̺at̪e
badezate	bað̞es̻at̪e
badezazu	bað̞es̺as̺u
badezazu	bað̞es̻as̻u
badezazue	bað̞es̺as̺ue
badezazue	bað̞es̻as̻ue
badia	bað̞ia
baditza	bað̞its̻a
baditzagu	bað̞its̻aɣ̞u
baditzak	bað̞its̻ak
baditzan	bað̞its̻ãn
baditzat	bað̞its̻at̪
baditzate	bað̞its̻at̪e
baditzazu	bað̞its̻as̺u
baditzazu	bað̞its̻as̻u
baditzazue	bað̞its̻as̺ue
baditzazue	bað̞its̻as̻ue
bagaitez	baɣ̞ai̯t̪es̺
bagaitez	baɣ̞ai̯t̪es̻
bagaitza	baɣ̞ai̯ts̻a
bagaitzak	baɣ̞ai̯ts̻ak
bagaitzan	baɣ̞ai̯ts̻ãn
bagaitzate	baɣ̞ai̯ts̻at̪e
bagaitzazu	baɣ̞ai̯ts̻as̺u
bagaitzazu	baɣ̞ai̯ts̻as̻u
bagaitzazue	baɣ̞ai̯ts̻as̺ue
bagaitzazue	baɣ̞ai̯ts̻as̻ue
bagenbiltza	baɣ̞ẽmbilts̻a
bagenegi	baɣ̞eneɣ̞i
bagenegitza	baɣ̞eneɣ̞its̻a
bageneki	baɣ̞e̞ne̞ki
bagenekizki	baɣ̞e̞ne̞kis̻ki
bagenekusa	baɣ̞e̞ne̞kus̺a
bagenekuski	baɣ̞e̞ne̞kus̺ki
bagenentzu	baɣ̞e̞nẽ̞nts̻u
bagenentzuzki	baɣ̞e̞nẽ̞nts̻us̻ki
bagenerakuski	baɣ̞e̞ne̞ɾakus̺ki
bagenerakutsa	baɣ̞e̞ne̞ɾakuts̺a
bageneuka	baɣ̞eneu̯ka
bageneuzka	baɣ̞eneu̯s̺ka
bageneuzka	baɣ̞eneu̯s̻ka
bageneza	baɣ̞enes̺a
bageneza	baɣ̞enes̻a
bagenezagu	baɣ̞e̞ne̞s̻aɣ̞u
bagenezaguzki	baɣ̞e̞ne̞s̻aɣ̞us̻ki
bagenihardu	baɣ̞e̞niarð̞u
bagenihardu	baɣ̞e̞niɦarð̞u
bageniharduka	baɣ̞e̞niarð̞uka
bageniharduka	baɣ̞e̞niɦarð̞uka
bagenirau	baɣ̞e̞niɾau̯
bagenirudi	baɣ̞e̞niɾuð̞i
bagenitu	baɣ̞e̞nit̪u
bagenitza	baɣ̞enits̻a
bagentoz	baɣ̞ẽn̪t̪os̺
bagentoz	baɣ̞ẽn̪t̪os̻
bagenu	baɣ̞e̞nu
bageunde	baɣ̞ẽũ̯n̪d̪e
bagil	baɣ̞il
bagina	baɣ̞ina
bagina	baɣ̞iɲa
bagindezaguzki	baɣ̞ĩn̪d̪e̞s̻aɣ̞us̻ki
bagindezaguzkik	baɣ̞ĩn̪d̪e̞s̻aɣ̞us̻kik
bagindezaguzkin	baɣ̞ĩn̪d̪e̞s̻aɣ̞us̻kĩn
bagindezaguzkite	baɣ̞ĩn̪d̪e̞s̻aɣ̞us̻kit̪e̞
bagindezaguzkizu	baɣ̞ĩn̪d̪e̞s̻aɣ̞us̻kis̻u
bagindezaguzkizue	baɣ̞ĩn̪d̪e̞s̻aɣ̞us̻kis̻ue̞
bagindoaz	baɣ̞ĩn̪d̪oas̺
bagindoaz	baɣ̞ĩn̪d̪oas̻
baginduzka	baɣ̞ĩn̪d̪us̺ka
baginduzka	baɣ̞ĩn̪d̪us̻ka
baginduzkak	baɣ̞ĩn̪d̪us̺kak
baginduzkak	baɣ̞ĩn̪d̪us̻kak
baginduzkan	baɣ̞ĩn̪d̪us̺kãn
baginduzkan	baɣ̞ĩn̪d̪us̻kãn
baginduzkate	baɣ̞ĩn̪d̪us̺kat̪e
baginduzkate	baɣ̞ĩn̪d̪us̻kat̪e
baginduzkazu	baɣ̞ĩn̪d̪us̺kas̺u
baginduzkazu	baɣ̞ĩn̪d̪us̻kas̻u
baginduzkazue	baɣ̞ĩn̪d̪us̺kas̺ue
baginduzkazue	baɣ̞ĩn̪d̪us̻kas̻ue
bagintez	baɣ̞ĩn̪t̪es̺
bagintez	baɣ̞ĩn̪t̪es̻
bagintu	baɣ̞ĩn̪t̪u
bagintuk	baɣ̞ĩn̪t̪uk
bagintun	baɣ̞ĩn̪t̪ũn
bagintuzte	baɣ̞ĩn̪t̪us̻t̪e̞
bagintuzu	baɣ̞ĩn̪t̪us̻u
bagintuzue	baɣ̞ĩn̪t̪us̻ue̞
bagintza	baɣ̞ĩnts̻a
bagintzak	baɣ̞ĩnts̻ak
bagintzan	baɣ̞ĩnts̻ãn
bagintzate	baɣ̞ĩnts̻at̪e
bagintzazu	baɣ̞ĩnts̻as̺u
bagintzazu	baɣ̞ĩnts̻as̻u
bagintzazue	baɣ̞ĩnts̻as̺ue
bagintzazue	baɣ̞ĩnts̻as̻ue
bahadi	baað̞i
bahadi	bahað̞i
bahaza	baas̺a
bahaza	baas̻a
bahaza	bahas̻a
bahazagu	baas̺aɣ̞u
bahazagu	baas̻aɣ̞u
bahazagu	bahas̻aɣ̞u
bahazat	baas̺at̪
bahazat	baas̻at̪
bahazat	bahas̻at̪
bahazate	baas̺at̪e
bahazate	baas̻at̪e
bahazate	bahas̻at̪e
bahe	bae̞
bahe	baɦe̞
bahegi	baeɣ̞i
bahegi	baheɣ̞i
bahegitza	baeɣ̞its̻a
bahegitza	baheɣ̞its̻a
baheki	bae̞ki
baheki	baɦe̞ki
bahekizki	bae̞kis̻ki
bahekizki	baɦe̞kis̻ki
bahekusa	bae̞kus̺a
bahekusa	baɦe̞kus̺a
bahekuski	bae̞kus̺ki
bahekuski	baɦe̞kus̺ki
bahenbil	baẽmbil
bahenbil	bahẽmbil
bahendi	baẽn̪d̪i
bahendi	bahẽn̪d̪i
bahengo	baeŋɡo
bahengo	baheŋɡo
bahentor	baẽn̪t̪or
bahentor	bahẽn̪t̪or
bahentzu	baẽ̞nts̻u
bahentzu	baɦẽ̞nts̻u
bahentzuzki	baẽ̞nts̻us̻ki
bahentzuzki	baɦẽ̞nts̻us̻ki
baherakuski	bae̞ɾakus̺ki
baherakuski	baɦe̞ɾakus̺ki
baherakutsa	bae̞ɾakuts̺a
baherakutsa	baɦe̞ɾakuts̺a
baheuka	baeu̯ka
baheuka	baheu̯ka
baheuzka	baeu̯s̺ka
baheuzka	baeu̯s̻ka
baheuzka	baheu̯s̻ka
baheza	baes̺a
baheza	baes̻a
baheza	bahes̻a
bahezagu	bae̞s̻aɣ̞u
bahezagu	baɦe̞s̻aɣ̞u
bahezaguzki	bae̞s̻aɣ̞us̻ki
bahezaguzki	baɦe̞s̻aɣ̞us̻ki
bahihardu	baɦiɦarð̞u
bahihardu	bai̯arð̞u
bahiharduka	baɦiɦarð̞uka
bahiharduka	bai̯arð̞uka
bahindezagu	baɦĩn̪d̪e̞s̻aɣ̞u
bahindezagu	bãĩ̯n̪d̪e̞s̻aɣ̞u
bahindezagugu	baɦĩn̪d̪e̞s̻aɣ̞uɣ̞u
bahindezagugu	bãĩ̯n̪d̪e̞s̻aɣ̞uɣ̞u
bahindezagut	baɦĩn̪d̪e̞s̻aɣ̞ut̪
bahindezagut	bãĩ̯n̪d̪e̞s̻aɣ̞ut̪
bahindezagute	baɦĩn̪d̪e̞s̻aɣ̞ut̪e̞
bahindezagute	bãĩ̯n̪d̪e̞s̻aɣ̞ut̪e̞
bahindoa	bahĩn̪d̪oa
bahindoa	baĩn̪d̪oa
bahindu	baɦĩn̪d̪u
bahindu	bãĩ̯n̪d̪u
bahindugu	baɦĩn̪d̪uɣ̞u
bahindugu	bãĩ̯n̪d̪uɣ̞u
bahinduka	bahĩn̪d̪uka
bahinduka	bãĩ̯n̪d̪uka
bahindukagu	bahĩn̪d̪ukaɣ̞u
bahindukagu	baĩn̪d̪ukaɣ̞u
bahindukat	bahĩn̪d̪ukat̪
bahindukat	baĩn̪d̪ukat̪
bahindukate	bahĩn̪d̪ukat̪e
bahindukate	bãĩ̯n̪d̪ukat̪e
bahindut	baɦĩn̪d̪ut̪
bahindut	bãĩ̯n̪d̪ut̪
bahindute	baɦĩn̪d̪ut̪e̞
bahindute	bãĩ̯n̪d̪ut̪e̞
bahintza	bahĩnts̻a
bahintza	baĩnts̻a
bahintzagu	bahĩnts̻aɣ̞u
bahintzagu	baĩnts̻aɣ̞u
bahintzat	bahĩnts̻at̪
bahintzat	baĩnts̻at̪
bahintzate	bahĩnts̻at̪e
bahintzate	baĩnts̻at̪e
bahintz	bahĩnts̻
bahintz	baĩnts̻
bahirau	baɦiɾau̯
bahirau	bai̯ɾau̯
bahirudi	baɦiɾuð̞i
bahirudi	bai̯ɾuð̞i
bahitu	baɦit̪u
bahitu	bai̯t̪u
bahitza	bahits̻a
bahitza	baits̻a
bahu	bahu
bahu	bau
bai	bai̯
baietz	bai̯ets̻
baina	bai̯na
baina	baɲa
baino	bai̯no
baino	baɲo
bainu	bai̯nu
bainu	baɲu
bainuetxe	bai̯nuetʃe
bainuetxe	baɲuetʃe
bainugela	bai̯nuɣ̞ela
bainugela	baɲuɣ̞ela
bainujantzi	bai̯nuɟãnts̻i
bainujantzi	baɲudʒãnts̻i
bainujantzi	baɲujãnts̻i
bainujantzi	baɲuxãnts̻i
bainulari	bai̯nulaɾi
bainulari	baɲulaɾi
bainuontzi	bai̯nuõnts̻i
bainuontzi	baɲuõnts̻i
bainutegi	bai̯nut̪eɣ̞i
bainutegi	baɲut̪eɣ̞i
bainutoki	bai̯nut̪oki
bainutoki	baɲut̪oki
baita	bai̯t̪a
bakailao	bakai̯lao̞
bakailao	bakaʎao̞
bakarrik	bakarik
bake	bake
baketu	bake̞t̪u
baketuko	baket̪uko
baketze	bakets̻e
baketzen	bakets̻ẽn
bakoitza	bakoi̯ts̻a
bakoitz	bakoi̯ts̻
bakteriofago	bakt̪e̞ɾio̞faɣ̞o̞
balakatu	balakat̪u
baldin	bal̪d̪ĩn
bale	bale
balebil	baleβ̞il
balebiltza	baleβ̞ilts̻a
baledi	baleð̞i
balegi	baleɣ̞i
balegite	baleɣ̞it̪e
balegitza	baleɣ̞its̻a
balegitzate	baleɣ̞its̻at̪e
balego	baleɣ̞o
baleki	bale̞ki
balekite	bale̞kit̪e̞
balekizki	bale̞kis̻ki
balekizkite	bale̞kis̻kit̪e̞
balekusa	bale̞kus̺a
balekusate	bale̞kus̺at̪e̞
balekuski	bale̞kus̺ki
balekuskite	bale̞kus̺kit̪e̞
balentzu	balẽ̞nts̻u
balentzute	balẽ̞nts̻ut̪e̞
balentzuzki	balẽ̞nts̻us̻ki
balentzuzkite	balẽ̞nts̻us̻kit̪e̞
balerakuski	bale̞ɾakus̺ki
balerakuskite	bale̞ɾakus̺kit̪e̞
balerakutsa	bale̞ɾakuts̺a
balerakutsate	bale̞ɾakuts̺at̪e̞
baletor	balet̪or
baletoz	balet̪os̺
baletoz	balet̪os̻
baleude	baleu̯ð̞e
baleuka	baleu̯ka
baleukate	baleu̯kat̪e
baleuzka	baleu̯s̺ka
baleuzka	baleu̯s̻ka
baleuzkate	baleu̯s̺kat̪e
baleuzkate	baleu̯s̻kat̪e
baleza	bales̺a
baleza	bales̻a
balezagu	bale̞s̻aɣ̞u
balezagute	bale̞s̻aɣ̞ut̪e̞
balezaguzki	bale̞s̻aɣ̞us̻ki
balezaguzkite	bale̞s̻aɣ̞us̻kit̪e̞
balezate	bales̺at̪e
balezate	bales̻at̪e
baliabide	baliaβ̞ið̞e̞
balihardu	baliarð̞u
balihardu	baliɦarð̞u
baliharduka	baliarð̞uka
baliharduka	baliɦarð̞uka
balihardukate	baliarð̞ukat̪e̞
balihardukate	baliɦarð̞ukat̪e̞
balihardute	baliarð̞ut̪e̞
balihardute	baliɦarð̞ut̪e̞
balihoa	balihoa
balihoa	balixoa
balihoaz	balihoas̻
balihoaz	balixoas̺
balihoaz	balixoas̻
balio	balio̞
balira	baliɾa
balirau	baliɾau̯
baliraute	baliɾau̯t̪e̞
balirudi	baliɾuð̞i
balirudite	baliɾuð̞it̪e̞
balitez	balit̪es̺
balitez	balit̪es̻
balitu	balit̪u
balituzte	balit̪us̻t̪e̞
balitza	balits̻a
balitzate	balits̻at̪e
balitz	balits̻
balkoi	balkoi̯
baloi	balo̞i̯
balu	balu
balute	balut̪e̞
bana	bana
banadi	banað̞i
bananondo	bananõ̞n̪d̪o̞
banatu	banat̪u
banatuko	banat̪uko
banatze	banats̻e
banatzen	banats̻ẽn
banaza	banas̺a
banaza	banas̻a
banazak	banas̺ak
banazak	banas̻ak
banazan	banas̺ãn
banazan	banas̻ãn
banazate	banas̺at̪e
banazate	banas̻at̪e
banazazu	banas̺as̺u
banazazu	banas̻as̻u
banazazue	banas̺as̺ue
banazazue	banas̻as̻ue
bandalismo	bãn̪d̪aliz̺mo̞
bandera	bãn̪d̪eɾa
banegi	baneɣ̞i
banegitza	baneɣ̞its̻a
baneki	bane̞ki
banekizki	bane̞kis̻ki
banekusa	bane̞kus̺a
banekuski	bane̞kus̺ki
banenbil	banẽmbil
banendi	banẽn̪d̪i
banengo	baneŋɡo
banentor	banẽn̪t̪or
banentorkio	banẽn̪t̪orkio
banentzu	banẽ̞nts̻u
banentzuzki	banẽ̞nts̻us̻ki
banerakuski	bane̞ɾakus̺ki
banerakutsa	bane̞ɾakuts̺a
baneuka	baneu̯ka
baneuzka	baneu̯s̺ka
baneuzka	baneu̯s̻ka
baneza	banes̺a
baneza	banes̻a
banezagu	bane̞s̻aɣ̞u
banezaguzki	bane̞s̻aɣ̞us̻ki
bangladesh	baŋɡlað̞es̺
bangladeshtar	baŋɡlað̞es̺t̪ar
bangladeshtar	baŋɡlað̞eʃt̪ar
banihardu	baniarð̞u
banihardu	baniɦarð̞u
baniharduka	baniarð̞uka
baniharduka	baniɦarð̞uka
banindezagu	banĩn̪d̪e̞s̻aɣ̞u
banindezaguk	banĩn̪d̪e̞s̻aɣ̞uk
banindezagun	banĩn̪d̪e̞s̻aɣ̞ũn
banindezagute	banĩn̪d̪e̞s̻aɣ̞ut̪e̞
banindezaguzu	banĩn̪d̪e̞s̻aɣ̞us̻u
banindezaguzue	banĩn̪d̪e̞s̻aɣ̞us̻ue̞
banindoa	banĩn̪d̪oa
banindu	banĩn̪d̪u
baninduka	banĩn̪d̪uka
banindukak	banĩn̪d̪ukak
banindukan	banĩn̪d̪ukãn
banindukate	banĩn̪d̪ukat̪e
banindukazu	banĩn̪d̪ukas̺u
banindukazu	banĩn̪d̪ukas̻u
banindukazue	banĩn̪d̪ukas̺ue
banindukazue	banĩn̪d̪ukas̻ue
baninduk	banĩn̪d̪uk
banindun	banĩn̪d̪ũn
banindute	banĩn̪d̪ut̪e̞
baninduzu	banĩn̪d̪us̻u
baninduzue	banĩn̪d̪us̻ue̞
banintza	banĩnts̻a
banintzak	banĩnts̻ak
banintzan	banĩnts̻ãn
banintzate	banĩnts̻at̪e
banintzazu	banĩnts̻as̺u
banintzazu	banĩnts̻as̻u
banintzazue	banĩnts̻as̺ue
banintzazue	banĩnts̻as̻ue
banintz	banĩnts̻
banirau	baniɾau̯
banirudi	baniɾuð̞i
banitu	banit̪u
banitza	banits̻a
banketxe	baŋketʃe
banpiro	bãmpiɾo
banu	banu
bapore	bapoɾe
barantaila	baɾãn̪t̪ai̯la
barantaila	baɾãn̪t̪aʎa
barazkari	baɾas̺kaɾi
barazkari	baɾas̻kaɾi
barbuda	barβ̞uð̞a
bare	baɾe̞
bariku	baɾiku
barkatu	barkat̪u
barna	barna
barnean	barne̞ãn
barne	barne̞
barrabil	baraβ̞il
barre	bare̞
barrena	barena
barren	barẽn
barrundia	barũn̪d̪ia
bart	bart̪
basajaun	bas̺adʒãũ̯n
basajaun	bas̺ajãũ̯n
basajaun	bas̺aɟãũ̯n
basajaun	bas̺axãũ̯n
basakatu	bas̺akat̪u
basamortu	bas̺amort̪u
basara	bas̺aɾa
basaran	bas̺aɾãn
basarte	bas̺art̪e
basarto	bas̺art̪o
basate	bas̺at̪e
basati	bas̺at̪i
baseliza	bas̺elis̺a
baseliza	bas̺elis̻a
baserri	bas̺eri
baserritar	bas̺erit̪ar
baserritartu	bas̺erit̪art̪u
baserritartuko	bas̺erit̪art̪uko
baserritartze	bas̺erit̪arts̻e
baserritartzen	bas̺erit̪arts̻ẽn
baso	bas̺o
basolo	bas̺olo
basurde	bas̺urð̞e
basusarri	bas̺us̺ari
bata	bat̪a
bataiatu	bat̪ai̯at̪u
bataio	bat̪ai̯o̞
batak	bat̪ak
batasun	bat̪as̺ũn
bat	bat̪
batean	bat̪eãn
batek	bat̪ek
batel	bat̪e̞l
baten	bat̪ẽn
batera	bat̪eɾa
batez	bat̪es̺
batez	bat̪es̻
bati	bat̪i
batxiler	batʃiler
batxiler	batʃiʎer
batxilergo	batʃilerɣ̞o
batxilergo	batʃiʎerɣ̞o
batzoki	bats̻o̞ki
batzuetan	bats̻uet̪ãn
batzuetan	bats̻ut̪ãn
batzuk	bats̻uk
baxu	baʃu
bazaitez	bas̺ai̯t̪es̺
bazaitez	bas̻ai̯t̪es̻
bazaitezte	bas̺ai̯t̪es̺t̪e
bazaitezte	bas̻ai̯t̪es̻t̪e
bazaitza	bas̺ai̯ts̻a
bazaitza	bas̻ai̯ts̻a
bazaitzagu	bas̺ai̯ts̻aɣ̞u
bazaitzagu	bas̻ai̯ts̻aɣ̞u
bazaitzat	bas̺ai̯ts̻at̪
bazaitzat	bas̻ai̯ts̻at̪
bazaitzate	bas̺ai̯ts̻at̪e
bazaitzate	bas̻ai̯ts̻at̪e
bazaitzategu	bas̺ai̯ts̻at̪eɣ̞u
bazaitzategu	bas̻ai̯ts̻at̪eɣ̞u
bazaitzatet	bas̺ai̯ts̻at̪et̪
bazaitzatet	bas̻ai̯ts̻at̪et̪
bazaitzatete	bas̺ai̯ts̻at̪et̪e
bazaitzatete	bas̻ai̯ts̻at̪et̪e
bazenbiltza	bas̺ẽmbilts̻a
bazenbiltza	bas̻ẽmbilts̻a
bazenbiltzate	bas̺ẽmbilts̻at̪e
bazenbiltzate	bas̻ẽmbilts̻at̪e
bazenegi	bas̺eneɣ̞i
bazenegi	bas̻eneɣ̞i
bazenegite	bas̺eneɣ̞it̪e
bazenegite	bas̻eneɣ̞it̪e
bazenegitza	bas̺eneɣ̞its̻a
bazenegitza	bas̻eneɣ̞its̻a
bazenegitzate	bas̺eneɣ̞its̻at̪e
bazenegitzate	bas̻eneɣ̞its̻at̪e
bazeneki	bas̻e̞ne̞ki
bazenekite	bas̻e̞ne̞kit̪e̞
bazenekizki	bas̻e̞ne̞kis̻ki
bazenekizkite	bas̻e̞ne̞kis̻kit̪e̞
bazenekusa	bas̻e̞ne̞kus̺a
bazenekusate	bas̻e̞ne̞kus̺at̪e̞
bazenekuski	bas̻e̞ne̞kus̺ki
bazenekuskite	bas̻e̞ne̞kus̺kit̪e̞
bazenentzu	bas̻e̞nẽ̞nts̻u
bazenentzute	bas̻e̞nẽ̞nts̻ut̪e̞
bazenentzuzki	bas̻e̞nẽ̞nts̻us̻ki
bazenentzuzkite	bas̻e̞nẽ̞nts̻us̻kit̪e̞
bazenerakuski	bas̻e̞ne̞ɾakus̺ki
bazenerakuskite	bas̻e̞ne̞ɾakus̺kit̪e̞
bazenerakutsa	bas̻e̞ne̞ɾakuts̺a
bazenerakutsate	bas̻e̞ne̞ɾakuts̺at̪e̞
bazeneuka	bas̺eneu̯ka
bazeneuka	bas̻eneu̯ka
bazeneukate	bas̺eneu̯kat̪e
bazeneukate	bas̻eneu̯kat̪e
bazeneuzka	bas̺eneu̯s̺ka
bazeneuzka	bas̻eneu̯s̻ka
bazeneuzkate	bas̺eneu̯s̺kat̪e
bazeneuzkate	bas̻eneu̯s̻kat̪e
bazeneza	bas̺enes̺a
bazeneza	bas̻enes̻a
bazenezagu	bas̻e̞ne̞s̻aɣ̞u
bazenezagute	bas̻e̞ne̞s̻aɣ̞ut̪e̞
bazenezaguzki	bas̻e̞ne̞s̻aɣ̞us̻ki
bazenezaguzkite	bas̻e̞ne̞s̻aɣ̞us̻kit̪e̞
bazenezate	bas̺enes̺at̪e
bazenezate	bas̻enes̻at̪e
bazenihardu	bas̻e̞niarð̞u
bazenihardu	bas̻e̞niɦarð̞u
bazeniharduka	bas̻e̞niarð̞uka
bazeniharduka	bas̻e̞niɦarð̞uka
bazenihardukate	bas̻e̞niarð̞ukat̪e̞
bazenihardukate	bas̻e̞niɦarð̞ukat̪e̞
bazenihardute	bas̻e̞niarð̞ut̪e̞
bazenihardute	bas̻e̞niɦarð̞ut̪e̞
bazenirau	bas̻e̞niɾau̯
bazeniraute	bas̻e̞niɾau̯t̪e̞
bazenirudi	bas̻e̞niɾuð̞i
bazenirudite	bas̻e̞niɾuð̞it̪e̞
bazenitu	bas̻e̞nit̪u
bazenituzte	bas̻e̞nit̪us̻t̪e̞
bazenitza	bas̺enits̻a
bazenitza	bas̻enits̻a
bazenitzate	bas̺enits̻at̪e
bazenitzate	bas̻enits̻at̪e
bazentoz	bas̺ẽn̪t̪os̺
bazentoz	bas̻ẽn̪t̪os̻
bazentozte	bas̺ẽn̪t̪os̺t̪e
bazentozte	bas̻ẽn̪t̪os̻t̪e
bazenu	bas̻e̞nu
bazenute	bas̻e̞nut̪e̞
bazeunde	bas̺ẽũ̯n̪d̪e
bazeunde	bas̻ẽũ̯n̪d̪e
bazeundete	bas̺ẽũ̯n̪d̪et̪e
bazeundete	bas̻ẽũ̯n̪d̪et̪e
bazina	bas̻ina
bazina	bas̺iɲa
bazina	bas̻iɲa
bazindezaguzki	bas̻ĩn̪d̪e̞s̻aɣ̞us̻ki
bazindezaguzkigu	bas̻ĩn̪d̪e̞s̻aɣ̞us̻kiɣ̞u
bazindezaguzkit	bas̻ĩn̪d̪e̞s̻aɣ̞us̻kit̪
bazindezaguzkite	bas̻ĩn̪d̪e̞s̻aɣ̞us̻kit̪e̞
bazindezaguzte	bas̻ĩn̪d̪e̞s̻aɣ̞us̻t̪e̞
bazindezaguztegu	bas̻ĩn̪d̪e̞s̻aɣ̞us̻t̪e̞ɣ̞u
bazindezaguztet	bas̻ĩn̪d̪e̞s̻aɣ̞us̻t̪e̞t̪
bazindezaguztete	bas̻ĩn̪d̪e̞s̻aɣ̞us̻t̪e̞t̪e̞
bazindoaz	bas̺ĩn̪d̪oas̺
bazindoaz	bas̻ĩn̪d̪oas̻
bazindoazte	bas̺ĩn̪d̪oas̺t̪e
bazindoazte	bas̻ĩn̪d̪oas̻t̪e
bazinduzka	bas̺ĩn̪d̪us̺ka
bazinduzka	bas̻ĩn̪d̪us̻ka
bazinduzkagu	bas̺ĩn̪d̪us̺kaɣ̞u
bazinduzkagu	bas̻ĩn̪d̪us̻kaɣ̞u
bazinduzkat	bas̺ĩn̪d̪us̺kat̪
bazinduzkat	bas̻ĩn̪d̪us̻kat̪
bazinduzkate	bas̺ĩn̪d̪us̺kat̪e
bazinduzkate	bas̻ĩn̪d̪us̻kat̪e
bazinduzkategu	bas̺ĩn̪d̪us̺kat̪eɣ̞u
bazinduzkategu	bas̻ĩn̪d̪us̻kat̪eɣ̞u
bazinduzkatet	bas̺ĩn̪d̪us̺kat̪et̪
bazinduzkatet	bas̻ĩn̪d̪us̻kat̪et̪
bazinduzkatete	bas̺ĩn̪d̪us̺kat̪et̪e
bazinduzkatete	bas̻ĩn̪d̪us̻kat̪et̪e
bazinete	bas̻inet̪e
bazinete	bas̺iɲet̪e
bazinete	bas̻iɲet̪e
bazintez	bas̺ĩn̪t̪es̺
bazintez	bas̻ĩn̪t̪es̻
bazintezte	bas̺ĩn̪t̪es̺t̪e
bazintezte	bas̻ĩn̪t̪es̻t̪e
bazintu	bas̻ĩn̪t̪u
bazintugu	bas̻ĩn̪t̪uɣ̞u
bazintut	bas̻ĩn̪t̪ut̪
bazintuzte	bas̻ĩn̪t̪us̻t̪e̞
bazintuztegu	bas̻ĩn̪t̪us̻t̪e̞ɣ̞u
bazintuztet	bas̻ĩn̪t̪us̻t̪e̞t̪
bazintuztete	bas̻ĩn̪t̪us̻t̪e̞t̪e̞
bazintza	bas̺ĩnts̻a
bazintza	bas̻ĩnts̻a
bazintzagu	bas̺ĩnts̻aɣ̞u
bazintzagu	bas̻ĩnts̻aɣ̞u
bazintzat	bas̺ĩnts̻at̪
bazintzat	bas̻ĩnts̻at̪
bazintzate	bas̺ĩnts̻at̪e
bazintzate	bas̻ĩnts̻at̪e
bazintzategu	bas̺ĩnts̻at̪eɣ̞u
bazintzategu	bas̻ĩnts̻at̪eɣ̞u
bazintzatet	bas̺ĩnts̻at̪et̪
bazintzatet	bas̻ĩnts̻at̪et̪
bazintzatete	bas̺ĩnts̻at̪et̪e
bazintzatete	bas̻ĩnts̻at̪et̪e
bazkaldu	bas̻kal̪d̪u
bazkari	bas̺kaɾi
bazkari	bas̻kaɾi
bazter	bas̺t̪er
bazter	bas̻t̪er
baztertu	bas̺t̪ert̪u
baztertu	bas̻t̪ert̪u
b	be̞
beasain	beas̺ãĩ̯n
be	be̞
bebil	beβ̞il
bebiltza	beβ̞ilts̻a
becquerel	bekeɾel
bedeinkatu	beð̞ei̯ŋkat̪u
bederatzi	beð̞eɾats̻i
bederatzigarren	beð̞eɾats̻iɣ̞arẽn
bedi	beð̞i
begi	beɣ̞i
begira	beɣ̞iɾa
begiratu	beɣ̞iɾat̪u
begiratuko	beɣ̞iɾat̪uko
begiratze	beɣ̞iɾats̻e
begiratzen	beɣ̞iɾats̻ẽn
begite	beɣ̞it̪e
begitza	beɣ̞its̻a
bego	beɣ̞o
behar	be̞ar
behar	be̞ɦar
behartsu	bearts̺u
behartsu	bearts̻u
behartsu	beharts̺u
behartu	be̞art̪u
behartu	be̞ɦart̪u
behatz	beats̻
behatz	behats̻
behi	behi
behi	bei̯
behikunde	behikũn̪d̪e
behikunde	bei̯kũn̪d̪e
behor	behor
behor	beor
bekain	bekãĩ̯n
bekatu	bekat̪u
beki	be̞ki
bekie	be̞kie̞
bekite	be̞kit̪e̞
bekizki	be̞kis̻ki
bekizkite	be̞kis̻kit̪e̞
bekusa	be̞kus̺a
bekusate	be̞kus̺at̪e̞
bekuski	be̞kus̺ki
bekuskite	be̞kus̺kit̪e̞
belar	belar
belarri	be̞lari
belaun	belãũ̯n
belaunburu	belãũ̯mbuɾu
beldur	bel̪d̪ur
bele	bele
belgika	belɣ̞ika
belgikar	be̞lɣ̞ikar
beltx	be̞lʲtʃ
beltz	be̞lts̻
belz	be̞ls̻
bentzu	bẽ̞nts̻u
bentzute	bẽ̞nts̻ut̪e̞
bentzuzki	bẽ̞nts̻us̻ki
bentzuzkite	bẽ̞nts̻us̻kit̪e̞
bepuru	bepuɾu
bera	beɾa
berakuski	be̞ɾakus̺ki
berakuskite	be̞ɾakus̺kit̪e̞
berakutsa	be̞ɾakuts̺a
berakutsate	be̞ɾakuts̺at̪e̞
berastegi	beɾas̺t̪eɣ̞i
beraz	beɾas̺
beraz	beɾas̻
berde	be̞rð̞e̞
berdin	be̞rð̞ĩn
berdindu	berð̞ĩn̪d̪u
berdintasun	berð̞ĩn̪t̪as̺ũn
berdintsu	berð̞ĩnts̺u
berdintsu	berð̞ĩnts̻u
berdintza	berð̞ĩnts̻a
bere	beɾe
beren	beɾẽn
bereziki	beɾes̺iki
bereziki	beɾes̻iki
berezitasun	beɾes̺it̪as̺ũn
berezitasun	beɾes̻it̪as̺ũn
bergara	berɣ̞aɾa
berilio	beɾilio
bermatu	bermat̪u
berme	be̞rme̞
bernedo	berneð̞o
beroa	be̞ɾo̞a
beroate	be̞ɾo̞at̪e̞
beroatza	be̞ɾo̞ats̻a
beroatzate	be̞ɾo̞ats̻at̪e̞
bero	be̞ɾo̞
berori	beɾoɾi
berpiztu	be̞rpis̻t̪u
berregin	be̞re̞ɣ̞ĩn
berri	be̞ri
berriro	beriɾo
berritu	berit̪u
berrogei	beroɣ̞ei̯
bertso	be̞rts̺o̞
bertsolari	berts̺olaɾi
bertsolari	berts̻olaɾi
berun	beɾũn
besape	be̞s̺ape̞
besarkada	bes̺arkað̞a
besarkatu	bes̺arkat̪u
beso	bes̺o
beste	be̞s̺t̪e̞
besterendu	bes̺t̪eɾẽn̪d̪u
betaurreko	bet̪au̯reko
betazal	bet̪as̺al
betazal	bet̪as̻al
bete	be̞t̪e̞
beti	be̞t̪i
betile	bet̪ile
betile	bet̪iʎe
betor	bet̪or
betoz	bet̪os̺
betoz	bet̪os̻
betza	bets̻a
beude	beu̯ð̞e
beuka	beu̯ka
beukate	beu̯kat̪e
beutza	beu̯ts̻a
beuzka	beu̯s̺ka
beuzka	beu̯s̻ka
beuzkate	beu̯s̺kat̪e
beuzkate	beu̯s̻kat̪e
beza	bes̺a
beza	bes̻a
bezagu	be̞s̻aɣ̞u
bezagute	be̞s̻aɣ̞ut̪e̞
bezaguzki	be̞s̻aɣ̞us̻ki
bezaguzkite	be̞s̻aɣ̞us̻kit̪e̞
bezala	bes̺ala
bezala	bes̻ala
bezate	bes̺at̪e
bezate	bes̻at̪e
bi	bi
bibote	biβ̞ot̪e
bidarte	bið̞art̪e
bide	bið̞e
bidegorri	bið̞e̞ɣ̞o̞ri
bidesari	bið̞e̞s̺aɾi
bielorrusia	bielorus̺ia
bielorrusiera	bielorus̺ieɾa
biera	bieɾa
bigarren	biɣ̞arẽn
bihar	biar
bihar	bihar
bihardu	biarð̞u
bihardu	biɦarð̞u
biharduka	biarð̞uka
biharduka	biɦarð̞uka
bihardukate	biarð̞ukat̪e̞
bihardukate	biɦarð̞ukat̪e̞
bihardute	biarð̞ut̪e̞
bihardute	biɦarð̞ut̪e̞
biharko	biarko
biharko	biharko
biharrera	biareɾa
biharrera	bihareɾa
bihartik	biart̪ik
bihartik	bihart̪ik
bihitegi	bihit̪eɣ̞i
bihitegi	bit̪eɣ̞i
bihoa	bihoa
bihoa	bixoa
bihoaz	bihoas̻
bihoaz	bixoas̺
bihoaz	bixoas̻
bihotz	biɦo̞ts̻
bihotz	bio̞ts̻
bihur	biɦur
bihur	biur
bihurri	biɦuri
bihurri	biuri
bihurritu	biɦurit̪u
bihurritu	biurit̪u
bihurtu	biɦurt̪u
bihurtu	biurt̪u
bikain	bikãĩ̯n
bikoitz	biko̞i̯ts̻
bikote	biko̞t̪e̞
bila	bila
bila	biʎa
bilatu	bilat̪u
bilatu	biʎat̪u
bilbo	bilβ̞o
bilbotar	bilβ̞ot̪ar
bildil	bil̪d̪il
bildu	bil̪d̪u
bilur	bilur
bilur	biʎur
biologia	bioloɣ̞ia
biologiak	bioloɣ̞iak
bira	biɾa
birao	biɾao̞
birau	biɾau̯
biraute	biɾau̯t̪e̞
biribilketa	biɾiβ̞ilket̪a
birika	biɾika
birudi	biɾuð̞i
birudite	biɾuð̞it̪e̞
bisita	bis̺it̪a
bista	bis̺t̪a
bisuts	bis̺uts̺
bitartean	bit̪art̪eãn
bitez	bit̪es̺
bitez	bit̪es̻
bitza	bits̻a
bitzate	bits̻at̪e
bizar	bis̻ar
biz	bis̺
biz	bis̻
bizi	bis̺i
bizi	bis̻i
bizikleta	bis̻ikle̞t̪a
bizimodu	bis̺imoð̞u
bizimodu	bis̻imoð̞u
bizitza	bis̺its̻a
bizitza	bis̻its̻a
bizkaia	bis̺kai̯a
bizkaia	bis̻kai̯a
bizkar	bis̺kar
bizkar	bis̻kar
bizpahiru	bis̻pahiɾu
bizpahiru	bis̺pai̯ɾu
bizpahiru	bis̻pai̯ɾu
biztanle	bis̺t̪ãnle
biztanle	bis̻t̪ãnle
bloke	bloke
boilur	bo̞i̯lur
boilur	bo̞ʎur
bolada	bo̞lað̞a
bolante	bo̞lãn̪t̪e̞
bolibar	boliβ̞ar
boligrafo	boliɣ̞rafo
boro	bo̞ɾo̞
boronde	bo̞ɾõ̞n̪d̪e̞
borrero	bo̞re̞ɾo̞
bosgarren	boz̺ɣ̞arẽn
boskoitz	bo̞s̺ko̞i̯ts̻
bosniera	boz̺nieɾa
bost	bo̞s̺t̪
bosten	bos̺t̪ẽn
bostortz	bo̞s̺t̪o̞rts̻
bota	bo̞t̪a
botere	bo̞t̪e̞ɾe̞
botila	bot̪ila
botila	bot̪iʎa
boto	bo̞t̪o̞
botoi	bot̪oi̯
boz	bos̺
boz	bos̻
bozkatu	bo̞s̻kat̪u
bozketa	bos̺ket̪a
bozketa	bos̻ket̪a
bretoiera	bret̪oi̯eɾa
brusa	brus̺a
bukatu	bukat̪u
bular	bular
bularki	bularki
bularretako	bularet̪ako
bulgaria	bulɣ̞aɾia
bulgarian	bulɣ̞aɾiãn
bulgariera	bulɣ̞aɾieɾa
bumeran	bume̞ɾãn
burdina	burð̞ina
burdina	burð̞iɲa
burdinbide	burð̞ĩmbið̞e̞
burdingintza	burð̞iŋɡĩnts̻a
burko	burko
buru	buɾu
burugogor	buɾuɣ̞oɣ̞or
buruil	buɾui̯l
burukomin	buɾuko̞mĩn
burumuin	buɾumũĩ̯n
burusoil	buɾus̺oi̯l
buruz	buɾus̻
bustialdi	bus̺t̪ial̪d̪i
busti	bus̺t̪i
bustidura	bus̺t̪ið̞uɾa
buztan	bus̻t̪ãn
bypass	bai̯pas̺
byte	bai̯t̪
caboverdetar	kaβ̞oβ̞erð̞et̪ar
camembert	kamẽmber
camembert	kamẽmbert̪
camping	kãmpĩn
campus	kãmpus̺
cancer	kãns̺er
cancer	kãns̻er
capoeira	kapoei̯ɾa
capricornus	kaprikornus̺
carmeltazita	karmel̪t̪as̺it̪a
carmeltazita	karmel̪t̪as̻it̪a
casting	kas̺t̪ĩn
catering	kat̪eɾĩn
cava	kaβ̞a
cello	tʃelo
chantilly	ʃãn̪t̪iʎi
charleston	tʃarles̺t̪õn
charter	tʃart̪er
chauvinista	tʃoβ̞inis̺t̪a
chef	ʃef
chef	tʃef
chihuahua	tʃiwawa
cicerone	s̺is̺eɾone
cicerone	s̻is̻eɾone
clown	klãũ̯n
collage	kolaʃ
collage	kolaʒ
collie	koli
copyleft	kopileft̪
copyright	kopirai̯t̪
corpus	korpus̺
costarricar	kos̺t̪arikar
coulomb	kulõm
coulomb	kulõmb
country	kãũ̯n̪t̪ri
cowboy	kau̯β̞oi̯
cricket	kriket̪
croissant	krwas̺ãn
cromlech	krõmletʃ
cross	kros̺
ç	s̻e̞au̯ts̺i
ç	s̻e̞ɦau̯ts̺i
cumbia	kũmbia
curling	kurlĩn
curriculum	kurikulũm
curry	kuri
dabil	d̪aβ̞il
dabilela	d̪aβ̞ile̞la
dabilela	d̪aβ̞iʎe̞la
dabilen	d̪aβ̞ilẽn
dabilen	d̪aβ̞iʎẽn
dabilke	d̪aβ̞ilke
dabiltza	d̪aβ̞ilts̻a
dabiltzala	d̪aβ̞ilts̻ala
dabiltzan	d̪aβ̞ilts̻ãn
dabilzke	d̪aβ̞ils̺ke
dabilzke	d̪aβ̞ils̻ke
da	d̪a
dadila	d̪að̞ila
dadila	d̪að̞iʎa
dadin	d̪að̞ĩn
dagi	d̪aɣ̞i
dagigu	d̪aɣ̞iɣ̞u
dagik	d̪aɣ̞ik
dagin	d̪aɣ̞ĩn
dagit	d̪aɣ̞it̪
dagite	d̪aɣ̞it̪e
dagitza	d̪aɣ̞its̻a
dagitzagu	d̪aɣ̞its̻aɣ̞u
dagitzak	d̪aɣ̞its̻ak
dagitzan	d̪aɣ̞its̻ãn
dagitzat	d̪aɣ̞its̻at̪
dagitzate	d̪aɣ̞its̻at̪e
dagitzazu	d̪aɣ̞its̻as̺u
dagitzazu	d̪aɣ̞its̻as̻u
dagitzazue	d̪aɣ̞its̻as̺ue
dagitzazue	d̪aɣ̞its̻as̻ue
dagizu	d̪aɣ̞is̺u
dagizu	d̪aɣ̞is̻u
dagizue	d̪aɣ̞is̺ue
dagizue	d̪aɣ̞is̻ue
dago	d̪aɣ̞o
dagoela	d̪aɣ̞oela
dagoen	d̪aɣ̞oẽn
dagoke	d̪aɣ̞oke
dagonil	d̪aɣ̞onil
daiteke	d̪ai̯t̪eke
daitekek	d̪ai̯t̪ekek
daiteken	d̪ai̯t̪ekẽn
daitezela	d̪ai̯t̪es̺ela
daitezela	d̪ai̯t̪es̻ela
daitezen	d̪ai̯t̪es̺ẽn
daitezen	d̪ai̯t̪es̻ẽn
daitezke	d̪ai̯t̪es̺ke
daitezke	d̪ai̯t̪es̻ke
daitezkek	d̪ai̯t̪es̺kek
daitezkek	d̪ai̯t̪es̻kek
daitezken	d̪ai̯t̪es̺kẽn
daitezken	d̪ai̯t̪es̻kẽn
dakar	d̪akar
daki	d̪aki
dakigu	d̪akiɣ̞u
dakik	d̪akik
dakin	d̪akĩn
dakit	d̪akit̪
dakite	d̪akit̪e̞
dakizki	d̪akis̻ki
dakizkigu	d̪akis̻kiɣ̞u
dakizkik	d̪akis̻kik
dakizkin	d̪akis̻kĩn
dakizkit	d̪akis̻kit̪
dakizkite	d̪akis̻kit̪e̞
dakizkizu	d̪akis̻kis̻u
dakizkizue	d̪akis̻kis̻ue̞
dakizu	d̪akis̻u
dakizue	d̪akis̻ue̞
dakusa	d̪akus̺a
dakusagu	d̪akus̺aɣ̞u
dakusak	d̪akus̺ak
dakusan	d̪akus̺ãn
dakusat	d̪akus̺at̪
dakusate	d̪akus̺at̪e̞
dakusazu	d̪akus̺as̻u
dakusazue	d̪akus̺as̻ue̞
dakuski	d̪akus̺ki
dakuskigu	d̪akus̺kiɣ̞u
dakuskik	d̪akus̺kik
dakuskin	d̪akus̺kĩn
dakuskit	d̪akus̺kit̪
dakuskite	d̪akus̺kit̪e̞
dakuskizu	d̪akus̺kis̻u
dakuskizue	d̪akus̺kis̻ue̞
damu	d̪amu
damutu	d̪amut̪u
daniera	d̪anie̞ɾa
danimarka	d̪animarka
dantza	d̪ãnts̻a
dantzu	d̪ãnts̻u
dantzugu	d̪ãnts̻uɣ̞u
dantzuk	d̪ãnts̻uk
dantzun	d̪ãnts̻ũn
dantzut	d̪ãnts̻ut̪
dantzute	d̪ãnts̻ut̪e̞
dantzuzki	d̪ãnts̻us̻ki
dantzuzkigu	d̪ãnts̻us̻kiɣ̞u
dantzuzkik	d̪ãnts̻us̻kik
dantzuzkin	d̪ãnts̻us̻kĩn
dantzuzkit	d̪ãnts̻us̻kit̪
dantzuzkite	d̪ãnts̻us̻kit̪e̞
dantzuzkizu	d̪ãnts̻us̻kis̻u
dantzuzkizue	d̪ãnts̻us̻kis̻ue̞
dantzuzu	d̪ãnts̻us̻u
dantzuzue	d̪ãnts̻us̻ue̞
darakuski	d̪aɾakus̺ki
darakuskigu	d̪aɾakus̺kiɣ̞u
darakuskik	d̪aɾakus̺kik
darakuskin	d̪aɾakus̺kĩn
darakuskit	d̪aɾakus̺kit̪
darakuskite	d̪aɾakus̺kit̪e̞
darakuskizu	d̪aɾakus̺kis̻u
darakuskizue	d̪aɾakus̺kis̻ue̞
darakutsa	d̪aɾakuts̺a
darakutsagu	d̪aɾakuts̺aɣ̞u
darakutsak	d̪aɾakuts̺ak
darakutsan	d̪aɾakuts̺ãn
darakutsat	d̪aɾakuts̺at̪
darakutsate	d̪aɾakuts̺at̪e̞
darakutsazu	d̪aɾakuts̺as̻u
darakutsazue	d̪aɾakuts̺as̻ue̞
darama	d̪aɾama
daratulu	d̪aɾat̪ulu
dardara	d̪arð̞aɾa
dardaratu	d̪arð̞aɾat̪u
darik	d̪aɾik
darin	d̪aɾĩn
daroa	d̪aɾoa
daroagu	d̪aɾoaɣ̞u
daroak	d̪aɾoak
daroan	d̪aɾoãn
daroat	d̪aɾoat̪
daroate	d̪aɾoat̪e
daroatza	d̪aɾo̞ats̻a
daroatzagu	d̪aɾo̞ats̻aɣ̞u
daroatzak	d̪aɾo̞ats̻ak
daroatzan	d̪aɾo̞ats̻ãn
daroatzat	d̪aɾo̞ats̻at̪
daroatzate	d̪aɾo̞ats̻at̪e̞
daroatzazu	d̪aɾo̞ats̻as̻u
daroatzazue	d̪aɾo̞ats̻as̻ue̞
daroazu	d̪aɾoas̺u
daroazu	d̪aɾoas̻u
daroazue	d̪aɾoas̺ue
daroazue	d̪aɾoas̻ue
dateke	d̪at̪eke
dator	d̪at̪or
datorke	d̪at̪orke
datorrela	d̪at̪orela
datorren	d̪at̪orẽn
datoz	d̪at̪os̺
datoz	d̪at̪os̻
datozela	d̪at̪os̺ela
datozela	d̪at̪os̻ela
datozen	d̪at̪os̺ẽn
datozen	d̪at̪os̻ẽn
datozke	d̪at̪os̺ke
datozke	d̪at̪os̻ke
datu	d̪at̪u
datxekie	d̪atʃekie
datxekigu	d̪atʃekiɣ̞u
datxekik	d̪atʃekik
datxekin	d̪atʃekĩn
datxekio	d̪atʃekio
datxekit	d̪atʃekit̪
datxekizu	d̪atʃekis̺u
datxekizu	d̪atʃekis̻u
datxekizue	d̪atʃekis̺ue
datxekizue	d̪atʃekis̻ue
datxezkie	d̪atʃes̺kie
datxezkie	d̪atʃes̻kie
datxezkigu	d̪atʃes̺kiɣ̞u
datxezkigu	d̪atʃes̻kiɣ̞u
datxezkik	d̪atʃes̺kik
datxezkik	d̪atʃes̻kik
datxezkin	d̪atʃes̺kĩn
datxezkin	d̪atʃes̻kĩn
datxezkio	d̪atʃes̺kio
datxezkio	d̪atʃes̻kio
datxezkit	d̪atʃes̺kit̪
datxezkit	d̪atʃes̻kit̪
datxezkizu	d̪atʃes̺kis̺u
datxezkizu	d̪atʃes̻kis̻u
datxezkizue	d̪atʃes̺kis̺ue
datxezkizue	d̪atʃes̻kis̻ue
datza	d̪ats̻a
daude	d̪au̯ð̞e
daudeke	d̪au̯ð̞eke
daudela	d̪au̯ð̞ela
dauden	d̪au̯ð̞ẽn
dauka	d̪au̯ka
daukagu	d̪au̯kaɣ̞u
daukak	d̪au̯kak
daukan	d̪au̯kãn
daukat	d̪au̯kat̪
daukate	d̪au̯kat̪e
daukazu	d̪au̯kas̺u
daukazu	d̪au̯kas̻u
daukazue	d̪au̯kas̺ue
daukazue	d̪au̯kas̻ue
dautza	d̪au̯ts̻a
dauzka	d̪au̯s̺ka
dauzka	d̪au̯s̻ka
dauzkagu	d̪au̯s̺kaɣ̞u
dauzkagu	d̪au̯s̻kaɣ̞u
dauzkak	d̪au̯s̺kak
dauzkak	d̪au̯s̻kak
dauzkan	d̪au̯s̺kãn
dauzkan	d̪au̯s̻kãn
dauzkat	d̪au̯s̺kat̪
dauzkat	d̪au̯s̻kat̪
dauzkate	d̪au̯s̺kat̪e
dauzkate	d̪au̯s̻kat̪e
dauzkazu	d̪au̯s̺kas̺u
dauzkazu	d̪au̯s̻kas̻u
dauzkazue	d̪au̯s̺kas̺ue
dauzkazue	d̪au̯s̻kas̻ue
dazagu	d̪as̻aɣ̞u
dazagugu	d̪as̻aɣ̞uɣ̞u
dazaguk	d̪as̻aɣ̞uk
dazagun	d̪as̻aɣ̞ũn
dazagut	d̪as̻aɣ̞ut̪
dazagute	d̪as̻aɣ̞ut̪e̞
dazaguzki	d̪as̻aɣ̞us̻ki
dazaguzkigu	d̪as̻aɣ̞us̻kiɣ̞u
dazaguzkik	d̪as̻aɣ̞us̻kik
dazaguzkin	d̪as̻aɣ̞us̻kĩn
dazaguzkit	d̪as̻aɣ̞us̻kit̪
dazaguzkite	d̪as̻aɣ̞us̻kit̪e̞
dazaguzkizu	d̪as̻aɣ̞us̻kis̻u
dazaguzkizue	d̪as̻aɣ̞us̻kis̻ue̞
dazaguzu	d̪as̻aɣ̞us̻u
dazaguzue	d̪as̻aɣ̞us̻ue̞
d	d̪e̞
deabru	d̪e̞aβ̞ru
deabrukeria	d̪eaβ̞rukeɾia
de	d̪e̞
deia	d̪e̞i̯a
dei	d̪e̞i̯
deien	d̪e̞i̯ẽ̞n
deiez	d̪ei̯es̺
deiez	d̪ei̯es̻
deira	d̪ei̯ɾa
deiri	d̪ei̯ɾi
deitara	d̪ei̯t̪aɾa
deitu	d̪ei̯t̪u
deitura	d̪e̞i̯t̪uɾa
denda	d̪ẽn̪d̪a
dendari	d̪ẽn̪d̪aɾi
derrigortu	d̪e̞riɣ̞o̞rt̪u
desagertu	d̪e̞s̺aɣ̞e̞rt̪u
desberdin	d̪e̞z̺β̞e̞rð̞ĩn
desberdintasun	d̪e̞z̺β̞e̞rð̞ĩn̪t̪as̺ũn
desegigo	d̪es̺eɣ̞iɣ̞o
desegin	d̪es̺eɣ̞ĩn
desira	d̪e̞s̺iɾa
desiratu	d̪es̺iɾat̪u
deskargatu	d̪e̞s̺karɣ̞at̪u
despit	d̪e̞s̺pit̪
dezaala	d̪es̺aala
dezaala	d̪es̻aala
dezaan	d̪es̺aãn
dezaan	d̪es̻aãn
dezadala	d̪es̺að̞ala
dezadala	d̪es̻að̞ala
dezadan	d̪es̺að̞ãn
dezadan	d̪es̻að̞ãn
dezagula	d̪es̺aɣ̞ula
dezagula	d̪es̻aɣ̞ula
dezagun	d̪es̺aɣ̞ũn
dezagun	d̪es̻aɣ̞ũn
dezake	d̪es̺ake
dezake	d̪es̻ake
dezakegu	d̪es̺akeɣ̞u
dezakegu	d̪es̻akeɣ̞u
dezakek	d̪es̺akek
dezakek	d̪es̻akek
dezaken	d̪es̺akẽn
dezaken	d̪es̻akẽn
dezaket	d̪es̺aket̪
dezaket	d̪es̻aket̪
dezakete	d̪es̺aket̪e
dezakete	d̪es̻aket̪e
dezakezu	d̪es̺akes̺u
dezakezu	d̪es̻akes̻u
dezakezue	d̪es̺akes̺ue
dezakezue	d̪es̻akes̻ue
dezala	d̪es̺ala
dezala	d̪es̻ala
dezanala	d̪es̺anala
dezanala	d̪es̻anala
dezanan	d̪es̺anãn
dezanan	d̪es̻anãn
dezan	d̪es̺ãn
dezan	d̪es̻ãn
dezatela	d̪es̺at̪ela
dezatela	d̪es̻at̪ela
dezaten	d̪es̺at̪ẽn
dezaten	d̪es̻at̪ẽn
dezazuela	d̪es̺as̺uela
dezazuela	d̪es̻as̻uela
dezazuen	d̪es̺as̺uẽn
dezazuen	d̪es̻as̻uẽn
dezazula	d̪es̺as̺ula
dezazula	d̪es̻as̻ula
dezazun	d̪es̺as̺ũn
dezazun	d̪es̻as̻ũn
dibertitu	d̪iβ̞ert̪it̪u
dibertsio	d̪iβ̞erts̺io
dibertsio	d̪iβ̞erts̻io
dihardu	d̪iarð̞u
dihardu	d̪iɦarð̞u
dihardugu	d̪iarð̞uɣ̞u
dihardugu	d̪iɦarð̞uɣ̞u
diharduka	d̪iarð̞uka
diharduka	d̪iɦarð̞uka
dihardukagu	d̪iarð̞ukaɣ̞u
dihardukagu	d̪iɦarð̞ukaɣ̞u
dihardukak	d̪iarð̞ukak
dihardukak	d̪iɦarð̞ukak
dihardukan	d̪iarð̞ukãn
dihardukan	d̪iɦarð̞ukãn
dihardukat	d̪iarð̞ukat̪
dihardukat	d̪iɦarð̞ukat̪
dihardukate	d̪iarð̞ukat̪e̞
dihardukate	d̪iɦarð̞ukat̪e̞
dihardukazu	d̪iarð̞ukas̻u
dihardukazu	d̪iɦarð̞ukas̻u
dihardukazue	d̪iarð̞ukas̻ue̞
dihardukazue	d̪iɦarð̞ukas̻ue̞
diharduk	d̪iarð̞uk
diharduk	d̪iɦarð̞uk
dihardun	d̪iarð̞ũn
dihardun	d̪iɦarð̞ũn
dihardut	d̪iarð̞ut̪
dihardut	d̪iɦarð̞ut̪
dihardute	d̪iarð̞ut̪e̞
dihardute	d̪iɦarð̞ut̪e̞
diharduzu	d̪iarð̞us̻u
diharduzu	d̪iɦarð̞us̻u
diharduzue	d̪iarð̞us̻ue̞
diharduzue	d̪iɦarð̞us̻ue̞
dira	d̪iɾa
dirateke	d̪iɾat̪eke
dirau	d̪iɾau̯
diraugu	d̪iɾau̯ɣ̞u
dirauk	d̪iɾau̯k
diraun	d̪iɾãũ̯n
diraut	d̪iɾau̯t̪
diraute	d̪iɾau̯t̪e̞
dirauzu	d̪iɾau̯s̻u
dirauzue	d̪iɾau̯s̻ue̞
dirudi	d̪iɾuð̞i
dirudigu	d̪iɾuð̞iɣ̞u
dirudik	d̪iɾuð̞ik
dirudin	d̪iɾuð̞ĩn
diru	d̪iɾu
dirudit	d̪iɾuð̞it̪
dirudite	d̪iɾuð̞it̪e̞
dirudizu	d̪iɾuð̞is̻u
dirudizue	d̪iɾuð̞is̻ue̞
disfrutatu	d̪is̺frut̪at̪u
disko	d̪is̺ko̞
diskoetxe	d̪is̺ko̞e̞tʃe̞
ditu	d̪it̪u
ditugu	d̪it̪uɣ̞u
dituk	d̪it̪uk
ditun	d̪it̪ũn
ditut	d̪it̪ut̪
dituzke	d̪it̪us̺ke
dituzke	d̪it̪us̻ke
dituzkegu	d̪it̪us̺keɣ̞u
dituzkegu	d̪it̪us̻keɣ̞u
dituzkek	d̪it̪us̺kek
dituzkek	d̪it̪us̻kek
dituzken	d̪it̪us̺kẽn
dituzken	d̪it̪us̻kẽn
dituzket	d̪it̪us̺ket̪
dituzket	d̪it̪us̻ket̪
dituzkete	d̪it̪us̺ket̪e
dituzkete	d̪it̪us̻ket̪e
dituzkezu	d̪it̪us̺kes̺u
dituzkezu	d̪it̪us̻kes̻u
dituzkezue	d̪it̪us̺kes̺ue
dituzkezue	d̪it̪us̻kes̻ue
dituzte	d̪it̪us̺t̪e
dituzte	d̪it̪us̻t̪e
dituzu	d̪it̪us̻u
dituzue	d̪it̪us̺ue
dituzue	d̪it̪us̻ue
ditzaala	d̪its̻aala
ditzaan	d̪its̻aãn
ditzadala	d̪its̻að̞ala
ditzadan	d̪its̻að̞ãn
ditzagula	d̪its̻aɣ̞ula
ditzagun	d̪its̻aɣ̞ũn
ditzake	d̪its̻ake
ditzakegu	d̪its̻akeɣ̞u
ditzakek	d̪its̻akek
ditzaken	d̪its̻akẽn
ditzaket	d̪its̻aket̪
ditzakete	d̪its̻aket̪e
ditzakezu	d̪its̻akes̺u
ditzakezu	d̪its̻akes̻u
ditzakezue	d̪its̻akes̺ue
ditzakezue	d̪its̻akes̻ue
ditzala	d̪its̻ala
ditzanala	d̪its̻anala
ditzanan	d̪its̻anãn
ditzan	d̪its̻ãn
ditzatela	d̪its̻at̪ela
ditzaten	d̪its̻at̪ẽn
ditzazuela	d̪its̻as̺uela
ditzazuela	d̪its̻as̻uela
ditzazuen	d̪its̻as̺uẽn
ditzazuen	d̪its̻as̻uẽn
ditzazula	d̪its̻as̺ula
ditzazula	d̪its̻as̻ula
ditzazun	d̪its̻as̺ũn
ditzazun	d̪its̻as̻ũn
dizipulu	d̪is̺ipulu
dizipulu	d̪is̻ipulu
doa	d̪oa
doake	d̪oake
doan	d̪oãn
doaz	d̪oas̺
doaz	d̪oas̻
doazen	d̪oas̺ẽn
doazen	d̪oas̻ẽn
doazke	d̪oas̺ke
doazke	d̪oas̻ke
dohainik	d̪oaɲik
dohainik	d̪ohai̯nik
doinu	d̪o̞i̯nu
doinu	d̪o̞ɲu
dokumentu	d̪o̞kumẽ̞n̪t̪u
dolar	d̪o̞lar
domeka	d̪o̞me̞ka
done	d̪one
donostia	d̪onos̺t̪ia
dorretxe	d̪oretʃe
dortoka	d̪ort̪oka
dotore	d̪o̞t̪o̞ɾe̞
dozena	d̪o̞s̻e̞na
droga	d̪roɣ̞a
dromedario	d̪romeð̞aɾio
du	d̪u
duela	d̪uela
dugu	d̪uɣ̞u
duk	d̪uk
duke	d̪uke
dukegu	d̪ukeɣ̞u
dukek	d̪ukek
duken	d̪ukẽn
duket	d̪uket̪
dukete	d̪uket̪e
dukezu	d̪ukes̺u
dukezu	d̪ukes̻u
dukezue	d̪ukes̺ue
dukezue	d̪ukes̻ue
dun	d̪ũn
durundi	d̪uɾũn̪d̪i
dut	d̪ut̪
dute	d̪ut̪e
duzu	d̪us̺u
duzu	d̪us̻u
duzue	d̪us̺ue
duzue	d̪us̻ue
dzast	d̪s̻as̺t̪
ea	ea
ebaki	eβ̞aki
ebanjelio	eβ̞ãnʲdʒelio
ebanjelio	eβ̞ãɲjelio
ebanjelio	eβ̞ãɲɟelio
ebanjelio	eβ̞aŋxelio
ebiakoitz	e̞β̞iako̞i̯ts̻
edan	eð̞ãn
edari	eð̞aɾi
eder	eð̞er
eder	e̞ð̞e̞r
edertasun	eð̞ert̪as̺ũn
edin	e̞ð̞ĩn
edo	eð̞o
edonor	eð̞onor
edorta	e̞ð̞o̞rt̪a
edozein	eð̞os̺ẽĩ̯n
edozein	eð̞os̻ẽĩ̯n
edozer	eð̞os̺er
edozer	eð̞os̻er
eduki	eð̞uki
edukiko	eð̞ukiko
edukitze	eð̞ukits̻e
edukitzen	eð̞ukits̻ẽn
edun	e̞ð̞ũn
e	e̞
efe	e̞fe̞
egarri	eɣ̞ari
egia	e̞ɣ̞ia
egiaz	eɣ̞ias̺
egiaz	eɣ̞ias̻
egiazko	e̞ɣ̞ias̻ko̞
egiaztatu	e̞ɣ̞ias̻t̪at̪u
egik	eɣ̞ik
egile	eɣ̞ile
egile	eɣ̞iʎe
egin	eɣ̞ĩn
egingo	eɣ̞iŋɡo
egitasmo	e̞ɣ̞it̪az̺mo̞
egite	eɣ̞it̪e
egiten	eɣ̞it̪ẽn
egitzak	eɣ̞its̻ak
egitzan	eɣ̞its̻ãn
egitzazue	eɣ̞its̻as̺ue
egitzazue	eɣ̞its̻as̻ue
egitzazu	eɣ̞its̻as̺u
egitzazu	eɣ̞its̻as̻u
egizue	eɣ̞is̺ue
egizue	eɣ̞is̻ue
egizu	eɣ̞is̺u
egizu	eɣ̞is̻u
egokitu	eɣ̞okit̪u
egon	e̞ɣ̞õ̞n
egongo	eɣ̞oŋɡo
egosi	e̞ɣ̞o̞s̺i
egote	eɣ̞ot̪e
egoten	eɣ̞ot̪ẽn
eguazten	e̞ɣ̞uas̻t̪ẽ̞n
egubakoitz	e̞ɣ̞uβ̞ako̞i̯ts̻
eguberri	eɣ̞uβ̞eri
eguen	e̞ɣ̞uẽ̞n
eguerdi	eɣ̞uerð̞i
egun	e̞ɣ̞ũn
egungo	eɣ̞uŋɡo
egunkari	eɣ̞uŋkaɾi
eguraldi	eɣ̞uɾal̪d̪i
egur	eɣ̞ur
eguzki	eɣ̞us̺ki
eguzki	eɣ̞us̻ki
eguzkitsu	eɣ̞us̺kits̻u
eguzkitsu	eɣ̞us̻kits̺u
ehe	ẽh̃ẽ
ehiza	e̞ɦis̻a
ehiza	e̞i̯s̻a
ehiztari	ehis̻t̪aɾi
ehiztari	ei̯s̺t̪aɾi
ehiztari	ei̯s̻t̪aɾi
eho	eho
eho	eo
ehundu	e̞ɦũn̪d̪u
ehundu	ẽ̞ũ̯n̪d̪u
ehun	e̞ɦũn
ehun	ẽ̞ũ̯n
eibar	ei̯β̞ar
ekain	e̞kãĩ̯n
ekaiztsu	e̞kai̯s̻ts̺u
ekark	ekark
ekarna	ekarna
ekarri	e̞kari
ekialde	e̞kial̪d̪e̞
ekuador	ekwað̞or
eldarnio	el̪d̪arnio
ele	e̞le̞
elefante	e̞le̞fãn̪t̪e̞
elexpuru	e̞le̞ʃpuɾu
elgoibar	elɣ̞oi̯β̞ar
eliza	elis̺a
eliza	elis̻a
elizbarruti	eliz̺β̞arut̪i
elizbarruti	eliz̻β̞arut̪i
elkar	elkar
elkarlan	elkarlãn
elkarrekin	elkarekĩn
elkarren	e̞lkarẽ̞n
elkarrengana	e̞lkarẽ̞ŋɡana
elkarrenganaino	e̞lkarẽ̞ŋɡanai̯no̞
elkarrenganaino	e̞lkarẽ̞ŋɡanaɲo̞
elkarrenganako	e̞lkarẽ̞ŋɡanako̞
elkarrenganantz	e̞lkarẽ̞ŋɡanãnts̻
elkarrengandik	e̞lkarẽ̞ŋɡãn̪d̪ik
elkarrengan	e̞lkarẽ̞ŋɡãn
elkarrengatik	e̞lkarẽ̞ŋɡat̪ik
elkarrentzat	e̞lkarẽ̞nts̻at̪
elkarrez	e̞lkare̞s̻
elkarri	e̞lkari
elkartasun	elkart̪as̺ũn
elkartu	elkart̪u
eltxo	e̞lʲtʃo̞
emagaldu	e̞maɣ̞al̪d̪u
emagizon	emaɣ̞is̺õn
emagizon	emaɣ̞is̻õn
emakume	e̞makume̞
eman	e̞mãn
emaztegai	emas̺t̪eɣ̞ai̯
emaztegai	emas̻t̪eɣ̞ai̯
eme	e̞me̞
enara	e̞naɾa
ene	e̞ne̞
eñe	eɲe
enegan	e̞ne̞ɣ̞ãn
eneko	e̞ne̞ko̞
enigmatiko	eniɣ̞mat̪iko
entziklopedia	ẽnts̻iklopeð̞ia
entzuk	ẽ̞nts̻uk
entzun	ẽ̞nts̻ũn
entzungor	ẽ̞nts̻ũŋɡo̞r
entzuzue	ẽ̞nts̻us̻ue̞
entzuzu	ẽ̞nts̻us̻u
epai	epai̯
epaikari	epai̯kaɾi
epaiketa	epai̯ket̪a
epaile	epai̯le
epaile	epaʎe
epail	e̞pai̯l
epaitegi	epai̯t̪eɣ̞i
epaitu	epai̯t̪u
eper	e̞pe̞r
epidemiologiko	e̞pið̞e̞mio̞lo̞ɣ̞iko̞
erabakitze	eɾaβ̞akits̻e
erabili	eɾaβ̞ili
erabili	eɾaβ̞iʎi
erabilketa	eɾaβ̞ilket̪a
erabiltzaile	eɾaβ̞ilts̻ai̯le
erabiltzaile	eɾaβ̞ilts̻aʎe
eragin	eɾaɣ̞ĩn
eraikin	e̞ɾai̯kĩn
erakuskuk	eɾakus̺kuk
erakuskun	eɾakus̺kũn
erakuskuzue	eɾakus̺kus̺ue
erakuskuzue	eɾakus̺kus̻ue
erakuskuzu	eɾakus̺kus̺u
erakuskuzu	eɾakus̺kus̻u
erakusmahai	eɾakuz̺mahai̯
erakusmahai	eɾakuz̺mai̯
erakustak	eɾakus̺t̪ak
erakustan	eɾakus̺t̪ãn
erakustazue	eɾakus̺t̪as̺ue
erakustazue	eɾakus̺t̪as̻ue
erakustazu	eɾakus̺t̪as̺u
erakustazu	eɾakus̺t̪as̻u
erakutsak	e̞ɾakuts̺ak
erakutsan	e̞ɾakuts̺ãn
erakutsazkidak	eɾakuts̺as̻kið̞ak
erakutsazkidak	eɾakuts̻as̺kið̞ak
erakutsazkidan	eɾakuts̺as̻kið̞ãn
erakutsazkidan	eɾakuts̻as̺kið̞ãn
erakutsazkidazue	eɾakuts̺as̻kið̞as̻ue
erakutsazkidazue	eɾakuts̻as̺kið̞as̺ue
erakutsazkidazu	eɾakuts̺as̻kið̞as̻u
erakutsazkidazu	eɾakuts̻as̺kið̞as̺u
erakutsazkiek	eɾakuts̺as̻kiek
erakutsazkiek	eɾakuts̻as̺kiek
erakutsazkien	eɾakuts̺as̻kiẽn
erakutsazkien	eɾakuts̻as̺kiẽn
erakutsazkiezue	eɾakuts̺as̻kies̻ue
erakutsazkiezue	eɾakuts̻as̺kies̺ue
erakutsazkiezu	eɾakuts̺as̻kies̻u
erakutsazkiezu	eɾakuts̻as̺kies̺u
erakutsazkiguk	eɾakuts̺as̻kiɣ̞uk
erakutsazkiguk	eɾakuts̻as̺kiɣ̞uk
erakutsazkigun	eɾakuts̺as̻kiɣ̞ũn
erakutsazkigun	eɾakuts̻as̺kiɣ̞ũn
erakutsazkiguzue	eɾakuts̺as̻kiɣ̞us̻ue
erakutsazkiguzue	eɾakuts̻as̺kiɣ̞us̺ue
erakutsazkiguzu	eɾakuts̺as̻kiɣ̞us̻u
erakutsazkiguzu	eɾakuts̻as̺kiɣ̞us̺u
erakutsazkiok	eɾakuts̺as̻kiok
erakutsazkiok	eɾakuts̻as̺kiok
erakutsazkion	eɾakuts̺as̻kiõn
erakutsazkion	eɾakuts̻as̺kiõn
erakutsazkiozue	eɾakuts̺as̻kios̻ue
erakutsazkiozue	eɾakuts̻as̺kios̺ue
erakutsazkiozu	eɾakuts̺as̻kios̻u
erakutsazkiozu	eɾakuts̻as̺kios̺u
erakutsazue	e̞ɾakuts̺as̻ue̞
erakutsazu	e̞ɾakuts̺as̻u
erakutsiek	eɾakuts̺iek
erakutsiek	eɾakuts̻iek
erakutsien	eɾakuts̺iẽn
erakutsien	eɾakuts̻iẽn
erakutsi	eɾakuts̺i
erakutsi	eɾakuts̻i
erakutsiezue	eɾakuts̺ies̻ue
erakutsiezue	eɾakuts̻ies̺ue
erakutsiezu	eɾakuts̺ies̻u
erakutsiezu	eɾakuts̻ies̺u
erakutsiok	eɾakuts̺iok
erakutsiok	eɾakuts̻iok
erakutsion	eɾakuts̺iõn
erakutsion	eɾakuts̻iõn
erakutsiozue	eɾakuts̺ios̻ue
erakutsiozue	eɾakuts̻ios̺ue
erakutsiozu	eɾakuts̺ios̻u
erakutsiozu	eɾakuts̻ios̺u
eraman	eɾamãn
eramankor	eɾamaŋkor
eranskailu	eɾãns̺kai̯lu
eranskailu	eɾãns̺kaʎu
erantsi	eɾãnts̺i
erantsi	eɾãnts̻i
erantzun	e̞ɾãnts̻ũn
erbi	e̞rβ̞i
erdara	erð̞aɾa
erdi	erð̞i
erdigune	erð̞iɣ̞une
erditu	e̞rð̞it̪u
ere	e̞ɾe̞
ereiaro	e̞ɾe̞i̯aɾo̞
ergel	erɣ̞el
eri	e̞ɾi
erion	eɾiõn
eritasun	eɾit̪as̺ũn
erlategi	erlat̪eɣ̞i
erlauntza	erlãũ̯nts̻a
erle	erle
erlezain	erles̺ãĩ̯n
erlezain	erles̻ãĩ̯n
ermita	ermit̪a
erne	erne
eroak	e̞ɾo̞ak
eroan	eɾoãn
eroango	eɾoaŋɡo
eroate	eɾoat̪e
eroaten	eɾoat̪ẽn
eroazue	e̞ɾo̞as̻ue̞
eroazu	e̞ɾo̞as̻u
erori	eɾoɾi
erosak	e̞ɾo̞s̺ak
erosan	e̞ɾo̞s̺ãn
erosazkidak	eɾos̺as̺kið̞ak
erosazkidak	eɾos̺as̻kið̞ak
erosazkidan	eɾos̺as̺kið̞ãn
erosazkidan	eɾos̺as̻kið̞ãn
erosazkidazue	eɾos̺as̺kið̞as̺ue
erosazkidazue	eɾos̺as̻kið̞as̻ue
erosazkidazu	eɾos̺as̺kið̞as̺u
erosazkidazu	eɾos̺as̻kið̞as̻u
erosazkiek	eɾos̺as̺kiek
erosazkiek	eɾos̺as̻kiek
erosazkien	eɾos̺as̺kiẽn
erosazkien	eɾos̺as̻kiẽn
erosazkiezue	eɾos̺as̺kies̺ue
erosazkiezue	eɾos̺as̻kies̻ue
erosazkiezu	eɾos̺as̺kies̺u
erosazkiezu	eɾos̺as̻kies̻u
erosazkiguk	eɾos̺as̺kiɣ̞uk
erosazkiguk	eɾos̺as̻kiɣ̞uk
erosazkigun	eɾos̺as̺kiɣ̞ũn
erosazkigun	eɾos̺as̻kiɣ̞ũn
erosazkiguzue	eɾos̺as̺kiɣ̞us̺ue
erosazkiguzue	eɾos̺as̻kiɣ̞us̻ue
erosazkiguzu	eɾos̺as̺kiɣ̞us̺u
erosazkiguzu	eɾos̺as̻kiɣ̞us̻u
erosazkiok	eɾos̺as̺kiok
erosazkiok	eɾos̺as̻kiok
erosazkion	eɾos̺as̺kiõn
erosazkion	eɾos̺as̻kiõn
erosazkiozue	eɾos̺as̺kios̺ue
erosazkiozue	eɾos̺as̻kios̻ue
erosazkiozu	eɾos̺as̺kios̺u
erosazkiozu	eɾos̺as̻kios̻u
erosazue	e̞ɾo̞s̺as̻ue̞
erosazu	e̞ɾo̞s̺as̻u
eros	eɾos̺
erosiek	eɾos̺iek
erosien	eɾos̺iẽn
erosi	e̞ɾo̞s̺i
erosiezue	eɾos̺ies̺ue
erosiezue	eɾos̺ies̻ue
erosiezu	eɾos̺ies̺u
erosiezu	eɾos̺ies̻u
erosiok	eɾos̺iok
erosion	eɾos̺iõn
erosiozue	eɾos̺ios̺ue
erosiozue	eɾos̺ios̻ue
erosiozu	eɾos̺ios̺u
erosiozu	eɾos̺ios̻u
eroskuk	eɾos̺kuk
eroskun	eɾos̺kũn
eroskuzue	eɾos̺kus̺ue
eroskuzue	eɾos̺kus̻ue
eroskuzu	eɾos̺kus̺u
eroskuzu	eɾos̺kus̻u
erostak	eɾos̺t̪ak
erostan	eɾos̺t̪ãn
erostazue	eɾos̺t̪as̺ue
erostazue	eɾos̺t̪as̻ue
erostazu	eɾos̺t̪as̺u
erostazu	eɾos̺t̪as̻u
erpuru	erpuɾu
erradar	erað̞ar
errain	erãĩ̯n
erraldoi	e̞ral̪d̪o̞i̯
erramu	eramu
erran	erãn
errauts	erau̯ts̺
errauts	erau̯ts̻
erraz	e̞ras̻
erre	ere
erreferentzia	e̞re̞fe̞ɾẽ̞nts̻ia
errege	ereɣ̞e
erregela	ereɣ̞ela
erregina	ereɣ̞ina
erregina	ereɣ̞iɲa
erreka	ereka
errementari	e̞re̞mẽ̞n̪t̪aɾi
errenteria	erẽn̪t̪eɾia
errepide	erepið̞e
errepika	e̞re̞pika
errepikatu	e̞re̞pikat̪u
erresistentzia	eres̺is̺t̪ẽnts̻ia
erresuma	eres̺uma
errez	e̞re̞s̻
errota	e̞ro̞t̪a
errudun	eruð̞ũn
erru	e̞ru
errumania	erumania
errumaniar	e̞rumaniar
errumaniera	erumanieɾa
errusia	erus̺ia
errusiar	e̞rus̺iar
errusiera	erus̺ieɾa
ertzaina	erts̻ai̯na
ertzaina	erts̻aɲa
ertzain	erts̻ãĩ̯n
ertzaintza	erts̻ãĩ̯nts̻a
ertz	e̞rts̻
esaldi	es̺al̪d̪i
esaneko	es̺aneko
esan	es̺ãn
esango	es̺aŋɡo
esanguratsu	es̺aŋɡuɾats̺u
esanguratsu	es̺aŋɡuɾats̻u
esate	es̺at̪e
ese	e̞s̺e̞
eseki	es̺eki
esekitoki	es̺ekit̪oki
eseri	es̺eɾi
eskabide	es̺kaβ̞ið̞e
eskailera	e̞s̺kai̯le̞ɾa
eskailera	e̞s̺kaʎe̞ɾa
eskaini	es̺kai̯ni
eskaini	es̺kaɲi
eskari	es̺kaɾi
eskatu	e̞s̺kat̪u
esker	e̞s̺ke̞r
eskertu	e̞s̺ke̞rt̪u
eskibel	es̺kiβ̞el
eskola	es̺kola
eskozia	e̞s̺ko̞s̻ia
eskribitu	e̞s̺kriβ̞it̪u
eskubila	e̞s̺kuβ̞ila
eskubila	e̞s̺kuβ̞iʎa
esku	e̞s̺ku
eskuin	e̞s̺kũĩ̯n
eskutitz	es̺kut̪its̻
eskuzabal	es̺kus̺aβ̞al
eskuzabal	es̺kus̻aβ̞al
eslogan	ez̺loɣ̞ãn
eslovakia	e̞z̺lo̞β̞akia
eslovakiar	e̞z̺lo̞β̞akiar
eslovakiera	ez̺loβ̞akieɾa
eslovenia	ez̺loβ̞enia
esloveniar	e̞z̺lo̞β̞e̞niar
esloveniera	ez̺loβ̞enieɾa
esnatu	e̞z̺nat̪u
esne	e̞z̺ne̞
espainia	es̺pai̯nia
espainia	es̺paɲia
espainiar	e̞s̺pai̯niar
espainiar	e̞s̺paɲiar
esperanto	e̞s̺pe̞ɾãn̪t̪o̞
espezie	es̺pes̺ie
espezie	es̺pes̻ie
espioi	es̺pioi̯
esportatu	es̺port̪at̪u
esportazio	es̺port̪as̺io
esportazio	es̺port̪as̻io
espresuki	es̺pres̺uki
estalgune	es̺t̪alɣ̞une
estali	e̞s̺t̪ali
estalki	es̺t̪alki
estatua	es̺t̪at̪ua
estatua	es̺t̪at̪wa
estatu	es̺t̪at̪u
estonia	es̺t̪onia
estoniako	e̞s̺t̪o̞niako̞
estonian	e̞s̺t̪o̞niãn
estoniar	e̞s̺t̪o̞niar
estoniera	es̺t̪onieɾa
estralurtar	e̞s̺t̪ralurt̪ar
estrata	e̞s̺t̪rat̪a
estrategia	es̺t̪rat̪eɣ̞ia
estutu	es̺t̪ut̪u
eta	e̞t̪a
eten	e̞t̪ẽ̞n
etete	et̪et̪e
etor	et̪or
etorkin	et̪orkĩn
etorri	et̪ori
etorriko	et̪oriko
etortze	et̪orts̻e
etortzen	et̪orts̻ẽn
etsai	e̞ts̺ai̯
etxague	etʃaɣ̞ue
etxano	etʃano
etxea	etʃea
etxeak	etʃeak
etxean	etʃeãn
etxearekin	etʃeaɾekĩn
etxearen	etʃeaɾẽn
etxearengatik	etʃeaɾeŋɡat̪ik
etxearentzat	etʃeaɾẽnts̻at̪
etxeari	etʃeaɾi
etxeaz	etʃeas̺
etxeaz	etʃeas̻
etxeei	etʃeei̯
etxeek	etʃeek
etxeekin	etʃeekĩn
etxeen	etʃeẽn
etxeengatik	etʃeeŋɡat̪ik
etxeentzat	etʃeẽnts̻at̪
etxeetako	etʃeet̪ako
etxeetan	etʃeet̪ãn
etxeetara	etʃeet̪aɾa
etxeetaraino	etʃeet̪aɾai̯no
etxeetaraino	etʃeet̪aɾaɲo
etxeetarako	etʃeet̪aɾako
etxeetarantz	etʃeet̪aɾãnts̻
etxeetatik	etʃeet̪at̪ik
etxe	etʃe
etxeez	etʃees̺
etxeez	etʃees̻
etxek	etʃek
etxekoandre	etʃekoãn̪d̪re
etxeko	etʃeko
etxera	etʃeɾa
etxeraino	etʃeɾai̯no
etxeraino	etʃeɾaɲo
etxerako	etʃeɾako
etxerantz	etʃeɾãnts̻
etxerekin	etʃeɾekĩn
etxeren	etʃeɾẽn
etxerengatik	etʃeɾeŋɡat̪ik
etxerentzat	etʃeɾẽnts̻at̪
etxeri	etʃeɾi
etxerik	etʃeɾik
etxetako	etʃet̪ako
etxetan	etʃet̪ãn
etxetara	etʃet̪aɾa
etxetaraino	etʃet̪aɾai̯no
etxetaraino	etʃet̪aɾaɲo
etxetarako	etʃet̪aɾako
etxetarantz	etʃet̪aɾãnts̻
etxetatik	etʃet̪at̪ik
etxetik	etʃet̪ik
etxetzat	etʃets̻at̪
etxez	etʃes̺
etxez	etʃes̻
etzan	e̞ts̻ãn
etzango	ets̻aŋɡo
etzate	ets̻at̪e
etzaten	ets̻at̪ẽn
etzi	e̞ts̻i
eukak	eu̯kak
eukan	eu̯kãn
eukazue	eu̯kas̺ue
eukazue	eu̯kas̻ue
eukazu	eu̯kas̺u
eukazu	eu̯kas̻u
euli	e̞u̯li
eultzitu	eu̯lts̻it̪u
eurak	eu̯ɾak
euri	eu̯ɾi
euritako	eu̯ɾit̪ako
euritsu	eu̯ɾits̺u
euritsu	eu̯ɾits̻u
eurok	eu̯ɾok
euskadi	eu̯s̺kað̞i
euskaldun	eu̯s̺kal̪d̪ũn
euskal	eu̯s̺kal
euskalki	eu̯s̺kalki
euskaltegi	eu̯s̺kal̪t̪eɣ̞i
euskaltzaindia	eu̯s̺kalts̻ãĩ̯n̪d̪ia
euskaltzale	e̞u̯s̺kalts̻ale̞
euskara	e̞u̯s̺kaɾa
euskera	e̞u̯s̺ke̞ɾa
eusko	e̞u̯s̺ko̞
eutsi	e̞u̯ts̺i
euzkadi	e̞u̯s̻kað̞i
euzkak	eu̯s̺kak
euzkak	eu̯s̻kak
euzkan	eu̯s̺kãn
euzkan	eu̯s̻kãn
euzkazue	eu̯s̺kas̺ue
euzkazue	eu̯s̻kas̻ue
euzkazu	eu̯s̺kas̺u
euzkazu	eu̯s̻kas̻u
existitu	e̞ks̺is̺t̪it̪u
ezaguk	e̞s̻aɣ̞uk
ezagun	es̺aɣ̞ũn
ezagun	es̻aɣ̞ũn
ezagut	es̺aɣ̞ut̪
ezagut	es̻aɣ̞ut̪
ezagutu	es̺aɣ̞ut̪u
ezagutu	es̻aɣ̞ut̪u
ezagutuko	es̺aɣ̞ut̪uko
ezagutuko	es̻aɣ̞ut̪uko
ezagutze	es̺aɣ̞uts̻e
ezagutze	es̻aɣ̞uts̻e
ezagutzen	es̺aɣ̞uts̻ẽn
ezagutzen	es̻aɣ̞uts̻ẽn
ezaguzue	e̞s̻aɣ̞us̻ue̞
ezaguzu	e̞s̻aɣ̞us̻u
ezak	es̺ak
ezak	es̻ak
ezan	es̺ãn
ezan	es̻ãn
ezarri	e̞s̻ari
ezazue	es̺as̺ue
ezazue	es̻as̻ue
ezazu	es̺as̺u
ezazu	es̻as̻u
ezberdin	e̞z̻β̞e̞rð̞ĩn
ezberdintasun	e̞z̻β̞e̞rð̞ĩn̪t̪as̺ũn
ezer	es̺er
ezer	es̻er
ezeri	e̞s̻e̞ɾi
ez	es̺
ez	es̻
ezetz	es̺ets̻
ezetz	es̻ets̻
ezezagun	e̞s̻e̞s̻aɣ̞ũn
ezjakin	es̻xakĩn
ezjakin	ez̺dʒakĩn
ezjakin	ez̻jakĩn
ezjakin	ez̻ɟakĩn
ezker	e̞s̻ke̞r
ezkerra	e̞s̻ke̞ra
ezkibel	es̺kiβ̞el
ezkibel	es̻kiβ̞el
ezki	es̺ki
ezki	es̻ki
ezko	e̞s̻ko̞
ezkondu	e̞s̻kõ̞n̪d̪u
ezkongabe	e̞s̻kõ̞ŋɡaβ̞e̞
ezkontza	e̞s̻kõ̞nts̻a
ezkor	es̺kor
ezkor	es̻kor
ezkortasun	es̺kort̪as̺ũn
ezkortasun	es̻kort̪as̺ũn
ezkutatu	e̞s̻kut̪at̪u
ezpain	es̺pãĩ̯n
ezpain	es̻pãĩ̯n
ezpata	e̞s̻pat̪a
ezpel	e̞s̻pe̞l
ezpeleta	es̺pelet̪a
ezpeleta	es̻pelet̪a
eztainu	es̻t̪ai̯nu
eztainu	es̺t̪aɲu
eztainu	es̻t̪aɲu
eztarri	e̞s̻t̪ari
eztegui	e̞s̻t̪e̞ɣ̞ui̯
ezti	e̞s̻t̪i
falta	fal̪t̪a
faltsu	falts̺u
faltsu	falts̻u
famatu	famat̪u
familia	familia
fanfarroi	fãɱfaro̞i̯
fardel	farð̞el
fase	fas̺e̞
fatxada	fatʃað̞a
fede	fe̞ð̞e̞
f	e̞fe̞
feltro	fel̪t̪ro
feria	feɾia
festa	fe̞s̺t̪a
fetitxe	fe̞t̪itʃe̞
fetitxismo	fe̞t̪itʃiz̺mo̞
fidatu	fið̞at̪u
filipinak	filipinak
fin	fĩn
finlandia	fĩnlãn̪d̪ia
finlandiar	fĩnlãn̪d̪iar
finlandiera	fĩnlãn̪d̪ieɾa
flatulentzia	flat̪ulẽ̞nts̻ia
fluor	fluo̞r
fonologia	fonoloɣ̞ia
forma	fo̞rma
franko	frãŋko̞
frantses	frãnts̺e̞s̺
frantzia	frãnts̻ia
frantziar	frãnts̻iar
fresko	fres̺ko
frisiera	fris̺ieɾa
frisiera	fris̺jeɾa
froga	fro̞ɣ̞a
fruta	frut̪a
fundatu	fũn̪d̪at̪u
funsgabe	fũnz̺ɣ̞aβ̞e
funsgabeki	fũnz̺ɣ̞aβ̞eki
funsgabeko	fũnz̺ɣ̞aβ̞eko
funsgabetasun	fũnz̺ɣ̞aβ̞et̪as̺ũn
funtsezkotasun	fũnts̺es̻kot̪as̺ũn
funtsezkotasun	fũnts̻es̺kot̪as̺ũn
funts	fũnts̺
funts	fũnts̻
funtzionatu	fũnts̻ionat̪u
fusilari	fus̺ilaɾi
futbol	fut̪β̞ol
gabarra	ɡaβ̞ara
gabe	ɡaβ̞e̞
gabentza	ɡaβ̞ẽnts̻a
gabez	ɡaβ̞e̞s̻
gabiltza	ɡaβ̞ilts̻a
gabiltzan	ɡaβ̞ilts̻ãn
gabilzke	ɡaβ̞ils̺ke
gabilzke	ɡaβ̞ils̻ke
gai	ɡai̯
gailu	ɡai̯lu
gailu	ɡaʎu
gailur	ɡai̯lur
gailur	ɡaʎur
gain	ɡãĩ̯n
gaitezela	ɡai̯t̪es̺ela
gaitezela	ɡai̯t̪es̻ela
gaitezen	ɡai̯t̪es̺ẽn
gaitezen	ɡai̯t̪es̻ẽn
gaitezke	ɡai̯t̪es̺ke
gaitezke	ɡai̯t̪es̻ke
gaitezkek	ɡai̯t̪es̺kek
gaitezkek	ɡai̯t̪es̻kek
gaitezken	ɡai̯t̪es̺kẽn
gaitezken	ɡai̯t̪es̻kẽn
gaitu	ɡai̯t̪u
gaituk	ɡai̯t̪uk
gaitun	ɡai̯t̪ũn
gaituzke	ɡai̯t̪us̺ke
gaituzke	ɡai̯t̪us̻ke
gaituzkek	ɡai̯t̪us̺kek
gaituzkek	ɡai̯t̪us̻kek
gaituzken	ɡai̯t̪us̺kẽn
gaituzken	ɡai̯t̪us̻kẽn
gaituzkete	ɡai̯t̪us̺ket̪e
gaituzkete	ɡai̯t̪us̻ket̪e
gaituzkezue	ɡai̯t̪us̺kes̺ue
gaituzkezue	ɡai̯t̪us̻kes̻ue
gaituzkezu	ɡai̯t̪us̺kes̺u
gaituzkezu	ɡai̯t̪us̻kes̻u
gaituzte	ɡai̯t̪us̻t̪e̞
gaituzue	ɡai̯t̪us̻ue̞
gaituzu	ɡai̯t̪us̻u
gaitzaala	ɡai̯ts̻aala
gaitzaan	ɡai̯ts̻aãn
gaitzake	ɡai̯ts̻ake
gaitzakek	ɡai̯ts̻akek
gaitzaken	ɡai̯ts̻akẽn
gaitzakete	ɡai̯ts̻aket̪e
gaitzakezue	ɡai̯ts̻akes̺ue
gaitzakezue	ɡai̯ts̻akes̻ue
gaitzakezu	ɡai̯ts̻akes̺u
gaitzakezu	ɡai̯ts̻akes̻u
gaitzak	ɡai̯ts̻ak
gaitzala	ɡai̯ts̻ala
gaitzanala	ɡai̯ts̻anala
gaitzanan	ɡai̯ts̻anãn
gaitzan	ɡai̯ts̻ãn
gaitzatela	ɡai̯ts̻at̪ela
gaitzaten	ɡai̯ts̻at̪ẽn
gaitzazue	ɡai̯ts̻as̺ue
gaitzazue	ɡai̯ts̻as̻ue
gaitzazuela	ɡai̯ts̻as̺uela
gaitzazuela	ɡai̯ts̻as̻uela
gaitzazuen	ɡai̯ts̻as̺uẽn
gaitzazuen	ɡai̯ts̻as̻uẽn
gaitzazu	ɡai̯ts̻as̺u
gaitzazu	ɡai̯ts̻as̻u
gaitzazula	ɡai̯ts̻as̺ula
gaitzazula	ɡai̯ts̻as̻ula
gaitzazun	ɡai̯ts̻as̺ũn
gaitzazun	ɡai̯ts̻as̻ũn
gaixo	ɡai̯ʃo
gaixorik	ɡai̯ʃoɾik
gaixotasun	ɡai̯ʃot̪as̺ũn
gaizki	ɡai̯s̺ki
gaizki	ɡai̯s̻ki
gaizkile	ɡai̯s̻kile
gaizkile	ɡai̯s̺kiʎe
gaizkile	ɡai̯s̻kiʎe
gaizto	ɡai̯s̻t̪o̞
galdakao	ɡal̪d̪akao
galdetu	ɡal̪d̪et̪u
galdu	ɡal̪d̪u
galeper	ɡale̞pe̞r
galesera	ɡales̺eɾa
gales	ɡale̞s̺
galiziar	ɡalis̻iar
galtzak	ɡalts̻ak
galtzarbe	ɡalts̻arβ̞e
galtzari	ɡalts̻aɾi
galtzerdi	ɡalts̻e̞rð̞i
galtzetin	ɡalts̻e̞t̪ĩn
gamelu	ɡame̞lu
ganibet	ɡaniβ̞e̞t̪
gantz	ɡãnts̻
garabi	ɡaɾaβ̞i
garagardogile	ɡaɾaɣ̞arð̞oɣ̞ile
garagardogile	ɡaɾaɣ̞arð̞oɣ̞iʎe
garagardogintza	ɡaɾaɣ̞arð̞oɣ̞ĩnts̻a
garagardo	ɡaɾaɣ̞arð̞o
garagardotegi	ɡaɾaɣ̞arð̞ot̪eɣ̞i
garagar	ɡaɾaɣ̞ar
garagarril	ɡaɾaɣ̞aril
gara	ɡaɾa
garai	ɡaɾai̯
garaile	ɡaɾai̯le
garaile	ɡaɾaʎe
garaipen	ɡaɾai̯pẽn
garaitu	ɡaɾai̯t̪u
garateke	ɡaɾat̪eke
garatu	ɡaɾat̪u
garatxo	ɡaɾatʃo
garau	ɡaɾau̯
garautegi	ɡaɾau̯t̪eɣ̞i
garbantzu	ɡarβ̞ãnts̻u
garbigailu	ɡarβ̞iɣ̞ai̯lu
garbigailu	ɡarβ̞iɣ̞aʎu
garbi	ɡarβ̞i
garbiñe	ɡarβ̞iɲe̞
garbitu	ɡarβ̞it̪u
garbitzaile	ɡarβ̞its̻ai̯le
garbitzaile	ɡarβ̞its̻aʎe
garesti	ɡaɾe̞s̺t̪i
garestitu	ɡaɾes̺t̪it̪u
gari	ɡaɾi
garikoitz	ɡaɾikoi̯ts̻
garil	ɡaɾil
garizuma	ɡaɾis̻uma
garun	ɡaɾũn
gasteiz	ɡas̺t̪ei̯s̺
gasteiz	ɡas̺t̪ei̯s̻
gatazka	ɡat̪as̻ka
gatozen	ɡat̪os̺ẽn
gatozen	ɡat̪os̻ẽn
gatoz	ɡat̪os̺
gatoz	ɡat̪os̻
gatozke	ɡat̪os̺ke
gatozke	ɡat̪os̻ke
gatxezkie	ɡatʃes̺kie
gatxezkie	ɡatʃes̻kie
gatxezkik	ɡatʃes̺kik
gatxezkik	ɡatʃes̻kik
gatxezkin	ɡatʃes̺kĩn
gatxezkin	ɡatʃes̻kĩn
gatxezkio	ɡatʃes̺kio
gatxezkio	ɡatʃes̻kio
gatxezkizue	ɡatʃes̺kis̺ue
gatxezkizue	ɡatʃes̻kis̻ue
gatxezkizu	ɡatʃes̺kis̺u
gatxezkizu	ɡatʃes̻kis̻u
gatz	ɡats̻
gaude	ɡau̯ð̞e
gaudeke	ɡau̯ð̞eke
gauden	ɡau̯ð̞ẽn
gauenara	ɡau̯enaɾa
gau	ɡau̯
gaupasa	ɡau̯pas̺a
gaur	ɡau̯r
gautza	ɡau̯ts̻a
gauza	ɡau̯s̻a
gauzatu	ɡau̯s̻at̪u
gauzka	ɡau̯s̺ka
gauzka	ɡau̯s̻ka
gauzkak	ɡau̯s̺kak
gauzkak	ɡau̯s̻kak
gauzkan	ɡau̯s̺kãn
gauzkan	ɡau̯s̻kãn
gauzkate	ɡau̯s̺kat̪e
gauzkate	ɡau̯s̻kat̪e
gauzkazue	ɡau̯s̺kas̺ue
gauzkazue	ɡau̯s̻kas̻ue
gauzkazu	ɡau̯s̺kas̺u
gauzkazu	ɡau̯s̻kas̻u
gazaguzki	ɡas̻aɣ̞us̻ki
gazaguzkik	ɡas̻aɣ̞us̻kik
gazaguzkin	ɡas̻aɣ̞us̻kĩn
gazaguzkite	ɡas̻aɣ̞us̻kit̪e̞
gazaguzkizue	ɡas̻aɣ̞us̻kis̻ue̞
gazaguzkizu	ɡas̻aɣ̞us̻kis̻u
gazi	ɡas̻i
gazta	ɡas̺t̪a
gazta	ɡas̻t̪a
gaztaina	ɡas̻t̪ai̯na
gaztaina	ɡas̻t̪aɲa
gaztainondo	ɡas̻t̪ai̯nõn̪d̪o
gaztainondo	ɡas̺t̪aɲõn̪d̪o
gaztainondo	ɡas̻t̪aɲõn̪d̪o
gazte	ɡas̻t̪e̞
gaztela	ɡas̺t̪ela
gaztela	ɡas̻t̪ela
gaztelania	ɡas̻t̪e̞lania
gaztelera	ɡas̺t̪eleɾa
gaztelera	ɡas̻t̪eleɾa
gaztelu	ɡas̺t̪elu
gaztelu	ɡas̻t̪elu
gebara	ɡeβ̞aɾa
gehiegizko	ɡehieɣ̞is̻ko
gehiegizko	ɡei̯eɣ̞is̺ko
gehiegizko	ɡei̯eɣ̞is̻ko
gehienbat	ɡehiẽmbat̪
gehienbat	ɡei̯ẽmbat̪
gehitu	ɡe̞ɦit̪u
gehitu	ɡe̞i̯t̪u
gela	ɡe̞la
geltokiburu	ɡe̞l̪t̪o̞kiβ̞uɾu
geltokiek	ɡel̪t̪okiek
geltoki	ɡel̪t̪oki
geltokiz	ɡel̪t̪okis̺
geltokiz	ɡel̪t̪okis̻
genbiltzan	ɡẽmbilts̻ãn
genbilzkeen	ɡẽmbils̺keẽn
genbilzkeen	ɡẽmbils̻keẽn
genbilzke	ɡẽmbils̺ke
genbilzke	ɡẽmbils̻ke
genegien	ɡeneɣ̞iẽn
genegike	ɡeneɣ̞ike
genegitzake	ɡeneɣ̞its̻ake
genegitzan	ɡeneɣ̞its̻ãn
genekien	ɡe̞ne̞kiẽ̞n
genekike	ɡe̞ne̞kike̞
genekizke	ɡe̞ne̞kis̻ke̞
genekizkien	ɡe̞ne̞kis̻kiẽ̞n
genekusan	ɡe̞ne̞kus̺ãn
genekusazke	ɡe̞ne̞kus̺as̻ke̞
genekuske	ɡe̞ne̞kus̺ke̞
genekuskien	ɡe̞ne̞kus̺kiẽ̞n
genentzuen	ɡe̞nẽ̞nts̻uẽ̞n
genentzuke	ɡe̞nẽ̞nts̻uke̞
genentzuzke	ɡe̞nẽ̞nts̻us̻ke̞
genentzuzkien	ɡe̞nẽ̞nts̻us̻kiẽ̞n
generakuske	ɡe̞ne̞ɾakus̺ke̞
generakuskien	ɡe̞ne̞ɾakus̺kiẽ̞n
generakutsan	ɡe̞ne̞ɾakuts̺ãn
generakutsazke	ɡe̞ne̞ɾakuts̺as̻ke̞
generoake	ɡe̞ne̞ɾo̞ake̞
generoan	ɡe̞ne̞ɾo̞ãn
generoatzan	ɡe̞ne̞ɾo̞ats̻ãn
generoazke	ɡe̞ne̞ɾo̞as̻ke̞
geneukake	ɡeneu̯kake
geneukan	ɡeneu̯kãn
geneuzkake	ɡeneu̯s̺kake
geneuzkake	ɡeneu̯s̻kake
geneuzkan	ɡeneu̯s̺kãn
geneuzkan	ɡeneu̯s̻kãn
genezaguen	ɡe̞ne̞s̻aɣ̞uẽ̞n
genezaguke	ɡe̞ne̞s̻aɣ̞uke̞
genezaguzke	ɡe̞ne̞s̻aɣ̞us̻ke̞
genezaguzkien	ɡe̞ne̞s̻aɣ̞us̻kiẽ̞n
genezakeen	ɡenes̺akeẽn
genezakeen	ɡenes̻akeẽn
genezake	ɡenes̺ake
genezake	ɡenes̻ake
genezala	ɡenes̺ala
genezala	ɡenes̻ala
genezan	ɡenes̺ãn
genezan	ɡenes̻ãn
geniharduen	ɡe̞niarð̞uẽ̞n
geniharduen	ɡe̞niɦarð̞uẽ̞n
genihardukake	ɡe̞niarð̞ukake̞
genihardukake	ɡe̞niɦarð̞ukake̞
genihardukan	ɡe̞niarð̞ukãn
genihardukan	ɡe̞niɦarð̞ukãn
geniharduke	ɡe̞niarð̞uke̞
geniharduke	ɡe̞niɦarð̞uke̞
genirauen	ɡe̞niɾau̯ẽ̞n
genirauke	ɡe̞niɾau̯ke̞
genirudien	ɡe̞niɾuð̞iẽ̞n
genirudike	ɡe̞niɾuð̞ike̞
genituen	ɡe̞nit̪uẽ̞n
genituzkeen	ɡenit̪us̺keẽn
genituzkeen	ɡenit̪us̻keẽn
genituzke	ɡenit̪us̺ke
genituzke	ɡenit̪us̻ke
genitzakeen	ɡenits̻akeẽn
genitzake	ɡenits̻ake
genitzala	ɡenits̻ala
genitzan	ɡenits̻ãn
genkizkien	ɡẽ̞ŋkis̻kiẽ̞n
genkizkion	ɡẽ̞ŋkis̻kiõ̞n
gentozen	ɡẽn̪t̪os̺ẽn
gentozen	ɡẽn̪t̪os̻ẽn
gentozkeen	ɡẽn̪t̪os̺keẽn
gentozkeen	ɡẽn̪t̪os̻keẽn
gentozke	ɡẽn̪t̪os̺ke
gentozke	ɡẽn̪t̪os̻ke
gentxezkiake	ɡẽnʲtʃes̺kiake
gentxezkiake	ɡẽnʲtʃes̻kiake
gentxezkian	ɡẽnʲtʃes̺kiãn
gentxezkian	ɡẽnʲtʃes̻kiãn
gentxezkieke	ɡẽnʲtʃes̺kieke
gentxezkieke	ɡẽnʲtʃes̻kieke
gentxezkien	ɡẽnʲtʃes̺kiẽn
gentxezkien	ɡẽnʲtʃes̻kiẽn
gentxezkinake	ɡẽnʲtʃes̻kinake
gentxezkinake	ɡẽnʲtʃes̺kiɲake
gentxezkinake	ɡẽnʲtʃes̻kiɲake
gentxezkinan	ɡẽnʲtʃes̻kinãn
gentxezkinan	ɡẽnʲtʃes̺kiɲãn
gentxezkinan	ɡẽnʲtʃes̻kiɲãn
gentxezkioke	ɡẽnʲtʃes̺kioke
gentxezkioke	ɡẽnʲtʃes̻kioke
gentxezkion	ɡẽnʲtʃes̺kiõn
gentxezkion	ɡẽnʲtʃes̻kiõn
gentxezkizueke	ɡẽnʲtʃes̺kis̺ueke
gentxezkizueke	ɡẽnʲtʃes̻kis̻ueke
gentxezkizuen	ɡẽnʲtʃes̺kis̺uẽn
gentxezkizuen	ɡẽnʲtʃes̻kis̻uẽn
gentxezkizuke	ɡẽnʲtʃes̺kis̺uke
gentxezkizuke	ɡẽnʲtʃes̻kis̻uke
gentxezkizun	ɡẽnʲtʃes̺kis̺ũn
gentxezkizun	ɡẽnʲtʃes̻kis̻ũn
genuen	ɡe̞nuẽ̞n
genukeen	ɡenukeẽn
genuke	ɡenuke
georgia	ɡeorɣ̞ia
georgiar	ɡe̞o̞rɣ̞iar
georgiera	ɡeorɣ̞ieɾa
geraxane	ɡe̞ɾaʃane̞
gerezi	ɡe̞ɾe̞s̻i
gereziondo	ɡeɾes̺iõn̪d̪o
gereziondo	ɡeɾes̻iõn̪d̪o
germana	ɡermana
german	ɡe̞rmãn
gernika	ɡernika
gernu	ɡernu
gero	ɡe̞ɾo̞
gerra	ɡe̞ra
gerri	ɡe̞ri
gerriko	ɡe̞riko̞
gertaera	ɡert̪aeɾa
gertatu	ɡert̪at̪u
gertu	ɡert̪u
getaria	ɡet̪aɾia
geu	ɡeu̯
geundekeen	ɡẽũ̯n̪d̪ekeẽn
geundeke	ɡẽũ̯n̪d̪eke
geunden	ɡẽũ̯n̪d̪ẽn
geuntzake	ɡẽũ̯nts̻ake
geuntzan	ɡẽũ̯nts̻ãn
geure	ɡeu̯ɾe
gezi	ɡe̞s̻i
gezur	ɡes̺ur
gezur	ɡes̻ur
gezurti	ɡes̺urt̪i
gezurti	ɡes̻urt̪i
ggi	ɡeɣ̞ei
g	ɡe̞
ghana	ɡana
ghanan	ɡanãn
gibel	ɡiβ̞e̞l
gidatu	ɡið̞at̪u
gilermo	ɡile̞rmo̞
gilermo	ɡiʎe̞rmo̞
gil	ɡil
gillermo	ɡiʎermo
giltza	ɡilts̻a
giltzurrun	ɡilts̻urũn
ginarreba	ɡinareβ̞a
ginarreba	ɡiɲareβ̞a
ginatekeen	ɡinat̪ekeẽn
ginatekeen	ɡiɲat̪ekeẽn
ginateke	ɡinat̪eke
ginateke	ɡiɲat̪eke
gindezaguzke	ɡĩn̪d̪e̞s̻aɣ̞us̻ke̞
gindezaguzkek	ɡĩn̪d̪e̞s̻aɣ̞us̻ke̞k
gindezaguzken	ɡĩn̪d̪e̞s̻aɣ̞us̻kẽ̞n
gindezaguzkete	ɡĩn̪d̪e̞s̻aɣ̞us̻ke̞t̪e̞
gindezaguzkezue	ɡĩn̪d̪e̞s̻aɣ̞us̻ke̞s̻ue̞
gindezaguzkezu	ɡĩn̪d̪e̞s̻aɣ̞us̻ke̞s̻u
gindezaguzkian	ɡĩn̪d̪e̞s̻aɣ̞us̻kiãn
gindezaguzkien	ɡĩn̪d̪e̞s̻aɣ̞us̻kiẽ̞n
gindezaguzkinan	ɡĩn̪d̪e̞s̻aɣ̞us̻kinãn
gindezaguzkinan	ɡĩn̪d̪e̞s̻aɣ̞us̻kiɲãn
gindezaguzkiten	ɡĩn̪d̪e̞s̻aɣ̞us̻kit̪ẽ̞n
gindezaguzkizuen	ɡĩn̪d̪e̞s̻aɣ̞us̻kis̻uẽ̞n
gindezaguzkizun	ɡĩn̪d̪e̞s̻aɣ̞us̻kis̻ũn
gindoazen	ɡĩn̪d̪oas̺ẽn
gindoazen	ɡĩn̪d̪oas̻ẽn
gindoazkeen	ɡĩn̪d̪oas̺keẽn
gindoazkeen	ɡĩn̪d̪oas̻keẽn
gindoazke	ɡĩn̪d̪oas̺ke
gindoazke	ɡĩn̪d̪oas̻ke
ginduzkaan	ɡĩn̪d̪us̺kaãn
ginduzkaan	ɡĩn̪d̪us̻kaãn
ginduzkake	ɡĩn̪d̪us̺kake
ginduzkake	ɡĩn̪d̪us̻kake
ginduzkakek	ɡĩn̪d̪us̺kakek
ginduzkakek	ɡĩn̪d̪us̻kakek
ginduzkaken	ɡĩn̪d̪us̺kakẽn
ginduzkaken	ɡĩn̪d̪us̻kakẽn
ginduzkakete	ɡĩn̪d̪us̺kaket̪e
ginduzkakete	ɡĩn̪d̪us̻kaket̪e
ginduzkakezue	ɡĩn̪d̪us̺kakes̺ue
ginduzkakezue	ɡĩn̪d̪us̻kakes̻ue
ginduzkakezu	ɡĩn̪d̪us̺kakes̺u
ginduzkakezu	ɡĩn̪d̪us̻kakes̻u
ginduzkanan	ɡĩn̪d̪us̺kanãn
ginduzkanan	ɡĩn̪d̪us̻kanãn
ginduzkan	ɡĩn̪d̪us̺kãn
ginduzkan	ɡĩn̪d̪us̻kãn
ginduzkaten	ɡĩn̪d̪us̺kat̪ẽn
ginduzkaten	ɡĩn̪d̪us̻kat̪ẽn
ginduzkazuen	ɡĩn̪d̪us̺kas̺uẽn
ginduzkazuen	ɡĩn̪d̪us̻kas̻uẽn
ginduzkazun	ɡĩn̪d̪us̺kas̺ũn
ginduzkazun	ɡĩn̪d̪us̻kas̻ũn
ginea	ɡinea
ginen	ɡinẽn
ginen	ɡiɲẽn
gintezela	ɡĩn̪t̪es̺ela
gintezela	ɡĩn̪t̪es̻ela
gintezen	ɡĩn̪t̪es̺ẽn
gintezen	ɡĩn̪t̪es̻ẽn
gintezkean	ɡĩn̪t̪es̺keãn
gintezkean	ɡĩn̪t̪es̻keãn
gintezkeen	ɡĩn̪t̪es̺keẽn
gintezkeen	ɡĩn̪t̪es̻keẽn
gintezke	ɡĩn̪t̪es̺ke
gintezke	ɡĩn̪t̪es̻ke
gintezkek	ɡĩn̪t̪es̺kek
gintezkek	ɡĩn̪t̪es̻kek
gintezkenan	ɡĩn̪t̪es̺kenãn
gintezkenan	ɡĩn̪t̪es̻kenãn
gintezken	ɡĩn̪t̪es̺kẽn
gintezken	ɡĩn̪t̪es̻kẽn
gintuan	ɡĩn̪t̪uãn
gintuen	ɡĩn̪t̪uẽ̞n
gintunan	ɡĩn̪t̪unãn
gintuzkean	ɡĩn̪t̪us̺keãn
gintuzkean	ɡĩn̪t̪us̻keãn
gintuzkeen	ɡĩn̪t̪us̺keẽn
gintuzkeen	ɡĩn̪t̪us̻keẽn
gintuzke	ɡĩn̪t̪us̺ke
gintuzke	ɡĩn̪t̪us̻ke
gintuzkek	ɡĩn̪t̪us̺kek
gintuzkek	ɡĩn̪t̪us̻kek
gintuzkenan	ɡĩn̪t̪us̺kenãn
gintuzkenan	ɡĩn̪t̪us̻kenãn
gintuzken	ɡĩn̪t̪us̺kẽn
gintuzken	ɡĩn̪t̪us̻kẽn
gintuzkete	ɡĩn̪t̪us̺ket̪e
gintuzkete	ɡĩn̪t̪us̻ket̪e
gintuzketen	ɡĩn̪t̪us̺ket̪ẽn
gintuzketen	ɡĩn̪t̪us̻ket̪ẽn
gintuzkezue	ɡĩn̪t̪us̺kes̺ue
gintuzkezue	ɡĩn̪t̪us̻kes̻ue
gintuzkezuen	ɡĩn̪t̪us̺kes̺uẽn
gintuzkezuen	ɡĩn̪t̪us̻kes̻uẽn
gintuzkezu	ɡĩn̪t̪us̺kes̺u
gintuzkezu	ɡĩn̪t̪us̻kes̻u
gintuzkezun	ɡĩn̪t̪us̺kes̺ũn
gintuzkezun	ɡĩn̪t̪us̻kes̻ũn
gintuzten	ɡĩn̪t̪us̻t̪ẽ̞n
gintuzuen	ɡĩn̪t̪us̻uẽ̞n
gintuzun	ɡĩn̪t̪us̻ũn
gintzaala	ɡĩnts̻aala
gintzaan	ɡĩnts̻aãn
gintzakean	ɡĩnts̻akeãn
gintzakeen	ɡĩnts̻akeẽn
gintzake	ɡĩnts̻ake
gintzakek	ɡĩnts̻akek
gintzakenan	ɡĩnts̻akenãn
gintzaken	ɡĩnts̻akẽn
gintzakete	ɡĩnts̻aket̪e
gintzaketen	ɡĩnts̻aket̪ẽn
gintzakezue	ɡĩnts̻akes̺ue
gintzakezue	ɡĩnts̻akes̻ue
gintzakezuen	ɡĩnts̻akes̺uẽn
gintzakezuen	ɡĩnts̻akes̻uẽn
gintzakezu	ɡĩnts̻akes̺u
gintzakezu	ɡĩnts̻akes̻u
gintzakezun	ɡĩnts̻akes̺ũn
gintzakezun	ɡĩnts̻akes̻ũn
gintzala	ɡĩnts̻ala
gintzanala	ɡĩnts̻anala
gintzanan	ɡĩnts̻anãn
gintzan	ɡĩnts̻ãn
gintzatela	ɡĩnts̻at̪ela
gintzaten	ɡĩnts̻at̪ẽn
gintzazuela	ɡĩnts̻as̺uela
gintzazuela	ɡĩnts̻as̻uela
gintzazuen	ɡĩnts̻as̺uẽn
gintzazuen	ɡĩnts̻as̻uẽn
gintzazula	ɡĩnts̻as̺ula
gintzazula	ɡĩnts̻as̻ula
gintzazun	ɡĩnts̻as̺ũn
gintzazun	ɡĩnts̻as̻ũn
gipuzkoa	ɡipus̺koa
gipuzkoa	ɡipus̻koa
gipuzkoan	ɡipus̻ko̞ãn
giralda	ɡiɾal̪d̪a
gisa	ɡis̺a
gisako	ɡis̺ako̞
gisan	ɡis̺ãn
gisatu	ɡis̺at̪u
gisela	ɡis̺ela
gixane	ɡiʃane
gizakunde	ɡis̺akũn̪d̪e
gizakunde	ɡis̻akũn̪d̪e
gizane	ɡis̺ane
gizane	ɡis̻ane
gizarte	ɡis̺art̪e
gizarte	ɡis̻art̪e
gizatasun	ɡis̺at̪as̺ũn
gizatasun	ɡis̻at̪as̺ũn
gizongai	ɡis̺oŋɡai̯
gizongai	ɡis̻oŋɡai̯
gizon	ɡis̺õn
gizon	ɡis̻õn
goazen	ɡoas̺ẽn
goazen	ɡoas̻ẽn
goaz	ɡoas̺
goaz	ɡoas̻
goazke	ɡoas̺ke
goazke	ɡoas̻ke
godantzia	ɡo̞ð̞ãnts̻ia
gogo	ɡo̞ɣ̞o̞
gogor	ɡoɣ̞or
gogortu	ɡo̞ɣ̞o̞rt̪u
gogotsu	ɡoɣ̞ots̺u
gogotsu	ɡoɣ̞ots̻u
goibeldu	ɡo̞i̯β̞e̞l̪d̪u
goikoetxea	ɡoi̯koetʃea
goilara	ɡo̞i̯laɾa
goilara	ɡo̞ʎaɾa
goiz	ɡo̞i̯s̻
gol	ɡo̞l
gontz	ɡõ̞nts̻
gora	ɡo̞ɾa
gorakada	ɡo̞ɾakað̞a
gorde	ɡorð̞e
gorka	ɡorka
gorospe	ɡoɾos̺pe
gorosti	ɡo̞ɾo̞s̺t̪i
gorotzil	ɡo̞ɾo̞ts̻il
gorputz	ɡorputs̻
gorri	ɡo̞ri
gorrimin	ɡo̞rimĩn
gorrimotel	ɡo̞rimo̞t̪e̞l
gorringo	ɡo̞rĩŋɡo̞
gorrotatu	ɡo̞ro̞t̪at̪u
gosaldu	ɡo̞s̺al̪d̪u
gotzon	ɡo̞ts̻õ̞n
gozatu	ɡos̺at̪u
gozatu	ɡos̻at̪u
gozo	ɡo̞s̻o̞
gramatika	ɡramat̪ika
granadari	ɡranað̞aɾi
grapagailu	ɡrapaɣ̞ai̯lu
grapagailu	ɡrapaɣ̞aʎu
greko	ɡreko
grezia	ɡres̺ia
grezia	ɡres̻ia
gris	ɡris̺
guda	ɡuð̞a
gudaroste	ɡuð̞aɾos̺t̪e
gu	ɡu
guk	ɡuk
gune	ɡune̞
guneka	ɡune̞ka
guraize	ɡuɾai̯s̺e
guraize	ɡuɾai̯s̻e
gurdi	ɡurð̞i
gure	ɡuɾe̞
guri	ɡuɾi
gurin	ɡuɾĩn
gurpil	ɡurpil
gurutze	ɡuɾuts̻e
gustatu	ɡus̺t̪at̪u
gutizia	ɡut̪is̺ia
gutizia	ɡut̪is̻ia
guztia	ɡus̺t̪ia
guztia	ɡus̻t̪ia
guztiak	ɡus̺t̪iak
guztiak	ɡus̻t̪iak
guzti	ɡus̺t̪i
guzti	ɡus̻t̪i
guztiok	ɡus̺t̪iok
guztiok	ɡus̻t̪iok
habe	aβ̞e̞
habe	ɦaβ̞e̞
habia	aβ̞ia
habia	ɦaβ̞ia
habil	aβ̞il
habilen	aβ̞iʎẽn
habilen	haβ̞ilẽn
habil	haβ̞il
habilke	aβ̞ilke
habilke	haβ̞ilke
hadi	að̞i
hadi	hað̞i
hadila	að̞iʎa
hadila	hað̞ila
hadin	að̞ĩn
hadin	hað̞ĩn
hagin	aɣ̞ĩn
hagin	ɦaɣ̞ĩn
hago	aɣ̞o
hagoen	aɣ̞oẽn
hagoen	haɣ̞oẽn
hago	haɣ̞o
hagoke	aɣ̞oke
hagoke	haɣ̞oke
haiei	ai̯ei̯
haiei	hai̯ei̯
haiek	ai̯ek
haiek	hai̯ek
haien	ai̯ẽn
haien	hai̯ẽn
haiteke	ai̯t̪eke
haiteke	hai̯t̪eke
haitz	ai̯ts̻
haitz	hai̯ts̻
haiz	ai̯s̺
haiz	ai̯s̻
haizateke	ai̯s̺at̪eke
haizateke	ai̯s̻at̪eke
haizateke	hai̯s̻at̪eke
haize	ai̯s̻e̞
haize	ɦai̯s̻e̞
haizetsu	ai̯s̻e̞ts̺u
haizetsu	ɦai̯s̻e̞ts̺u
haiz	hai̯s̻
hakar	akar
hakar	hakar
hakien	akiẽ̞n
hakien	ɦakiẽ̞n
hala	ala
hala	ɦala
haltz	alts̻
haltz	halts̻
hamabi	amaβ̞i
hamabigarren	amaβ̞iɣ̞arẽn
hamabigarren	hamaβ̞iɣ̞arẽn
hamabi	ɦamaβ̞i
hamabost	amaβ̞o̞s̺t̪
hamabost	ɦamaβ̞o̞s̺t̪
hamahiru	amai̯ɾu
hamahirugarren	amai̯ɾuɣ̞arẽn
hamahirugarren	hamahiɾuɣ̞arẽn
hamahiru	hamahiɾu
hamaika	amai̯ka
hamaikagarren	amai̯kaɣ̞arẽn
hamaikagarren	hamai̯kaɣ̞arẽn
hamaika	hamai̯ka
hamairu	amai̯ɾu
hamairu	ɦamai̯ɾu
hamalau	amalau̯
hamalaugarren	amalau̯ɣ̞arẽn
hamalaugarren	hamalau̯ɣ̞arẽn
hamalau	ɦamalau̯
hamar	amar
hamargarren	amarɣ̞arẽn
hamargarren	hamarɣ̞arẽn
hamar	hamar
hamarren	amarẽn
hamarren	hamarẽn
hamasei	amas̺e̞i̯
hamasei	ɦamas̺e̞i̯
hamazazpi	amas̺as̺pi
hamazazpi	amas̻as̻pi
hamazazpi	hamas̻as̻pi
hamazortzi	amas̺orts̻i
hamazortzi	amas̻orts̻i
hamazortzi	hamas̻orts̻i
han	ãn
handitu	ãn̪d̪it̪u
handitu	hãn̪d̪it̪u
han	ɦãn
haragi	aɾaɣ̞i
haragi	ɦaɾaɣ̞i
harakin	aɾakĩn
harakin	haɾakĩn
haran	aɾãn
haran	haɾãn
harategi	aɾat̪eɣ̞i
harategi	haɾat̪eɣ̞i
haratustel	aɾat̪us̺t̪el
haratustel	haɾat̪us̺t̪el
haren	aɾẽ̞n
haren	ɦaɾẽ̞n
hari	aɾi
hari	ɦaɾi
haritz	aɾits̻
haritzezko	aɾits̻es̺ko
haritzezko	aɾits̻es̻ko
haritzezko	haɾits̻es̻ko
haritz	haɾits̻
harizki	aɾis̺ki
harizki	aɾis̻ki
harizki	haɾis̻ki
hark	ark
hark	ɦark
harrabots	araβ̞ots̺
harrabots	araβ̞ots̻
harrabots	haraβ̞ots̺
harri	ari
harri	hari
harro	aro
harro	haro
harrotu	aro̞t̪u
harrotu	ɦaro̞t̪u
hartan	art̪ãn
hartan	ɦart̪ãn
hartara	art̪aɾa
hartara	ɦart̪aɾa
hartarat	art̪aɾat̪
hartarat	ɦart̪aɾat̪
hartu	art̪u
hartu	ɦart̪u
hartz	arts̻
hartz	ɦarts̻
hartzitu	arts̻it̪u
hartzitu	harts̻it̪u
haserretu	as̺e̞re̞t̪u
haserretu	ɦas̺e̞re̞t̪u
hasi	as̺i
hasi	has̺i
haste	as̺t̪e
haste	has̺t̪e
hasten	as̺t̪ẽn
hasten	has̺t̪ẽn
hator	at̪or
hator	hat̪or
hatorke	at̪orke
hatorke	hat̪orke
hatorren	at̪orẽn
hatorren	hat̪orẽn
h	atʃe̞
hatxe	atʃe̞
hatxe	ɦatʃe̞
hatxekie	atʃekie
hatxekie	hatʃekie
hatxekigu	atʃekiɣ̞u
hatxekigu	hatʃekiɣ̞u
hatxekio	atʃekio
hatxekio	hatʃekio
hatxekit	atʃekit̪
hatxekit	hatʃekit̪
hatza	ats̻a
hatza	hats̻a
hatz	ats̻
hatz	hats̻
hau	au̯
hauei	au̯e̞i
hauei	ɦau̯e̞i
hauek	au̯e̞k
hauek	ɦau̯e̞k
hauen	au̯ẽn
hauen	hau̯ẽn
hauetako	au̯et̪ako
hauetako	hau̯et̪ako
hauetan	au̯et̪ãn
hauetan	hau̯et̪ãn
hauetara	au̯et̪aɾa
hauetara	hau̯et̪aɾa
haugu	au̯ɣ̞u
haugu	hau̯ɣ̞u
hau	hau̯
hauka	au̯ka
haukagu	au̯kaɣ̞u
haukagu	hau̯kaɣ̞u
hauka	hau̯ka
haukat	au̯kat̪
haukate	au̯kat̪e
haukate	hau̯kat̪e
haukat	hau̯kat̪
hauke	au̯ke
haukegu	au̯keɣ̞u
haukegu	hau̯keɣ̞u
hauke	hau̯ke
hauket	au̯ket̪
haukete	au̯ket̪e
haukete	hau̯ket̪e
hauket	hau̯ket̪
hautatu	au̯t̪at̪u
hautatu	ɦau̯t̪at̪u
haut	au̯t̪
haute	au̯t̪e
haute	hau̯t̪e
haut	hau̯t̪
hauts	au̯ts̺
hauts	au̯ts̻
hauts	hau̯ts̺
hazadala	as̺að̞ala
hazadala	as̻að̞ala
hazadala	has̻að̞ala
hazadan	as̺að̞ãn
hazadan	as̻að̞ãn
hazadan	has̻að̞ãn
hazagu	as̻aɣ̞u
hazagugu	as̻aɣ̞uɣ̞u
hazagugu	ɦas̻aɣ̞uɣ̞u
hazagu	ɦas̻aɣ̞u
hazagula	as̺aɣ̞ula
hazagula	as̻aɣ̞ula
hazagula	has̻aɣ̞ula
hazagun	as̺aɣ̞ũn
hazagun	as̻aɣ̞ũn
hazagun	has̻aɣ̞ũn
hazagut	as̻aɣ̞ut̪
hazagute	as̻aɣ̞ut̪e̞
hazagute	ɦas̻aɣ̞ut̪e̞
hazagut	ɦas̻aɣ̞ut̪
hazake	as̺ake
hazake	as̻ake
hazakegu	as̺akeɣ̞u
hazakegu	as̻akeɣ̞u
hazakegu	has̻akeɣ̞u
hazake	has̻ake
hazaket	as̺aket̪
hazaket	as̻aket̪
hazakete	as̺aket̪e
hazakete	as̻aket̪e
hazakete	has̻aket̪e
hazaket	has̻aket̪
hazala	as̺ala
hazala	as̻ala
hazala	has̻ala
hazan	as̺ãn
hazan	as̻ãn
hazan	has̻ãn
hazatela	as̺at̪ela
hazatela	as̻at̪ela
hazatela	has̻at̪ela
hazaten	as̺at̪ẽn
hazaten	as̻at̪ẽn
hazaten	has̻at̪ẽn
hazil	as̻il
hazil	ɦas̻il
hazlodi	az̺loð̞i
hazlodi	az̻loð̞i
hazlodi	haz̻loð̞i
hebreera	e̞β̞re̞e̞ɾa
hebreera	ɦe̞β̞re̞e̞ɾa
hega	e̞ɣ̞a
hega	ɦe̞ɣ̞a
hegalari	eɣ̞alaɾi
hegalari	heɣ̞alaɾi
hegaldatu	e̞ɣ̞al̪d̪at̪u
hegaldatu	ɦe̞ɣ̞al̪d̪at̪u
hegal	e̞ɣ̞al
hegal	ɦe̞ɣ̞al
hegats	e̞ɣ̞ats̺
hegats	ɦe̞ɣ̞ats̺
hegazkin	eɣ̞as̺kĩn
hegazkin	eɣ̞as̻kĩn
hegazkin	heɣ̞as̻kĩn
hegazti	e̞ɣ̞as̻t̪i
hegazti	ɦe̞ɣ̞as̻t̪i
hegien	eɣ̞iẽn
hegien	heɣ̞iẽn
hegike	eɣ̞ike
hegike	heɣ̞ike
hegitzake	eɣ̞its̻ake
hegitzake	heɣ̞its̻ake
hegitzan	eɣ̞its̻ãn
hegitzan	heɣ̞its̻ãn
hego	e̞ɣ̞o̞
hego	ɦe̞ɣ̞o̞
hekien	e̞kiẽ̞n
hekien	ɦe̞kiẽ̞n
hekike	e̞kike̞
hekike	ɦe̞kike̞
hekizke	e̞kis̻ke̞
hekizke	ɦe̞kis̻ke̞
hekizkien	e̞kis̻kiẽ̞n
hekizkien	ɦe̞kis̻kiẽ̞n
hekusan	e̞kus̺ãn
hekusan	ɦe̞kus̺ãn
hekusazke	e̞kus̺as̻ke̞
hekusazke	ɦe̞kus̺as̻ke̞
hekuske	e̞kus̺ke̞
hekuske	ɦe̞kus̺ke̞
hekuskien	e̞kus̺kiẽ̞n
hekuskien	ɦe̞kus̺kiẽ̞n
helburu	e̞lβ̞uɾu
helburu	ɦe̞lβ̞uɾu
heldu	e̞l̪d̪u
heldu	ɦe̞l̪d̪u
helikoptero	elikopt̪eɾo
helio	elio
helio	helio
helize	e̞lis̻e̞
helize	ɦe̞lis̻e̞
hemen	e̞mẽ̞n
hemen	ɦe̞mẽ̞n
hemeretzi	e̞me̞ɾe̞ts̻i
hemeretzi	ɦe̞me̞ɾe̞ts̻i
hemezortzi	e̞me̞s̻o̞rts̻i
hemezortzi	ɦe̞me̞s̻o̞rts̻i
henbilen	ẽmbiʎẽn
henbilen	hẽmbilẽn
henbilke	ẽmbilke
henbilkeen	ẽmbilkeẽn
henbilkeen	hẽmbilkeẽn
henbilke	hẽmbilke
hendaia	ẽn̪d̪ai̯a
hendaia	hẽn̪d̪ai̯a
hendila	ẽn̪d̪iʎa
hendila	hẽn̪d̪ila
hendin	ẽn̪d̪ĩn
hendin	hẽn̪d̪ĩn
hengoen	eŋɡoẽn
hengoen	heŋɡoẽn
hengokeen	eŋɡokeẽn
hengokeen	heŋɡokeẽn
hengoke	eŋɡoke
hengoke	heŋɡoke
henkien	ẽ̞ŋkiẽ̞n
henkien	ɦẽ̞ŋkiẽ̞n
henkion	ẽ̞ŋkiõ̞n
henkion	ɦẽ̞ŋkiõ̞n
hentorkeen	ẽn̪t̪orkeẽn
hentorkeen	hẽn̪t̪orkeẽn
hentorke	ẽn̪t̪orke
hentorke	hẽn̪t̪orke
hentorren	ẽn̪t̪orẽn
hentorren	hẽn̪t̪orẽn
hentxekidake	ẽnʲtʃekið̞ake
hentxekidake	hẽnʲtʃekið̞ake
hentxekidan	ẽnʲtʃekið̞ãn
hentxekidan	hẽnʲtʃekið̞ãn
hentxekieke	ẽnʲtʃekieke
hentxekieke	hẽnʲtʃekieke
hentxekien	ẽnʲtʃekiẽn
hentxekien	hẽnʲtʃekiẽn
hentxekiguke	ẽnʲtʃekiɣ̞uke
hentxekiguke	hẽnʲtʃekiɣ̞uke
hentxekigun	ẽnʲtʃekiɣ̞ũn
hentxekigun	hẽnʲtʃekiɣ̞ũn
hentxekioke	ẽnʲtʃekioke
hentxekioke	hẽnʲtʃekioke
hentxekion	ẽnʲtʃekiõn
hentxekion	hẽnʲtʃekiõn
hentzake	ẽnts̻ake
hentzake	hẽnts̻ake
hentzan	ẽnts̻ãn
hentzan	hẽnts̻ãn
hentzuen	ẽ̞nts̻uẽ̞n
hentzuen	ɦẽ̞nts̻uẽ̞n
hentzuke	ẽ̞nts̻uke̞
hentzuke	ɦẽ̞nts̻uke̞
hentzuzke	ẽ̞nts̻us̻ke̞
hentzuzke	ɦẽ̞nts̻us̻ke̞
hentzuzkien	ẽ̞nts̻us̻kiẽ̞n
hentzuzkien	ɦẽ̞nts̻us̻kiẽ̞n
herakuske	e̞ɾakus̺ke̞
herakuske	ɦe̞ɾakus̺ke̞
herakuskien	e̞ɾakus̺kiẽ̞n
herakuskien	ɦe̞ɾakus̺kiẽ̞n
herakutsan	e̞ɾakuts̺ãn
herakutsan	ɦe̞ɾakuts̺ãn
herakutsazke	e̞ɾakuts̺as̻ke̞
herakutsazke	ɦe̞ɾakuts̺as̻ke̞
herbehereak	erβ̞eɾeak
herbehereak	herβ̞eheɾeak
herdoil	erð̞oi̯l
herdoil	herð̞oi̯l
herenegun	eɾeneɣ̞ũn
herenegun	heɾeneɣ̞ũn
heren	e̞ɾẽ̞n
heren	ɦe̞ɾẽ̞n
herensuge	eɾẽns̺uɣ̞e
herensuge	heɾẽns̺uɣ̞e
heriotza	eɾiots̻a
heriotza	heɾiots̻a
heroake	e̞ɾo̞ake̞
heroake	ɦe̞ɾo̞ake̞
heroan	e̞ɾo̞ãn
heroan	ɦe̞ɾo̞ãn
heroatzan	e̞ɾo̞ats̻ãn
heroatzan	ɦe̞ɾo̞ats̻ãn
heroazke	e̞ɾo̞as̻ke̞
heroazke	ɦe̞ɾo̞as̻ke̞
herri	eri
herri	heri
herrikoi	erikoi̯
herrikoi	herikoi̯
herritar	erit̪ar
herritar	herit̪ar
heu	eu̯
heu	heu̯
heukake	eu̯kake
heukake	heu̯kake
heukan	eu̯kãn
heukan	heu̯kãn
heuk	e̞u̯k
heuk	ɦe̞u̯k
heure	eu̯ɾe
heure	heu̯ɾe
heuzkake	eu̯s̺kake
heuzkake	eu̯s̻kake
heuzkake	heu̯s̻kake
heuzkan	eu̯s̺kãn
heuzkan	eu̯s̻kãn
heuzkan	heu̯s̻kãn
hezaguen	e̞s̻aɣ̞uẽ̞n
hezaguen	ɦe̞s̻aɣ̞uẽ̞n
hezaguke	e̞s̻aɣ̞uke̞
hezaguke	ɦe̞s̻aɣ̞uke̞
hezaguzke	e̞s̻aɣ̞us̻ke̞
hezaguzke	ɦe̞s̻aɣ̞us̻ke̞
hezaguzkien	e̞s̻aɣ̞us̻kiẽ̞n
hezaguzkien	ɦe̞s̻aɣ̞us̻kiẽ̞n
hezakeen	es̺akeẽn
hezakeen	es̻akeẽn
hezakeen	hes̻akeẽn
hezake	es̺ake
hezake	es̻ake
hezake	hes̻ake
hezala	es̺ala
hezala	es̻ala
hezala	hes̻ala
hezan	es̺ãn
hezan	es̻ãn
hezan	hes̻ãn
hezueri	es̺ueɾi
hezueri	es̻ueɾi
hezueri	hes̻ueɾi
hezurdura	e̞s̻urð̞uɾa
hezurdura	ɦe̞s̻urð̞uɾa
hezur	e̞s̻ur
hezur	ɦe̞s̻ur
hezurtegi	es̺urt̪eɣ̞i
hezurtegi	es̻urt̪eɣ̞i
hezurtegi	hes̻urt̪eɣ̞i
h	ɦatʃe̞
hidrogeno	ɦið̞ro̞ɣ̞e̞no̞
hidrogeno	ið̞ro̞ɣ̞e̞no̞
hiena	ɦie̞na
hiena	ie̞na
higan	ɦiɣ̞ãn
higan	iɣ̞ãn
hiharduen	ɦiɦarð̞uẽ̞n
hiharduen	iarð̞uẽ̞n
hihardukake	ɦiɦarð̞ukake̞
hihardukake	iarð̞ukake̞
hihardukan	ɦiɦarð̞ukãn
hihardukan	iarð̞ukãn
hiharduke	ɦiɦarð̞uke̞
hiharduke	iarð̞uke̞
hi	hi
hi	i
hika	hika
hika	ika
hik	ɦik
hik	ik
hilabete	hilaβ̞et̪e
hilabete	iʎaβ̞et̪e
hilerri	ɦile̞ri
hilerri	iʎe̞ri
hil	hil
hil	il
hindezagudan	ɦĩn̪d̪e̞s̻aɣ̞uð̞ãn
hindezagudan	ĩn̪d̪e̞s̻aɣ̞uð̞ãn
hindezaguen	ɦĩn̪d̪e̞s̻aɣ̞uẽ̞n
hindezaguen	ĩn̪d̪e̞s̻aɣ̞uẽ̞n
hindezagugun	ɦĩn̪d̪e̞s̻aɣ̞uɣ̞ũn
hindezagugun	ĩn̪d̪e̞s̻aɣ̞uɣ̞ũn
hindezagukegu	ɦĩn̪d̪e̞s̻aɣ̞uke̞ɣ̞u
hindezagukegu	ĩn̪d̪e̞s̻aɣ̞uke̞ɣ̞u
hindezaguke	ɦĩn̪d̪e̞s̻aɣ̞uke̞
hindezaguke	ĩn̪d̪e̞s̻aɣ̞uke̞
hindezagukete	ɦĩn̪d̪e̞s̻aɣ̞uke̞t̪e̞
hindezagukete	ĩn̪d̪e̞s̻aɣ̞uke̞t̪e̞
hindezaguket	ɦĩn̪d̪e̞s̻aɣ̞uke̞t̪
hindezaguket	ĩn̪d̪e̞s̻aɣ̞uke̞t̪
hindezaguten	ɦĩn̪d̪e̞s̻aɣ̞ut̪ẽ̞n
hindezaguten	ĩn̪d̪e̞s̻aɣ̞ut̪ẽ̞n
hindoakeen	hĩn̪d̪oakeẽn
hindoakeen	ĩn̪d̪oakeẽn
hindoake	hĩn̪d̪oake
hindoake	ĩn̪d̪oake
hindoan	hĩn̪d̪oãn
hindoan	ĩn̪d̪oãn
hindudan	ɦĩn̪d̪uð̞ãn
hindudan	ĩn̪d̪uð̞ãn
hinduen	ɦĩn̪d̪uẽ̞n
hinduen	ĩn̪d̪uẽ̞n
hindugun	ɦĩn̪d̪uɣ̞ũn
hindugun	ĩn̪d̪uɣ̞ũn
hindukadan	hĩn̪d̪ukað̞ãn
hindukadan	ĩn̪d̪ukað̞ãn
hindukagun	hĩn̪d̪ukaɣ̞ũn
hindukagun	ĩn̪d̪ukaɣ̞ũn
hindukakegu	hĩn̪d̪ukakeɣ̞u
hindukakegu	ĩn̪d̪ukakeɣ̞u
hindukake	hĩn̪d̪ukake
hindukake	ĩn̪d̪ukake
hindukakete	hĩn̪d̪ukaket̪e
hindukakete	ĩn̪d̪ukaket̪e
hindukaket	hĩn̪d̪ukaket̪
hindukaket	ĩn̪d̪ukaket̪
hindukan	hĩn̪d̪ukãn
hindukan	ĩn̪d̪ukãn
hindukaten	hĩn̪d̪ukat̪ẽn
hindukaten	ĩn̪d̪ukat̪ẽn
hindukedan	hĩn̪d̪ukeð̞ãn
hindukedan	ĩn̪d̪ukeð̞ãn
hindukeen	hĩn̪d̪ukeẽn
hindukeen	ĩn̪d̪ukeẽn
hindukegu	hĩn̪d̪ukeɣ̞u
hindukegu	ĩn̪d̪ukeɣ̞u
hindukegun	hĩn̪d̪ukeɣ̞ũn
hindukegun	ĩn̪d̪ukeɣ̞ũn
hinduke	hĩn̪d̪uke
hinduke	ĩn̪d̪uke
hindukete	hĩn̪d̪uket̪e
hindukete	ĩn̪d̪uket̪e
hinduketen	hĩn̪d̪uket̪ẽn
hinduketen	ĩn̪d̪uket̪ẽn
hinduket	hĩn̪d̪uket̪
hinduket	ĩn̪d̪uket̪
hinduten	ɦĩn̪d̪ut̪ẽ̞n
hinduten	ĩn̪d̪ut̪ẽ̞n
hintekeen	hĩn̪t̪ekeẽn
hintekeen	ĩn̪t̪ekeẽn
hinteke	hĩn̪t̪eke
hinteke	ĩn̪t̪eke
hintzadala	hĩnts̻að̞ala
hintzadala	ĩnts̻að̞ala
hintzadan	hĩnts̻að̞ãn
hintzadan	ĩnts̻að̞ãn
hintzagula	hĩnts̻aɣ̞ula
hintzagula	ĩnts̻aɣ̞ula
hintzagun	hĩnts̻aɣ̞ũn
hintzagun	ĩnts̻aɣ̞ũn
hintzakedan	hĩnts̻akeð̞ãn
hintzakedan	ĩnts̻akeð̞ãn
hintzakeen	hĩnts̻akeẽn
hintzakeen	ĩnts̻akeẽn
hintzakegu	hĩnts̻akeɣ̞u
hintzakegu	ĩnts̻akeɣ̞u
hintzakegun	hĩnts̻akeɣ̞ũn
hintzakegun	ĩnts̻akeɣ̞ũn
hintzake	hĩnts̻ake
hintzake	ĩnts̻ake
hintzakete	hĩnts̻aket̪e
hintzakete	ĩnts̻aket̪e
hintzaketen	hĩnts̻aket̪ẽn
hintzaketen	ĩnts̻aket̪ẽn
hintzaket	hĩnts̻aket̪
hintzaket	ĩnts̻aket̪
hintzala	hĩnts̻ala
hintzala	ĩnts̻ala
hintzan	hĩnts̻ãn
hintzan	ĩnts̻ãn
hintzatekeen	hĩnts̻at̪ekeẽn
hintzatekeen	ĩnts̻at̪ekeẽn
hintzateke	hĩnts̻at̪eke
hintzateke	ĩnts̻at̪eke
hintzatela	hĩnts̻at̪ela
hintzatela	ĩnts̻at̪ela
hintzaten	hĩnts̻at̪ẽn
hintzaten	ĩnts̻at̪ẽn
hintzen	hĩnts̻ẽn
hintzen	ĩnts̻ẽn
hipersoniko	ipers̺oniko
hipopotamo	ɦipo̞po̞t̪amo̞
hipopotamo	ipo̞po̞t̪amo̞
hirauen	ɦiɾau̯ẽ̞n
hirauen	iɾau̯ẽ̞n
hirauke	ɦiɾau̯ke̞
hirauke	iɾau̯ke̞
hiregan	ɦiɾe̞ɣ̞ãn
hiregan	iɾe̞ɣ̞ãn
hire	ɦiɾe̞
hire	iɾe̞
hiriburu	hiɾiβ̞uɾu
hiriburu	iɾiβ̞uɾu
hirigile	hiɾiɣ̞ile
hirigile	iɾiɣ̞iʎe
hirigintza	hiɾiɣ̞ĩnts̻a
hirigintza	iɾiɣ̞ĩnts̻a
hiri	hiɾi
hiri	iɾi
hiriko	hiɾiko
hiriko	iɾiko
hirudien	ɦiɾuð̞iẽ̞n
hirudien	iɾuð̞iẽ̞n
hirudike	ɦiɾuð̞ike̞
hirudike	iɾuð̞ike̞
hirugarren	hiɾuɣ̞arẽn
hirugarren	iɾuɣ̞arẽn
hiruhortz	ɦiɾuɦo̞rts̻
hiruhortz	iɾuo̞rts̻
hiru	ɦiɾu
hiru	iɾu
hirukoitz	ɦiɾuko̞i̯ts̻
hirukoitz	iɾuko̞i̯ts̻
hirurogei	hiɾuɾoɣ̞ei̯
hirurogei	iɾuɾoɣ̞ei̯
historia	his̺t̪oɾia
historia	is̺t̪oɾia
hitan	ɦit̪ãn
hitan	it̪ãn
hituen	ɦit̪uẽ̞n
hituen	it̪uẽ̞n
hituzkeen	hit̪us̻keẽn
hituzkeen	it̪us̺keẽn
hituzkeen	it̪us̻keẽn
hituzke	hit̪us̻ke
hituzke	it̪us̺ke
hituzke	it̪us̻ke
hitzakeen	hits̻akeẽn
hitzakeen	its̻akeẽn
hitzake	hits̻ake
hitzake	its̻ake
hitzala	hits̻ala
hitzala	its̻ala
hitzan	hits̻ãn
hitzan	its̻ãn
hitz	hits̻
hitz	its̻
hitzordu	hits̻orð̞u
hitzordu	its̻orð̞u
hizkuntza	his̻kũnts̻a
hizkuntza	is̺kũnts̻a
hizkuntza	is̻kũnts̻a
hizkuntzalaritza	ɦis̻kũnts̻alaɾits̻a
hizkuntzalaritza	is̻kũnts̻alaɾits̻a
hiztegi	his̻t̪eɣ̞i
hiztegi	is̺t̪eɣ̞i
hiztegi	is̻t̪eɣ̞i
hiztun	his̻t̪ũn
hiztun	is̺t̪ũn
hiztun	is̻t̪ũn
hoa	hoa
hoake	hoake
hoake	oake
hoan	hoãn
hoan	oãn
hoa	oa
hobekien	hoβ̞ekiẽn
hobekien	oβ̞ekiẽn
hobeki	hoβ̞eki
hobeki	oβ̞eki
hoberen	ɦo̞β̞e̞ɾẽ̞n
hoberen	o̞β̞e̞ɾẽ̞n
hobeto	hoβ̞et̪o
hobeto	oβ̞et̪o
hodei	ɦo̞ð̞e̞i̯
hodei	o̞ð̞e̞i̯
hodeitsu	hoð̞ei̯ts̺u
hodeitsu	oð̞ei̯ts̺u
hodeitsu	oð̞ei̯ts̻u
hogei	ɦo̞ɣ̞e̞i̯
hogei	o̞ɣ̞e̞i̯
homosexual	omos̺eks̺ual
homosexual	omos̺eks̺wal
hondamen	hõn̪d̪amẽn
hondamen	õn̪d̪amẽn
hondartza	hõn̪d̪arts̻a
hondartza	õn̪d̪arts̻a
hondatu	ɦõ̞n̪d̪at̪u
hondatu	õ̞n̪d̪at̪u
honek	ɦo̞ne̞k
honek	o̞ne̞k
honen	ɦo̞nẽ̞n
honen	o̞nẽ̞n
honetako	honet̪ako
honetako	onet̪ako
honetan	honet̪ãn
honetan	onet̪ãn
honetara	honet̪aɾa
honetara	onet̪aɾa
honetatik	honet̪at̪ik
honetatik	onet̪at̪ik
honetaz	honet̪as̻
honetaz	onet̪as̺
honetaz	onet̪as̻
honi	ɦo̞ni
honi	o̞ni
hontz	ɦõ̞nts̻
hontz	õ̞nts̻
hor	ɦo̞r
hori	hoɾi
hori	oɾi
horixe	hoɾiʃe
horixe	oɾiʃe
hornitu	hornit̪u
hornitu	ornit̪u
hor	o̞r
horrek	ɦo̞re̞k
horrek	o̞re̞k
horrela	horela
horrela	orela
horren	ɦo̞rẽ̞n
horren	o̞rẽ̞n
horri	ɦo̞ri
horri	o̞ri
hostaro	ɦo̞s̺t̪aɾo̞
hostaro	o̞s̺t̪aɾo̞
hots	hots̺
hots	ots̺
hots	ots̻
hotz	ɦo̞ts̻
hotz	o̞ts̻
hozkailu	hos̻kai̯lu
hozkailu	os̺kaʎu
hozkailu	os̻kaʎu
hozkatu	ɦo̞s̻kat̪u
hozkatu	o̞s̻kat̪u
huen	ɦuẽ̞n
huen	uẽ̞n
hukeen	hukeẽn
hukeen	ukeẽn
huke	huke
huke	uke
hungaria	huŋɡaɾia
hungariako	ɦũŋɡaɾiako̞
hungariako	ũŋɡaɾiako̞
hungarian	huŋɡaɾiãn
hungarian	uŋɡaɾiãn
hungariar	ɦũŋɡaɾiar
hungariar	ũŋɡaɾiar
hungaria	uŋɡaɾia
hungariera	huŋɡaɾieɾa
hungariera	uŋɡaɾieɾa
hura	huɾa
hura	uɾa
hurbil	hurβ̞il
hurbil	urβ̞il
hur	ɦur
hurrondo	hurõn̪d̪o
hurrondo	urõn̪d̪o
hur	ur
huskune	hus̺kune
huskune	us̺kune
hustu	ɦus̺t̪u
hustu	us̺t̪u
huts	ɦuts̺
hutsik	huts̺ik
hutsik	uts̺ik
hutsik	uts̻ik
huts	uts̺
ia	ia
iaz	ias̺
iaz	ias̻
ibaiadar	iβ̞ai̯að̞ar
ibaibarren	iβ̞ai̯β̞arẽ̞n
ibaiburu	iβ̞ai̯β̞uɾu
ibaiertz	iβ̞ai̯e̞rts̻
ibai	iβ̞ai̯
ibairatu	iβ̞ai̯ɾat̪u
ibar	iβ̞ar
ibarreta	iβ̞aret̪a
ibilgailu	iβ̞ilɣ̞ai̯lu
ibilgailu	iβ̞ilɣ̞aʎu
ibili	iβ̞ili
ibili	iβ̞iʎi
idatzi	ið̞ats̻i
idazlea	ið̞az̺lea
idazlea	ið̞az̻lea
idazleak	ið̞az̺leak
idazleak	ið̞az̻leak
idazlearekin	ið̞az̺leaɾekĩn
idazlearekin	ið̞az̻leaɾekĩn
idazlearengan	ið̞az̺leaɾeŋɡãn
idazlearengan	ið̞az̻leaɾeŋɡãn
idazlearen	ið̞az̺leaɾẽn
idazlearen	ið̞az̻leaɾẽn
idazlearentzat	ið̞az̺leaɾẽnts̻at̪
idazlearentzat	ið̞az̻leaɾẽnts̻at̪
idazleari	ið̞az̺leaɾi
idazleari	ið̞az̻leaɾi
idazleaz	ið̞az̺leas̺
idazleaz	ið̞az̻leas̻
idazleei	ið̞az̺leei̯
idazleei	ið̞az̻leei̯
idazleek	ið̞az̺leek
idazleek	ið̞az̻leek
idazleekin	ið̞az̺leekĩn
idazleekin	ið̞az̻leekĩn
idazleengan	ið̞az̺leeŋɡãn
idazleengan	ið̞az̻leeŋɡãn
idazleen	ið̞az̺leẽn
idazleen	ið̞az̻leẽn
idazleentzat	ið̞az̺leẽnts̻at̪
idazleentzat	ið̞az̻leẽnts̻at̪
idazleez	ið̞az̺lees̺
idazleez	ið̞az̻lees̻
idazle	ið̞az̺le
idazle	ið̞az̻le
idazlek	ið̞az̺lek
idazlek	ið̞az̻lek
idazlerekin	ið̞az̺leɾekĩn
idazlerekin	ið̞az̻leɾekĩn
idazlerengan	ið̞az̺leɾeŋɡãn
idazlerengan	ið̞az̻leɾeŋɡãn
idazleren	ið̞az̺leɾẽn
idazleren	ið̞az̻leɾẽn
idazlerentzat	ið̞az̺leɾẽnts̻at̪
idazlerentzat	ið̞az̻leɾẽnts̻at̪
idazleri	ið̞az̺leɾi
idazleri	ið̞az̻leɾi
idazlerik	ið̞az̺leɾik
idazlerik	ið̞az̻leɾik
idazletzat	ið̞az̺lets̻at̪
idazletzat	ið̞az̻lets̻at̪
idazlez	ið̞az̺les̺
idazlez	ið̞az̻les̻
identifikatu	ið̞ẽ̞n̪t̪ifikat̪u
idiazabal	ið̞ias̺aβ̞al
idiazabal	ið̞ias̻aβ̞al
idi	ið̞i
ido	ið̞o̞
igali	iɣ̞ali
igande	iɣ̞ãn̪d̪e
igandekari	iɣ̞ãn̪d̪ekaɾi
igandero	iɣ̞ãn̪d̪e̞ɾo̞
igaraba	iɣ̞aɾaβ̞a
igarbide	iɣ̞arβ̞ið̞e
igargaitz	iɣ̞arɣ̞ai̯ts̻
igarketa	iɣ̞arket̪a
igarkizun	iɣ̞arkis̺ũn
igarkizun	iɣ̞arkis̻ũn
igarle	iɣ̞arle
igarmen	iɣ̞armẽn
igaroaldi	iɣ̞aɾoal̪d̪i
igarobide	iɣ̞aɾoβ̞ið̞e
igarogaitz	iɣ̞aɾoɣ̞ai̯ts̻
igaro	iɣ̞aɾo
igaroko	iɣ̞aɾoko
igarokor	iɣ̞aɾokor
igarokortasun	iɣ̞aɾokort̪as̺ũn
igaroleku	iɣ̞aɾoleku
igarpen	iɣ̞arpẽn
igarri	iɣ̞ari
igaz	iɣ̞as̺
igaz	iɣ̞as̻
igebelar	iɣ̞e̞β̞e̞lar
igel	iɣ̞e̞l
igeltsatu	iɣ̞elts̺at̪u
igeltsatu	iɣ̞elts̻at̪u
igeltsero	iɣ̞elts̺eɾo
igeltsero	iɣ̞elts̻eɾo
igeltserotza	iɣ̞elts̺eɾots̻a
igeltserotza	iɣ̞elts̻eɾots̻a
igeltsugin	iɣ̞elts̺uɣ̞ĩn
igeltsugin	iɣ̞elts̻uɣ̞ĩn
igeltsugintza	iɣ̞elts̺uɣ̞ĩnts̻a
igeltsugintza	iɣ̞elts̻uɣ̞ĩnts̻a
igeltsu	iɣ̞elts̺u
igeltsu	iɣ̞elts̻u
igeltsutegi	iɣ̞elts̺ut̪eɣ̞i
igeltsutegi	iɣ̞elts̻ut̪eɣ̞i
igeltsuztatu	iɣ̞elts̺us̻t̪at̪u
igeltsuztatu	iɣ̞elts̻us̺t̪at̪u
igerialdi	iɣ̞eɾial̪d̪i
igerian	iɣ̞eɾiãn
igerigailu	iɣ̞eɾiɣ̞ai̯lu
igerigailu	iɣ̞eɾiɣ̞aʎu
igeri	iɣ̞eɾi
igerika	iɣ̞eɾika
igerikan	iɣ̞eɾikãn
igerikari	iɣ̞eɾikaɾi
igerikatu	iɣ̞eɾikat̪u
igeriketa	iɣ̞eɾiket̪a
igerilari	iɣ̞eɾilaɾi
igerileku	iɣ̞eɾileku
igeritako	iɣ̞eɾit̪ako
igita	iɣ̞it̪a
igitai	iɣ̞it̪ai̯
igitaldi	iɣ̞it̪al̪d̪i
igitari	iɣ̞it̪aɾi
igitatu	iɣ̞it̪at̪u
iglu	iɣ̞lu
igneo	iɣ̞ne̞o̞
igogailu	iɣ̞oɣ̞ai̯lu
igogailu	iɣ̞oɣ̞aʎu
igo	iɣ̞o
igordak	iɣ̞orð̞ak
igordan	iɣ̞orð̞ãn
igordazue	iɣ̞orð̞as̺ue
igordazue	iɣ̞orð̞as̻ue
igordazu	iɣ̞orð̞as̺u
igordazu	iɣ̞orð̞as̻u
igorguk	iɣ̞orɣ̞uk
igorgun	iɣ̞orɣ̞ũn
igorguzue	iɣ̞orɣ̞us̺ue
igorguzue	iɣ̞orɣ̞us̻ue
igorguzu	iɣ̞orɣ̞us̺u
igorguzu	iɣ̞orɣ̞us̻u
igork	iɣ̞ork
igorna	iɣ̞orna
igorriek	iɣ̞oriek
igorrien	iɣ̞oriẽn
igorriezue	iɣ̞ories̺ue
igorriezue	iɣ̞ories̻ue
igorriezu	iɣ̞ories̺u
igorriezu	iɣ̞ories̻u
igorri	iɣ̞o̞ri
igorriok	iɣ̞oriok
igorrion	iɣ̞oriõn
igorriozue	iɣ̞orios̺ue
igorriozue	iɣ̞orios̻ue
igorriozu	iɣ̞orios̺u
igorriozu	iɣ̞orios̻u
igorzkidak	iɣ̞ors̺kið̞ak
igorzkidak	iɣ̞ors̻kið̞ak
igorzkidan	iɣ̞ors̺kið̞ãn
igorzkidan	iɣ̞ors̻kið̞ãn
igorzkidazue	iɣ̞ors̺kið̞as̺ue
igorzkidazue	iɣ̞ors̻kið̞as̻ue
igorzkidazu	iɣ̞ors̺kið̞as̺u
igorzkidazu	iɣ̞ors̻kið̞as̻u
igorzkiek	iɣ̞ors̺kiek
igorzkiek	iɣ̞ors̻kiek
igorzkien	iɣ̞ors̺kiẽn
igorzkien	iɣ̞ors̻kiẽn
igorzkiezue	iɣ̞ors̺kies̺ue
igorzkiezue	iɣ̞ors̻kies̻ue
igorzkiezu	iɣ̞ors̺kies̺u
igorzkiezu	iɣ̞ors̻kies̻u
igorzkiguk	iɣ̞ors̺kiɣ̞uk
igorzkiguk	iɣ̞ors̻kiɣ̞uk
igorzkigun	iɣ̞ors̺kiɣ̞ũn
igorzkigun	iɣ̞ors̻kiɣ̞ũn
igorzkiguzue	iɣ̞ors̺kiɣ̞us̺ue
igorzkiguzue	iɣ̞ors̻kiɣ̞us̻ue
igorzkiguzu	iɣ̞ors̺kiɣ̞us̺u
igorzkiguzu	iɣ̞ors̻kiɣ̞us̻u
igorzkiok	iɣ̞ors̺kiok
igorzkiok	iɣ̞ors̻kiok
igorzkion	iɣ̞ors̺kiõn
igorzkion	iɣ̞ors̻kiõn
igorzkiozue	iɣ̞ors̺kios̺ue
igorzkiozue	iɣ̞ors̻kios̻ue
igorzkiozu	iɣ̞ors̺kios̺u
igorzkiozu	iɣ̞ors̻kios̻u
igorzue	iɣ̞o̞rs̻ue̞
igorzu	iɣ̞ors̺u
igorzu	iɣ̞ors̻u
ihardukak	iarð̞ukak
ihardukak	iɦarð̞ukak
ihardukan	iarð̞ukãn
ihardukan	iɦarð̞ukãn
ihardukazue	iarð̞ukas̻ue̞
ihardukazue	iɦarð̞ukas̻ue̞
ihardukazu	iarð̞ukas̻u
ihardukazu	iɦarð̞ukas̻u
iharduk	iarð̞uk
iharduk	iɦarð̞uk
iharduki	iarð̞uki
iharduki	iɦarð̞uki
ihardun	iarð̞ũn
ihardun	iɦarð̞ũn
iharduzue	iarð̞us̻ue̞
iharduzue	iɦarð̞us̻ue̞
iharduzu	iarð̞us̻u
iharduzu	iɦarð̞us̻u
ihartu	iart̪u
ihartu	ihart̪u
ihes	ies̺
ihes	ihes̺
ihi	i
ihi	iɦi
i	i
ijito	ixit̪o
ijito	iʒit̪o
ijitokeria	ixit̪okeɾia
ijitokeria	iʒit̪okeɾia
ikasbide	ikaz̺β̞ið̞e
ikasgai	ikaz̺ɣ̞ai̯
ikasgela	ikaz̺ɣ̞ela
ikasi	ikas̺i
ikasketa	ikas̺ket̪a
ikaskide	ikas̺kið̞e
ikaskuntza	ikas̺kũnts̻a
ikasle	ikaz̺le
ikasleria	ikaz̺leɾia
ikasliburu	ikaz̺liβ̞uɾu
ikasmahai	ikaz̺mahai̯
ikasmahai	ikaz̺mai̯
ikastaldi	ikas̺t̪al̪d̪i
ikastaro	ikas̺t̪aɾo
ikastegi	ikas̺t̪eɣ̞i
ikastetxe	ikas̺t̪etʃe
ikastola	ikas̺t̪ola
ikastordu	ikas̺t̪orð̞u
ikastun	ikas̺t̪ũn
ikasturte	ikas̺t̪urt̪e
ikatz	ikats̻
iker	iker
ikertu	ike̞rt̪u
ikur	ikur
ikusak	ikus̺ak
ikusan	ikus̺ãn
ikusazue	ikus̺as̻ue̞
ikusazu	ikus̺as̻u
ikusi	ikus̺i
ikusiko	ikus̺iko
ikus	ikus̺
ikuste	ikus̺t̪e
ikusten	ikus̺t̪ẽn
ilara	ilaɾa
ilara	iʎaɾa
ilargia	ilarɣ̞ia
ilargia	iʎarɣ̞ia
ilargi	ilarɣ̞i
ilargi	iʎarɣ̞i
ilargitar	ilarɣ̞it̪ar
ilargitar	iʎarɣ̞it̪ar
ilar	ilar
ilar	iʎar
ilbeltz	ilβ̞elts̻
ile	ile̞
ile	iʎe̞
ilen	ilẽ̞n
ilen	iʎẽ̞n
ilertz	ile̞rts̻
ilertz	iʎe̞rts̻
iloba	iloβ̞a
iloba	iʎoβ̞a
ilun	ilũn
ilun	iʎũn
imanol	imanol
imitatu	imit̪at̪u
iñaki	iɲaki
inbaditu	ĩmbað̞it̪u
inbutu	ĩmbut̪u
indaba	ĩn̪d̪aβ̞a
indar	ĩn̪d̪ar
indarretxe	ĩn̪d̪aretʃe
independentzia	ĩn̪d̪e̞pẽ̞n̪d̪ẽ̞nts̻ia
india	ĩn̪d̪ia
indioilar	ĩn̪d̪ioi̯lar
indioilar	ĩn̪d̪ioʎar
indonesiera	ĩn̪d̪ones̺ieɾa
informazio	ĩɱfo̞rmas̻io̞
ingalaterra	iŋɡalat̪era
ingelera	ĩŋɡe̞le̞ɾa
ingeles	ĩŋɡe̞le̞s̺
ingude	iŋɡuð̞e
inon	inõ̞n
inon	iɲõ̞n
inora	ino̞ɾa
inora	iɲo̞ɾa
inoren	ino̞ɾẽ̞n
inoren	iɲo̞ɾẽ̞n
inori	inoɾi
inori	iɲoɾi
inor	ino̞r
inor	iɲo̞r
institutu	ĩns̺t̪it̪ut̪u
internazional	ĩn̪t̪ernas̺ional
internazional	ĩn̪t̪ernas̻ional
intsektu	ĩnts̺ekt̪u
intsektu	ĩnts̻ekt̪u
intxaur	ĩnʲtʃau̯r
inurri	inuri
inurri	iɲuri
inurritegi	inurit̪e̞ɣ̞i
inurritegi	iɲurit̪e̞ɣ̞i
ipar	ipar
ipini	ipini
ipini	ipiɲi
ipotx	ipo̞tʃ
ipurdi	ipurð̞i
ipurtzulo	ipurts̻ulo̞
irabazi	iɾaβ̞as̺i
irabazi	iɾaβ̞as̻i
irail	iɾai̯l
irain	iɾãĩ̯n
irakaskuk	iɾakas̺kuk
irakaskun	iɾakas̺kũn
irakaskuzue	iɾakas̺kus̺ue
irakaskuzue	iɾakas̺kus̻ue
irakaskuzu	iɾakas̺kus̺u
irakaskuzu	iɾakas̺kus̻u
irakasle	iɾakaz̺le̞
irakastak	iɾakas̺t̪ak
irakastan	iɾakas̺t̪ãn
irakastazue	iɾakas̺t̪as̺ue
irakastazue	iɾakas̺t̪as̻ue
irakastazu	iɾakas̺t̪as̺u
irakastazu	iɾakas̺t̪as̻u
irakatsak	iɾakats̺ak
irakatsak	iɾakats̻ak
irakatsan	iɾakats̺ãn
irakatsan	iɾakats̻ãn
irakatsazkidak	iɾakats̺as̻kið̞ak
irakatsazkidak	iɾakats̻as̺kið̞ak
irakatsazkidan	iɾakats̺as̻kið̞ãn
irakatsazkidan	iɾakats̻as̺kið̞ãn
irakatsazkidazue	iɾakats̺as̻kið̞as̻ue
irakatsazkidazue	iɾakats̻as̺kið̞as̺ue
irakatsazkidazu	iɾakats̺as̻kið̞as̻u
irakatsazkidazu	iɾakats̻as̺kið̞as̺u
irakatsazkiek	iɾakats̺as̻kiek
irakatsazkiek	iɾakats̻as̺kiek
irakatsazkien	iɾakats̺as̻kiẽn
irakatsazkien	iɾakats̻as̺kiẽn
irakatsazkiezue	iɾakats̺as̻kies̻ue
irakatsazkiezue	iɾakats̻as̺kies̺ue
irakatsazkiezu	iɾakats̺as̻kies̻u
irakatsazkiezu	iɾakats̻as̺kies̺u
irakatsazkiguk	iɾakats̺as̻kiɣ̞uk
irakatsazkiguk	iɾakats̻as̺kiɣ̞uk
irakatsazkigun	iɾakats̺as̻kiɣ̞ũn
irakatsazkigun	iɾakats̻as̺kiɣ̞ũn
irakatsazkiguzue	iɾakats̺as̻kiɣ̞us̻ue
irakatsazkiguzue	iɾakats̻as̺kiɣ̞us̺ue
irakatsazkiguzu	iɾakats̺as̻kiɣ̞us̻u
irakatsazkiguzu	iɾakats̻as̺kiɣ̞us̺u
irakatsazkiok	iɾakats̺as̻kiok
irakatsazkiok	iɾakats̻as̺kiok
irakatsazkion	iɾakats̺as̻kiõn
irakatsazkion	iɾakats̻as̺kiõn
irakatsazkiozue	iɾakats̺as̻kios̻ue
irakatsazkiozue	iɾakats̻as̺kios̺ue
irakatsazkiozu	iɾakats̺as̻kios̻u
irakatsazkiozu	iɾakats̻as̺kios̺u
irakatsazue	iɾakats̺as̻ue
irakatsazue	iɾakats̻as̺ue
irakatsazu	iɾakats̺as̻u
irakatsazu	iɾakats̻as̺u
irakatsiek	iɾakats̺iek
irakatsiek	iɾakats̻iek
irakatsien	iɾakats̺iẽn
irakatsien	iɾakats̻iẽn
irakatsiezue	iɾakats̺ies̻ue
irakatsiezue	iɾakats̻ies̺ue
irakatsiezu	iɾakats̺ies̻u
irakatsiezu	iɾakats̻ies̺u
irakatsi	iɾakats̺i
irakatsiok	iɾakats̺iok
irakatsiok	iɾakats̻iok
irakatsion	iɾakats̺iõn
irakatsion	iɾakats̻iõn
irakatsiozue	iɾakats̺ios̻ue
irakatsiozue	iɾakats̻ios̺ue
irakatsiozu	iɾakats̺ios̻u
irakatsiozu	iɾakats̻ios̺u
irakin	iɾakĩn
irakurgela	iɾakurɣ̞ela
irakurle	iɾakurle̞
irakurri	iɾakuri
irakurterraz	iɾakurt̪eras̺
irakurterraz	iɾakurt̪eras̻
iraniar	iɾaniar
iran	iɾãn
iratxe	iɾatʃe
irauk	iɾau̯k
iraun	iɾãũ̯n
irauzue	iɾau̯s̻ue̞
irauzu	iɾau̯s̻u
ireki	iɾe̞ki
irin	iɾĩn
iritsi	iɾits̺i
iritsi	iɾits̻i
iritzi	iɾits̻i
irla	irla
irlanda	irlãn̪d̪a
irten	irt̪ẽ̞n
irudi	iɾuð̞i
irudik	iɾuð̞ik
irudiko	iɾuð̞iko
irudin	iɾuð̞ĩn
iruditu	iɾuð̞it̪u
irudizue	iɾuð̞is̻ue̞
irudizu	iɾuð̞is̻u
irulegi	iɾuleɣ̞i
iruña	iɾuɲa
iruñea	iɾuɲea
iruzur	iɾus̺ur
iruzur	iɾus̻ur
iruzurti	iɾus̺urt̪i
iruzurti	iɾus̻urt̪i
isats	is̺ats̺
isiltasun	is̺il̪t̪as̺ũn
isilune	is̺ilune
isilune	is̺iʎune
isla	iz̺la
islandia	iz̺lãn̪d̪ia
islandiar	iz̺lãn̪d̪iar
islandiera	iz̺lãn̪d̪ieɾa
islandiera	iz̺lãn̪d̪jeɾa
ispilu	is̺pilu
ispilu	is̺piʎu
istil	is̺t̪il
isun	is̺ũn
isuri	is̺uɾi
italia	it̪alia
italian	it̪aliãn
italiar	it̪aliar
italiera	it̪alieɾa
itaundu	it̪ãũ̯n̪d̪u
ito	it̪o
itsasadar	its̺as̺að̞ar
itsasadar	its̻as̺að̞ar
itsasalde	its̺as̺al̪d̪e
itsasalde	its̻as̺al̪d̪e
itsasargi	its̺as̺arɣ̞i
itsasargi	its̻as̺arɣ̞i
itsasgaitz	its̺az̺ɣ̞ai̯ts̻
itsasgaitz	its̻az̺ɣ̞ai̯ts̻
itsasgarri	its̺az̺ɣ̞ari
itsaskor	its̺as̺kor
itsaskor	its̻as̺kor
itsaso	its̺as̺o
itsaso	its̻as̺o
itsasontzi	its̺as̺õnts̻i
itsasontzi	its̻as̺õnts̻i
itsasoratu	its̺as̺oɾat̪u
itsasoratu	its̻as̺oɾat̪u
itsaspen	its̺as̺pẽn
itsaspen	its̻as̺pẽn
itsasu	its̺as̺u
itsasu	its̻as̺u
itsatsi	its̺ats̺i
itsu	its̺u
itsusi	its̺us̺i
iturralde	it̪ural̪d̪e
iturri	it̪uri
itxaso	itʃas̺o
itzak	its̻ak
itzali	its̻ali
itzal	its̻al
itzan	its̻ãn
itzazue	its̻as̺ue
itzazue	its̻as̻ue
itzazu	its̻as̺u
itzazu	its̻as̻u
itziar	its̻iar
itzuli	its̻uli
itzultzaile	its̻ults̻ai̯le̞
itzultzaile	its̻ults̻aʎe̞
itzuri	its̻uɾi
ixa	iʃa
izain	is̺ãĩ̯n
izain	is̻ãĩ̯n
izango	is̺aŋɡo
izango	is̻aŋɡo
izan	is̺ãn
izan	is̻ãn
izar	is̻ar
izaro	is̺aɾo
izaro	is̻aɾo
izate	is̺at̪e
izate	is̻at̪e
izaten	is̺at̪ẽn
izaten	is̻at̪ẽn
izeba	is̺eβ̞a
izeba	is̻eβ̞a
izeko	is̺eko
izeko	is̻eko
izenburu	is̻ẽ̞mbuɾu
izen	is̻ẽ̞n
izenlagun	is̻ẽ̞nlaɣ̞ũn
izenordain	is̺enorð̞ãĩ̯n
izenordain	is̻enorð̞ãĩ̯n
izerdi	is̻e̞rð̞i
izkira	is̻kiɾa
izokin	is̺okĩn
izokin	is̻okĩn
izotzil	is̻o̞ts̻il
izotz	is̺ots̻
izotz	is̻ots̻
izozkailu	is̻os̻kai̯lu
izozkailu	is̺os̺kaʎu
izozkailu	is̻os̻kaʎu
izter	is̻t̪e̞r
izurde	is̻urð̞e̞
jai	dʒai̯
jaiegun	dʒai̯eɣ̞ũn
jaiegun	jai̯eɣ̞ũn
jaiegun	ɟai̯eɣ̞ũn
jaiegun	xai̯eɣ̞ũn
jai	jai̯
jai	ɟai̯
jainko	dʒai̯ŋko
jainkoilo	dʒai̯ŋkoʎo
jainkoilo	jai̯ŋkoʎo
jainkoilo	ɟai̯ŋkoi̯lo
jainkoilo	xai̯ŋkoʎo
jainko	jai̯ŋko
jainkojale	dʒai̯ŋkodʒale
jainkojale	jai̯ŋkojale
jainkojale	ɟai̯ŋkoɟale
jainkojale	xai̯ŋkoxale
jainko	ɟai̯ŋko
jainkosa	dʒai̯ŋkos̺a
jainkosa	jai̯ŋkos̺a
jainkosa	ɟai̯ŋkos̺a
jainkosa	xai̯ŋkos̺a
jainko	xai̯ŋko
jainkozale	dʒai̯ŋkos̺ale
jainkozale	jai̯ŋkos̻ale
jainkozale	ɟai̯ŋkos̻ale
jainkozaletasun	dʒai̯ŋkos̺alet̪as̺ũn
jainkozaletasun	jai̯ŋkos̻alet̪as̺ũn
jainkozaletasun	ɟai̯ŋkos̻alet̪as̺ũn
jainkozaletasun	xai̯ŋkos̻alet̪as̺ũn
jainkozale	xai̯ŋkos̻ale
jaio	jai̯o̞
jaio	xai̯o̞
jaitsi	dʒai̯ts̻i
jaitsi	jai̯ts̺i
jaitsi	ɟai̯ts̺i
jaitsi	xai̯ts̺i
jai	xai̯
jakadun	jakað̞ũn
jakadun	xakað̞ũn
jaka	jaka
jaka	xaka
jakik	jakik
jakik	xakik
jakin	jakĩn
jakin	xakĩn
jakitzak	jakits̻ak
jakitzak	xakits̻ak
jakitzan	jakits̻ãn
jakitzan	xakits̻ãn
jakitzazue	jakits̻as̻ue̞
jakitzazue	xakits̻as̻ue̞
jakitzazu	jakits̻as̻u
jakitzazu	xakits̻as̻u
jakizue	jakis̻ue̞
jakizue	xakis̻ue̞
jakizu	jakis̻u
jakizu	xakis̻u
janari	janaɾi
janari	xanaɾi
jan	dʒan
jan	jan
jan	jãn
jan	ɟan
jan	xan
jan	xãn
jan	ʒan
japonia	dʒaponia
japonia	japonia
japonia	ɟaponia
japoniera	dʒaponieɾa
japoniera	japonieɾa
japoniera	ɟaponieɾa
japoniera	xaponieɾa
jardun	jarð̞ũn
jardun	xarð̞ũn
jarraiki	dʒarai̯ki
jarraiki	jarai̯ki
jarraiki	ɟarai̯ki
jarraiki	xarai̯ki
jarraitu	dʒarai̯t̪u
jarraitu	jarai̯t̪u
jarraitu	ɟarai̯t̪u
jarraitu	xarai̯t̪u
jarri	jari
jarri	xari
jatetxe	dʒat̪etʃe
jatetxe	jat̪etʃe
jatetxe	ɟat̪etʃe
jatetxe	xat̪etʃe
jaun	dʒãũ̯n
jaungoikoa	dʒau̯ŋɡoi̯koa
jaungoikoa	jau̯ŋɡoi̯koa
jaungoikoa	ɟau̯ŋɡoi̯koa
jaungoikoa	xau̯ŋɡoi̯koa
jaun	jãũ̯n
jaun	ɟãũ̯n
jaun	xãũ̯n
jauregi	dʒau̯ɾeɣ̞i
jauregi	jau̯ɾeɣ̞i
jauregi	ɟau̯ɾeɣ̞i
jauregitar	dʒau̯ɾeɣ̞it̪ar
jauregitar	jau̯ɾeɣ̞it̪ar
jauregitar	ɟau̯ɾeɣ̞it̪ar
jauregitar	xau̯ɾeɣ̞it̪ar
jauregi	xau̯ɾeɣ̞i
jausi	jau̯s̺i
jausi	xau̯s̺i
jautsi	jau̯ts̺i
jautsi	xau̯ts̺i
jeltzale	je̞lts̻ale̞
jeltzale	xe̞lts̻ale̞
jende	jẽ̞n̪d̪e̞
jendetza	dʒẽn̪d̪ets̻a
jendetza	jẽn̪d̪ets̻a
jendetza	ɟẽn̪d̪ets̻a
jendetza	xẽn̪d̪ets̻a
jende	xẽ̞n̪d̪e̞
jengibre	xẽ̞nxiβ̞re̞
jipoitu	jipo̞i̯t̪u
jipoitu	xipo̞i̯t̪u
jirafa	dʒiɾafa
jirafa	jiɾafa
jirafa	ɟiɾafa
jirafa	xiɾafa
jiratu	xiɾat̪u
jiratu	ʒiɾat̪u
j	jo̞t̪a
joan	dʒoãn
joan	joãn
joan	ɟoãn
joan	xoãn
joan	ʒoan
jo	dʒo
joera	dʒoeɾa
joera	joeɾa
joera	ɟoeɾa
joera	xoeɾa
jo	jo
jo	ɟo
joka	dʒoka
joka	joka
joka	ɟoka
jokatu	jo̞kat̪u
jokatu	xo̞kat̪u
joka	xoka
jon	dʒõn
jone	dʒone
jone	jone
jone	ɟone
jon	jõn
jon	ɟõn
jordania	dʒorð̞ania
jordania	jorð̞ania
jordania	ɟorð̞ania
jordaniar	dʒorð̞aniar
jordaniar	jorð̞aniar
jordaniar	ɟorð̞aniar
jordaniar	xorð̞aniar
jordania	xorð̞ania
jorrail	jo̞rai̯l
jorrail	xo̞rai̯l
josi	dʒos̺i
josi	jos̺i
josi	ɟos̺i
josi	xos̺i
jostailu	dʒos̺t̪aʎu
jostailu	jos̺t̪aʎu
jostailu	ɟos̺t̪ai̯lu
jostailu	xos̺t̪aʎu
jostun	dʒos̺t̪ũn
jostun	jos̺t̪ũn
jostun	ɟos̺t̪ũn
jostun	xos̺t̪ũn
jota	dʒota
jota	jota
jota	jo̞t̪a
jota	ɟota
jota	xota
jota	xo̞t̪a
jota	ʒota
jo	xo
jugoslavia	dʒuɣ̞oz̺laβ̞ia
jugoslavia	juɣ̞oz̺laβ̞ia
jugoslavia	ɟuɣ̞oz̺laβ̞ia
jugoslavian	juɣ̞o̞z̺laβ̞iãn
julen	dʒulẽn
julen	julẽn
julen	ɟulẽn
j	xo̞t̪a
kafesne	kafez̺ne
kaixo	kai̯ʃo
ka	ka
kakahuete	kakawe̞t̪e̞
kaka	kaka
kakalardo	kakalarð̞o
kako	kako̞
kale	kale
kalimotxo	kalimo̞tʃo̞
kaltegarri	kal̪t̪eɣ̞ari
kaltzita	kalts̻it̪a
kamerun	kameɾũn
kameu	kame̞u
kamuts	kamuts̺
kamuts	kamuts̻
kanbodia	kãmboð̞ia
kanbodiar	kãmboð̞iar
kandela	kãn̪d̪ela
kandelak	kãn̪d̪elak
kanguru	kaŋɡuɾu
kanpai	kãmpai̯
kanpotar	kãmpot̪ar
kapare	kapaɾe
kapar	kapar
kapera	kapeɾa
kapo	kapo
karaoke	kaɾaoke
karbono	karβ̞o̞no̞
karlistada	karlis̺t̪að̞a
karlistaldi	karlis̺t̪al̪d̪i
karmeldar	karmel̪d̪ar
karmele	karmele
karramarroa	karamaroa
karramarro	karamaro
kartago	kart̪aɣ̞o
kastore	kas̺t̪oɾe
katagorri	kat̪aɣ̞ori
katakume	kat̪akume
katalunia	kat̪alunia
katea	kat̪ea
kate	kat̪e
katuarrain	kat̪uarãĩ̯n
katu	kat̪u
kaxa	kaʃa
kazakhera	kas̻akeɾa
kazakhera	kas̺axeɾa
kazakhera	kas̻axeɾa
kazakhstan	kas̻aks̺t̪ãn
kazakhstan	kas̺axs̺t̪ãn
kazakhstan	kas̻axs̺t̪ãn
ke	ke
kemen	ke̞mẽ̞n
kendu	kẽn̪d̪u
kepa	kepa
ketsu	kets̺u
ketsu	kets̻u
kilate	kilat̪e̞
kilotoi	kilot̪oi̯
kimu	kimu
kirgizistan	kirɣ̞is̺is̺t̪ãn
kirgizistan	kirɣ̞is̻is̺t̪ãn
kiribil	kiɾiβ̞il
kirolari	kiɾolaɾi
kiroldegi	kiɾol̪d̪eɣ̞i
kirol	kiɾol
k	ka
klera	kle̞ɾa
kloroformo	klo̞ɾo̞fo̞rmo̞
koaderno	ko̞að̞e̞rno̞
koala	koala
kobre	koβ̞re
kode	ko̞ð̞e̞
koilarakada	ko̞i̯laɾakað̞a
koilarakada	ko̞ʎaɾakað̞a
koilara	ko̞i̯laɾa
koilara	ko̞ʎaɾa
koinata	koi̯nat̪a
koinata	koɲat̪a
koinatu	koi̯nat̪u
koinatu	koɲat̪u
koipe	koi̯pe
koke	koke
kokots	ko̞ko̞ts̺
kokotx	ko̞ko̞tʃ
koldar	kol̪d̪ar
koldo	kol̪d̪o
kolera	koleɾa
koltxoi	kolʲtʃoi̯
komentu	komẽn̪t̪u
kometa	komet̪a
komunismo	komuniz̺mo
komunista	komunis̺t̪a
konbentzitu	kõmbẽnts̻it̪u
kondaira	kõn̪d̪ai̯ɾa
kondentsadore	kõn̪d̪ẽnts̺að̞oɾe
kondentsadore	kõn̪d̪ẽnts̻að̞oɾe
kono	ko̞no̞
konponbide	kõmpõmbið̞e
konpondu	kõmpõn̪d̪u
kontagailu	kõn̪t̪aɣ̞ai̯lu
kontagailu	kõn̪t̪aɣ̞aʎu
kontentatu	kõ̞n̪t̪ẽ̞n̪t̪at̪u
kontu	kõ̞n̪t̪u
konturatu	kõn̪t̪uɾat̪u
kontzeptu	kõnts̻ept̪u
kontzientzia	kõnts̻iẽnts̻ia
koral	koɾal
korapilatsu	koɾapilats̺u
korapilatsu	koɾapiʎats̺u
korapilatsu	koɾapiʎats̻u
kordoba	korð̞oβ̞a
koronabirus	ko̞ɾo̞naβ̞iɾus̺
korronte	korõn̪t̪e
korsikera	kors̺ikeɾa
kortxeaerdi	kortʃeaerð̞i
kortxea	kortʃea
koru	ko̞ɾu
kostatu	ko̞s̺t̪at̪u
kotxe	kotʃe
krater	krat̪e̞r
kreatu	kre̞at̪u
kriket	kriket̪
kroazia	kroas̺ia
kroazia	kroas̻ia
kroaziar	kro̞as̻iar
kroaziera	kroas̺ieɾa
kroaziera	kroas̻ieɾa
krokodilo	krokoð̞ilo
kronologia	kronoloɣ̞ia
kros	kros̺
kuantu	kwãn̪t̪u
kuba	kuβ̞a
ku	ku
kuku	kuku
kukutxeztul	kukutʃe̞s̻t̪ul
kulero	kule̞ɾo̞
kulunkatu	kuluŋkat̪u
kume	kume
kurrilo	kurilo
kurrilo	kuriʎo
kurrinka	kuriŋka
kurrinkatu	kuriŋkat̪u
kuttun	kucũn
kutun	kut̪ũn
labaien	laβ̞ai̯ẽn
labana	laβ̞ana
labar	laβ̞ar
labe	laβ̞e̞
labezomorroak	laβ̞es̺omoroak
labezomorroak	laβ̞es̻omoroak
labezomorroa	laβ̞es̺omoroa
labezomorroa	laβ̞es̻omoroa
labezomorroarenganantz	laβ̞es̺omoroaɾeŋɡanãnts̻
labezomorroarenganantz	laβ̞es̻omoroaɾeŋɡanãnts̻
labezomorroek	laβ̞es̺omoroek
labezomorroek	laβ̞es̻omoroek
labezomorroenganantz	laβ̞es̺omoroeŋɡanãnts̻
labezomorroenganantz	laβ̞es̻omoroeŋɡanãnts̻
labezomorrok	laβ̞es̺omorok
labezomorrok	laβ̞es̻omorok
labezomorro	laβ̞es̺omoro
labezomorro	laβ̞es̻omoro
labezomorrorenganako	laβ̞es̺omoroɾeŋɡanako
labezomorrorenganako	laβ̞es̻omoroɾeŋɡanako
labezomorrorenganantz	laβ̞es̺omoroɾeŋɡanãnts̻
labezomorrorenganantz	laβ̞es̻omoroɾeŋɡanãnts̻
labezomorrorengandik	laβ̞es̺omoroɾeŋɡãn̪d̪ik
labezomorrorengandik	laβ̞es̻omoroɾeŋɡãn̪d̪ik
labezomorrorik	laβ̞es̺omoroɾik
labezomorrorik	laβ̞es̻omoroɾik
labezomorrotzat	laβ̞es̺omorots̻at̪
labezomorrotzat	laβ̞es̻omorots̻at̪
labur	laβ̞ur
laga	laɣ̞a
lagundi	laɣ̞ũn̪d̪i
lagundu	laɣ̞ũn̪d̪u
lagun	laɣ̞ũn
laguntza	laɣ̞ũnts̻a
lahar	laɦar
lahar	lar
laia	lai̯a
lain	lãĩ̯n
laino	lai̯no̞
laino	laɲo̞
laket	laket̪
laku	laku
lanbas	lãmbas̺
lanbro	lãmbro
lan	lãn
lantegi	lãn̪t̪eɣ̞i
laosera	laos̺eɾa
laos	laos̺
laostar	laos̺t̪ar
lapar	lapar
lapurkume	lapurkume
lapur	lapur
lapurreria	lapureɾia
lapurreta	lapuret̪a
lapurtu	lapurt̪u
lapurtxori	lapurtʃoɾi
laranja	laɾãnʲdʒa
laranja	laɾãɲja
laranja	laɾãɲɟa
laranja	laɾaŋxa
laranjondo	laɾaɲjõ̞n̪d̪o̞
laranjondo	laɾãŋxõ̞n̪d̪o̞
laratro	laɾat̪ro
lardizabal	larð̞is̺aβ̞al
lardizabal	larð̞is̻aβ̞al
lari	laɾi
larunbat	laɾũmbat̪
lasaitu	las̺ai̯t̪u
lasarte	las̺art̪e
lastail	las̺t̪ai̯l
laster	las̺t̪e̞r
lauburu	lau̯β̞uɾu
laugarren	lau̯ɣ̞arẽn
lauhortz	lau̯ɦo̞rts̻
lauhortz	lau̯o̞rts̻
laukoitz	lau̯ko̞i̯ts̻
lau	lau̯
laurden	lau̯rð̞ẽ̞n
laurogei	lau̯ɾoɣ̞ei̯
lebilke	leβ̞ilke
lebilzke	leβ̞ils̺ke
lebilzke	leβ̞ils̻ke
ledin	leð̞ĩn
legarda	leɣ̞arð̞a
legazpi	leɣ̞as̺pi
legazpi	leɣ̞as̻pi
legebiltzar	leɣ̞eβ̞ilts̻ar
legezko	leɣ̞es̺ko
legezko	leɣ̞es̻ko
legike	leɣ̞ike
legikete	leɣ̞iket̪e
legitzake	leɣ̞its̻ake
legitzakete	leɣ̞its̻aket̪e
legoke	leɣ̞oke
lehendabizi	le̞ɦẽ̞n̪d̪aβ̞is̻i
lehendabizi	lẽ̞n̪d̪aβ̞is̻i
lehendakari	lehẽn̪d̪akaɾi
lehendakari	lẽn̪d̪akaɾi
lehen	lehẽn
lehen	le̞ɦẽ̞n
lehen	lẽn
lehen	lẽ̞n
leher	leher
leher	ler
lehoi	lehoi̯
lehoi	leoi̯
lei	le̞i̯
leitu	le̞i̯t̪u
lekike	le̞kike̞
lekikete	le̞kike̞t̪e̞
lekizke	le̞kis̻ke̞
lekizkete	le̞kis̻ke̞t̪e̞
lekubarri	lekuβ̞ari
lekunberri	lekũmberi
lekusazke	le̞kus̺as̻ke̞
lekusazkete	le̞kus̺as̻ke̞t̪e̞
lekuske	le̞kus̺ke̞
lekuskete	le̞kus̺ke̞t̪e̞
l	e̞le̞
lelo	le̞lo̞
lentzeria	lẽ̞nts̻e̞ɾia
lentzuke	lẽ̞nts̻uke̞
lentzukete	lẽ̞nts̻uke̞t̪e̞
lentzuzke	lẽ̞nts̻us̻ke̞
lentzuzkete	lẽ̞nts̻us̻ke̞t̪e̞
leonora	leonoɾa
leopoldo	leopol̪d̪o
lepo	le̞po̞
lerak	leɾak
lerakuske	le̞ɾakus̺ke̞
lerakuskete	le̞ɾakus̺ke̞t̪e̞
lerakutsazke	le̞ɾakuts̺as̻ke̞
lerakutsazkete	le̞ɾakuts̺as̻ke̞t̪e̞
lera	le̞ɾa
leraren	le̞ɾaɾẽ̞n
lerari	le̞ɾaɾi
lerate	leɾat̪e
lerei	le̞ɾe̞i
lerek	leɾek
leroake	le̞ɾo̞ake̞
leroakete	le̞ɾo̞ake̞t̪e̞
leroazke	le̞ɾo̞as̻ke̞
leroazkete	le̞ɾo̞as̻ke̞t̪e̞
lerro	lero
letizia	let̪is̺ia
letizia	let̪is̻ia
letonia	let̪onia
letoniera	let̪onieɾa
letorke	let̪orke
letozke	let̪os̺ke
letozke	let̪os̻ke
letra	let̪ra
letreiatu	let̪rei̯at̪u
letxekiake	letʃekiake
letxekidake	letʃekið̞ake
letxekieke	letʃekieke
letxekiguke	letʃekiɣ̞uke
letxekinake	letʃekinake
letxekinake	letʃekiɲake
letxekioke	letʃekioke
letxekizueke	letʃekis̺ueke
letxekizueke	letʃekis̻ueke
letxekizuke	letʃekis̺uke
letxekizuke	letʃekis̻uke
letxezkiake	le̞tʃe̞s̻kiake̞
letxezkidake	le̞tʃe̞s̻kið̞ake̞
letxezkieke	le̞tʃe̞s̻kie̞ke̞
letxezkiguke	le̞tʃe̞s̻kiɣ̞uke̞
letxezkinake	le̞tʃe̞s̻kinake̞
letxezkinake	le̞tʃe̞s̻kiɲake̞
letxezkioke	le̞tʃe̞s̻kio̞ke̞
letxezkizueke	le̞tʃe̞s̻kis̻ue̞ke̞
letxezkizuke	le̞tʃe̞s̻kis̻uke̞
letzake	lets̻ake
leudeke	leu̯ð̞eke
leukake	leu̯kake
leukakete	leu̯kaket̪e
leun	lẽ̞ũ̯n
leutzake	leu̯ts̻ake
leuzkake	leu̯s̺kake
leuzkake	leu̯s̻kake
leuzkakete	leu̯s̺kaket̪e
leuzkakete	leu̯s̻kaket̪e
lezaeta	les̺aet̪a
lezaeta	les̻aet̪a
lezaguke	le̞s̻aɣ̞uke̞
lezagukete	le̞s̻aɣ̞uke̞t̪e̞
lezaguzke	le̞s̻aɣ̞us̻ke̞
lezaguzkete	le̞s̻aɣ̞us̻ke̞t̪e̞
lezake	les̺ake
lezake	les̻ake
lezakete	les̺aket̪e
lezakete	les̻aket̪e
leza	les̺a
leza	les̻a
lezana	les̺ana
lezana	les̻ana
lezan	les̺ãn
lezan	les̻ãn
lezaten	les̺at̪ẽn
lezaten	les̻at̪ẽn
lezeta	les̺et̪a
lezeta	les̻et̪a
lezka	les̺ka
lezka	les̻ka
lezo	les̺o
lezo	les̻o
libanoar	liβ̞anoar
libano	liβ̞ano
libe	liβ̞e
libreto	liβ̞re̞t̪o̞
liburu	liβ̞uɾu
liburutegi	liβ̞uɾut̪eɣ̞i
lide	lið̞e
lidia	lið̞ia
lierni	lierni
lihardukake	liarð̞ukake̞
lihardukake	liɦarð̞ukake̞
lihardukakete	liarð̞ukake̞t̪e̞
lihardukakete	liɦarð̞ukake̞t̪e̞
liharduke	liarð̞uke̞
liharduke	liɦarð̞uke̞
lihardukete	liarð̞uke̞t̪e̞
lihardukete	liɦarð̞uke̞t̪e̞
lihoake	lihoake
lihoake	lixoake
lihoazke	lihoas̻ke
lihoazke	lixoas̺ke
lihoazke	lixoas̻ke
lilian	liliãn
liluragarri	liluɾaɣ̞ari
liluragarri	liʎuɾaɣ̞ari
lima	lima
limoiondo	limoi̯õn̪d̪o
linguistika	liŋɡwis̺t̪ika
lino	lino
lionel	lionel
lipschitzar	lipʃits̻ar
lirain	liɾãĩ̯n
lirateke	liɾat̪eke
lirauke	liɾau̯ke̞
liraukete	liɾau̯ke̞t̪e̞
lirudike	liɾuð̞ike̞
lirudikete	liɾuð̞ike̞t̪e̞
lisabe	lis̺aβ̞e
litekek	lit̪ekek
liteke	lit̪eke
liteken	lit̪ekẽn
litezen	lit̪es̺ẽn
litezen	lit̪es̻ẽn
litezkek	lit̪es̺kek
litezkek	lit̪es̻kek
litezke	lit̪es̺ke
litezke	lit̪es̻ke
litezken	lit̪es̺kẽn
litezken	lit̪es̻kẽn
litio	lit̪io̞
lituania	lit̪uania
lituania	lit̪wania
lituaniera	lit̪uanieɾa
lituzkek	lit̪us̺kek
lituzkek	lit̪us̻kek
lituzke	lit̪us̺ke
lituzke	lit̪us̻ke
lituzken	lit̪us̺kẽn
lituzken	lit̪us̻kẽn
lituzkete	lit̪us̺ket̪e
lituzkete	lit̪us̻ket̪e
litzake	lits̻ake
litzakete	lits̻aket̪e
litzan	lits̻ãn
litzateke	lits̻at̪eke
litzaten	lits̻at̪ẽn
lizardi	lis̺arð̞i
lizardi	lis̻arð̞i
lizarki	lis̺arki
lizarki	lis̻arki
lizar	lis̺ar
lizar	lis̻ar
lizarra	lis̺ara
lizarra	lis̻ara
llabur	ʎaβ̞ur
llama	ʎama
llollobelar	ʎoʎoβ̞elar
llollo	ʎoʎo
lodikor	loð̞ikor
lodi	loð̞i
logika	lo̞ɣ̞ika
lokailu	lokai̯lu
lokailu	lokaʎu
lorail	lo̞ɾai̯l
lorategi	loɾat̪eɣ̞i
loratu	lo̞ɾat̪u
loredenda	loɾeð̞ẽn̪d̪a
lore	loɾe
lotazil	lot̪as̺il
lotazil	lot̪as̻il
lotsakor	lots̺akor
lotsakor	lots̻akor
lotsa	lots̺a
lotsa	lots̻a
lotsati	lots̺at̪i
lotsati	lots̻at̪i
lotu	lo̞t̪u
luhuso	luhus̺o
luhuso	lus̺o
lukek	lukek
luke	luke
luken	lukẽn
lukete	luket̪e
lu	lu
luma	luma
lunes	lunes̺
lur	lur
lurra	lura
lurreratu	lureɾat̪u
lurrikara	lurikaɾa
luxenburgo	luks̺ẽmburɣ̞o
luzatu	lus̺at̪u
luzatu	lus̻at̪u
luze	lus̻e̞
luzetasun	lus̻e̞t̪as̺ũn
madariaga	mað̞aɾiaɣ̞a
madarika	mað̞aɾika
madarikatuko	mað̞aɾikat̪uko
madarikatu	mað̞aɾikat̪u
madarikatze	mað̞aɾikats̻e
madarikatzen	mað̞aɾikats̻ẽn
madari	mað̞aɾi
madariondo	mað̞aɾiõn̪d̪o
madril	mað̞ril
mahai	mahai̯
mahai	mai̯
mahats	mahats̺
mahats	mats̺
mahats	mats̻
mahuka	maɦuka
mahuka	mau̯ka
maiatz	mai̯ats̻
maila	mai̯la
maila	maʎa
mairuilar	mai̯ɾui̯lar
mairuilar	mai̯ɾui̯ʎar
mairu	mai̯ɾu
maitasun	mai̯t̪as̺ũn
maitatu	mai̯t̪at̪u
maite	mai̯t̪e
maitemin	mai̯t̪e̞mĩn
makaronesia	makaɾones̺ia
makea	makea
maketo	maket̪o
makito	makit̪o
makur	makur
mali	mali
malin	malĩn
malko	malko̞
malta	mal̪t̪a
maltera	mal̪t̪eɾa
mandarina	mãn̪d̪aɾina
mandarinondo	mãn̪d̪aɾinõn̪d̪o
mapa	mapa
marasma	maɾaz̺ma
margotu	marɣ̞o̞t̪u
margoztatu	marɣ̞o̞s̻t̪at̪u
marikoi	maɾikoi̯
marka	marka
maroko	maɾoko
marra	mara
marroi	maroi̯
marti	mart̪i
martitzen	mart̪its̻ẽ̞n
martopil	mart̪opil
martxo	martʃo̞
maskulinotasun	mas̺kulinot̪as̺ũn
masturbatu	mas̺t̪urβ̞at̪u
masusta	mas̺us̺t̪a
masustondo	mas̺us̺t̪õ̞n̪d̪o̞
matxinada	matʃinað̞a
matxinatu	matʃinat̪u
matxino	matʃino
mauka	mau̯ka
mauser	mau̯s̺e̞r
mayte	mai̯t̪e
mazedoniera	mas̺eð̞onieɾa
mazedoniera	mas̻eð̞onieɾa
mea	me̞a
meatze	me̞ats̻e̞
mehatxatu	meatʃat̪u
mehatxatu	mehatʃat̪u
mehatxu	meatʃu
mehatxu	mehatʃu
mehe	me̞
mehe	me̞ɦe̞
m	e̞me̞
mendate	mẽ̞n̪d̪at̪e̞
mendebal	mẽ̞n̪d̪e̞β̞al
mendi	mẽ̞n̪d̪i
mendiola	mẽn̪d̪iola
mendoza	mẽn̪d̪os̺a
mendoza	mẽn̪d̪os̻a
merkatu	me̞rkat̪u
mertxika	me̞rtʃika
mertxikondo	mertʃikõn̪d̪o
mesede	me̞s̺e̞ð̞e̞
mesedez	mes̺eð̞es̺
mesedez	mes̺eð̞es̻
meza	mes̺a
meza	mes̻a
mezulari	mes̺ulaɾi
mezulari	mes̻ulaɾi
mezularitza	me̞s̻ulaɾits̻a
mezu	me̞s̻u
miarritze	miarits̻e
mika	mika
mikel	mikel
milesker	mile̞s̺ke̞r
milesker	miʎe̞s̺ke̞r
mina	mina
mina	miɲa
minatu	minat̪u
minbizidun	mĩmbis̺ið̞ũn
minbizidun	mĩmbis̻ið̞ũn
minbizi	mĩmbis̺i
minbizi	mĩmbis̻i
mindu	mĩn̪d̪u
min	mĩn
mintzatu	mĩnts̻at̪u
miren	miɾẽn
miretsi	miɾe̞ts̺i
misantropok	mis̺ãn̪t̪ropok
misantropo	mis̺ãn̪t̪ropo
misantropotzat	mis̺ãn̪t̪ropots̻at̪
misil	mis̺il
mitiko	mit̪iko
mito	mit̪o̞
mizpira	mis̺piɾa
mizpira	mis̻piɾa
mizpirondo	mis̻piɾõ̞n̪d̪o̞
modu	mo̞ð̞u
moldavia	mol̪d̪aβ̞ia
moldavian	mo̞l̪d̪aβ̞iãn
monarka	monarka
mongolia	moŋɡolia
mongoliar	moŋɡoliar
mongoliera	mõ̞ŋɡo̞lie̞ɾa
monitore	mo̞nit̪o̞ɾe̞
mosketari	mos̺ket̪aɾi
mota	mo̞t̪a
motozikleta	mot̪os̺iklet̪a
motozikleta	mot̪os̻iklet̪a
motz	mo̞ts̻
mozkor	mos̺kor
mozkor	mos̻kor
mozorro	mos̺oro
mozorro	mos̻oro
moztu	mo̞s̻t̪u
muga	muɣ̞a
mugimendu	muɣ̞imẽn̪d̪u
mugitu	muɣ̞it̪u
mugurdi	muɣ̞urð̞i
muino	mui̯no̞
muino	mui̯ɲo̞
multzo	mults̻o
mundu	mũn̪d̪u
murtxikatu	murtʃikat̪u
musker	mus̺ker
muskertu	mus̺kert̪u
mutiko	mut̪iko
mutil	mut̪il
naba	naβ̞a
nabaritu	naβ̞aɾit̪u
nabar	naβ̞ar
nabilen	naβ̞ilẽn
nabilen	naβ̞iʎẽn
nabilke	naβ̞ilke
nabil	naβ̞il
nadila	nað̞ila
nadila	nað̞iʎa
nadin	nað̞ĩn
nafarroa	nafaroa
nagoen	naɣ̞oẽn
nagoke	naɣ̞oke
nago	naɣ̞o
nagusi	naɣ̞us̺i
nahasi	nahas̺i
nahasi	nas̺i
nahikoa	nahikoa
nahikoa	nai̯koa
nahiko	nahiko
nahiko	nai̯ko
nahita	nahit̪a
nahita	nai̯t̪a
naitekek	nai̯t̪ekek
naiteke	nai̯t̪eke
naiteken	nai̯t̪ekẽn
naizateke	nai̯s̺at̪eke
naizateke	nai̯s̻at̪eke
naiz	nai̯s̺
naiz	nai̯s̻
nakar	nakar
nakie	nakie
nano	nano̞
nare	naɾe̞
nasai	nas̺ai̯
nasa	nas̺a
naski	nas̺ki
natorke	nat̪orke
natorkioke	nat̪orkioke
natorkio	nat̪orkio
natorkion	nat̪orkiõn
nator	nat̪or
natorren	nat̪orẽn
natxekie	natʃekie
natxekik	natʃekik
natxekin	natʃekĩn
natxekio	natʃekio
natxekizue	natʃekis̺ue
natxekizue	natʃekis̻ue
natxekizu	natʃekis̺u
natxekizu	natʃekis̻u
natza	nats̻a
naukak	nau̯kak
nauka	nau̯ka
naukan	nau̯kãn
naukate	nau̯kat̪e
naukazue	nau̯kas̺ue
naukazue	nau̯kas̻ue
naukazu	nau̯kas̺u
naukazu	nau̯kas̻u
naukek	nau̯kek
nauke	nau̯ke
nauken	nau̯kẽn
naukete	nau̯ket̪e
naukezue	nau̯kes̺ue
naukezue	nau̯kes̻ue
naukezu	nau̯kes̺u
naukezu	nau̯kes̻u
nauk	nau̯k
nau	nau̯
naun	nãũ̯n
naute	nau̯t̪e
nauzue	nau̯s̻ue̞
nauzu	nau̯s̻u
nazaala	nas̺aala
nazaala	nas̻aala
nazaan	nas̺aãn
nazaan	nas̻aãn
nazaguk	nas̻aɣ̞uk
nazagu	nas̻aɣ̞u
nazagun	nas̻aɣ̞ũn
nazagute	nas̻aɣ̞ut̪e̞
nazaguzue	nas̻aɣ̞us̻ue̞
nazaguzu	nas̻aɣ̞us̻u
nazakek	nas̺akek
nazakek	nas̻akek
nazake	nas̺ake
nazake	nas̻ake
nazaken	nas̺akẽn
nazaken	nas̻akẽn
nazakete	nas̺aket̪e
nazakete	nas̻aket̪e
nazakezue	nas̺akes̺ue
nazakezue	nas̻akes̻ue
nazakezu	nas̺akes̺u
nazakezu	nas̻akes̻u
nazak	nas̺ak
nazak	nas̻ak
nazala	nas̺ala
nazala	nas̻ala
nazanala	nas̺anala
nazanala	nas̻anala
nazanan	nas̺anãn
nazanan	nas̻anãn
nazan	nas̺ãn
nazan	nas̻ãn
nazatela	nas̺at̪ela
nazatela	nas̻at̪ela
nazaten	nas̺at̪ẽn
nazaten	nas̻at̪ẽn
nazazuela	nas̺as̺uela
nazazuela	nas̻as̻uela
nazazue	nas̺as̺ue
nazazue	nas̻as̻ue
nazazuen	nas̺as̺uẽn
nazazuen	nas̻as̻uẽn
nazazula	nas̺as̺ula
nazazula	nas̻as̻ula
nazazu	nas̺as̺u
nazazu	nas̻as̻u
nazazun	nas̺as̺ũn
nazazun	nas̻as̻ũn
nazioarteko	nas̺ioart̪eko
nazioarteko	nas̻ioart̪eko
nazkatu	nas̺kat̪u
nazkatu	nas̻kat̪u
neba	ne̞β̞a
nederlandera	ne̞ð̞e̞rlãn̪d̪e̞ɾa
negien	neɣ̞iẽn
negike	neɣ̞ike
negitzake	neɣ̞its̻ake
negitzan	neɣ̞its̻ãn
neguero	neɣ̞ueɾo
neguil	ne̞ɣ̞ui̯l
negu	neɣ̞u
nekatu	ne̞kat̪u
nekien	ne̞kiẽ̞n
nekike	ne̞kike̞
nekizke	ne̞kis̻ke̞
nekizkien	ne̞kis̻kiẽ̞n
nekusan	ne̞kus̺ãn
nekusazke	ne̞kus̺as̻ke̞
nekuske	ne̞kus̺ke̞
nekuskien	ne̞kus̺kiẽ̞n
nenbilen	nẽmbilẽn
nenbilen	nẽmbiʎẽn
nenbilkeen	nẽmbilkeẽn
nenbilke	nẽmbilke
nendila	nẽn̪d̪ila
nendila	nẽn̪d̪iʎa
nendin	nẽn̪d̪ĩn
n	e̞ne̞
nengoen	neŋɡoẽn
nengokeen	neŋɡokeẽn
nengoke	neŋɡoke
nenkien	nẽ̞ŋkiẽ̞n
nenkion	nẽ̞ŋkiõ̞n
nentorkeen	nẽn̪t̪orkeẽn
nentorke	nẽn̪t̪orke
nentorkiokeen	nẽn̪t̪orkiokeẽn
nentorkioke	nẽn̪t̪orkioke
nentorkion	nẽn̪t̪orkiõn
nentorren	nẽn̪t̪orẽn
nentxekiake	nẽnʲtʃekiake
nentxekian	nẽnʲtʃekiãn
nentxekieke	nẽnʲtʃekieke
nentxekien	nẽnʲtʃekiẽn
nentxekinake	nẽnʲtʃekinake
nentxekinake	nẽnʲtʃekiɲake
nentxekinan	nẽnʲtʃekinãn
nentxekinan	nẽnʲtʃekiɲãn
nentxekioke	nẽnʲtʃekioke
nentxekion	nẽnʲtʃekiõn
nentxekizueke	nẽnʲtʃekis̺ueke
nentxekizueke	nẽnʲtʃekis̻ueke
nentxekizuen	nẽnʲtʃekis̺uẽn
nentxekizuen	nẽnʲtʃekis̻uẽn
nentxekizuke	nẽnʲtʃekis̺uke
nentxekizuke	nẽnʲtʃekis̻uke
nentxekizun	nẽnʲtʃekis̺ũn
nentxekizun	nẽnʲtʃekis̻ũn
nentzake	nẽnts̻ake
nentzan	nẽnts̻ãn
nentzuen	nẽ̞nts̻uẽ̞n
nentzuke	nẽ̞nts̻uke̞
nentzuzke	nẽ̞nts̻us̻ke̞
nentzuzkien	nẽ̞nts̻us̻kiẽ̞n
nenufar	nenufar
neon	ne̞õ̞n
nerabe	neɾaβ̞e
nerakuske	ne̞ɾakus̺ke̞
nerakuskien	ne̞ɾakus̺kiẽ̞n
nerakutsan	ne̞ɾakuts̺ãn
nerakutsazke	ne̞ɾakuts̺as̻ke̞
neroake	ne̞ɾo̞ake̞
neroan	ne̞ɾo̞ãn
neroatzan	ne̞ɾo̞ats̻ãn
neroazke	neɾoas̺ke
neroazke	neɾoas̻ke
neska	ne̞s̺ka
neskatila	ne̞s̺kat̪ila
neskatila	ne̞s̺kat̪iʎa
neskenegun	ne̞s̺ke̞ne̞ɣ̞ũn
neukake	neu̯kake
neukan	neu̯kãn
neuk	ne̞u̯k
neu	ne̞u̯
neurekin	ne̞u̯ɾe̞kĩn
neure	ne̞u̯ɾe̞
neuri	ne̞u̯ɾi
neurologia	ne̞u̯ɾo̞lo̞ɣ̞ia
neurozientzia	neu̯ɾos̺iẽnts̻ia
neurozientzia	neu̯ɾos̻iẽnts̻ia
neurri	ne̞u̯ri
neurtu	neu̯rt̪u
neuzkake	neu̯s̺kake
neuzkake	neu̯s̻kake
neuzkan	neu̯s̺kãn
neuzkan	neu̯s̻kãn
nezaguen	ne̞s̻aɣ̞uẽ̞n
nezaguke	ne̞s̻aɣ̞uke̞
nezaguzke	ne̞s̻aɣ̞us̻ke̞
nezaguzkien	ne̞s̻aɣ̞us̻kiẽ̞n
nezakeen	nes̺akeẽn
nezakeen	nes̻akeẽn
nezake	nes̺ake
nezake	nes̻ake
nezala	nes̺ala
nezala	nes̻ala
nezan	nes̺ãn
nezan	nes̻ãn
nigan	niɣ̞ãn
niharduen	niarð̞uẽ̞n
niharduen	niɦarð̞uẽ̞n
nihardukake	niarð̞ukake̞
nihardukake	niɦarð̞ukake̞
nihardukan	niarð̞ukãn
nihardukan	niɦarð̞ukãn
niharduke	niarð̞uke̞
niharduke	niɦarð̞uke̞
nik	nik
nindezaguan	nĩn̪d̪e̞s̻aɣ̞uãn
nindezaguen	nĩn̪d̪e̞s̻aɣ̞uẽ̞n
nindezagukek	nĩn̪d̪e̞s̻aɣ̞uke̞k
nindezaguke	nĩn̪d̪e̞s̻aɣ̞uke̞
nindezaguken	nĩn̪d̪e̞s̻aɣ̞ukẽ̞n
nindezagukete	nĩn̪d̪e̞s̻aɣ̞uke̞t̪e̞
nindezagukezue	nĩn̪d̪e̞s̻aɣ̞uke̞s̻ue̞
nindezagukezu	nĩn̪d̪e̞s̻aɣ̞uke̞s̻u
nindezagunan	nĩn̪d̪e̞s̻aɣ̞unãn
nindezaguten	nĩn̪d̪e̞s̻aɣ̞ut̪ẽ̞n
nindezaguzuen	nĩn̪d̪e̞s̻aɣ̞us̻uẽ̞n
nindezaguzun	nĩn̪d̪e̞s̻aɣ̞us̻ũn
nindoakeen	nĩn̪d̪oakeẽn
nindoake	nĩn̪d̪oake
nindoan	nĩn̪d̪oãn
ninduan	nĩn̪d̪uãn
ninduen	nĩn̪d̪uẽ̞n
nindukaan	nĩn̪d̪ukaãn
nindukakek	nĩn̪d̪ukakek
nindukake	nĩn̪d̪ukake
nindukaken	nĩn̪d̪ukakẽn
nindukakete	nĩn̪d̪ukaket̪e
nindukakezue	nĩn̪d̪ukakes̺ue
nindukakezue	nĩn̪d̪ukakes̻ue
nindukakezu	nĩn̪d̪ukakes̺u
nindukakezu	nĩn̪d̪ukakes̻u
nindukanan	nĩn̪d̪ukanãn
nindukan	nĩn̪d̪ukãn
nindukaten	nĩn̪d̪ukat̪ẽn
nindukazuen	nĩn̪d̪ukas̺uẽn
nindukazuen	nĩn̪d̪ukas̻uẽn
nindukazun	nĩn̪d̪ukas̺ũn
nindukazun	nĩn̪d̪ukas̻ũn
nindukean	nĩn̪d̪ukeãn
nindukeen	nĩn̪d̪ukeẽn
nindukek	nĩn̪d̪ukek
nindukenan	nĩn̪d̪ukenãn
ninduke	nĩn̪d̪uke
ninduken	nĩn̪d̪ukẽn
nindukete	nĩn̪d̪uket̪e
ninduketen	nĩn̪d̪uket̪ẽn
nindukezue	nĩn̪d̪ukes̺ue
nindukezue	nĩn̪d̪ukes̻ue
nindukezuen	nĩn̪d̪ukes̺uẽn
nindukezuen	nĩn̪d̪ukes̻uẽn
nindukezu	nĩn̪d̪ukes̺u
nindukezu	nĩn̪d̪ukes̻u
nindukezun	nĩn̪d̪ukes̺ũn
nindukezun	nĩn̪d̪ukes̻ũn
nindunan	nĩn̪d̪unãn
ninduten	nĩn̪d̪ut̪ẽ̞n
ninduzuen	nĩn̪d̪us̻uẽ̞n
ninduzun	nĩn̪d̪us̻ũn
ni	ni
nintekean	nĩn̪t̪ekeãn
nintekeen	nĩn̪t̪ekeẽn
nintekek	nĩn̪t̪ekek
nintekenan	nĩn̪t̪ekenãn
ninteke	nĩn̪t̪eke
ninteken	nĩn̪t̪ekẽn
nintzaala	nĩnts̻aala
nintzaan	nĩnts̻aãn
nintzakean	nĩnts̻akeãn
nintzakeen	nĩnts̻akeẽn
nintzakek	nĩnts̻akek
nintzakenan	nĩnts̻akenãn
nintzake	nĩnts̻ake
nintzaken	nĩnts̻akẽn
nintzakete	nĩnts̻aket̪e
nintzaketen	nĩnts̻aket̪ẽn
nintzakezue	nĩnts̻akes̺ue
nintzakezue	nĩnts̻akes̻ue
nintzakezuen	nĩnts̻akes̺uẽn
nintzakezuen	nĩnts̻akes̻uẽn
nintzakezu	nĩnts̻akes̺u
nintzakezu	nĩnts̻akes̻u
nintzakezun	nĩnts̻akes̺ũn
nintzakezun	nĩnts̻akes̻ũn
nintzala	nĩnts̻ala
nintzanala	nĩnts̻anala
nintzanan	nĩnts̻anãn
nintzan	nĩnts̻ãn
nintzatekeen	nĩnts̻at̪ekeẽn
nintzateke	nĩnts̻at̪eke
nintzatela	nĩnts̻at̪ela
nintzaten	nĩnts̻at̪ẽn
nintzazuela	nĩnts̻as̺uela
nintzazuela	nĩnts̻as̻uela
nintzazuen	nĩnts̻as̺uẽn
nintzazuen	nĩnts̻as̻uẽn
nintzazula	nĩnts̻as̺ula
nintzazula	nĩnts̻as̻ula
nintzazun	nĩnts̻as̺ũn
nintzazun	nĩnts̻as̻ũn
nintzen	nĩnts̻ẽn
nirauen	niɾau̯ẽ̞n
nirauke	niɾau̯ke̞
niregan	niɾe̞ɣ̞ãn
nire	niɾe̞
nirudien	niɾuð̞iẽ̞n
nirudike	niɾuð̞ike̞
nitan	nit̪ãn
nitrogeno	nit̪ro̞xe̞no̞
nituen	nit̪uẽ̞n
nituzkeen	nit̪us̺keẽn
nituzkeen	nit̪us̻keẽn
nituzke	nit̪us̺ke
nituzke	nit̪us̻ke
nitzakeen	nits̻akeẽn
nitzake	nits̻ake
nitzala	nits̻ala
nitzan	nits̻ãn
noake	noake
noan	noãn
noa	noa
nogat	noɣ̞at̪
noizarte	noi̯s̺art̪e
noizarte	noi̯s̻art̪e
noizdaino	noi̯z̻ð̞ai̯no
noizdaino	noi̯z̺ð̞aɲo
noizdaino	noi̯z̻ð̞aɲo
noizko	noi̯s̺ko
noizko	noi̯s̻ko
noiz	noi̯s̺
noiz	noi̯s̻
noiztsu	noi̯s̺ts̻u
noiztsu	noi̯s̻ts̺u
nolako	nolako
nolakotasun	nolakot̪as̺ũn
nolakotsu	nolakots̺u
nolakotsu	nolakots̻u
nola	no̞la
non	nõn
nora	noɾa
norbait	no̞rβ̞ai̯t̪
nori	noɾi
nork	nork
nor	nor
nortzuk	norts̻uk
norvegia	norβ̞eɣ̞ia
norvegiera	norβ̞eɣ̞ieɾa
nuen	nuẽn
nukeen	nukeẽn
nuke	nuke
oasi	oas̺i
objektu	o̞β̞je̞kt̪u
odol	oð̞ol
odoltsu	oð̞olts̺u
odoltsu	oð̞olts̻u
odolustu	oð̞olus̺t̪u
odolzale	oð̞ols̺ale
odolzale	oð̞ols̻ale
ogale	oɣ̞ale
ogasun	oɣ̞as̺ũn
ogerleko	oɣ̞erleko
ogi	oɣ̞i
ogitarteko	oɣ̞it̪art̪eko
ogro	oɣ̞ro
ohe	o̞e̞
ohe	o̞ɦe̞
ohe	o̞β̞je̞kt̪ue̞ɣ̞alaɾie̞s̻e̞s̻aɣ̞ũn
ohe	o̞β̞je̞kt̪uɦe̞ɣ̞alaɾie̞s̻e̞s̻aɣ̞ũn
oheratu	o̞e̞ɾat̪u
oheratu	o̞ɦe̞ɾat̪u
ohoin	ohõĩ̯n
ohoin	õĩ̯n
ohore	ohoɾe
ohore	oɾe
oilartu	o̞i̯lart̪u
oilartu	o̞ʎart̪u
oilasko	oi̯las̺ko
oilasko	oʎas̺ko
oilaur	o̞i̯lau̯r
oilaur	o̞ʎau̯r
oilo	o̞i̯lo̞
oilo	o̞ʎo̞
oinarri	oi̯nari
oinarri	oɲari
oinetako	o̞i̯ne̞t̪ako̞
oinetako	o̞ɲe̞t̪ako̞
oinezko	oi̯nes̻ko
oinezko	oɲes̺ko
oinezko	oɲes̻ko
oin	õĩ̯n
oka	o̞ka
okela	okela
okindegi	okĩn̪d̪eɣ̞i
okin	okĩn
okzitaniera	oks̺it̪anieɾa
okzitaniera	oks̻it̪anieɾa
olagarro	olaɣ̞aro
olano	olano
olarte	olart̪e
olerkari	olerkaɾi
olerkaritza	olerkaɾits̻a
olerkigintza	olerkiɣ̞ĩnts̻a
olerki	olerki
olibondo	o̞liβ̞õ̞n̪d̪o̞
olo	olo
omen	omẽn
omonier	omonier
onartu	onart̪u
oñati	oɲat̪i
ondarroa	õn̪d̪aroa
onddoketari	õɲɟoket̪aɾi
onddo	õɲɟo
ondoegi	õn̪d̪oeɣ̞i
ondoen	õn̪d̪oẽn
ondo	õn̪d̪o
ondoren	õ̞n̪d̪o̞ɾẽ̞n
ondorio	õn̪d̪oɾio
ongiegi	oŋɡieɣ̞i
ongietorri	oŋɡiet̪ori
ongi	oŋɡi
ongizate	oŋɡis̺at̪e
ongizate	oŋɡis̻at̪e
onil	o̞nil
on	õ̞n
ontzi	õnts̻i
o	o̞
opagai	opaɣ̞ai̯
opagarri	o̞paɣ̞ari
opaka	o̞paka
opakizun	o̞pakis̻ũn
opaku	o̞paku
opaldu	opal̪d̪u
opalo	o̞palo̞
opa	opa
oparigai	opaɾiɣ̞ai̯
opari	opaɾi
oparitu	opaɾit̪u
oparoaldi	opaɾoal̪d̪i
oparo	opaɾo
oparotasun	opaɾot̪as̺ũn
oparotsu	opaɾots̺u
oparotsu	opaɾots̻u
oparri	opari
opatu	o̞pat̪u
ope	ope
operadore	opeɾað̞oɾe
opera	opeɾa
operatibo	opeɾat̪iβ̞o
operatu	opeɾat̪u
operatzaile	opeɾats̻ai̯le
operatzaile	opeɾats̻aʎe
operazio	opeɾas̺io
operazio	opeɾas̻io
opereta	opeɾet̪a
operkulu	operkulu
opetsi	opets̺i
opetsi	opets̻i
opil	opil
oratu	o̞ɾat̪u
ordenagailu	orð̞enaɣ̞ai̯lu
ordenagailu	orð̞enaɣ̞aʎu
ordenatu	o̞rð̞e̞nat̪u
ordots	o̞rð̞o̞ts̺
orein	o̞ɾẽ̞ĩ̯n
oreka	o̞ɾe̞ka
orendain	oɾẽn̪d̪ãĩ̯n
orlegi	o̞rle̞ɣ̞i
oroitu	o̞ɾo̞i̯t̪u
orokor	oɾokor
or	o̞r
orratz	o̞rats̻
orreaga	oreaɣ̞a
orril	o̞ril
orri	o̞ri
ortzadar	orts̻að̞ar
ortzegun	o̞rts̻e̞ɣ̞ũn
ortzi	o̞rts̻i
ortzirale	o̞rts̻iɾale̞
osaba	os̺aβ̞a
osasun	o̞s̺as̺ũn
oskol	o̞s̺ko̞l
osoki	o̞s̺o̞ki
osoko	o̞s̺o̞ko̞
oso	os̺o
ospe	os̺pe
ospetsu	os̺pets̺u
ospetsu	os̺pets̻u
ostean	o̞s̺t̪e̞ãn
ostegun	o̞s̺t̪e̞ɣ̞ũn
oste	o̞s̺t̪e̞
ostiral	o̞s̺t̪iɾal
otarteko	ot̪art̪eko
oteka	ot̪eka
ote	ot̪e
otordu	ot̪orð̞u
otsail	ots̺ai̯l
otsail	ots̻ai̯l
otsein	ots̺ẽĩ̯n
otsein	ots̻ẽĩ̯n
otso	o̞ts̺o̞
otxardi	o̞tʃarð̞i
otxar	otʃar
oxigeno	o̞ks̺ixe̞no̞
ozpin	os̺pĩn
ozpin	os̻pĩn
oztin	o̞s̻t̪ĩn
pago	paɣ̞o̞
palestina	pales̺t̪ina
palestinar	pales̺t̪inar
pandemia	pãn̪d̪emia
pandora	pãn̪d̪oɾa
panparroi	pãmparo̞i̯
papar	papar
pasaporte	pas̺aport̪e
pasatu	pas̺at̪u
paseko	pas̺eko
pase	pas̺e̞
patata	pat̪at̪a
pattaldu	pacal̪d̪u
pattal	pacal
patxaran	patʃaɾãn
pauso	pau̯s̺o̞
peirahorada	pei̯ɾahoɾað̞a
peirahorada	pei̯ɾaoɾað̞a
pelikula	pelikula
penintsula	pe̞nĩnts̺ula
pentagrama	pẽ̞n̪t̪aɣ̞rama
pentsaera	pẽnts̺aeɾa
pentsaera	pẽnts̻aeɾa
pentsatu	pẽ̞nts̺at̪u
pe	pe̞
perpaus	perpau̯s̺
perretxiko	peretʃiko
pertsonal	perts̺onal
pertsonal	perts̻onal
petri	pet̪ri
pika	pika
pikondo	pikõn̪d̪o
piku	piku
pila	pila
pila	piʎa
pinaburu	pinaβ̞uɾu
pinaburu	piɲaβ̞uɾu
pinpilinpauxa	pĩmpilĩmpau̯ʃa
pinpilinpauxa	pĩmpiʎĩmpau̯ʃa
pintxo	pĩnʲtʃo
pinu	pinu
pinu	piɲu
piraña	piɾaɲa
pirinioak	piɾinioak
pistoi	pis̺t̪oi̯
pistola	pis̺t̪ola
pisu	pis̺u
pixa	piʃa
piztu	pis̻t̪u
plaia	plai̯a
plangintza	plãŋɡĩnts̻a
plantain	plãn̪t̪ãĩ̯n
plastiko	plas̺t̪iko̞
plater	plat̪e̞r
pobrezia	poβ̞res̺ia
pobrezia	poβ̞res̻ia
poeta	poet̪a
polen	po̞lẽ̞n
politikari	polit̪ikaɾi
politiko	polit̪iko
polit	po̞lit̪
polje	poʎe
polonian	po̞lo̞niãn
polonia	polonia
poloniera	polonieɾa
poltsa	polts̺a
poltsa	polts̻a
porlan	porlãn
pornografiko	pornoɣ̞rafiko
porrot	porot̪
porru	po̞ru
porrusalda	po̞rus̺al̪d̪a
portugaldar	po̞rt̪uɣ̞al̪d̪ar
portugalera	po̞rt̪uɣ̞ale̞ɾa
portugal	port̪uɣ̞al
portuges	po̞rt̪uɣ̞e̞s̺
potasio	pot̪as̺io
potentzia	pot̪ẽnts̻ia
potolo	pot̪olo
pozoidun	po̞s̻o̞i̯ð̞ũn
pozoidura	po̞s̻o̞i̯ð̞uɾa
pozoi	po̞s̻o̞i̯
pozoitasun	po̞s̻o̞i̯t̪as̺ũn
pozoitsu	po̞s̻o̞i̯ts̺u
pozoitu	po̞s̻o̞i̯t̪u
p	pe̞
prepuzio	pre̞pus̻io̞
presa	pres̺a
presidente	pres̺ið̞ẽn̪t̪e
primerako	primeɾako
primeran	primeɾãn
probintzia	proβ̞ĩnts̻ia
prostituzio	pros̺t̪it̪us̺io
prostituzio	pros̺t̪it̪us̻io
psikologia	s̺ikoloɣ̞ia
publizitate	puβ̞lis̺it̪at̪e
publizitate	puβ̞lis̻it̪at̪e
punta	pũn̪t̪a
puntu	pũn̪t̪u
putakume	put̪akume
putre	put̪re̞
putzu	puts̻u
qatartar	kat̪art̪ar
q	ku
quad	kwað̞
quantum	kwãn̪t̪ũm
quark	kwark
quasar	kwas̺ar
quebectar	keβ̞ekt̪ar
quorum	kwoɾũm
rabbi	raβ̞i
radar	rað̞ar
radian	rað̞iãn
radian	rað̞jãn
radio	rað̞io
radon	rað̞õ̞n
raid	rai̯ð̞
raja	raja
raja	raxa
ralenti	ralẽ̞n̪t̪i
rally	rali
ramadan	ramað̞ãn
rand	rãn̪d̪
ranking	rãŋkĩn
rankin	rãŋkĩn
rantxera	rãnʲtʃeɾa
rapanui	rapanui̯
rappel	rape̞l
rap	rap
rapsoda	raps̺o̞ð̞a
rapsodia	raps̺o̞ð̞ja
requiem	rekiẽm
requiem	rekjẽm
r	e̞re̞
robotika	roβ̞ot̪ika
robot	roβ̞ot̪
sabin	s̺aβ̞ĩn
sable	s̺aβ̞le
sagardo	s̺aɣ̞arð̞o
sagarrondo	s̺aɣ̞arõ̞n̪d̪o̞
sagar	s̺aɣ̞ar
sagu	s̺aɣ̞u
saguzar	s̺aɣ̞us̻ar
saio	s̺ai̯o̞
salaberria	s̺alaβ̞eria
salatu	s̺alat̪u
salbatu	s̺alβ̞at̪u
saldu	s̺al̪d̪u
salmenta	s̺almẽ̞n̪t̪a
saltxitxa	s̺alʲtʃitʃa
saltzaile	s̺alts̻ai̯le
saltzaile	s̺alts̻aʎe
sama	s̺ama
sanroke	s̺ãnroke
san	s̺ãn
santutegi	s̺ãn̪t̪ut̪eɣ̞i
sardexka	s̺arð̞e̞ʃka
sari	s̺aɾi
sarraila	s̺arai̯la
sarraila	s̺araʎa
sarrera	s̺areɾa
sarriegi	s̺arieɣ̞i
sartalde	s̺art̪al̪d̪e̞
sartu	s̺art̪u
sasi	s̺as̺i
satandre	s̺at̪ãn̪d̪re
satan	s̺at̪ãn
satitsu	s̺at̪its̺u
satitsu	s̺at̪its̻u
sator	s̺at̪o̞r
satsu	s̺ats̺u
satsu	s̺ats̻u
segitu	s̺e̞ɣ̞it̪u
segurtatu	s̺eɣ̞urt̪at̪u
seguru	s̺e̞ɣ̞uɾu
seigarren	s̺ei̯ɣ̞arẽn
seikoitz	s̺e̞i̯ko̞i̯ts̻
seiren	s̺e̞i̯ɾẽ̞n
sei	s̺e̞i̯
sekretu	s̺e̞kre̞t̪u
semaforo	s̺emafoɾo
seme	s̺eme
senargai	s̺enarɣ̞ai̯
senar	s̺enar
senide	s̺enið̞e
serbia	s̺erβ̞ia
serbiera	s̺erβ̞ieɾa
serbokroaziera	s̺e̞rβ̞o̞kro̞as̻ie̞ɾa
s	e̞s̺e̞
setemere	s̺e̞t̪e̞me̞ɾe̞
setio	s̺e̞t̪io̞
sinatu	s̺inat̪u
sinatu	s̺iɲat̪u
sinekdoke	s̺inekð̞oke
sinestezin	s̺ine̞s̺t̪e̞s̻ĩn
sinestezin	s̺iɲe̞s̺t̪e̞s̻ĩn
singapur	s̺iŋɡapur
sits	s̺its̺
siziliera	s̺is̻ilieɾa
siziliera	s̺is̺iʎieɾa
siziliera	s̺is̻iʎieɾa
ska	es̺ka
skate	es̺kei̯t̪
skater	es̺kei̯t̪er
slogan	ez̺loɣ̞ãn
sofokles	s̺ofokles̺
soilik	s̺oi̯lik
soilik	s̺oʎik
soil	s̺oi̯l
soin	s̺õĩ̯n
soinu	s̺oi̯nu
soinu	s̺oɲu
sokamutur	s̺okamut̪ur
soka	s̺oka
soldadu	s̺ol̪d̪að̞u
somaliera	s̺omalieɾa
sorbalda	s̺orβ̞al̪d̪a
sorgin	s̺orɣ̞ĩn
sor	s̺or
sortalde	s̺ort̪al̪d̪e
sortu	s̺ort̪u
so	s̺o
squash	es̺kwaʃ
sudur	s̺uð̞ur
suebaki	s̺ueβ̞aki
suedia	s̺ueð̞ia
suediera	s̺ueð̞ieɾa
sufre	s̺ufre̞
suge	s̺uɣ̞e̞
suhi	s̺uhi
suhi	s̺ui̯
suitza	s̺ui̯ts̻a
sukalde	s̺ukal̪d̪e
suma	s̺uma
sumendi	s̺umẽ̞n̪d̪i
suntsipen	s̺ũnts̺ipẽn
suntsipen	s̺ũnts̻ipẽn
suntsitu	s̺ũnts̺it̪u
suntsitu	s̺ũnts̻it̪u
supazter	s̺upas̺t̪er
supazter	s̺upas̻t̪er
sur	s̺ur
sushi	s̺uʃi
susmo	s̺uz̺mo̞
su	s̺u
sutegi	s̺ut̪eɣ̞i
sutu	s̺ut̪u
taberna	t̪aβ̞e̞rna
tailandiera	t̪ai̯lãn̪d̪ieɾa
tailandiera	t̪aʎãn̪d̪ieɾa
talde	t̪al̪d̪e̞
talka	t̪alka
talo	t̪alo̞
tamaina	t̪amai̯na
tamaina	t̪amaɲa
taratulu	t̪aɾat̪ulu
tarteka	t̪art̪e̞ka
tarte	t̪art̪e̞
tatami	t̪at̪ami
taupadaka	t̪au̯pað̞aka
taupada	t̪au̯pað̞a
tauromakia	t̪au̯ɾo̞makia
taxilari	t̪aks̺ilaɾi
teleaulki	t̪eleau̯lki
telezabor	t̪e̞le̞s̻aβ̞o̞r
ternua	t̪ernua
testuinguru	t̪es̺t̪ui̯ŋɡuɾu
te	t̪e̞
tibia	t̪iβ̞ia
tigreari	t̪iɣ̞re̞aɾi
tigrea	t̪iɣ̞re̞a
tigre	t̪iɣ̞re
tigrez	t̪iɣ̞re̞s̻
tindagai	t̪ĩn̪d̪aɣ̞ai̯
tinda	t̪ĩn̪d̪a
tindatu	t̪ĩn̪d̪at̪u
tipula	t̪ipula
tiro	t̪iɾo̞
tirrin	t̪irĩn
titulu	t̪it̪ulu
tobera	t̪o̞β̞e̞ɾa
tokik	t̪okik
toki	t̪oki
tomate	t̪omat̪e
tona	t̪o̞na
tontor	t̪õn̪t̪or
tonuerdi	t̪onuerð̞i
tonu	t̪o̞nu
topa	t̪o̞pa
tori	t̪oɾi
tradizional	t̪rað̞is̺ional
tradizional	t̪rað̞is̻ional
trafiko	t̪rafiko̞
tramankuluk	t̪ramaŋkuluk
tramankuluren	t̪ramaŋkuluɾẽn
tramankulurik	t̪ramaŋkuluɾik
tramankulu	t̪ramaŋkulu
tramankulutzat	t̪ramaŋkuluts̻at̪
tranpa	t̪rãmpa
transnistria	t̪rãnz̺nis̺t̪ria
tren	t̪rẽ̞n
trepeta	t̪repet̪a
tresna	t̪rez̺na
tronboi	t̪rõmboi̯
truke	t̪ruke
ttantta	cãɲca
t	t̪e̞
ttipi	cipi
tunisian	t̪unis̺iãn
tunisia	t̪unis̺ia
turkiar	t̪urkiar
turkia	t̪urkia
turkiera	t̪urkieɾa
turkmenera	t̪urkmeneɾa
tutu	t̪ut̪u
txahal	tʃahal
txahal	tʃal
txakaviera	tʃakaβ̞ie̞ɾa
txakolin	tʃakolĩn
txakurkume	tʃakurkume
txakur	tʃakur
txalupa	tʃalupa
txanda	tʃãn̪d̪a
txantxangorri	tʃãnʲtʃaŋɡori
txantxa	tʃãnʲtʃa
txapeldun	tʃapel̪d̪ũn
txapel	tʃapel
txar	tʃar
txatxarkeria	tʃatʃarkeɾia
txatxar	tʃatʃar
txekiera	tʃekieɾa
txermen	tʃermẽn
txerriki	tʃeriki
txerrikume	tʃerikume
txerri	tʃeri
txerto	tʃert̪o
txetnik	tʃe̞t̪nik
txibia	tʃiβ̞ia
txigorgailu	tʃiɣ̞orɣ̞ai̯lu
txigorgailu	tʃiɣ̞orɣ̞aʎu
txile	tʃile
tximeleta	tʃimelet̪a
tximinia	tʃiminia
tximinia	tʃimiɲia
tximino	tʃimino
tximino	tʃimiɲo
tximitxa	tʃimitʃa
txina	tʃina
txinera	tʃineɾa
txingurri	tʃĩŋɡuri
txipiroi	tʃipiɾoi̯
txirrindulari	tʃirĩn̪d̪ulaɾi
txirrindularitza	tʃirĩn̪d̪ulaɾits̻a
txirrindu	tʃirĩn̪d̪u
txirrin	tʃirĩn
txiste	tʃis̺t̪e
txistu	tʃis̺t̪u
txiza	tʃis̺a
txiza	tʃis̻a
txoke	tʃoke
txokolate	tʃo̞ko̞lat̪e̞
txori	tʃoɾi
txorizo	tʃoɾis̺o
txorizo	tʃoɾis̻o
txotx	tʃotʃ
txuleta	tʃulet̪a
ubalde	uβ̞al̪d̪e
udaberriro	uð̞aβ̞eriɾo
udaberri	uð̞aβ̞e̞ri
udalerri	uð̞aleri
udaletxe	uð̞aletʃe
udaltzainburu	uð̞alts̻ãĩ̯mbuɾu
udaltzaingo	uð̞alts̻ai̯ŋɡo
udaltzain	uð̞alts̻ãĩ̯n
udal	uð̞al
udare	uð̞aɾe
udaro	uð̞aɾo
uda	uð̞a
udazkenero	uð̞as̺keneɾo
udazkenero	uð̞as̻keneɾo
udazken	uð̞as̺kẽn
udazken	uð̞as̻kẽn
ugalde	uɣ̞al̪d̪e
ugaldu	uɣ̞al̪d̪u
ugatz	uɣ̞ats̻
ugaztun	uɣ̞as̻t̪ũn
uhandre	uãn̪d̪re
uhandre	uhãn̪d̪re
uhartedi	uart̪eð̞i
uhartedi	uhart̪eð̞i
uhartegi	uart̪eɣ̞i
uhartegi	uhart̪eɣ̞i
uharte	uart̪e
uharte	uhart̪e
ukabilkada	ukaβ̞ilkað̞a
ukabilkatu	ukaβ̞ilkat̪u
ukabil	ukaβ̞il
ukan	ukãn
ukitu	ukit̪u
ukondo	ukõ̞n̪d̪o̞
ukondu	ukõ̞n̪d̪u
ukrainan	ukrai̯nãn
ukraina	ukrai̯na
ukrainera	ukrai̯neɾa
ulertu	ulert̪u
ultzera	ults̻eɾa
umedun	ume̞ð̞ũn
ume	ume̞
unai	unai̯
unibertsitate	uniβ̞erts̺it̪at̪e
unibertsitate	uniβ̞erts̻it̪at̪e
untxitegi	ũnʲtʃit̪eɣ̞i
untxi	ũnʲtʃi
urdandegi	urð̞ãn̪d̪eɣ̞i
urde	urð̞e
urdin	urð̞ĩn
urizaharra	uɾis̻ahara
urizaharra	uɾis̺ara
urizaharra	uɾis̻ara
urrats	urats̺
urrats	urats̻
urre	ure̞
urrieta	urie̞t̪a
urril	uril
urri	uri
urtaro	urt̪aɾo̞
urtarril	urt̪aril
urtegi	urt̪eɣ̞i
urte	urt̪e
urtu	urt̪u
urtxintxa	urtʃĩnʲtʃa
ur	ur
urzo	urs̻o̞
usategi	us̺at̪eɣ̞i
uso	us̺o
usteldura	us̺t̪el̪d̪uɾa
usteldu	us̺t̪e̞l̪d̪u
ustel	us̺t̪el
utzak	uts̻ak
utzan	uts̻ãn
utzazkidak	uts̻as̺kið̞ak
utzazkidak	uts̻as̻kið̞ak
utzazkidan	uts̻as̺kið̞ãn
utzazkidan	uts̻as̻kið̞ãn
utzazkidazue	uts̻as̺kið̞as̺ue
utzazkidazue	uts̻as̻kið̞as̻ue
utzazkidazu	uts̻as̺kið̞as̺u
utzazkidazu	uts̻as̻kið̞as̻u
utzazkiek	uts̻as̺kiek
utzazkiek	uts̻as̻kiek
utzazkien	uts̻as̺kiẽn
utzazkien	uts̻as̻kiẽn
utzazkiezue	uts̻as̺kies̺ue
utzazkiezue	uts̻as̻kies̻ue
utzazkiezu	uts̻as̺kies̺u
utzazkiezu	uts̻as̻kies̻u
utzazkiguk	uts̻as̺kiɣ̞uk
utzazkiguk	uts̻as̻kiɣ̞uk
utzazkigun	uts̻as̺kiɣ̞ũn
utzazkigun	uts̻as̻kiɣ̞ũn
utzazkiguzue	uts̻as̺kiɣ̞us̺ue
utzazkiguzue	uts̻as̻kiɣ̞us̻ue
utzazkiguzu	uts̻as̺kiɣ̞us̺u
utzazkiguzu	uts̻as̻kiɣ̞us̻u
utzazkiok	uts̻as̺kiok
utzazkiok	uts̻as̻kiok
utzazkion	uts̻as̺kiõn
utzazkion	uts̻as̻kiõn
utzazkiozue	uts̻as̺kios̺ue
utzazkiozue	uts̻as̻kios̻ue
utzazkiozu	uts̻as̺kios̺u
utzazkiozu	uts̻as̻kios̻u
utzazue	uts̻as̺ue
utzazue	uts̻as̻ue
utzazu	uts̻as̺u
utzazu	uts̻as̻u
utziek	uts̻iek
utzien	uts̻iẽn
utziezue	uts̻ies̺ue
utziezue	uts̻ies̻ue
utziezu	uts̻ies̺u
utziezu	uts̻ies̻u
utziok	uts̻iok
utzion	uts̻iõn
utziozue	uts̻ios̺ue
utziozue	uts̻ios̻ue
utziozu	uts̻ios̺u
utziozu	uts̻ios̻u
utzi	uts̻i
utz	uts̻
u	u
uve	uβ̞e̞
uzbekera	uz̻β̞e̞ke̞ɾa
uzkuk	us̺kuk
uzkuk	us̻kuk
uzkun	us̺kũn
uzkun	us̻kũn
uzkuzue	us̺kus̺ue
uzkuzue	us̻kus̻ue
uzkuzu	us̺kus̺u
uzkuzu	us̻kus̻u
uztail	us̻t̪ai̯l
uztak	us̺t̪ak
uztak	us̻t̪ak
uztan	us̺t̪ãn
uztan	us̻t̪ãn
uzta	us̻t̪a
uztazue	us̺t̪as̺ue
uztazue	us̻t̪as̻ue
uztazu	us̺t̪as̺u
uztazu	us̻t̪as̻u
valentzia	balẽnts̻ia
vietnam	biet̪nãm
vietnamdar	biet̪nãmd̪ar
vietnamera	biet̪nameɾa
vietnamera	bjet̪nameɾa
v	uβ̞e̞
wagnertar	baɣ̞nert̪ar
wikiztegia	wikis̺t̪eɣ̞ia
wikiztegia	wikis̻t̪eɣ̞ia
w	uβ̞e̞β̞iko̞i̯ts̻
xabier	ʃaβ̞ier
xaboi	ʃaβ̞o̞i̯
xakelari	ʃakelaɾi
xake	ʃake
xanpu	ʃãmpu
xelena	ʃelena
xemein	ʃemẽĩ̯n
ximena	ʃimena
ximon	ʃimõn
ximun	ʃimũn
x	iʃa
xobadin	ʃoβ̞að̞ĩn
xuban	ʃuβ̞ãn
xuntako	ʃũn̪t̪ako
xurgagailu	ʃurɣ̞aɣ̞ai̯lu
xurgagailu	ʃurɣ̞aɣ̞aʎu
yarda	dʒarð̞a
yarda	jarð̞a
yarda	ɟarð̞a
y	iɣ̞re̞ko̞
zabala	s̺aβ̞ala
zabala	s̻aβ̞ala
zabaldu	s̻aβ̞al̪d̪u
zabal	s̻aβ̞al
zabiltzan	s̺aβ̞ilts̻ãn
zabiltzan	s̻aβ̞ilts̻ãn
zabiltza	s̺aβ̞ilts̻a
zabiltza	s̻aβ̞ilts̻a
zabiltzaten	s̺aβ̞ilts̻at̪ẽn
zabiltzaten	s̻aβ̞ilts̻at̪ẽn
zabiltzate	s̺aβ̞ilts̻at̪e
zabiltzate	s̻aβ̞ilts̻at̪e
zabilzke	s̺aβ̞ils̺ke
zabilzke	s̻aβ̞ils̻ke
zabilzkete	s̺aβ̞ils̺ket̪e
zabilzkete	s̻aβ̞ils̻ket̪e
zabor	s̺aβ̞or
zabor	s̻aβ̞or
zabortegi	s̺aβ̞ort̪eɣ̞i
zabortegi	s̻aβ̞ort̪eɣ̞i
zahar	s̻ahar
zahar	s̺ar
zahar	s̻ar
zahi	s̻aɦi
zahi	s̻ai̯
zaindu	s̺ãĩ̯n̪d̪u
zaindu	s̻ãĩ̯n̪d̪u
zaingorri	s̻ãĩ̯ŋɡo̞ri
zain	s̺ãĩ̯n
zain	s̻ãĩ̯n
zaintxuri	s̻ãĩ̯nʲtʃuɾi
zaintzuri	s̻ãĩ̯nts̻uɾi
zainurdin	s̻ai̯nurð̞ĩn
zainurdin	s̻aɲurð̞ĩn
zainzuri	s̻ãĩ̯ns̻uɾi
zaitezela	s̺ai̯t̪es̺ela
zaitezela	s̻ai̯t̪es̻ela
zaitezen	s̺ai̯t̪es̺ẽn
zaitezen	s̻ai̯t̪es̻ẽn
zaitezke	s̺ai̯t̪es̺ke
zaitezke	s̻ai̯t̪es̻ke
zaitezkete	s̺ai̯t̪es̺ket̪e
zaitezkete	s̻ai̯t̪es̻ket̪e
zaitez	s̺ai̯t̪es̺
zaitez	s̻ai̯t̪es̻
zaiteztela	s̺ai̯t̪es̺t̪ela
zaiteztela	s̻ai̯t̪es̻t̪ela
zaitezten	s̺ai̯t̪es̺t̪ẽn
zaitezten	s̻ai̯t̪es̻t̪ẽn
zaitezte	s̺ai̯t̪es̺t̪e
zaitezte	s̻ai̯t̪es̻t̪e
zaitugu	s̻ai̯t̪uɣ̞u
zaitu	s̻ai̯t̪u
zaitut	s̻ai̯t̪ut̪
zaituzkegu	s̺ai̯t̪us̺keɣ̞u
zaituzkegu	s̻ai̯t̪us̻keɣ̞u
zaituzke	s̺ai̯t̪us̺ke
zaituzke	s̻ai̯t̪us̻ke
zaituzketegu	s̺ai̯t̪us̺ket̪eɣ̞u
zaituzketegu	s̻ai̯t̪us̻ket̪eɣ̞u
zaituzkete	s̺ai̯t̪us̺ket̪e
zaituzkete	s̻ai̯t̪us̻ket̪e
zaituzketete	s̺ai̯t̪us̺ket̪et̪e
zaituzketete	s̻ai̯t̪us̻ket̪et̪e
zaituzketet	s̺ai̯t̪us̺ket̪et̪
zaituzketet	s̻ai̯t̪us̻ket̪et̪
zaituzket	s̺ai̯t̪us̺ket̪
zaituzket	s̻ai̯t̪us̻ket̪
zaituztegu	s̻ai̯t̪us̻t̪e̞ɣ̞u
zaituzte	s̻ai̯t̪us̻t̪e̞
zaituztete	s̺ai̯t̪us̺t̪et̪e
zaituztete	s̻ai̯t̪us̻t̪et̪e
zaituztet	s̻ai̯t̪us̻t̪e̞t̪
zaitzadala	s̺ai̯ts̻að̞ala
zaitzadala	s̻ai̯ts̻að̞ala
zaitzadan	s̺ai̯ts̻að̞ãn
zaitzadan	s̻ai̯ts̻að̞ãn
zaitzagula	s̺ai̯ts̻aɣ̞ula
zaitzagula	s̻ai̯ts̻aɣ̞ula
zaitzagun	s̺ai̯ts̻aɣ̞ũn
zaitzagun	s̻ai̯ts̻aɣ̞ũn
zaitzakegu	s̺ai̯ts̻akeɣ̞u
zaitzakegu	s̻ai̯ts̻akeɣ̞u
zaitzake	s̺ai̯ts̻ake
zaitzake	s̻ai̯ts̻ake
zaitzaketegu	s̺ai̯ts̻aket̪eɣ̞u
zaitzaketegu	s̻ai̯ts̻aket̪eɣ̞u
zaitzakete	s̺ai̯ts̻aket̪e
zaitzakete	s̻ai̯ts̻aket̪e
zaitzaketete	s̺ai̯ts̻aket̪et̪e
zaitzaketete	s̻ai̯ts̻aket̪et̪e
zaitzaketet	s̺ai̯ts̻aket̪et̪
zaitzaketet	s̻ai̯ts̻aket̪et̪
zaitzaket	s̺ai̯ts̻aket̪
zaitzaket	s̻ai̯ts̻aket̪
zaitzala	s̺ai̯ts̻ala
zaitzala	s̻ai̯ts̻ala
zaitzan	s̺ai̯ts̻ãn
zaitzan	s̻ai̯ts̻ãn
zaitzatedala	s̺ai̯ts̻at̪eð̞ala
zaitzatedala	s̻ai̯ts̻at̪eð̞ala
zaitzatedan	s̺ai̯ts̻at̪eð̞ãn
zaitzatedan	s̻ai̯ts̻at̪eð̞ãn
zaitzategula	s̺ai̯ts̻at̪eɣ̞ula
zaitzategula	s̻ai̯ts̻at̪eɣ̞ula
zaitzategun	s̺ai̯ts̻at̪eɣ̞ũn
zaitzategun	s̻ai̯ts̻at̪eɣ̞ũn
zaitzatela	s̺ai̯ts̻at̪ela
zaitzatela	s̻ai̯ts̻at̪ela
zaitzaten	s̺ai̯ts̻at̪ẽn
zaitzaten	s̻ai̯ts̻at̪ẽn
zaitzatetela	s̺ai̯ts̻at̪et̪ela
zaitzatetela	s̻ai̯ts̻at̪et̪ela
zaitzateten	s̺ai̯ts̻at̪et̪ẽn
zaitzateten	s̻ai̯ts̻at̪et̪ẽn
zakatz	s̺akats̻
zakatz	s̻akats̻
zakilkada	s̺akilkað̞a
zakilkada	s̻akilkað̞a
zakil	s̺akil
zakil	s̻akil
zakur	s̺akur
zakur	s̻akur
zalantza	s̺alãnts̻a
zalantza	s̻alãnts̻a
zalaparta	s̻alapart̪a
zaldarriaga	s̺al̪d̪ariaɣ̞a
zaldarriaga	s̻al̪d̪ariaɣ̞a
zaldibar	s̺al̪d̪iβ̞ar
zaldibar	s̻al̪d̪iβ̞ar
zaldi	s̻al̪d̪i
zaldun	s̺al̪d̪ũn
zaldun	s̻al̪d̪ũn
zaltu	s̺al̪t̪u
zaltu	s̻al̪t̪u
zamari	s̻amaɾi
zama	s̺ama
zama	s̻ama
zangoza	s̺aŋɡos̺a
zangoza	s̻aŋɡos̻a
zapaburu	s̻apaβ̞uɾu
zapaldu	s̻apal̪d̪u
zapalkeria	s̻apalke̞ɾia
zapalketa	s̻apalke̞t̪a
zapalkuntza	s̻apalkũnts̻a
zapata	s̻apat̪a
zapatu	s̺apat̪u
zapatu	s̻apat̪u
zara	s̺aɾa
zara	s̻aɾa
zarateke	s̺aɾat̪eke
zarateke	s̻aɾat̪eke
zaratekete	s̺aɾat̪eket̪e
zaratekete	s̻aɾat̪eket̪e
zarautz	s̺aɾau̯ts̻
zarautz	s̻aɾau̯ts̻
zarete	s̺aɾet̪e
zarete	s̻aɾet̪e
zaroatzan	s̻aɾo̞ats̻ãn
zatekeen	s̺at̪ekeẽn
zatekeen	s̻at̪ekeẽn
zatozen	s̺at̪os̺ẽn
zatozen	s̻at̪os̻ẽn
zatozke	s̺at̪os̺ke
zatozke	s̻at̪os̻ke
zatozkete	s̺at̪os̺ket̪e
zatozkete	s̻at̪os̻ket̪e
zatoz	s̺at̪os̺
zatoz	s̻at̪os̻
zatozten	s̺at̪os̺t̪ẽn
zatozten	s̻at̪os̻t̪ẽn
zatozte	s̺at̪os̺t̪e
zatozte	s̻at̪os̻t̪e
zatxezkidate	s̺atʃes̺kið̞at̪e
zatxezkidate	s̻atʃes̻kið̞at̪e
zatxezkie	s̺atʃes̺kie
zatxezkie	s̻atʃes̻kie
zatxezkiete	s̺atʃes̺kiet̪e
zatxezkiete	s̻atʃes̻kiet̪e
zatxezkigu	s̺atʃes̺kiɣ̞u
zatxezkigu	s̻atʃes̻kiɣ̞u
zatxezkigute	s̺atʃes̺kiɣ̞ut̪e
zatxezkigute	s̻atʃes̻kiɣ̞ut̪e
zatxezkio	s̺atʃes̺kio
zatxezkio	s̻atʃes̻kio
zatxezkiote	s̺atʃes̺kiot̪e
zatxezkiote	s̻atʃes̻kiot̪e
zatxezkit	s̺atʃes̺kit̪
zatxezkit	s̻atʃes̻kit̪
zaudeke	s̺au̯ð̞eke
zaudeke	s̻au̯ð̞eke
zaudekete	s̺au̯ð̞eket̪e
zaudekete	s̻au̯ð̞eket̪e
zauden	s̺au̯ð̞ẽn
zauden	s̻au̯ð̞ẽn
zaude	s̺au̯ð̞e
zaude	s̻au̯ð̞e
zaudeten	s̺au̯ð̞et̪ẽn
zaudeten	s̻au̯ð̞et̪ẽn
zaudete	s̺au̯ð̞et̪e
zaudete	s̻au̯ð̞et̪e
zauri	s̻au̯ɾi
zautza	s̺au̯ts̻a
zautza	s̻au̯ts̻a
zautzate	s̺au̯ts̻at̪e
zautzate	s̻au̯ts̻at̪e
zauzkagu	s̺au̯s̺kaɣ̞u
zauzkagu	s̻au̯s̻kaɣ̞u
zauzka	s̺au̯s̺ka
zauzka	s̻au̯s̻ka
zauzkategu	s̺au̯s̺kat̪eɣ̞u
zauzkategu	s̻au̯s̻kat̪eɣ̞u
zauzkate	s̺au̯s̺kat̪e
zauzkate	s̻au̯s̻kat̪e
zauzkatete	s̺au̯s̺kat̪et̪e
zauzkatete	s̻au̯s̻kat̪et̪e
zauzkatet	s̺au̯s̺kat̪et̪
zauzkatet	s̻au̯s̻kat̪et̪
zauzkat	s̺au̯s̺kat̪
zauzkat	s̻au̯s̻kat̪
zazaguzkigu	s̻as̻aɣ̞us̻kiɣ̞u
zazaguzki	s̻as̻aɣ̞us̻ki
zazaguzkite	s̻as̻aɣ̞us̻kit̪e̞
zazaguzkit	s̻as̻aɣ̞us̻kit̪
zazaguztegu	s̻as̻aɣ̞us̻t̪e̞ɣ̞u
zazaguzte	s̻as̻aɣ̞us̻t̪e̞
zazaguztete	s̻as̻aɣ̞us̻t̪e̞t̪e̞
zazaguztet	s̻as̻aɣ̞us̻t̪e̞t̪
zazpigarren	s̺as̺piɣ̞arẽn
zazpigarren	s̻as̻piɣ̞arẽn
zazpikoitz	s̻as̻piko̞i̯ts̻
zazpiren	s̻as̻piɾẽ̞n
zazpi	s̻as̻pi
zebilen	s̻eβ̞ilẽn
zebilen	s̺eβ̞iʎẽn
zebilen	s̻eβ̞iʎẽn
zebilkeen	s̺eβ̞ilkeẽn
zebilkeen	s̻eβ̞ilkeẽn
zebiltzan	s̺eβ̞ilts̻ãn
zebiltzan	s̻eβ̞ilts̻ãn
zebilzkeen	s̺eβ̞ils̺keẽn
zebilzkeen	s̻eβ̞ils̻keẽn
zebra	s̺eβ̞ra
zebra	s̻eβ̞ra
zedila	s̻eð̞ila
zedila	s̺eð̞iʎa
zedila	s̻eð̞iʎa
zedin	s̺eð̞ĩn
zedin	s̻eð̞ĩn
zegien	s̺eɣ̞iẽn
zegien	s̻eɣ̞iẽn
zegiten	s̺eɣ̞it̪ẽn
zegiten	s̻eɣ̞it̪ẽn
zegitzan	s̺eɣ̞its̻ãn
zegitzan	s̻eɣ̞its̻ãn
zegitzaten	s̺eɣ̞its̻at̪ẽn
zegitzaten	s̻eɣ̞its̻at̪ẽn
zegoen	s̺eɣ̞oẽn
zegoen	s̻eɣ̞oẽn
zegokeen	s̺eɣ̞okeẽn
zegokeen	s̻eɣ̞okeẽn
zehatz	s̺eats̻
zehatz	s̻eats̻
zehatz	s̻ehats̻
zehaztasun	s̺eas̺t̪as̺ũn
zehaztasun	s̻eas̻t̪as̺ũn
zehaztasun	s̻ehas̻t̪as̺ũn
zein	s̺ẽĩ̯n
zein	s̻ẽĩ̯n
zekien	s̻e̞kiẽ̞n
zekion	s̻e̞kiõ̞n
zekiten	s̻e̞kit̪ẽ̞n
zekizkien	s̻e̞kis̻kiẽ̞n
zekizkion	s̻e̞kis̻kiõ̞n
zekizkiten	s̻e̞kis̻kit̪ẽ̞n
zekusan	s̻e̞kus̺ãn
zekusaten	s̻e̞kus̺at̪ẽ̞n
zekuskien	s̻e̞kus̺kiẽ̞n
zekuskiten	s̻e̞kus̺kit̪ẽ̞n
zemendi	s̺emẽn̪d̪i
zemendi	s̻emẽn̪d̪i
zenbaki	s̺ẽmbaki
zenbaki	s̻ẽmbaki
zenbiltzan	s̺ẽmbilts̻ãn
zenbiltzan	s̻ẽmbilts̻ãn
zenbiltzaten	s̺ẽmbilts̻at̪ẽn
zenbiltzaten	s̻ẽmbilts̻at̪ẽn
zenbilzkeen	s̺ẽmbils̺keẽn
zenbilzkeen	s̻ẽmbils̻keẽn
zenbilzke	s̺ẽmbils̺ke
zenbilzke	s̻ẽmbils̻ke
zenbilzketen	s̺ẽmbils̺ket̪ẽn
zenbilzketen	s̻ẽmbils̻ket̪ẽn
zenbilzkete	s̺ẽmbils̺ket̪e
zenbilzkete	s̻ẽmbils̻ket̪e
zenegien	s̺eneɣ̞iẽn
zenegien	s̻eneɣ̞iẽn
zenegike	s̺eneɣ̞ike
zenegike	s̻eneɣ̞ike
zenegikete	s̺eneɣ̞iket̪e
zenegikete	s̻eneɣ̞iket̪e
zenegiten	s̺eneɣ̞it̪ẽn
zenegiten	s̻eneɣ̞it̪ẽn
zenegitzake	s̺eneɣ̞its̻ake
zenegitzake	s̻eneɣ̞its̻ake
zenegitzakete	s̺eneɣ̞its̻aket̪e
zenegitzakete	s̻eneɣ̞its̻aket̪e
zenegitzan	s̺eneɣ̞its̻ãn
zenegitzan	s̻eneɣ̞its̻ãn
zenegitzaten	s̺eneɣ̞its̻at̪ẽn
zenegitzaten	s̻eneɣ̞its̻at̪ẽn
zenekien	s̻e̞ne̞kiẽ̞n
zenekike	s̻e̞ne̞kike̞
zenekikete	s̻e̞ne̞kike̞t̪e̞
zenekiten	s̻e̞ne̞kit̪ẽ̞n
zenekizke	s̻e̞ne̞kis̻ke̞
zenekizkete	s̻e̞ne̞kis̻ke̞t̪e̞
zenekizkien	s̻e̞ne̞kis̻kiẽ̞n
zenekizkiten	s̻e̞ne̞kis̻kit̪ẽ̞n
zenekusan	s̻e̞ne̞kus̺ãn
zenekusaten	s̻e̞ne̞kus̺at̪ẽ̞n
zenekusazke	s̻e̞ne̞kus̺as̻ke̞
zenekusazkete	s̻e̞ne̞kus̺as̻ke̞t̪e̞
zenekuske	s̻e̞ne̞kus̺ke̞
zenekuskete	s̻e̞ne̞kus̺ke̞t̪e̞
zenekuskien	s̻e̞ne̞kus̺kiẽ̞n
zenekuskiten	s̻e̞ne̞kus̺kit̪ẽ̞n
zenentzuen	s̻e̞nẽ̞nts̻uẽ̞n
zenentzuke	s̻e̞nẽ̞nts̻uke̞
zenentzukete	s̻e̞nẽ̞nts̻uke̞t̪e̞
zenentzuten	s̻e̞nẽ̞nts̻ut̪ẽ̞n
zenentzuzke	s̻e̞nẽ̞nts̻us̻ke̞
zenentzuzkete	s̻e̞nẽ̞nts̻us̻ke̞t̪e̞
zenentzuzkien	s̻e̞nẽ̞nts̻us̻kiẽ̞n
zenentzuzkiten	s̻e̞nẽ̞nts̻us̻kit̪ẽ̞n
zenerakuske	s̻e̞ne̞ɾakus̺ke̞
zenerakuskete	s̻e̞ne̞ɾakus̺ke̞t̪e̞
zenerakuskien	s̻e̞ne̞ɾakus̺kiẽ̞n
zenerakuskiten	s̻e̞ne̞ɾakus̺kit̪ẽ̞n
zenerakutsan	s̻e̞ne̞ɾakuts̺ãn
zenerakutsaten	s̻e̞ne̞ɾakuts̺at̪ẽ̞n
zenerakutsazke	s̻e̞ne̞ɾakuts̺as̻ke̞
zenerakutsazkete	s̻e̞ne̞ɾakuts̺as̻ke̞t̪e̞
zeneroake	s̻e̞ne̞ɾo̞ake̞
zeneroakete	s̻e̞ne̞ɾo̞ake̞t̪e̞
zeneroan	s̻e̞ne̞ɾo̞ãn
zeneroaten	s̻e̞ne̞ɾo̞at̪ẽ̞n
zeneroatzan	s̻e̞ne̞ɾo̞ats̻ãn
zeneroatzaten	s̻e̞ne̞ɾo̞ats̻at̪ẽ̞n
zeneroazke	s̻e̞ne̞ɾo̞as̻ke̞
zeneroazkete	s̻e̞ne̞ɾo̞as̻ke̞t̪e̞
zeneukake	s̺eneu̯kake
zeneukake	s̻eneu̯kake
zeneukakete	s̺eneu̯kaket̪e
zeneukakete	s̻eneu̯kaket̪e
zeneukan	s̺eneu̯kãn
zeneukan	s̻eneu̯kãn
zeneukaten	s̺eneu̯kat̪ẽn
zeneukaten	s̻eneu̯kat̪ẽn
zeneuzkake	s̺eneu̯s̺kake
zeneuzkake	s̻eneu̯s̻kake
zeneuzkakete	s̺eneu̯s̺kaket̪e
zeneuzkakete	s̻eneu̯s̻kaket̪e
zeneuzkan	s̺eneu̯s̺kãn
zeneuzkan	s̻eneu̯s̻kãn
zeneuzkaten	s̺eneu̯s̺kat̪ẽn
zeneuzkaten	s̻eneu̯s̻kat̪ẽn
zenezaguen	s̻e̞ne̞s̻aɣ̞uẽ̞n
zenezaguke	s̻e̞ne̞s̻aɣ̞uke̞
zenezagukete	s̻e̞ne̞s̻aɣ̞uke̞t̪e̞
zenezaguten	s̻e̞ne̞s̻aɣ̞ut̪ẽ̞n
zenezaguzke	s̻e̞ne̞s̻aɣ̞us̻ke̞
zenezaguzkete	s̻e̞ne̞s̻aɣ̞us̻ke̞t̪e̞
zenezaguzkien	s̻e̞ne̞s̻aɣ̞us̻kiẽ̞n
zenezaguzkiten	s̻e̞ne̞s̻aɣ̞us̻kit̪ẽ̞n
zenezakeen	s̺enes̺akeẽn
zenezakeen	s̻enes̻akeẽn
zenezake	s̺enes̺ake
zenezake	s̻enes̻ake
zenezaketen	s̺enes̺aket̪ẽn
zenezaketen	s̻enes̻aket̪ẽn
zenezakete	s̺enes̺aket̪e
zenezakete	s̻enes̻aket̪e
zenezala	s̺enes̺ala
zenezala	s̻enes̻ala
zenezan	s̺enes̺ãn
zenezan	s̻enes̻ãn
zenezatela	s̺enes̺at̪ela
zenezatela	s̻enes̻at̪ela
zenezaten	s̺enes̺at̪ẽn
zenezaten	s̻enes̻at̪ẽn
zeniharduen	s̻e̞niarð̞uẽ̞n
zeniharduen	s̻e̞niɦarð̞uẽ̞n
zenihardukake	s̻e̞niarð̞ukake̞
zenihardukake	s̻e̞niɦarð̞ukake̞
zenihardukakete	s̻e̞niarð̞ukake̞t̪e̞
zenihardukakete	s̻e̞niɦarð̞ukake̞t̪e̞
zenihardukan	s̻e̞niarð̞ukãn
zenihardukan	s̻e̞niɦarð̞ukãn
zenihardukaten	s̻e̞niarð̞ukat̪ẽ̞n
zenihardukaten	s̻e̞niɦarð̞ukat̪ẽ̞n
zeniharduke	s̻e̞niarð̞uke̞
zeniharduke	s̻e̞niɦarð̞uke̞
zenihardukete	s̻e̞niarð̞uke̞t̪e̞
zenihardukete	s̻e̞niɦarð̞uke̞t̪e̞
zeniharduten	s̻e̞niarð̞ut̪ẽ̞n
zeniharduten	s̻e̞niɦarð̞ut̪ẽ̞n
zenirauen	s̻e̞niɾau̯ẽ̞n
zenirauke	s̻e̞niɾau̯ke̞
zeniraukete	s̻e̞niɾau̯ke̞t̪e̞
zenirauten	s̻e̞niɾau̯t̪ẽ̞n
zenirudien	s̻e̞niɾuð̞iẽ̞n
zenirudike	s̻e̞niɾuð̞ike̞
zenirudikete	s̻e̞niɾuð̞ike̞t̪e̞
zeniruditen	s̻e̞niɾuð̞it̪ẽ̞n
zenituen	s̻e̞nit̪uẽ̞n
zenituzkeen	s̺enit̪us̺keẽn
zenituzkeen	s̻enit̪us̻keẽn
zenituzke	s̺enit̪us̺ke
zenituzke	s̻enit̪us̻ke
zenituzketen	s̺enit̪us̺ket̪ẽn
zenituzketen	s̻enit̪us̻ket̪ẽn
zenituzkete	s̺enit̪us̺ket̪e
zenituzkete	s̻enit̪us̻ket̪e
zenituzten	s̻e̞nit̪us̻t̪ẽ̞n
zenitzakeen	s̺enits̻akeẽn
zenitzakeen	s̻enits̻akeẽn
zenitzake	s̺enits̻ake
zenitzake	s̻enits̻ake
zenitzaketen	s̺enits̻aket̪ẽn
zenitzaketen	s̻enits̻aket̪ẽn
zenitzakete	s̺enits̻aket̪e
zenitzakete	s̻enits̻aket̪e
zenitzala	s̺enits̻ala
zenitzala	s̻enits̻ala
zenitzan	s̺enits̻ãn
zenitzan	s̻enits̻ãn
zenitzatela	s̺enits̻at̪ela
zenitzatela	s̻enits̻at̪ela
zenitzaten	s̺enits̻at̪ẽn
zenitzaten	s̻enits̻at̪ẽn
zenkizkien	s̻ẽ̞ŋkis̻kiẽ̞n
zenkizkieten	s̻ẽ̞ŋkis̻kie̞t̪ẽ̞n
zenkizkion	s̻ẽ̞ŋkis̻kiõ̞n
zenkizkioten	s̻ẽ̞ŋkis̻kio̞t̪ẽ̞n
zen	s̺ẽn
zen	s̻ẽn
zentozen	s̺ẽn̪t̪os̺ẽn
zentozen	s̻ẽn̪t̪os̻ẽn
zentozkeen	s̺ẽn̪t̪os̺keẽn
zentozkeen	s̻ẽn̪t̪os̻keẽn
zentozke	s̺ẽn̪t̪os̺ke
zentozke	s̻ẽn̪t̪os̻ke
zentozketen	s̺ẽn̪t̪os̺ket̪ẽn
zentozketen	s̻ẽn̪t̪os̻ket̪ẽn
zentozkete	s̺ẽn̪t̪os̺ket̪e
zentozkete	s̻ẽn̪t̪os̻ket̪e
zentozten	s̺ẽn̪t̪os̺t̪ẽn
zentozten	s̻ẽn̪t̪os̻t̪ẽn
zentxezkidake	s̻ẽ̞nʲtʃe̞s̻kið̞ake̞
zentxezkidakete	s̻ẽ̞nʲtʃe̞s̻kið̞ake̞t̪e̞
zentxezkidan	s̺ẽnʲtʃes̺kið̞ãn
zentxezkidan	s̻ẽnʲtʃes̻kið̞ãn
zentxezkidaten	s̺ẽnʲtʃes̺kið̞at̪ẽn
zentxezkidaten	s̻ẽnʲtʃes̻kið̞at̪ẽn
zentxezkieke	s̻ẽ̞nʲtʃe̞s̻kie̞ke̞
zentxezkiekete	s̻ẽ̞nʲtʃe̞s̻kie̞ke̞t̪e̞
zentxezkien	s̺ẽnʲtʃes̺kiẽn
zentxezkien	s̻ẽnʲtʃes̻kiẽn
zentxezkieten	s̺ẽnʲtʃes̺kiet̪ẽn
zentxezkieten	s̻ẽnʲtʃes̻kiet̪ẽn
zentxezkiguke	s̻ẽ̞nʲtʃe̞s̻kiɣ̞uke̞
zentxezkigukete	s̻ẽ̞nʲtʃe̞s̻kiɣ̞uke̞t̪e̞
zentxezkigun	s̺ẽnʲtʃes̺kiɣ̞ũn
zentxezkigun	s̻ẽnʲtʃes̻kiɣ̞ũn
zentxezkiguten	s̺ẽnʲtʃes̺kiɣ̞ut̪ẽn
zentxezkiguten	s̻ẽnʲtʃes̻kiɣ̞ut̪ẽn
zentxezkioke	s̻ẽ̞nʲtʃe̞s̻kio̞ke̞
zentxezkiokete	s̻ẽ̞nʲtʃe̞s̻kio̞ke̞t̪e̞
zentxezkion	s̺ẽnʲtʃes̺kiõn
zentxezkion	s̻ẽnʲtʃes̻kiõn
zentxezkioten	s̺ẽnʲtʃes̺kiot̪ẽn
zentxezkioten	s̻ẽnʲtʃes̻kiot̪ẽn
zentzuen	s̻ẽ̞nts̻uẽ̞n
zentzuten	s̻ẽ̞nts̻ut̪ẽ̞n
zentzuzkien	s̻ẽ̞nts̻us̻kiẽ̞n
zentzuzkiten	s̻ẽ̞nts̻us̻kit̪ẽ̞n
zenuen	s̻e̞nuẽ̞n
zenukeen	s̺enukeẽn
zenukeen	s̻enukeẽn
zenuke	s̺enuke
zenuke	s̻enuke
zenuketen	s̺enuket̪ẽn
zenuketen	s̻enuket̪ẽn
zenukete	s̺enuket̪e
zenukete	s̻enuket̪e
zenuten	s̻e̞nut̪ẽ̞n
zerakuskien	s̻e̞ɾakus̺kiẽ̞n
zerakuskiten	s̻e̞ɾakus̺kit̪ẽ̞n
zerakutsan	s̻e̞ɾakuts̺ãn
zerakutsaten	s̻e̞ɾakuts̺at̪ẽ̞n
zera	s̺eɾa
zera	s̻eɾa
zerbait	s̺erβ̞ai̯t̪
zerbait	s̻erβ̞ai̯t̪
zerbeza	s̺erβ̞es̺a
zerbeza	s̻erβ̞es̻a
zerbitzugune	s̻e̞rβ̞its̻uɣ̞une̞
zerbitzu	s̺erβ̞its̻u
zerbitzu	s̻erβ̞its̻u
zerekin	s̺eɾekĩn
zerekin	s̻eɾekĩn
zeremonia	s̺eɾemonia
zeremonia	s̻eɾemonia
zeren	s̺eɾẽn
zeren	s̻eɾẽn
zerentzat	s̺eɾẽnts̻at̪
zerentzat	s̻eɾẽnts̻at̪
zerez	s̺eɾes̺
zerez	s̻eɾes̻
zerga	s̺erɣ̞a
zerga	s̻erɣ̞a
zergatik	s̺erɣ̞at̪ik
zergatik	s̻erɣ̞at̪ik
zerikusi	s̺eɾikus̺i
zerikusi	s̻eɾikus̺i
zeri	s̺eɾi
zeri	s̻eɾi
zerk	s̺erk
zerk	s̻erk
zeroan	s̻e̞ɾo̞ãn
zeroaten	s̻e̞ɾo̞at̪ẽ̞n
zeroatzaten	s̻e̞ɾo̞ats̻at̪ẽ̞n
zerogarren	s̺eɾoɣ̞arẽn
zerogarren	s̻eɾoɣ̞arẽn
zero	s̺eɾo
zero	s̻eɾo
zerra	s̺era
zerra	s̻era
zerri	s̺eri
zerri	s̻eri
zer	s̺er
zer	s̻er
zertaz	s̺ert̪as̺
zertaz	s̻ert̪as̻
zertzeta	s̺erts̻et̪a
zertzeta	s̻erts̻et̪a
zeru	s̺eɾu
zeru	s̻eɾu
ze	s̺e
ze	s̻e
zeta	s̺et̪a
zeta	s̻et̪a
zetorkeen	s̺et̪orkeẽn
zetorkeen	s̻et̪orkeẽn
zetorren	s̺et̪orẽn
zetorren	s̻et̪orẽn
zetozen	s̺et̪os̺ẽn
zetozen	s̻et̪os̻ẽn
zetozkeen	s̺et̪os̺keẽn
zetozkeen	s̻et̪os̻keẽn
zetxekian	s̺etʃekiãn
zetxekian	s̻etʃekiãn
zetxekidan	s̺etʃekið̞ãn
zetxekidan	s̻etʃekið̞ãn
zetxekien	s̺etʃekiẽn
zetxekien	s̻etʃekiẽn
zetxekigun	s̺etʃekiɣ̞ũn
zetxekigun	s̻etʃekiɣ̞ũn
zetxekinan	s̻etʃekinãn
zetxekinan	s̺etʃekiɲãn
zetxekinan	s̻etʃekiɲãn
zetxekion	s̺etʃekiõn
zetxekion	s̻etʃekiõn
zetxekizuen	s̺etʃekis̺uẽn
zetxekizuen	s̻etʃekis̻uẽn
zetxekizun	s̺etʃekis̺ũn
zetxekizun	s̻etʃekis̻ũn
zetxezkian	s̺etʃes̺kiãn
zetxezkian	s̻etʃes̻kiãn
zetxezkidan	s̺etʃes̺kið̞ãn
zetxezkidan	s̻etʃes̻kið̞ãn
zetxezkien	s̺etʃes̺kiẽn
zetxezkien	s̻etʃes̻kiẽn
zetxezkigun	s̺etʃes̺kiɣ̞ũn
zetxezkigun	s̻etʃes̻kiɣ̞ũn
zetxezkinan	s̻etʃes̻kinãn
zetxezkinan	s̺etʃes̺kiɲãn
zetxezkinan	s̻etʃes̻kiɲãn
zetxezkion	s̺etʃes̺kiõn
zetxezkion	s̻etʃes̻kiõn
zetxezkizuen	s̺etʃes̺kis̺uẽn
zetxezkizuen	s̻etʃes̻kis̻uẽn
zetxezkizun	s̺etʃes̺kis̺ũn
zetxezkizun	s̻etʃes̻kis̻ũn
zetzan	s̺ets̻ãn
zetzan	s̻ets̻ãn
zeudekeen	s̺eu̯ð̞ekeẽn
zeudekeen	s̻eu̯ð̞ekeẽn
zeuden	s̺eu̯ð̞ẽn
zeuden	s̻eu̯ð̞ẽn
zeukan	s̺eu̯kãn
zeukan	s̻eu̯kãn
zeukaten	s̺eu̯kat̪ẽn
zeukaten	s̻eu̯kat̪ẽn
zeundekeen	s̺ẽũ̯n̪d̪ekeẽn
zeundekeen	s̻ẽũ̯n̪d̪ekeẽn
zeundeke	s̺ẽũ̯n̪d̪eke
zeundeke	s̻ẽũ̯n̪d̪eke
zeundeketen	s̺ẽũ̯n̪d̪eket̪ẽn
zeundeketen	s̻ẽũ̯n̪d̪eket̪ẽn
zeundekete	s̺ẽũ̯n̪d̪eket̪e
zeundekete	s̻ẽũ̯n̪d̪eket̪e
zeunden	s̺ẽũ̯n̪d̪ẽn
zeunden	s̻ẽũ̯n̪d̪ẽn
zeundeten	s̺ẽũ̯n̪d̪et̪ẽn
zeundeten	s̻ẽũ̯n̪d̪et̪ẽn
zeuntzake	s̺ẽũ̯nts̻ake
zeuntzake	s̻ẽũ̯nts̻ake
zeuntzakete	s̺ẽũ̯nts̻aket̪e
zeuntzakete	s̻ẽũ̯nts̻aket̪e
zeuntzan	s̺ẽũ̯nts̻ãn
zeuntzan	s̻ẽũ̯nts̻ãn
zeuntzaten	s̺ẽũ̯nts̻at̪ẽn
zeuntzaten	s̻ẽũ̯nts̻at̪ẽn
zeure	s̻e̞u̯ɾe̞
zeu	s̺eu̯
zeu	s̻eu̯
zeutzan	s̺eu̯ts̻ãn
zeutzan	s̻eu̯ts̻ãn
zeuzkan	s̺eu̯s̺kãn
zeuzkan	s̻eu̯s̻kãn
zeuzkaten	s̺eu̯s̺kat̪ẽn
zeuzkaten	s̻eu̯s̻kat̪ẽn
zezaguen	s̻e̞s̻aɣ̞uẽ̞n
zezaguten	s̻e̞s̻aɣ̞ut̪ẽ̞n
zezaguzkien	s̻e̞s̻aɣ̞us̻kiẽ̞n
zezaguzkiten	s̻e̞s̻aɣ̞us̻kit̪ẽ̞n
zezakeen	s̺es̺akeẽn
zezakeen	s̻es̻akeẽn
zezaketen	s̺es̺aket̪ẽn
zezaketen	s̻es̻aket̪ẽn
zezala	s̺es̺ala
zezala	s̻es̻ala
zezan	s̺es̺ãn
zezan	s̻es̻ãn
zezatela	s̺es̺at̪ela
zezatela	s̻es̻at̪ela
zezaten	s̺es̺at̪ẽn
zezaten	s̻es̻at̪ẽn
zezeil	s̺es̺ei̯l
zezeil	s̻es̻ei̯l
zezenkari	s̺es̺eŋkaɾi
zezenkari	s̻es̻eŋkaɾi
zezen	s̺es̺ẽn
zezen	s̻es̻ẽn
ziapeaz	s̺iapeas̺
ziapeaz	s̻iapeas̻
ziaperik	s̺iapeɾik
ziaperik	s̻iapeɾik
ziape	s̺iape
ziape	s̻iape
zibil	s̺iβ̞il
zibil	s̻iβ̞il
zientzialari	s̺iẽnts̻ialaɾi
zientzialari	s̻iẽnts̻ialaɾi
zientzia	s̺iẽnts̻ia
zientzia	s̻iẽnts̻ia
zigilu	s̻iɣ̞ilu
zigilu	s̺iɣ̞iʎu
zigilu	s̻iɣ̞iʎu
zigor	s̺iɣ̞or
zigor	s̻iɣ̞or
zigortu	s̺iɣ̞ort̪u
zigortu	s̻iɣ̞ort̪u
ziharduen	s̻iarð̞uẽ̞n
ziharduen	s̻iɦarð̞uẽ̞n
zihardukan	s̻iarð̞ukãn
zihardukan	s̻iɦarð̞ukãn
zihardukaten	s̻iarð̞ukat̪ẽ̞n
zihardukaten	s̻iɦarð̞ukat̪ẽ̞n
ziharduten	s̻iarð̞ut̪ẽ̞n
ziharduten	s̻iɦarð̞ut̪ẽ̞n
zihoakeen	s̻ihoakeẽn
zihoakeen	s̺ixoakeẽn
zihoakeen	s̻ixoakeẽn
zihoan	s̻ihoãn
zihoan	s̺ixoãn
zihoan	s̻ixoãn
zihoazen	s̻ihoas̻ẽn
zihoazen	s̺ixoas̺ẽn
zihoazen	s̻ixoas̻ẽn
zihoazkeen	s̻ihoas̻keẽn
zihoazkeen	s̺ixoas̺keẽn
zihoazkeen	s̻ixoas̻keẽn
ziklotroi	s̺iklot̪roi̯
ziklotroi	s̻iklot̪roi̯
zikoina	s̻ikoi̯na
zikoina	s̺ikoɲa
zikoina	s̻ikoɲa
zilargile	s̻ilarɣ̞ile
zilargile	s̺iʎarɣ̞iʎe
zilargile	s̻iʎarɣ̞iʎe
zilargin	s̻ilarɣ̞ĩn
zilargin	s̺iʎarɣ̞ĩn
zilargin	s̻iʎarɣ̞ĩn
zilarkara	s̻ilarkaɾa
zilarkara	s̺iʎarkaɾa
zilarkara	s̻iʎarkaɾa
zilar	s̻ilar
zilar	s̺iʎar
zilar	s̻iʎar
zilegitu	s̻ileɣ̞it̪u
zilegitu	s̺iʎeɣ̞it̪u
zilegitu	s̻iʎeɣ̞it̪u
zimitz	s̺imits̻
zimitz	s̻imits̻
zinatekeen	s̻inat̪ekeẽn
zinatekeen	s̺iɲat̪ekeẽn
zinatekeen	s̻iɲat̪ekeẽn
zinateke	s̻inat̪eke
zinateke	s̺iɲat̪eke
zinateke	s̻iɲat̪eke
zinateketen	s̻inat̪eket̪ẽn
zinateketen	s̺iɲat̪eket̪ẽn
zinateketen	s̻iɲat̪eket̪ẽn
zinatekete	s̻inat̪eket̪e
zinatekete	s̺iɲat̪eket̪e
zinatekete	s̻iɲat̪eket̪e
zindezaguzkegu	s̻ĩn̪d̪e̞s̻aɣ̞us̻ke̞ɣ̞u
zindezaguzke	s̻ĩn̪d̪e̞s̻aɣ̞us̻ke̞
zindezaguzketegu	s̻ĩn̪d̪e̞s̻aɣ̞us̻ke̞t̪e̞ɣ̞u
zindezaguzkete	s̻ĩn̪d̪e̞s̻aɣ̞us̻ke̞t̪e̞
zindezaguzketete	s̻ĩn̪d̪e̞s̻aɣ̞us̻ke̞t̪e̞t̪e̞
zindezaguzketet	s̻ĩn̪d̪e̞s̻aɣ̞us̻ke̞t̪e̞t̪
zindezaguzket	s̻ĩn̪d̪e̞s̻aɣ̞us̻ke̞t̪
zindezaguzkidan	s̻ĩn̪d̪e̞s̻aɣ̞us̻kið̞ãn
zindezaguzkien	s̻ĩn̪d̪e̞s̻aɣ̞us̻kiẽ̞n
zindezaguzkigun	s̻ĩn̪d̪e̞s̻aɣ̞us̻kiɣ̞ũn
zindezaguzkiten	s̻ĩn̪d̪e̞s̻aɣ̞us̻kit̪ẽ̞n
zindezaguztedan	s̻ĩn̪d̪e̞s̻aɣ̞us̻t̪e̞ð̞ãn
zindezaguztegun	s̻ĩn̪d̪e̞s̻aɣ̞us̻t̪e̞ɣ̞ũn
zindezaguzten	s̻ĩn̪d̪e̞s̻aɣ̞us̻t̪ẽ̞n
zindezaguzteten	s̻ĩn̪d̪e̞s̻aɣ̞us̻t̪e̞t̪ẽ̞n
zindoazen	s̺ĩn̪d̪oas̺ẽn
zindoazen	s̻ĩn̪d̪oas̻ẽn
zindoazkeen	s̺ĩn̪d̪oas̺keẽn
zindoazkeen	s̻ĩn̪d̪oas̻keẽn
zindoazke	s̺ĩn̪d̪oas̺ke
zindoazke	s̻ĩn̪d̪oas̻ke
zindoazketen	s̺ĩn̪d̪oas̺ket̪ẽn
zindoazketen	s̻ĩn̪d̪oas̻ket̪ẽn
zindoazkete	s̺ĩn̪d̪oas̺ket̪e
zindoazkete	s̻ĩn̪d̪oas̻ket̪e
zindoazten	s̺ĩn̪d̪oas̺t̪ẽn
zindoazten	s̻ĩn̪d̪oas̻t̪ẽn
zinduzkadan	s̺ĩn̪d̪us̺kað̞ãn
zinduzkadan	s̻ĩn̪d̪us̻kað̞ãn
zinduzkagun	s̺ĩn̪d̪us̺kaɣ̞ũn
zinduzkagun	s̻ĩn̪d̪us̻kaɣ̞ũn
zinduzkakegu	s̺ĩn̪d̪us̺kakeɣ̞u
zinduzkakegu	s̻ĩn̪d̪us̻kakeɣ̞u
zinduzkake	s̺ĩn̪d̪us̺kake
zinduzkake	s̻ĩn̪d̪us̻kake
zinduzkakete	s̺ĩn̪d̪us̺kaket̪e
zinduzkakete	s̻ĩn̪d̪us̻kaket̪e
zinduzkaket	s̺ĩn̪d̪us̺kaket̪
zinduzkaket	s̻ĩn̪d̪us̻kaket̪
zinduzkan	s̺ĩn̪d̪us̺kãn
zinduzkan	s̻ĩn̪d̪us̻kãn
zinduzkatedan	s̺ĩn̪d̪us̺kat̪eð̞ãn
zinduzkatedan	s̻ĩn̪d̪us̻kat̪eð̞ãn
zinduzkategun	s̺ĩn̪d̪us̺kat̪eɣ̞ũn
zinduzkategun	s̻ĩn̪d̪us̻kat̪eɣ̞ũn
zinduzkategu	s̺ĩn̪d̪us̺kat̪eɣ̞u
zinduzkategu	s̻ĩn̪d̪us̻kat̪eɣ̞u
zinduzkaten	s̺ĩn̪d̪us̺kat̪ẽn
zinduzkaten	s̻ĩn̪d̪us̻kat̪ẽn
zinduzkate	s̺ĩn̪d̪us̺kat̪e
zinduzkate	s̻ĩn̪d̪us̻kat̪e
zinduzkateten	s̺ĩn̪d̪us̺kat̪et̪ẽn
zinduzkateten	s̻ĩn̪d̪us̻kat̪et̪ẽn
zinduzkatete	s̺ĩn̪d̪us̺kat̪et̪e
zinduzkatete	s̻ĩn̪d̪us̻kat̪et̪e
zinduzkatet	s̺ĩn̪d̪us̺kat̪et̪
zinduzkatet	s̻ĩn̪d̪us̻kat̪et̪
zinen	s̻inẽn
zinen	s̺iɲẽn
zinen	s̻iɲẽn
zineten	s̻inet̪ẽn
zineten	s̺iɲet̪ẽn
zineten	s̻iɲet̪ẽn
zintezela	s̺ĩn̪t̪es̺ela
zintezela	s̻ĩn̪t̪es̻ela
zintezen	s̺ĩn̪t̪es̺ẽn
zintezen	s̻ĩn̪t̪es̻ẽn
zintezkeen	s̺ĩn̪t̪es̺keẽn
zintezkeen	s̻ĩn̪t̪es̻keẽn
zintezke	s̺ĩn̪t̪es̺ke
zintezke	s̻ĩn̪t̪es̻ke
zintezketen	s̺ĩn̪t̪es̺ket̪ẽn
zintezketen	s̻ĩn̪t̪es̻ket̪ẽn
zintezkete	s̺ĩn̪t̪es̺ket̪e
zintezkete	s̻ĩn̪t̪es̻ket̪e
zinteztela	s̺ĩn̪t̪es̺t̪ela
zinteztela	s̻ĩn̪t̪es̻t̪ela
zintezten	s̺ĩn̪t̪es̺t̪ẽn
zintezten	s̻ĩn̪t̪es̻t̪ẽn
zintudan	s̺ĩn̪t̪uð̞ãn
zintudan	s̻ĩn̪t̪uð̞ãn
zintuen	s̻ĩn̪t̪uẽ̞n
zintugun	s̻ĩn̪t̪uɣ̞ũn
zintuzkedan	s̺ĩn̪t̪us̺keð̞ãn
zintuzkedan	s̻ĩn̪t̪us̻keð̞ãn
zintuzkeen	s̺ĩn̪t̪us̺keẽn
zintuzkeen	s̻ĩn̪t̪us̻keẽn
zintuzkegun	s̺ĩn̪t̪us̺keɣ̞ũn
zintuzkegun	s̻ĩn̪t̪us̻keɣ̞ũn
zintuzkegu	s̺ĩn̪t̪us̺keɣ̞u
zintuzkegu	s̻ĩn̪t̪us̻keɣ̞u
zintuzke	s̺ĩn̪t̪us̺ke
zintuzke	s̻ĩn̪t̪us̻ke
zintuzketedan	s̺ĩn̪t̪us̺ket̪eð̞ãn
zintuzketedan	s̻ĩn̪t̪us̻ket̪eð̞ãn
zintuzketegun	s̺ĩn̪t̪us̺ket̪eɣ̞ũn
zintuzketegun	s̻ĩn̪t̪us̻ket̪eɣ̞ũn
zintuzketegu	s̺ĩn̪t̪us̺ket̪eɣ̞u
zintuzketegu	s̻ĩn̪t̪us̻ket̪eɣ̞u
zintuzketen	s̺ĩn̪t̪us̺ket̪ẽn
zintuzketen	s̻ĩn̪t̪us̻ket̪ẽn
zintuzkete	s̺ĩn̪t̪us̺ket̪e
zintuzkete	s̻ĩn̪t̪us̻ket̪e
zintuzketeten	s̺ĩn̪t̪us̺ket̪et̪ẽn
zintuzketeten	s̻ĩn̪t̪us̻ket̪et̪ẽn
zintuzketete	s̺ĩn̪t̪us̺ket̪et̪e
zintuzketete	s̻ĩn̪t̪us̻ket̪et̪e
zintuzketet	s̺ĩn̪t̪us̺ket̪et̪
zintuzketet	s̻ĩn̪t̪us̻ket̪et̪
zintuzket	s̺ĩn̪t̪us̺ket̪
zintuzket	s̻ĩn̪t̪us̻ket̪
zintuztedan	s̻ĩn̪t̪us̻t̪e̞ð̞ãn
zintuztegun	s̻ĩn̪t̪us̻t̪e̞ɣ̞ũn
zintuzten	s̻ĩn̪t̪us̻t̪ẽ̞n
zintuzteten	s̻ĩn̪t̪us̻t̪e̞t̪ẽ̞n
zintzadala	s̺ĩnts̻að̞ala
zintzadala	s̻ĩnts̻að̞ala
zintzadan	s̺ĩnts̻að̞ãn
zintzadan	s̻ĩnts̻að̞ãn
zintzagula	s̺ĩnts̻aɣ̞ula
zintzagula	s̻ĩnts̻aɣ̞ula
zintzagun	s̺ĩnts̻aɣ̞ũn
zintzagun	s̻ĩnts̻aɣ̞ũn
zintzakedan	s̺ĩnts̻akeð̞ãn
zintzakedan	s̻ĩnts̻akeð̞ãn
zintzakeen	s̺ĩnts̻akeẽn
zintzakeen	s̻ĩnts̻akeẽn
zintzakegun	s̺ĩnts̻akeɣ̞ũn
zintzakegun	s̻ĩnts̻akeɣ̞ũn
zintzakegu	s̺ĩnts̻akeɣ̞u
zintzakegu	s̻ĩnts̻akeɣ̞u
zintzake	s̺ĩnts̻ake
zintzake	s̻ĩnts̻ake
zintzaketedan	s̺ĩnts̻aket̪eð̞ãn
zintzaketedan	s̻ĩnts̻aket̪eð̞ãn
zintzaketegun	s̺ĩnts̻aket̪eɣ̞ũn
zintzaketegun	s̻ĩnts̻aket̪eɣ̞ũn
zintzaketegu	s̺ĩnts̻aket̪eɣ̞u
zintzaketegu	s̻ĩnts̻aket̪eɣ̞u
zintzaketen	s̺ĩnts̻aket̪ẽn
zintzaketen	s̻ĩnts̻aket̪ẽn
zintzakete	s̺ĩnts̻aket̪e
zintzakete	s̻ĩnts̻aket̪e
zintzaketeten	s̺ĩnts̻aket̪et̪ẽn
zintzaketeten	s̻ĩnts̻aket̪et̪ẽn
zintzaketete	s̺ĩnts̻aket̪et̪e
zintzaketete	s̻ĩnts̻aket̪et̪e
zintzaketet	s̺ĩnts̻aket̪et̪
zintzaketet	s̻ĩnts̻aket̪et̪
zintzaket	s̺ĩnts̻aket̪
zintzaket	s̻ĩnts̻aket̪
zintzala	s̺ĩnts̻ala
zintzala	s̻ĩnts̻ala
zintzan	s̺ĩnts̻ãn
zintzan	s̻ĩnts̻ãn
zintzatedala	s̺ĩnts̻at̪eð̞ala
zintzatedala	s̻ĩnts̻at̪eð̞ala
zintzatedan	s̺ĩnts̻at̪eð̞ãn
zintzatedan	s̻ĩnts̻at̪eð̞ãn
zintzategula	s̺ĩnts̻at̪eɣ̞ula
zintzategula	s̻ĩnts̻at̪eɣ̞ula
zintzategun	s̺ĩnts̻at̪eɣ̞ũn
zintzategun	s̻ĩnts̻at̪eɣ̞ũn
zintzatela	s̺ĩnts̻at̪ela
zintzatela	s̻ĩnts̻at̪ela
zintzaten	s̺ĩnts̻at̪ẽn
zintzaten	s̻ĩnts̻at̪ẽn
zintzatetela	s̺ĩnts̻at̪et̪ela
zintzatetela	s̻ĩnts̻at̪et̪ela
zintzateten	s̺ĩnts̻at̪et̪ẽn
zintzateten	s̻ĩnts̻at̪et̪ẽn
zintzilikatu	s̻ĩnts̻ilikat̪u
zintzilikatu	s̺ĩnts̻iʎikat̪u
zintzilikatu	s̻ĩnts̻iʎikat̪u
zintzur	s̺ĩnts̻ur
zintzur	s̻ĩnts̻ur
zipre	s̺ipre
zipre	s̻ipre
ziratekeen	s̺iɾat̪ekeẽn
ziratekeen	s̻iɾat̪ekeẽn
zirauen	s̻iɾau̯ẽ̞n
zirauten	s̻iɾau̯t̪ẽ̞n
ziren	s̺iɾẽn
ziren	s̻iɾẽn
zirkonio	s̺irkonio
zirkonio	s̻irkonio
zirkulu	s̺irkulu
zirkulu	s̻irkulu
zirku	s̺irku
zirku	s̻irku
zirudien	s̻iɾuð̞iẽ̞n
ziruditen	s̻iɾuð̞it̪ẽ̞n
zi	s̺i
zi	s̻i
zitekean	s̺it̪ekeãn
zitekean	s̻it̪ekeãn
zitekeen	s̺it̪ekeẽn
zitekeen	s̻it̪ekeẽn
zitekenan	s̺it̪ekenãn
zitekenan	s̻it̪ekenãn
zitezela	s̺it̪es̺ela
zitezela	s̻it̪es̻ela
zitezen	s̺it̪es̺ẽn
zitezen	s̻it̪es̻ẽn
zitezkean	s̺it̪es̺keãn
zitezkean	s̻it̪es̻keãn
zitezkeen	s̺it̪es̺keẽn
zitezkeen	s̻it̪es̻keẽn
zitezkenan	s̺it̪es̺kenãn
zitezkenan	s̻it̪es̻kenãn
zituan	s̺it̪uãn
zituan	s̻it̪uãn
zituen	s̻it̪uẽ̞n
zitunan	s̺it̪unãn
zitunan	s̻it̪unãn
zituzkean	s̺it̪us̺keãn
zituzkean	s̻it̪us̻keãn
zituzkeen	s̺it̪us̺keẽn
zituzkeen	s̻it̪us̻keẽn
zituzkenan	s̺it̪us̺kenãn
zituzkenan	s̻it̪us̻kenãn
zituzketen	s̺it̪us̺ket̪ẽn
zituzketen	s̻it̪us̻ket̪ẽn
zituzten	s̻it̪us̻t̪ẽ̞n
zitzakeen	s̺its̻akeẽn
zitzakeen	s̻its̻akeẽn
zitzaketen	s̺its̻aket̪ẽn
zitzaketen	s̻its̻aket̪ẽn
zitzala	s̺its̻ala
zitzala	s̻its̻ala
zitzan	s̺its̻ãn
zitzan	s̻its̻ãn
zitzatela	s̺its̻at̪ela
zitzatela	s̻its̻at̪ela
zitzaten	s̺its̻at̪ẽn
zitzaten	s̻its̻at̪ẽn
zizare	s̺is̺aɾe
zizare	s̻is̻aɾe
ziztatu	s̺is̺t̪at̪u
ziztatu	s̻is̻t̪at̪u
zoazen	s̺oas̺ẽn
zoazen	s̻oas̻ẽn
zoazke	s̺oas̺ke
zoazke	s̻oas̻ke
zoazkete	s̺oas̺ket̪e
zoazkete	s̻oas̻ket̪e
zoaz	s̺oas̺
zoaz	s̻oas̻
zoazten	s̺oas̺t̪ẽn
zoazten	s̻oas̻t̪ẽn
zoazte	s̺oas̺t̪e
zoazte	s̻oas̻t̪e
zolda	s̻o̞l̪d̪a
zomorro	s̺omoro
zomorro	s̻omoro
zorabiatu	s̺oɾaβ̞iat̪u
zorabiatu	s̻oɾaβ̞iat̪u
zoratu	s̻o̞ɾat̪u
zorionak	s̻o̞ɾio̞nak
zorion	s̻o̞ɾiõ̞n
zoriontsu	s̺oɾiõnts̻u
zoriontsu	s̻oɾiõnts̺u
zori	s̻o̞ɾi
zorne	s̻o̞rne̞
zornotza	s̺ornots̻a
zornotza	s̻ornots̻a
zorri	s̻o̞ri
zorro	s̺oro
zorro	s̻oro
zorrotz	s̺orots̻
zorrotz	s̻orots̻
zorrozkailu	s̻oros̻kai̯lu
zorrozkailu	s̺oros̺kaʎu
zorrozkailu	s̻oros̻kaʎu
zorroztu	s̺oros̺t̪u
zorroztu	s̻oros̻t̪u
zor	s̻o̞r
zortzigarren	s̺orts̻iɣ̞arẽn
zortzigarren	s̻orts̻iɣ̞arẽn
zortzikoitz	s̻o̞rts̻iko̞i̯ts̻
zortziren	s̻o̞rts̻iɾẽ̞n
zortzi	s̺orts̻i
zortzi	s̻orts̻i
zotz	s̻o̞ts̻
zozo	s̻o̞s̻o̞
z	s̻e̞t̪a
zuan	s̺uãn
zuan	s̻uãn
zubiaga	s̺uβ̞iaɣ̞a
zubiaga	s̻uβ̞iaɣ̞a
zubibide	s̺uβ̞iβ̞ið̞e
zubibide	s̻uβ̞iβ̞ið̞e
zubiri	s̺uβ̞iɾi
zubiri	s̻uβ̞iɾi
zubi	s̺uβ̞i
zubi	s̻uβ̞i
zubizain	s̺uβ̞is̺ãĩ̯n
zubizain	s̻uβ̞is̻ãĩ̯n
zuek	s̻ue̞k
zuen	s̻uẽ̞n
zuhaitz	s̺uai̯ts̻
zuhaitz	s̻uai̯ts̻
zuhaitz	s̻uhai̯ts̻
zuhaixka	s̺uai̯ʃka
zuhaixka	s̻uai̯ʃka
zuhaixka	s̻uhai̯ʃka
zuhamu	s̻uamu
zuhamu	s̻uɦamu
zuhamuxka	s̺uamuʃka
zuhamuxka	s̻uamuʃka
zuhamuxka	s̻uhamuʃka
zuhur	s̻uɦur
zuhur	s̻ur
zukean	s̺ukeãn
zukean	s̻ukeãn
zukeen	s̺ukeẽn
zukeen	s̻ukeẽn
zukenan	s̺ukenãn
zukenan	s̻ukenãn
zuketen	s̺uket̪ẽn
zuketen	s̻uket̪ẽn
zuk	s̻uk
zulagailu	s̻ulaɣ̞ai̯lu
zulagailu	s̺ulaɣ̞aʎu
zulagailu	s̻ulaɣ̞aʎu
zulatu	s̻ulat̪u
zulogune	s̺uloɣ̞une
zulogune	s̻uloɣ̞une
zulo	s̺ulo
zulo	s̻ulo
zulueta	s̺uluet̪a
zulueta	s̻uluet̪a
zumake	s̻umake̞
zumarraga	s̺umaraɣ̞a
zumarraga	s̻umaraɣ̞a
zunan	s̺unãn
zunan	s̻unãn
zuñiga	s̺uɲiɣ̞a
zuñiga	s̻uɲiɣ̞a
zuraide	s̺uɾai̯ð̞e
zuraide	s̻uɾai̯ð̞e
zure	s̻uɾe̞
zurginak	s̻urɣ̞inak
zurginak	s̻urɣ̞iɲak
zurginarekin	s̻urɣ̞inaɾe̞kĩn
zurginarekin	s̻urɣ̞iɲaɾe̞kĩn
zurginarenganaino	s̻urɣ̞inaɾẽ̞ŋɡanai̯no̞
zurginarenganaino	s̻urɣ̞iɲaɾẽ̞ŋɡanaɲo̞
zurginarenganako	s̻urɣ̞inaɾẽ̞ŋɡanako̞
zurginarenganako	s̻urɣ̞iɲaɾẽ̞ŋɡanako̞
zurginarenganantz	s̻urɣ̞inaɾẽ̞ŋɡanãnts̻
zurginarenganantz	s̻urɣ̞iɲaɾẽ̞ŋɡanãnts̻
zurginarengana	s̻urɣ̞inaɾẽ̞ŋɡana
zurginarengana	s̻urɣ̞iɲaɾẽ̞ŋɡana
zurginarengandik	s̻urɣ̞inaɾẽ̞ŋɡãn̪d̪ik
zurginarengandik	s̻urɣ̞iɲaɾẽ̞ŋɡãn̪d̪ik
zurginarengan	s̻urɣ̞inaɾẽ̞ŋɡãn
zurginarengan	s̻urɣ̞iɲaɾẽ̞ŋɡãn
zurginarengatik	s̻urɣ̞inaɾẽ̞ŋɡat̪ik
zurginarengatik	s̻urɣ̞iɲaɾẽ̞ŋɡat̪ik
zurginaren	s̻urɣ̞inaɾẽ̞n
zurginaren	s̻urɣ̞iɲaɾẽ̞n
zurginarentzat	s̻urɣ̞inaɾẽ̞nts̻at̪
zurginarentzat	s̻urɣ̞iɲaɾẽ̞nts̻at̪
zurginari	s̻urɣ̞inaɾi
zurginari	s̻urɣ̞iɲaɾi
zurgina	s̻urɣ̞ina
zurgina	s̻urɣ̞iɲa
zurginaz	s̻urɣ̞inas̻
zurginaz	s̻urɣ̞iɲas̻
zurgindegi	s̺urɣ̞ĩn̪d̪eɣ̞i
zurgindegi	s̻urɣ̞ĩn̪d̪eɣ̞i
zurginei	s̻urɣ̞ine̞i
zurginei	s̻urɣ̞iɲe̞i
zurginekin	s̻urɣ̞ine̞kĩn
zurginekin	s̻urɣ̞iɲe̞kĩn
zurginek	s̻urɣ̞ine̞k
zurginek	s̻urɣ̞iɲe̞k
zurginenganaino	s̻urɣ̞inẽ̞ŋɡanai̯no̞
zurginenganaino	s̻urɣ̞iɲẽ̞ŋɡanaɲo̞
zurginenganako	s̻urɣ̞inẽ̞ŋɡanako̞
zurginenganako	s̻urɣ̞iɲẽ̞ŋɡanako̞
zurginenganantz	s̻urɣ̞inẽ̞ŋɡanãnts̻
zurginenganantz	s̻urɣ̞iɲẽ̞ŋɡanãnts̻
zurginengana	s̻urɣ̞inẽ̞ŋɡana
zurginengana	s̻urɣ̞iɲẽ̞ŋɡana
zurginengandik	s̻urɣ̞inẽ̞ŋɡãn̪d̪ik
zurginengandik	s̻urɣ̞iɲẽ̞ŋɡãn̪d̪ik
zurginengan	s̻urɣ̞inẽ̞ŋɡãn
zurginengan	s̻urɣ̞iɲẽ̞ŋɡãn
zurginengatik	s̻urɣ̞inẽ̞ŋɡat̪ik
zurginengatik	s̻urɣ̞iɲẽ̞ŋɡat̪ik
zurginen	s̻urɣ̞inẽ̞n
zurginen	s̻urɣ̞iɲẽ̞n
zurginentzat	s̻urɣ̞inẽ̞nts̻at̪
zurginentzat	s̻urɣ̞iɲẽ̞nts̻at̪
zurginez	s̻urɣ̞ine̞s̻
zurginez	s̻urɣ̞iɲe̞s̻
zurginik	s̻urɣ̞inik
zurginik	s̻urɣ̞iɲik
zurgini	s̻urɣ̞ini
zurgini	s̻urɣ̞iɲi
zurgin	s̺urɣ̞ĩn
zurgin	s̻urɣ̞ĩn
zurgintza	s̻urɣ̞ĩnts̻a
zurgintzat	s̻urɣ̞ĩnts̻at̪
zuriñe	s̺uɾiɲe
zuriñe	s̻uɾiɲe
zuri	s̻uɾi
zurrumurru	s̺urumuru
zurrumurru	s̻urumuru
zur	s̺ur
zur	s̻ur
zu	s̻u
zuten	s̻ut̪ẽ̞n
zuzena	s̺us̺ena
zuzena	s̻us̻ena
zuzenbide	s̺us̺ẽmbið̞e
zuzenbide	s̻us̻ẽmbið̞e
zuzenbidezko	s̺us̺ẽmbið̞es̺ko
zuzenbidezko	s̻us̻ẽmbið̞es̻ko
zuzendu	s̺us̺ẽn̪d̪u
zuzendu	s̻us̻ẽn̪d̪u
zuzenean	s̺us̺eneãn
zuzenean	s̻us̻eneãn
zuzen	s̺us̺ẽn
zuzen	s̻us̻ẽn
zuzentasun	s̺us̺ẽn̪t̪as̺ũn
zuzentasun	s̻us̻ẽn̪t̪as̺ũn
zuzentzaile	s̻us̻ẽnts̻ai̯le
zuzentzaile	s̺us̺ẽnts̻aʎe
zuzentzaile	s̻us̻ẽnts̻aʎe
