10منٹ	ɒnməɳʈ
1آ	ɑː
2آ	ɑː
2سپاہی	ʃɑpʰɑhiː
5-اور-0	ʔuːr
5منٹ	pʰəˈnʌt
6فٹ	ʃɪft
8میٹراونچی	ʔeːmɪt̪ɾɔ̃ːtʃiː
a-دس	əd̪əs
an-ایک	ənɪk
g-چیٹ	gɪtʃʰeːt̪
h-ہولڈ	ɦoːlɗ
ha-ha-ha-ہا	hahaːhaː
one-اٹھانوے	əʈʰənoe
s-اس	əs
s-ان-کے	sɪnke
µµہüاد	ɪɾʈɑːd
µàہ	ɑː
µçءِ	ɪ
µèءْ	ʔɪ
µéہ	ɪdʒɑːr
µéہا	ɑː
µéہج	ɑːɾɪg
µîاد	miːd
µîہ	ɪ
µîہهاد	ɪhɑːd
µûءِہع	ʊɾʊ
µüہج	ɑːɾ
µإءِ	ɑː
µإد	ɪd
µإن	ɪn
µئ	ɑː
µا	ɑː
µاµµ	ɑːɾʌ
µادءِ	maːd̪eː
µار	maːr
µاص	ʔɑs
µاہف	əɣəf
µب	ɑːb
µخ	ɣ
µر	əɾ
µرہ	ɾə
µرہج	ʊrɑhɑdʒ
µز	uz
µض	ʊdˈd
µع	ɑː
µعء	ɑːɽ
µعہا	ɑː
µه	ə
µهؤ	ɑː
µيہج	ɪj
µً	ʊrːdʊ
µًہعہج	ʊrduː
µًہْئ	ʊrːdʊ
àء	ɑː
àادءِ	ɑːd̪eː
àارإ	ɑːrɪ
àاط	ɑːʈ
àہا	ɑːhɑː
àہع	əɪ
âµµاك	ɑːk
âµéہا	ɑːmɑːr
âءِ	ə
âءْہج	ɑːhɑːdʒ
âآë	ɑːr
âإéہج	æɪdʒ
âاد	ɑːd̪
âادہـ	ɑːd̪ɑː
âب	ɑːb
âہ	ɑː
âہج	əɦdʒ
âہخءِ	ɑːx
âہد	əɦd̪
âہه	əɦe
âہهہ	ɑːhɑː
âہهہش	ɑːɦɑːʃ
çµéہج	ʃɪkɑːr
çءِ	ə
çءِہا	ɪha
çؤ	ʃɔː
çإآ	ʃɑː
çاد	ʃɑːd
çادءِ	ʃɑːdɪ
çار	ʃɑr
çارءِ	ʃɑːrɪ
çاز	ʃɑz
çاط	ʈʌ
çاك	ʃɑk
çب	ʃɑb
çہ	ʃɑː
çہûہخ	ʃɑɪ
çہج	ʃɑdʒ
çہجءِ	ʃɑdʒ
çہش	ʃɑʃ
çہع	ʃɑɾ
çہه	ɪ
èء	æ
èإد	ɛːd
èئ	ɛː
èاط	əʈ
èاكءز	ɑkːɑz
èب	ɛb
èہ	æ
èہا	əɪ
èہج	ɛhɟ
èہخµé	ɛhxʊ
èہخہج	əɪkɑːdʒ
éاد	æd
éاط	əɪt̪
éب	ɛb
éہ	ə
êµاءِ	æ
êہ	ɛː
êہج	əɪdʒ
êہجہف	ɛːdʒahf
ëµا	ɑː
ëء	æ
ëءِ	ə
ëءِءّµµ	əɪ
ëأâµئ	ɪɾʈɑːɪ
ëأâµئہ	ɑːɽɑː
ëأâµا	ɪkˈsɑːr
ëئْ	ɛː
ëا	ɑː
ëاا	əː
ëاد	ɑːd
ëاذ	ɑːð
ëار	ɑr
ëاز	ɑz
ëاش	ɑːʃ
ëاص	ɑːs
ëاط	əˈt̪ɑːt̪
ëاطءل	ʔɑːt̪ɑːl
ëب	æb
ëہدءِµµ	ɛːɦd̪eː
ëہه	əhe
ëہهہهہجہا	əhaːhaːhaːdʒɑː
îµز	ɪz
îµً	ɪmɾ
îµًµç	ɪmɑːr
îµًµçءِ	ɪɾaːd
îµًءز	ɪz
îµّ	ɪmˈdʌd
îµّءِ	ɪmˈɾi
îء	ɪ
îءà	ɪɑː
îءضءِ	ɪdʒ
îءل	ɪl
îءِ	ɪ
îءّ	ɪtː
îآ	ɑː
îآî	ɪɑː
îإح	əħ
îاد	iːɑːd
îار	ɑr
îاط	ɪʈ
îاك	ɪk
îہ	ɪ
îہج	ɪhɟ
îہجاد	ɪɦɟɑːd
ïاد	ɛːd
ïاط	ɪʈ
ïہ	ɪh
ôاد	ɔːd
ôادµç	ɔːd̪uː
ôار	ɔːr
ùاد	ʊd
ùہا	ʊɦɑ
ùہجµç	ʊɦdʒʌs
ûآïار	ɑːɪr
ûآïاط	ɑːɪt̪
ûاد	ʊd
ûادءز	ʊd̪z
ûاكءِ	ɑːkɪ
ûہ	ɔː
ûہج	əʊɦdʒ
üء	ɪ
üءكµé	ʊkæ
üءكµéہج	ʊkægʲeː
üءِ	ə
،	ʔ
؛	ʃ
ء	je
ء	ji
ء	ʔ
ءµذ	əɪz
ءµر	əɾ
ءà	ə
ءü	ə
ءüآ	əʊ
ءüہج	əʊ
ءء	ʔ
ءءà	ə
ءءءْ	ʔaː
ءءض	ʔɑːdʒ
ءءضءِ	ʔɑːdʒi
ءءل	əɭ
ءءلءِ	əːlɪ
ءءہ	əː
ءأؤ	ɑːu
ءؤ	əʊ
ءاز	əza
ءاك	əˈk
ءث	əθ
ءز	əˈz
ءض	əɖ
ءضµµاد	ˈɑdʒdʒʌd
ءضء	ʔɑdʒ
ءضءِ	ʔɑdʒi
ءضااإح	əzaːɪh
ءضااإحہا	əzaːɪhɑː
ءضہخ	əɖʌx
ءط	ʔəʈ
ءظ	ʔð
ءك	ək
ءكار	əˈkɑr
ءكاك	əˈkɑk
ءٌ	ʔ
ءُ	ʔuː
ءِ	ʔ
ءِµµ	əɪ
ءِؤر	əɾ
ءِؤرءض	əɾɽəɖ
ءِإ	ə
ءِا	ə
ءِاد	ɑːd
ءِبض	əpɖ
ءّ	ʔ
ءّء	ʔaː
ءّآ	əɑː
ءْ	ʔ
ءْہ	ə
ءْہج	əɦdʒ
ءہضءِ	əɦd̪ə
آ	ɑː
آµ	ɑː
آµé	ɑːmɑːr
آë	ɑː
آî	ɑːi
آïءْ	ɑːɪ
آû	ɑːu
آü	ɑːu
آءِ	ɑː
آءِµµ	ɑːiː
آءّ	ɑː
آأç	ɑːts
آأçء	ɑːɪs
آؤ	ɑu
آؤنگا	ɔːŋgə
آؤٹ	ɔːʈ
آؤٹر	ɔːʈəɾ
آؤں	ɔ̃
آئرس	ɑːɪrs
آئرش	ɑːɪrʃ
آئرن	ɑːɪrn
آئس	ɑɪs
آئلے	ɑːleː
آئند	ɑ̃ːi̯nd̪
آئندہ	ɑːɪnd̪ə
آئی	əɪ
آئیلینڈ	ɑɪlɑːnd
آئین	ɑːɪ̃ːn
آئیندہ	ɑːɪndə
آئینی	ɑːiːniː
آئیڈیا	ɑːɪdɪjɑː
آئیں	ɑ̃ẽ
آئیے	aije
آئے	ɑːjeː
آاط	ɑːt̪
آاکنوں	ɑːkənõː
آب	ɑːb
آباد	ɑːbɑːd
آبادکاروں	ɑːbɑːd̪kɑːroːŋ
آبادی	ɑːbɑːd̪iː
آبشار	ɑːbʃɑːr
آبشاروں	ɑːbʃɑːrʊ̃
آت	ɑːt̪
آتا	ɑːt̪ɑː
آتش	ɑːt̪ʃ
آتشبازی	ɑːtʃʰbɑːzi
آتشیں	ɑːt̪ʃeːn
آتہ	ɑːt̪ə
آتی	ɑːt̪iː
آتے	ɑːteː
آثار	ɑːt̪ɑːr
آج	əg
آجا	ɑːdʒɑː
آجاؤ	əˈdʒɔː
آجائیں	ədʒɑːɪ̃
آجاتا	əˈdʒət̪ə
آخر	ɑːkhir
آخرکار	ɑːkɛrkɑːr
آخری	ɔkɾi
آداب	ɑːdɑːb
آداب	ɑːd̪ɑːb
آدم	ɑːd̪əm
آدمی	ɑːd̪miː
آدمیوں	ɑːd̪mijõː
آدھ	ɑːd̪ʱ
آدھا	əːd̪ʱə
آدھی	əːd̪ʱiː
آدھے	ɑːd̪ʱeː
آذربائیجان	ɑːzɛɾbɑːɪjɑːn
آر	ɑːr
آرا	ɑːrɑː
آرائش	ɑːɾɑːɪʃ
آرام	ɑːrɑːm
آرسیی	ɑːɾsiː
آرلینڈو	ɑːrlɛnɖoː
آرمن	ɑːrmeːn
آرٹ	ɑːɾt̪
آرٹ	ɑːɾʈ
آرٹلری	ɑːɾt̪ɪlɾiː
آرٹی	ɑːrt̪iː
آرڈر	ɑːɾd̪əɾ
آرڈمر	ɑːɾd̪mər
آرکائیو	ɑːɾkɑːɪuː
آرگنائزیشن	ɑːrgɪnaɪˈʒiːʃən
آرہا	ɑːɾʰɑː
آرہی	ɑːɾʰiː
آرہے	ɑːrɑːe
آریئر	ɑːriːjəɾ
آریائی	ɑːɾiːɑː
آزاد	ɑːzɑːd
آزادانہ	ɑːzɑːd̪ɑːnə
آزادی	ɑːzɑːdɪ
آزادی	ɑːzɑːd̪iː
آزادیوں	ɑːzɑːd̪ijõː
آزما	ɑːzmɑː
آزمائش	ɑːzmɑːiːʃ
آس	ɑːs
آسان	ɑːsɑːn
آسانی	ɑːsɑːni
آسمان	ɑːsmaːn
آسمان	ɑːsmɑːn
آسمانوں	ɑːsmɑːnõː
آسمانی	ɑːsmɑːniː
آسٹریا	ɑːstɾiːjɑː
آسکر	ɑːskər
آسکے	əskɛ
آشام	əʃɑm
آشاہین	ɑːʃɑːhɪn
آشنائی	ɑːʃnɑːi
آغاز	ɑːgɑːz
آف	ɑːf
آفت	ɑːft
آفتاب	ɑːftɑːb
آفریدی	ɑːfɾiːdiː
آفس	ɑːfɪs
آفٹر	ɑːftər
آفیسر	ɑːfɪsər
آل	ɑːl
آلا	ɑːlɑː
آلات	ɑːlɑːt
آلو	ɑːluː
آلود	ɑːluːd
آلگائے	ɑːlgɑːe
آلہ	ɑːlə
آلے	ɑːleː
آم	ɑːm
آمادہ	ɑːmɑːd̪ɑː
آمد	ɑːməd
آمدنی	ɑːməd̪niː
آمدید	ɑːmɛdɪd
آمرانہ	ɑːməɾɑːnə
آمنے	əˈmæne
آمیز	əmiːz
آن	ɑːn
آنا	ɑːnɑː
آنتوں	əːn̪t̪oːn̪
آنسو	ɑ̃ːso
آنسو	ɑ̃ːsuː
آنکھ	ɑ̃kʰ
آنکھ	ɑ̃ːkʰ
آنکھوں	ɑ̃ːkʰõː
آنکھیں	ɑ̃kʰeːn
آنی	əˈniː
آنے	əne
آو	ɔː
آواز	ɑːwɑːz
آواز	ɑːʋɑːz
آوازوں	ɑːʋɑːzʊ̃
آوازیں	ɑːwɑːzɪ̃
آوروں	ɑːʋəɾõː
آوی	ɑːʋiː
آٌ	ɑː
آَآَاط	ɑːt̪
آُ	ɑː
آّ	ɑː
آّاد	ɑːd
آّار	ɑːr
آْ	ɑː
آْہ	ɑː
آٹا	ɑːt̪ɑː
آٹو	ɔːt̪oː
آٹوموبائل	ɑːt̪oːmoːbɑɪl
آٹومیشن	ɑːt̪oːmɪʃːən
آٹھ	ɑːʈʰ
آٹھویں	ɑːʈʰʋeːn
آٹے	ɑːʈeː
آپ	ɑːp
آپ-	ɑp
آپریشن	əpriːʃən
آپریشنز	əpɾeːʃənz
آپریشنوں	əpɾɪʃənõː
آپس	əps
آپشن	ɑːpʃn
آپکا	əpkə
آپکو	ɑːpkoː
آپکی	ɑpki
آپکے	əpke
آپی	ɑːpiː
آپے	ɑpɛ
آچکے	əʈʃke
آڈیو	ɑːd̪iːoː
آڈیٹر	ɑːdɪt̪əɾ
آڈیٹوریم	ɑːdiːt̪uːriːm
آڑ	ɑːɽ
آڑو	ɑːɽʊ
آکاشگنگا	ɑːkɑːʃgəŋgɑː
آکر	ɑːkəɾ
آکسیجن	ɑːksɪg̪n̪
آکلینڈ	ɑːkleɪnd
آکٹپس	ɑːkʈʰips
آگ	ɑːg
آگئی	əgeː
آگئیں	ɑːgeː
آگاہ	ɑːgɑː
آگزبرگ	ɑːgzbəɾg
آگیا	əgijə
آگے	əgeː
آں	ɑ̃
آہ	ɑː
آہا	ɑːhɑː
آہج	ɑːɦdʒ
آہستہ	ɑːhst̪ə
آہنگی	ɑːhɪŋgiː
آہیں	ɑ̃e̯
آیئے	aije
آیا	ɑːjɑː
آیت	ɑːɪt
أµéہج	ɑːɾɪg
أµب	ɑːb
أàء	ɑː
أءز	ɑːz
أءِ	ɑː
أؤ	ɔː
أؤءظ	ɔːɑːz
أؤر	ɔːr
أئ	ɑːiː
أار	ɑːr
أاط	ɑːt̪
أب	ɑb
أت	ɑt
أتہ	əˈt̪ə
أثہ	əθə
أر	ɑr
أرµ	ɑrɪ
أرہ	əɾə
أش	əʃ
أض	ɑdʒ
أك	ək
أكء	ək
أكأّہ	əkɑːh
أمونيوس	əmoːniːus
أو	ɔː
أوريستيس	ʔuːɾɪsˈtɪs
أّہج	ɑːɦdʒ
أہ	ə
أہغاد	əɦgɑːd
أہغار	əɣɑːr
أہغاطµµ	əɦgɑːt̪ʊ
أہه	əhe
أہْ	ə
ؤ	ə
ؤà	ɔː
ؤûءî	ɔː
ؤأأ	ɑː
ؤإ	ɔː
ؤا	ɔː
ؤاد	ɔːd
ؤار	ɔːr
ؤةہج	ɔːhɑːdʒ
ؤجئ	ɔdʒe
ؤرجاوان	ɔɾdʒɑːʋɑːn
ؤع	ɔː
ؤـ	ə
ؤـہ	ɔː
ؤں	ɒ̃
ؤھآùہ	ɔːɦɑː
ؤہ	ɔː
ؤہخ	ɔx
إµéہ	ɪmˈdʌr
إµéہا	ɪmˈdʌr
إµéہج	ɪmɑːdʒ
إëؤ	ɛo
إëب	ɛːb
إëہج	ɛhɛdʒ
إء	ə
إءز	ɑz
إءِ	ə
إآ	ɑː
إأل	ɑːl
إأہ	ɑː
إئ	ɛ
إاد	ɛːd
إادءِ	ɑːd̪eː
إاط	ɛt̪t̪
إاك	ɑːk
إب	ɪb
إح	ɪh
إحءِ	ɪhɑː
إحءّ	ɪhɑː
إد	ɪd
إدہا	ɪd̪ʱɑ
إذ	ɪð
إغہج	ɪɣɑdʒ
إن	ɪn
إواà	əwɑː
إً	ɪ
إُہش	əɦɪʃ
إُہع	əɦæ
إُہعاد	əhuˈd̪æːd̪
إُہعادءِ	əɦwaːd̪eː
إہ	əɪ
إہا	əɪhɑː
إہج	əiɦdʒ
ئ	ə
ئµ	ɑː
ئµé	ɪʃtɪkʰɑːr
ئµéہ	ɑːɾɪ
ئµéہج	ʔɪsɪ
ئµه	əme
ئç	ɛ
ئûئنہج	ɑːɪnɑːdʒ
ئûئنہجءز	ɑːɪnɑːdʒʌz
ئûئنہجہا	ɑːnɑːdʒhɑː
ئء	ə
ئءض	ɛɖ
ئءضءِ	əɽ
ئءل	ɑl
ئأ	ɑː
ئؤ	ɔː
ئؤئ	ɔɪ
ئإ	ɛ
ئئ	ə
ئئغ	əɣ
ئا	ɑː
ئاأ	ɑː
ئاد	ɑːd
ئاك	ək
ئاكءِ	əˈkʰeː
ئاكہ	əˈkʰə
ئب	əp
ئبµµ	əpə
ئبہ	əbe
ئبہج	əbeɣ
ئث	əθ
ئدبھی-1	ɛd̪bʱi
ئذ	əɪn
ئذئ	æɪn
ئغ	ɣ
ئغءٌ	əɣu
ئل	ɛl
ئماندار	ɪmɑːnd̪ɑːr
ئن	ə̃
ئيء	əɪ
ئياد	ɛjɑːd
ئيب	ɪb
ئيہجءِ	ɛːɦdʒeː
ئٍ	ɛ
ئَ	ə
ئّ	ɛː
ئّµµµéہا	ɑːɾɑː
ئْ	ə
ئہ	ə
ئہا	ə
ئہج	əɣ
ئہخ	əx
ئہخµéہ	əxu
ئہشµç	əɪʃ
ئہض	əɦd̪
ئہضہ	əɦd̪ə
ئہْ	ə
ئیڈی	ɛːɖiː
ئے	jeː
ا	ə
اµ	ɑː
اµéہج	ɑːmɑːdʒ
اà	ɑː
اàµ	ɑː
اàہج	ɑːɦɑdʒ
اè	æ
اèار	ɑːr
اèاص	əˈs
اê	æ
اï	əɪ
اô	ɔː
اùاز	ɔːz
اùہâ	əʊhɑː
اû	ɔː
اüء	ɑː
اء	ɑː
اأ	ɑː
اأہج	əɦdʒ
ائیر	ɑɪr
اا	ɑː
ااإح	əɪh
ااإُ	ɑːbɪr
ااد	ɑːd
اب	əp
ابأؤ	ɑbɑu
ابا	əˈbɑ
ابتدا	əpt̪əda
ابتداء	əbaːtˁiː
ابتدائی	əbt̪əd̪ɑːiː
ابر	əbr
ابرار	əbrɑːr
ابراہام	əbraːɦɑːm
ابراہیم	əbrɑːhɪm
ابرو	əˈbɾo
ابلاغ	əplɑːɣ
ابو	əbo
ابوظہبی	əbuzˈhæbi
ابھر	əpʰr̥
ابھی	əbiː
ابے	əbeː
ات	ɑt
اتإح	ɑt̪ɪh
اتار	əˈt̪ɑːr
اتارنا	ɑt̪ɑrnɑ
اتارنے	ətaːrɳe
اتارو	ɑt̪ɑrʊ
اتاولے	ɑt̪ɑu̯lɛ
اتحاد	ɪtːɑhɑd
اتحادی	ɪt̪ʰaːdʒiː
اتحادیوں	ɪt̪ʰaːdʒʱʊːd̪oːŋ
اتدیئ	ɑt̪d̪iː
اتر	ʊt̪r̪
اترا	əˈt̪rɑ
اترائی	ʊt̪ɾɑːɪ
اترتے	ət̪eːɾteː
اترنا	ʔʈərnə
اترنے	ət̪rənẽ
اترو	ɑt̪roː
اتساہی	ət̪sɑːhiː
اتفاق	ɪt̪ɑːq
اتفاقا	ɪt̪t̪efɑːqən
اتنا	ət̪nə
اتنظار	ɑt̪n̪əz̪ɑr
اتنی	ət̪niː
اتنے	ət̪neː
اتوار	ɑt̪ʋɑr
اتکرجتا	ətkərdʒtə
اتھارٹی	əθɑːɾtiː
اثاثہ	əθɑːsə
اثر	əθər
اثرات	əθrɑːt
اثنا	əθnɑ
اثناء	əθnɑe
اجارہ	əgɑːɾɑː
اجازت	əgɑːzət
اجتماع	ɪdʒt̪ɪmaːʔ
اجتماعات	ɪsːɑːgɑːmɑːt
اجر	əgər
اجرا	əgɾɑ
اجزاء	əgzɑːe
اجسام	əgzɑːm
اجلاس	əglɑs
اجلاسوں	əglɑːsõː
اجمود	ɛdʒmoːd
اجنبی	əgnbi
اجنبیوں	əgnbijoːn
اجوائن	əgoːɪ̃
اجھل	əʒl
اجیئ	əgiː
احاطوں	əɦɑːt̪õː
احاطہ	əɦɑːt̪ə
احاطے	əɦɑːt̪eː
احتجاج	əɦt̪dʒɑːʒ
احترام	əɦtəɾɑm
احتراماً	əɦtɾɑmɑ̃
احتساب	əɦt̪sɑbɑd̪
احتمال	ɑːt̪iːmɑːl
احتیاط	əɦtiːʔ
احتیاطا	əɦtiːʔɑː
احتیاطی	əɦtiːət̪iː
احساس	əɦsɑs
احساس	ʔæɦˈsɑːs
احساسات	əɦsɑsɑt
احمد	əˈhæmd
احمدبیٹا	əɦməd̪bɪt̪a
احمر	ɑhmər
احمق	əħmɑq
احمقانہ	əħmɑqɑnɑ
احمقوں	əhmqõː
احکام	əɦkɑːm
احکامات	əħkɑmɑt
اخإ	əxɪ
اخبار	əxˈbɑːr
اخبارات	əxbɑːɾɑːt̪
اخباری	əxbaːri
اختتام	əxt̪əmə
اخترتی	əxt̪eɾti
اختلاف	ɪxteɽɑf
اختلافات	ɪxtɪlaːɣɑːt
اختیار	əxt̪iɑːr
اختیارات	əxtiːɾɑːt̪
اخذ	əxð
اخراج	əxrɑːdʒ
اخراجات	əxɾɑːdʒət
اخروٹ	əxroːʈ
اخلاقی	əxlaːqi
اخلاقیات	əxlaːqijɑːt
اخی	əxɪ
اد	ɑːd
ادµµ	ədeːm
ادءز	ədeːz
ادءِ	ɑːd̪eː
ادءّ	ɑːd̪eː
ادا	əˈd̪ɑ
ادائیگی	ədaːigi
ادائیگی	əd̪ɑːeːgiː
ادار	əˈd̪ɑːr
ادارتی	ədaːrtiː
اداروں	əd̪ɑːɾoːŋ
ادارے	ədaːɾeː
اداس	əˈdɑs
اداسی	ədaːsiː
اداکاری	ədaːkɑːriː
ادب	əd̪b
ادخال	ɑdˈxɑːl
ادراک	ədɾɑk
ادقارکرتا	əˈd̪ʌrˌkɑːrˌt̪ɑː
ادویات	ədʋijɑːt
ادکارتا	ədaːkɑːɾtɑː
ادھار	ədaːr
ادھر	əɖʱə
ادھورا	əɖʱoːrɑ
ادھوری	əɖʱoːri
ادھیڑ	əɖʱiːɽ
ادہع	ədaː
ادہف	ədaːf
اذ	əð
اذان	əðɑn
اذیت	əˈzɪt
اذیتیں	əˈdʒiːt̪iːŋ
ار	əɾ
ارµµ	əɾəɾ
ارµخ	ɑrɪkʰ
ارإ	əɾe
ارادہ	əɾɑːd̪ə
ارادی	əɾaːdiː
ارادے	əɾɑːd̪eː
اراکین	əɾɑːkiːn
ارب	ɑrbʊ
اربوں	ərˈbõː
اربپتی	ərbʌpt̪i
ارتقاء	ɑːrt̪qɑːʔ
ارتکاب	ɑːrt̪kɑːb
ارد	ɑːɾd
اردن	ɑːrd̪n
اردنی	ərd̪niː
اردگرد	ɑːrdgʊrd
ارسال	ɑːrsɑːl
ارسترخس	ɑːrʌst̪rɪx
ارضیاتی	ərdʒiɑːti
ارکان	əɾkɑn
ارہـاط	əɾɑːt̪
ارے	əɾe
از	əz
ازارہ	əzaːrɑ
ازالہ	əzaːlə
ازراہِ	əˈzəɾɑhɪ
ازسرنو	əˈzərnu
ازلی	əˈzli
ازگر	əˈzgəɾ
اس	əs
اساتذہ	əsɑt̪ʌð̪e
اسامہ	əsaːmə
استاد	ɪst̪ɑːd̪
استثناءحاصل	ɪst̪t̪ɑ̃jɑ̃hɑːsɪl
استحصال	ɪst̪ʰəsaːl
استحقاق	ɪst̪ʰɪqɑq
استحکام	ɪst̪ʰkɑːm
استخلاف	ɪst̪exlɑːf
استر	ɪst̪r
استعفی	ɪstɑfɪ
استعمال	ɪstɪmɑːl
استفسار	ɪst̪fəsɑr
استقبال	ɪstɪkˈbɑl
استقبالیہ	ɪstɪkɑːbəliː
استنبول	ɪstæmbʊl
اسرائلیوں	ɪsɾɑːɪlijõː
اسرائیل	ɪsraːˈʔiːl
اسرائیلی	ɪsɾɑːɾɑɪliː
اسرائیلیوں	ɪsraːɪlɪjõː
اسرار	ɪsɾɑːɾ
اسسٹنٹ	əsistənt
اسعمال	əsæmæl
اسلئے	əsliːe
اسلام	ɪslɑːm
اسلحہ	əslaɦə
اسلحے	əsləɦeː
اسلیے	əsliːe
اسماعیل	ɪsmɑːˈʔiːl
اسمبلی	ɪsmʊlɪ
اسمگلر	ɪsmɛgləɾ
اسمگلنگ	ɪsmɛglæŋ
اسناد	əsnɑːd
اسنگتی	əsəŋgiː
اسو	əsʊ
اسٹار	ɪst̪əɾ
اسٹاف	əst̪ɑːf
اسٹریٹ	əsˈtɾiːt̪
اسٹریٹجک	əst̪ɾiːt̪gɪk
اسٹوری	ɪsʈoːɾiː
اسٹیج	əst̪eːdʒ
اسٹیشن	əstiːʃən
اسٹینڈ	ɪsʈæ̃d̪ː
اسٹینڈز	əsˈt̪æːnd̪z
اسٹیو	ɪsˈtiːoː
اسٹیورٹ	əst̪iːʋəɾt̪
اسٹیٹ	ɪst̪eːt̪
اسٹیڈیم	əst̪eːd̪iːm
اسپاسِس	əspɑsɪs
اسپاسیس	əspɑːsiːs
اسپاٹ	əspɑːt
اسپتال	əspətaːl
اسپین	əspiːn
اسپیکر	əspiːkəɾ
اسکا	əska
اسکائپ	ɪskɑːpɪ
اسکالر	əskɑːləɾ
اسکریننگ	əskriːnɪŋ
اسکندریہ	ɪskəndəɾiː
اسکوائر	ɪskuɑːjɪr
اسکواڈ	ɪskɑːd̪
اسکور	əskuːr
اسکول	əskul
اسکوپ	əskoːp
اسکی	əski
اسکین	əskɪn
اسکینڈل	ɪskæ̃ːndəl
اسکینڈلوں	əskæ̃ːnd̪əlõː
اسکے	əske
اسی	əˈsiː
اسینوف	əsɪnɔf
اسے	əsɛ
اش	əʃ
اشاروں	əʃɑːroːŋ
اشارہ	əʃɑːrɑː
اشارے	əʃɑːɾeː
اشتراک	əʃt̪ɾæk
اشتراک	ɪʃt̪eɾɑːk
اشتمالیت	ɪʃt̪emɑːlɪjət̪
اشتہاری	ɪʃt̪ʰɑːɾiː
اشرافیہ	əʃraːfiː
اشراوی	əʃraːvi
اشکال	əʃkɑl
اشیاء	əʃiːɑː
اشیاءاور	əʃiɑːoːr
اشیاٗ	əʃjɑː
اص	ɑs
اصرار	ɛssəɾɑr
اصطبل	əsˈt̪æbəl
اصطلاح	ɪsˈt̪ɑlaːh
اصل	ɪsːəl
اصلاح	ɪslɑːh
اصلاحات	ɪslɑːxɑːt
اصلی	əsliː
اصلیت	əsliːt
اصول	əsɔl
اصولاً	əsʊlæ̃
اصولوں	əsʊlõː
اضافہ	ɑːd̪ɑːfə
اضافی	ɑːdʒɑːfi
اضافے	ɑɖɑfe
اط	əʈ
اطµµ	ɑt̪ːʊ
اطµه	ɑt̪ʰe
اطء	ɑt̪eː
اطءà	ɑt̪ːe
اطءض	ɑt̪ːɑɪd̪ʒ
اطءضءِ	ɑt̪ːeːd̪s̪eː
اطءط	ɑt̪ːʌt̪
اطءظ	ɑt̪ːeːz̪
اطءلہ	ɑːt̪eːlə
اطؤ	ɑt̪uː
اطاعت	əˈt̪æːʋət̪
اطالوی	ɪtɑːlʋiː
اطراف	əˈt̪rɑːf
اطلاع	ətɪlɑːʔ
اطلاعات	ətɪlɑːʔɑːteːs
اطلاق	ɪt̪lɑːq
اطمینان	ɪtmiːnɑːn
اظہار	əʒɑːɦɑːr
اظہجµç	əʒhɑdʒmɑs
اظہخءّ	əˈzahkʌ
اعµé	əɪmɪ
اعتبار	eʔt̪ɪbɑːɾ
اعتبار	eːt̪bɑːɾ
اعتبار	eːt̪ebɑːɾ
اعتبار	əɪtɪbɑr
اعتراض	əɪtʃɾɑːz
اعتراضات	ɑːʋtɑːɾɑːʒɑːt
اعتراف	ɪkɾɑfʲ
اعترافات	əɪt̪ɾɑfɑːt̪ɑ
اعتماد	eʔt̪emɑːd̪
اعتماد	eʔt̪ɪmɑːd̪
اعتماد	ɪʋtɪmɑd
اعتمادی	ɑːt̪mɑːdiː
اعداد	ɑːʋɑːd̪
اعزاز	əɪzɑz
اعصاب	əʋsɑːb
اعصابی	əɪsɑːbi
اعضاء	ɑːɪzɑː
اعلان	əɪlɑːn
اعلی	əʋˈliː
اعلیٰ	əʋˈliː
اعمال	əˈʋɑːməl
اغوا	əgʋɑː
اغواء	əɣwaː
اف	ɑf
افتادہ	aftɑːd̪ə
افراتفری	əfɾaːtfɾiː
افراد	əfɾɑːd
افریقہ	ɑːfriːqə
افزا	əfzɑ
افزائش	əfzɑːiʃ
افزائی	əfzaːi
افزاش	əfzaʃ
افسانوں	əfsənõː
افسانوی	əfsənaːviː
افسر	əfsər
افسران	əfsərɑːn
افسوس	əfsuːs
افسوسناک	əfsuːsnɑːk
افغانستان	afɣɑnɪstɑːn
افق	əfɣ
افلاطون	əflaːt̪uːn
افواج	əfwaːdʒ
افواہ	əfʋɑh
افواہوں	əfʋɑːhõː
افواہیں	əfʋɑ̄hẽː
افوہ	əfʊ
اق	əq
اقتدار	əqt̪əd̪ɑr
اقتصاد	ɪktsɑːd
اقتصادی	ɪktsɑːdiː
اقدار	əqd̪ɑːr
اقدام	ɑːqd̪ɑːm
اقدامات	əqd̪ɑːmɑːt̪
اقرار	əqraːr
اقرارً	əqraːraː
اقسام	əqsɑːm
اقلیت	əqliːt̪
اقلیدسی	ɑːqleːd̪s̪iː
اقوام	əqɑːmɑː
اك	ək
اكءز	əˈkɑz
اكءِ	əˈki
اكہ	əkə
ال	æl
الائیڈ	ɑːlɑɪd
الادا	ɑlɑd̪ɑ
الارم	ɑlɑɾm
الاسکا	ælɑsˈkɑ
الاطالیہ	ɑlɑtɑˈliːjɑ
الاقوامی	ælɑqwɑmi
الامکان	ælæmˈkɑːn
البانیہ	ælbəniː
البتہ	ælβet̪ʰæ
البلاوی	ælbəlɑːʋiː
البم	ælbæm
التجا	ɪltɑdʒɑ
الجزیرہ	ælgɪzɪrɑ
الجھن	əlgʒʱən
الجھی	ɛlgʲʰiː
الحاد	ɦɑːd
الحال	ɦɑːl
الحمد	ɦʊmd
الدین	əɽˈdiːn
الرحمان	ɾəhˈmɑːn
الرحمٰن	ɾəhæmæːn
الرحیم	ɾəhɪm
الزام	ælzɑm
الزامات	ælzɑmɑt
السلام	ælsælæm
السيرابيوم	ɪsɪɾɑːbiːʊm
السّبت	ɪsːæbət
الشان	æʃæn
الظواہری	ælðʒɑːhɾi
العین	ælˈʋajn
الف	ælif
الفا	ælfɑ
الفاط	æfɑt̪ː
الفاظ	ælfɑːz
الفاظوں	ælfɑːzoːn
الفریڈ	ælfɾiːɖ
القاعدہ	ɑlqɑːˈʔiːdɑ
الله	ɑllɑh
اللہ	ɑllə
الماری	ælˈmaːri
المصری	əlmʊsˈriː
المناک	ælmɑnɑk
الموت	ælmuːt
الموتی	ælmoːti
المیڈا	ælˈmiːdɑː
الوت	ɑlʊt
الوداع	ælwɑdɑːʕ
الویل	ælwɪl
الٰہی	ɑːlɑːhiː
الٹ	ɑlʈ
الٹا	ɑlʈɑ
الٹنے	əɭʈne
الپس	ɑlpəs
الکوتی	əlkʊti
الکویتی	əlkʊʋiːti
الگ	ælg
الہیٰ	ɑlɑhiː
الینا	əlinɑ
الیکٹرانک	əleɪkʈrɑnɪk
الیکٹرانکس	ɛlɪktəˈɾɑŋks
الیگزینڈر	ɑlɪgzɑnd̪r̪
الیگزینڈرا	ælɪgzænd̪rɑ
ام	ɑm
امء	əːm
امارات	ɑmɑrɑːt
امام	ɑmɑm
اماں	əˈmɑ̃
امت	ɪmɑt
امتحان	ɪmtɑˈɦɑːn
امداد	əmd̪ɑːd̪
امدادی	əmdɑːdi
امر	əˈmɾ
امراء	əˈmɾɑː
امریکا	əˈmɾiːkə
امریکن	əˈmɾiːkən
امریکہ	əˈmɾiːkə
امریکی	əˈmɾiːki
امریکیوں	əmiːɾɪkijoːn
املاک	əmlɑːk
امم	ɑmː
امن	əˈmən
اموات	əmuːwaːt
امور	əmoːr
امورِ	əmoːri
امپیکٹ	əmpɪkt
امکان	əˈmɑkɑn
امکانات	əˈmʊkɑːnɑːt̪
امی	əmi
امیجنگ	əmiːdʒəŋ
امید	əmiːd
امید	ʊmːiːd̪
امیدواروں	əmiːd̪ʋɑːroːŋ
امیدیں	əmiːd̪eːn
امیر	əmiːr
امیر	ʔəmiːɾ
امیلیہ	əmiːliə
امیگریشن	əmigɾɪʃən
ان	ən
انا	əˈnɑ
اناج	əˈnɑdʒ
اناڑی	ənɑːɽiː
اناکانڈا	ənaːkənda
انتباہ	ənteˈbɑːh
انتخاب	əntəxɑb
انتخابات	ɪntəxɑbɑːt̪
انتردیشیی	ənt̪əɾd̪ɪʃiː
انتطار	ɑːnt̪t̪ɑːr
انتظار	ɪntɑˈzɑr
انتظام	ɪntɪzɑm
انتظام	ɪnt̪ezɑːm
انتظامی	əntəzmɑːi
انتظامیہ	ɪntəzmɑːjə
انتفاضہ	ɪnt̪əfaːɪdʒʰə
انتقال	ɪntəqɑl
انتقام	ɪntɑːqɑːm
انتھک	ənt̪ʰk
انتہا	ənt̪ʰɑ
انتہائی	ənt̪ʰɑːɪ
انتیس	əntiːs
انجام	ənˈgɑm
انجان	ənˈgən
انجن	əŋgən
انجنیئر	əŋgiːnɪr
انجوائے	əŋgoʊɑː
انجکشن	əŋgɪʃn
انجینئر	əŋgiːnɛːr
انجینئرنگ	əŋgiːnɛːrɪŋ
انجیکشن	əŋgɪkʃən
انحراف	ənhərɑf
انحصار	ənhəsɑr
انخلاء	əŋkʰlɑː
انداز	əndaːz
اندازہ	əndaːzə
اندر	ənd̪əɾ
اندراج	ənd̪ɾɑːg
اندراجات	ɑːnd̪rədʒət̪s
اندرتھا	əndəɾtʰɑ
اندردخش	ənd̪rəd̪oːkʃ
اندرونی	ənd̪roːniː
اندریاس	əndɾiːɑːs
اندوز	əndoːz
اندوشواس	ənd̪oːʃwaːs
اندکار	ənd̪kɑːr
اندھا	ə̃d̪ʰə
اندھوں	ə̃d̪ʰoːn
اندھیر	ənd̪ʱiːr
اندھیرا	ənd̪ʱiːrɑː
اندھیرے	ənd̪ʱiːre
اندھے	ənd̪ʰeː
انسان	ənsɑːn
انسان	ɪnsaːn
انسانوں	ənsɑːnõː
انسانی	ɪnsɑːniː
انسانیت	ɪnsɑːniːt̪
انسداد	ɪnsd̪əd̪
انسٹرکٹر	ɪnst̪rɪkt̪ər
انسٹیٹیوٹ	ɪnstitiːʔ
انشاءاللہ	ɪnʃɑːɪllɑː
انشانکن	ɪnʃɑːnˈkən
انشورنس	ə̃ʃoːrəns
انصاف	ənsɑf
انضباطی	ɪnʈʌbɑːt̪iː
انضمام	ənzaːm
انعام	ənˈʋɑːm
انعامی	ənæːmɪ
انعقاد	ɪnʋɑːqɑːd
انفرادی	ənfəɾɑːd̪iː
انفرمری	ənfəɾməɾiː
انفنٹری	ənfɪnˈtɾiː
انقلاب	ənroːlaːq
انمانگی	ənməngi
اننا	ənnə
انٹر	ɑ̃ːt̪əɾ
انٹرایکٹو	ənt̪əɾɑɪkʈʊ
انٹرفیس	ənt̪əɾfeɪs
انٹرنیشنل	ənt̪ɾəneːʃəɭ
انٹرنیٹ	ənt̪əɾneːt̪
انٹرویو	ənt̪roːiː
انٹرویوز	ənt̪roːʋeːz
انٹرپول	ɪnt̪əɾpuːl
انٹری	əntriː
انٹیل	ənt̪eːl
انٹیلی	əntiːliː
انچ	əntʃ
انچارج	əntʃərg
انڈسٹریز	ə̃ɳɖs̪t̪riːz̪
انڈسٹریل	ə̃nd̪s̪t̪riːl̪
انڈکوش	əndkoːʃ
انڈیا	ənd̪ɪjə
انڈین	ənd̪ɪn
انڈیکس	əndɪkəs
انڈے	ənd̪eː
انکار	ənkɑːr
انکشافات	ənkɪʃɑːfɑːt
انکل	əŋkəl
انکوڈنگ	ənkoːɖiŋ
انکی	əŋki
انگر	əŋgər
انگریزی	əŋgreːziː
انگلی	əŋgəli
انگلینڈ	ɪŋgəˈlɑːnd
انگلیوں	əŋglijõː
انگوٹھوں	əŋgoːʈʰoːn
انگوٹھی	əŋgoʈʰi
انگوٹی	əŋgoʈi
انگیز	əŋgiz
انھوں	ə̃hõː
انھیں	ə̃ɦẽː
انھیںاور	ənɦẽːnɔːr
انہر	əˈnɛr
انہوں	ənaːhõː
انہيں	ənɛ̃
انہی	əˈnɛː
انہین	ənaːɪn
انہیں	əˈnɛ̄
انے	əne
او	ɔː
اوائل	ɔːwɑːɪl
اوباما	ɔːbɑːmɑː
اوبامہ	ɔːbɑːmə
اوبرائن	ɔːbɾɑɪn
اودان	ɔːd̪ən
اور	ɔːr
اورات	ɔːɾɑːt
اورتحفہ	ɔːrt̪əɦəfə
اورجب	ɔːrgʌb
اورپھر	ɔːrpʰəɾ
اورہر	ɔːrɛr
اوسط	ɑːst̪ʊ
اوقات	ɔːqɑːt
اوقاتِ	ɔːqɑːt̪i
اوقیانوس	ɔːkjɑːnɔːs
اول	ɔːl
اولاد	ɔːlɑːd
اولادوں	əwlɑːd̪õː
اولمپس	ɔːlmɪps
اولمپک	ɔːlmɪk
اولگا	ɔːlgɑː
اولین	ɔːliːn
اونٹ	ɔːnʈ
اونٹوں	ɔːnʈoː
اونچائی	ɔːntʃɑːi
اونچی	ɔːntʃi
اونچے	ɔːntʃeː
اوور	ɔːr
اوپر	ɔːpəɾ
اوپن	ɔːpən
اوکردوست	ɔːkəɾd̪oːst̪
اوکیناوا	ɔːkɪnɑːwɑː
اوکے	ɔːkeː
اوہ	əʊ
اوہائیو	ɔːɦɑɪo
اوہایو	ɔːhɑːjoː
اوہو	əʊɦoː
اویوساییک	əʋjoːsɑːjɪk
اى	əj
اُ	uː
اُتارا	ʊt̪ɑːrɑː
اُمتیں	ʔʊmt̪ɪŋ
اُوٹ	ʊt̪ː
اُٹھا	ʊʈʰɑː
اُگائیں	ʊgɑːeːn
اُگائے	ʊgɑːje
اِس	ɪs
اِسی	ɪsi
اِسے	ɪse
اِن	ɪn
اِنہیں	ɪnhẽː
اِہç	əɪhɪ
اّ	ɑː
اْتنا	ətnɑ
اْتنی	ətni
اْدھر	əɖʱə
اْس	əs
اْستانی	ɑːst̪aniː
اْسے	əsɛ
اْلجھن	əlgʒən
اْلٹا	əɭt̪aː
اْمید	əmiːd
اْن	ə̃
اْنگلی	əŋgliː
اْنہوں	ə̃hõː
اْنہیں	ə̃heːn
اْٹھائیں	əʈʰɑ̃ẽ
اْٹھاو	əʈʰɑːʋ
اْکھڑے	əxɽe
آ	ɑː
آئے	ɑːeː
آتا	ɑːt̪ɑː
آتی	ɑːtiː
آثار	ɑːθɑːrɑː
آج	ɑːdʒ
آجاتا	ɑːgətɑː
آجانا	ɑːdʒɑːnɑː
آجاو	əʒɑːʋ
آخرت	ɑːxtər
آخری	ɑːxri
آدمی	ɑːdmi
آدھا	ɑːd̪ʱə
آدھی	ɑːd̪ʱiː
آرام	ɑːrɑːm
آرہا	ɑːrɑː
آرہے	ɑːrɑːɦeː
آزاد	ɑːzɑːd
آسان	ɑːsɑːn
آسانی	ɑːsɑːniː
آسمان	ɑːsmɑːn
آسمانوں	ɑːsmɑːnõː
آقا	ɑːqɑː
آمین	ɑːmiːn
آنا	ɑːnɑː
آنسو	ɑ̃ːsʊ
آنکھوں	ɑ̃kʰõː
آنکھیں	ɑ̃kʰeːn
آنے	əne
آو	ɑːʊ
آپ	əp
آپس	ɑːps
آکر	ɑkər
آگ	ɑːg
آگیا	əgjɑ
آگے	ɑːge
آہستہ	ɑːst̪ə
آیا	ɑːjɑː
آینگے	əɪŋe
اٹارنی	ɑːt̪əɾniː
اٹاری	əʈaːri
اٹلانٹک	ɑːt̪lɑ̃ːt̪k
اٹلس	ɑt̪əls
اٹھ	əʈ
اٹھا	əʈʰɑː
اٹھاؤ	əʈʰɑːo
اٹھائیں	əʈʰɑːẽː
اٹھائے	əʈʰɑːe
اٹھاتے	əʈʰɑːte
اٹھارہ	əʈəɾə
اٹھانا	əʈʰənə
اٹھانے	əʈʰɑːne
اٹھاو	əʈʰɑːʋ
اٹھایئں	əʈʰɑːjẽ
اٹھایا	əʈʰɑːjɑː
اٹھنا	əʈna
اٹھو	əʈʰoː
اٹھی	əʈʰiː
اٹھیں	əʈʰeːn
اٹھے	əʈʰe
اٹیرنا	əʈeːrna
اٹیک	ət̪ɪk
اپ	əp
اپارٹمنٹ	əpɑːrt̪mɛ̃ːt̪
اپالو	əpɑːlʊ
اپالُوی	əpɑluːi
اپاچی	əpɑtʃi
اپددر	əpd̪əɽ
اپریل	əpɾiːl
اپمانت	əpmənt
اپنا	ɑːpnɑː
اپنا	əpnə
اپنانے	əpnaːneː
اپنوں	əpnoː
اپنی	əpniː
اپنے	əpne
اپنےمنہ	əpneːmen
اپہاس	əpəɦɑs
اچانک	ətʃɑ̃k
اچکائے	əʧkɑːje
اچھا	ətʃʰɑ
اچھائی	ətʃʰɑːiː
اچھال	ətʃʰɑl
اچھالا	ətʃʰɑlɑ
اچھی	ətʃʰiː
اچھے	ətʃʰeː
اڈوں	əɽõː
اڈہ	əɖə
اڈے	əɽe
اڑ	əɽ
اڑا	əɽə
اڑائیے	ɔɽɑiː
اڑادیتے	əɽɑːdɪt̪eː
اڑان	əɽɑːn
اڑانے	əɽɑːne
اڑتے	ɔɽte
اڑی	əɽi
اک	ək
اکاؤنٹ	əˈkɔ̃ːt̪
اکاؤنٹس	əˈkɔ̃ːʈs
اکاب	əˈkɑb
اکبر	əˈkəβər
اکتوبر	əkoːt̪ʊbər
اکتیس	əkt̪ɪs
اکثر	əkˈt̪ʃər
اکثریت	əˈkəθriːt
اکر	əkr
اکسایا	əksɑjɑ
اکلوتی	əkloːti
اکٹھا	əkʈʰə
اکٹھی	əkt̪ʰiː
اکٹھے	əkʈʰe
اکڑکر	əkəɽkəɾ
اککا	əkkə
اکھاڑ	əˈkʰɑːɽ
اکیس	əkiːs
اکیلا	əkiːlə
اکیلی	əkeːli
اکیلے	əkiːlə
اکیڈمی	əkiːɖəmiː
اگاتے	əgɑːte
اگتا	əgt̪ə
اگتے	əgte
اگر	əgər
اگردوت	əgəɾd̪ʊt̪
اگرچہ	əgərtʃʰe
اگست	əgʌst
اگستس	əgʌst̪s
اگل	əgəl
اگلا	əglə
اگلوا	əgləʋɑ
اگلوانا	əglʋɑːnɑ
اگلی	əgli
اگلے	əgle
اگے	əgeː
اھ	ə
اہ	ə
اہاب	əɦɑːb
اہتمام	əɦtɑmɑl
اہج	əɦdʒ
اہداف	əɦd̪əf
اہل	əɦl
اہلکار	əɦl̪kɑːr
اہلکاروں	əɦlkɑːɾõː
اہم	əɦəm
اہمیت	əɦmiːt
اہنے	əɦne
اہوائی	əhoːɑi
ای	əj
ایئر	ɛːr
ایا	ɑjɑ
ایبل	ɛːbəl
ایبٹ	ɛːbət
ایج	ɛːdʒ
ایجاد	ɛːdʒɑːd̪
ایجنسی	əɪgənsi
ایجنسیوں	əɪgənsiˑoːn
ایجنٹ	əjgənt
ایجنٹس	əɪgənts
ایجنٹوں	əɪgənʈoːŋ
ایجنڈا	əjngɑːnɑː
ایجنڈے	əjgənɟeː
ایران	ɑːrɑːn
ایرانی	ɪrɑːnɪ
ایرر	ɛːrɾ
ایرن	ɛːrən
ایرو	ɛːroː
ایرک	ɛːɾk
ایریا	ɛːrijɑː
ایریزونا	ɑːɾɪzoːnɑː
ایس	ɛːs
ایسا	ɛsɑ
ایسانہیں	əjsɑnɑhɛ̃
ایسوبی	ɛːsoːbiː
ایسٹ	ɛːst̪
ایسٹرن	ɛːst̪ɪɾən
ایسڈ	ɛːsɪd
ایسی	əɪsɪ
ایسے	əjsɛ
ایف	ɛːf
ایل	ɛːl
ایلن	ɛːlən
ایم	ɛːm
ایمان	əjmɑːn
ایماندار	əjmɑːnd̪ɑːr
ایمانداری	əjmɑːnd̪əɾiː
ایمبولینس	ɛmbʊlɪns
ایمرجنسی	əɪmərdʒənsi
ایملی	əiməli
ایمپائر	ɪmpɑːɾ
این	əjn
اینا	əjnɑ
ایناکانڈا	əjnəkɑːndə
اینجل	əiŋgəl
اینجلس	ɛːngəls
ایندھن	ɪnd̪ʱən
اینریکے	əĩnɾiːkɛ
اینٹینا	əɪnt̪ɪnɑː
اینڈ	ɛːnd
اینڈی	ɛnɟiː
اینکر	əiŋkəɾ
اینکرز	ɛːnkrɛz
اینگما	əjŋmɑ
ایوانِ	ɛːvɑːn
ایوب	ajob
ایونز	ɑjuns
ایونٹ	ɑjɔ̃ːt̪
ایونیو	əjuniːo
ایٹم	əɪt̪m
ایپل	əpəl
ایچ	əɪtʃ
ایڈ	ɛːd
ایڈجسٹ	ɛːdʒʌsteː
ایڈریس	ɛːdrɛs
ایڈز	ɛːd̪z
ایڈمرل	ɛːd̪mərl̪
ایڈوائزر	ɛːd̪ʋɑːɪzər
ایڈورڈ	əɪɖʊrɽ
ایڈولف	ɛːd̪ol̪f
ایڈونٹسٹ	əɪɖoːn̪t̪s̪t̪
ایڈیٹر	ɛːdɪt̪əɾ
ایڑھی	əɪɽʰiː
ایڑھیاں	əɪɽʰijɑ̃
ایک	əɪk
ایکسرے	əɪksəɾe
ایکسلریشن	ɛksɛlɾɪʃn
ایکسپرٹ	ɛkspeːɾt
ایکسپلور	ɛksplɔːr
ایکسچینج	ɛkstʃɪng
ایکشن	əɪkʃən
ایکو	əɪko
ایکواڈور	əjkʋɑːd̪ʊr
ایکٹ	əɪkʈ
ایکٹر	əɪkt̪əɾ
ایکٹو	ɑɪkt̪ʊ
ایکٹیویشن	ɛkt̪iːʋɪʃə̃n
ایکی	ɛːki
ایگزیکٹو	ɛgzɪkˈtoː
اے	æː
ب	ɓ
بçار	bəˈsɑr
بï	beː
بïء	beː
بùئ	buːɛ
بûµé	buːmɛ
بءِ	beː
بآت	beːʈ
بؤ	boː
بؤأك	boʔæk
بؤأكµµ	boʔək
بؤإً	boʔə
بؤإًاد	boːɑːd
بؤب	boːb
بئ	beː
با	ba
باؤل	boːl
باؤنڈ	boːnd̪
بائبل	baːɪbəl
بائنری	beːnɪriː
بائڈ	baːɪɖ
بائیں	baːɪẽː
بااختیار	baːxt̪iɑːr
باب	bɑb
بابت	baːbɪt
بات	baːt
باتوں	baːtõː
باتھ	baːt̪ʰ
باتیں	baːt̪eːn
باخبر	baːxbar
باد	bɑːd
بادءِ	baːd̪eː
بادشاہ	baːd̪ʃɑːh
بادشاہت	baːd̪ʌʃɑːɦət̪
بادشاہوں	baːd̪ʌʃɑ̄ːõː
بادشاہی	baːd̪ʌʃɑːhiː
بادل	baːd̪əl
بادلوں	baːd̪ɪlõː
بار	baːr
بارت	baːɾt
بارز	baːrɪz
بارسیلونا	baːrsiːlʊnɑ
بارش	baːrʃ
بارنس	baːrnis
بارود	baːruːd
بارودی	baːɾuːdiː
بارٹیںڈر	baːɾʈeːɳɖəɾ
بارڈر	baːɾd̪əɾ
بارہ	baːɾə
باری	baɾiː
بارے	baːreː
باز	baːz
بازار	baːzɑːr
بازو	baːzoː
بازی	beːzɪ
بازیابی	beːzɑːjiːɑːbiː
بازیافت	baːziːaft
باس	baːs
باسٹرڈ	baːst̪əɾd̪
باسی	beːsi
باصلاحیت	beɑsliːɑhiːt
باضابطہ	baːɪdʒɑbɪt̪ʰɑ
باط	baːt̪
باعث	beːʔaθ
باغ	baːɣ
باغی	baːɣi
باغیوں	baːɣiːõː
بافتوں	beːft̪oːŋ
باقائدہ	baːqɑːiːdə
باقاعدگی	baːqɑːdʒdʒi
باقاعدہ	baːqɑːd̪eː
باقی	baqi
باقیات	baːqijɑːt̪
باقیوں	baqijõː
بال	baːl
بالآخر	baːlɑːxɑːrɪ
بالا	baːlə
بالاتر	baːlɑːt̪r̪
بالادستی	baːlɑːd̪ɑːs̪tiː
بالغ	bagəl
بالفرض	baːlfarɪdʒ
بالفعل	bɪlfeːl
بالو	baːloː
بالوں	baːlõː
بالٹک	baːlʈk
بالٹی	baːlt̪iː
بالٹیمور	baːlʈiːmuːr
بالڈون	baːlɖoːn
بالکل	baːlkal
بالکونی	baːlkoːniː
بام	baːm
بامقصد	baːmʔɑsˈd
باندھ	bɑːnd̪ʱ
باندھتے	ɑ̃ːd̪ʱt̪eː
باندھنے	ɑːnd̪ʱne
باندھیں	ɑ̃ːd̪ʱeːn
بانٹ	baːn̪ʈ
بانٹیں	baːnʈeː
بانڈ	baːnd̪
بانڈز	baːndz
بانیوں	banjõː
باوجود	baːwɑːdʒɪd
باورچی	baʊɾtʃi
باپ	baːp
باڈی	baːdiː
باڑ	baːɽ
باڑے	baɽe
باکس	baːks
باکسنگ	baːkseŋ
باگو	baːgoː
باںد	baːnd̪
باہر	baːɦər
باہری	baːɦriː
باہمی	baːɦmiː
باہوں	baːɦõː
بای	baɪ
بب	beːb
بةأئ	beːɑɪ
بت	beːt
بتا	beːt̪ɑː
بتاءو	beːtɑːuː
بتاؤ	ɪt̪ɑːu
بتاؤنگا	ɪt̪ɑːu̯ŋɑː
بتاؤں	beːt̪ɔ̃ː
بتائيں	beːt̪ɑi̯n
بتائی	ɪtɑi
بتائیں	beːt̪ɑ̃eːn
بتائیے	beːtɑːiːeː
بتائے	beːt̪ɑːeː
بتاتا	beːt̪ɑːt̪ɑː
بتاتی	beːt̪ɑːtiː
بتاتے	ɪt̪ɑːteː
بتانا	beːt̪ɑːnɑː
بتانے	beːt̪ɑːneː
بتاو	ɪt̪ɑːʊ
بتاوں	beːtɑ̃ː
بتایئے	beːt̪ɑːjeː
بتایا	beːtɑːjɑː
بتھ	ɪt̪ʰ
بتیجیاں	beːtiːdʒɑ̃
بتیس	beːt̪is
بج	beg
بجاؤ	bedʒɔː
بجائے	bedʒɑːeː
بجانے	bedʒɑːneː
بجتی	begti
بجلی	begli
بجنا	begnə
بجٹ	begʈ
بجھادو	beɪdʒʰɑːdoː
بجھایا	bəgʲɑːjɑː
بجے	bedʒeː
بحال	bəˈɦɑːl
بحالی	bəɣɑːliː
بحث	bəxˈtʃ
بحر	baʈʈʰ
بحرالکاہل	ɪɪnbʌɾɑːlkɑːɦɑːl
بحران	ɦɾɑːn
بحری	bəˈɾiː
بحرین	bɛɦɾiːn
بحریہ	ɪˈbɪɾiɑː
بحوالے	bəɣɑːlɛ
بحیرہ	beːɾə
بخ	ɓəx
بخار	baχɑr
بخارات	bəxɑːrɑːt̪
بخارسٹ	bəxɑːrsət
بختی	bəxtiː
بخش	baʃkʰ
بخشش	ɑːkʃʃ
بخشوں	ɓəʃgõː
بخشی	ɓəxʃi
بخل	ɓɪxl
بخوبی	bəxʊbiː
بخیر	baχeɾ
بد	beːd
بدبختی	beːdbəxtiː
بدبو	beːdboː
بدبودار	beːd̪poːd̪ɑːr
بدتر	beːd̪t̪eːr
بدترین	beːd̪rɪstɪn
بدتمیزی	beːd̪t̪eːmizɪ
بدروح	beːdrʊx
بدسلوکی	beːdsɪluːkiː
بدسورت	beːds̪oːɾt̪
بدسورتی	beːds̪uːɾtiː
بدعنوان	beːdoːrʌn
بدقسمتی	beːdqɑsmʌti
بدل	beːd̪l̪
بدلا	beːdlɑ
بدلتا	beːld̪eːt̪ə
بدلتے	bəɽlte
بدلنا	beːd̪l̪nɑː
بدلنے	beːdl̪neː
بدلہ	beːd̪lə
بدلے	beːdl̪eː
بدماش	beːd̪mɑːʃ
بدمعاش	beːd̪mɑːʃ
بدن	beːdən
بدنام	beːd̪nɑːm
بدوش	beːd̪oːʃ
بدکار	beːd̪kɑːr
بدھ	beːd̪ʱ
بدی	beːdi
بدیا	beːdiː
بر	ɓəɾ
برآمد	beraːməd
برآں	beraːŋ
برا	brɑː
براؤن	brɔ̃ːu̯n
براؤننگ	brɔ̃ːŋ
برائن	brɑːɪn
برائی	beːraːiː
برائیوں	ɪɾɑːjɪ̃ː
برائے	beːɾɑːeː
برابر	bəɾɑːbər
برادر	bəˈɾaːd̪ər
برادری	brɑːd̪rɪ
برازیل	brɑːzɪl
برانڈ	brɑːnd̪
برانڈز	brɑːndz
برانڈٹ	brɑːnd̪ʈ
برانڈڈ	brɑːnɖː
براوو	ɪɾɑːuː
براوو-foxtrot	bəɾɑːʋoːfɔːktʃɔːt
براڈوے	brɑːd̪oːe
براک	brɑk
براہ	brɑː
برباد	ɪɾbɑːd̪
بربط	beɾat̪ː
برتاؤ	ɾʌtɔː
برتر	ɪɾt̪eɾ
برتری	beːrt̪riː
برتن	ɪɾt̪ən
برتھا	ɾeːt̪ʰɑː
برجیوں	beɾdʒijõː
برخاستگی	ɪɾkʰɑːst̪iː
برخاف	ɪɾkʰɑf
برداشت	ɾeːd̪ɑːʃt̪
بردر	ɪɾd̪eːr
بردوست	ɪɾd̪oːst̪
برسات	ɪɾsɑːt̪
برسوں	ɪɾsõː
برطانوی	brət̪əŋʋiː
برطانیہ	ɪɾtɑːniːɑː
برطاو	ɾʊtɑːu
برطرف	ɪɾtɑfɪɾ
برعکس	beɾɑkʰs
برف	bəɾəf
برف	ɪ
برفباری	ɪɾɑfɑbɑɾiː
برقرار	ɪɾqɑːɾɑːr
برلن	beːrlən
برن	ɪɾn
بروز	ɪɾoːz
بروس	ɪɾoːs
بروک	brɔːk
بروکلن	brɔːkələn
برٹس	ɪɾt̪s
برڈ	ɪɾd̪
برکت	beɾəkət
برگر	beːɾgeːr
برہمچری	brəɦɛmtʃri
بری	beri
بریفنگ	beːɾiːfŋ
بریفنگز	beːɾifŋeːs
برینئر	beːɾiːneːr
برینئیر	beːɾiːneːɾ
برینڈن	bræːnd̪ən
بریویا	beːɾiːvijɑː
بریڈفورڈ	beːɾɪd̪fʊɾɑːd̪
بریڈلی	beːɾɪd̪liː
بریڈلے	beːɾɑːd̪leː
بریک	beɾɪk
بریکر	beɾɪkkəɾ
بریکنگ	beːɾiːkŋ
بریکوں	beɾiːkoːn
بریکٹ	beɾɪkt̪
بریگیڈ	beːɾiːgɪːd
بریگیڈیئر	ˌbɾiːgiːˈgɛːɾ
برے	beː
بز	βuz
بزدل	bezd̪əl
بزدلی	bezd̪liː
بزرگوار	bezəɾgʋɑːr
بس	bes
بسانا	bsɑnɑ
بسانے	bsɑnẽ
بستر	beːstər
بستروں	beːst̪roː
بستے	beːsˈteː
بسم	besim
بسنے	beːsneː
بسٹر	besʈər
بش	beʃ
بشانہ	ɓəʃɑːnə
بشریٰ	beʃriː
بشمول	beʃmuːl
بشہر	beʃɛr
بصری	besɪriː
بضأ	ɑː
بطليموس	ɪɾtɪlɑːjʊs
بطلیموس	ɪt̪ɪlɑːmus
بطور	ɑt̪ːuɾ
بظاہر	ɪzɑːɦɪr
بعد	bɑːd̪
بعد	bəˈd̪æ
بعض	βʊsd
بعقوبہ	beːdʒʊbʰɑː
بعید	beːd
بغاوت	baɣɑːut
بغداد	baɣd̪ɑːd̪
بغض	baɣɖ
بغیر	beɣiːr
بفیلو	befɪloː
بق	baq
بقا	bagɑ
بقایا	baqɑjɑ
بقہد	baqɑɑd
بل	bɪl
بلا	belɑ
بلاؤ	beːlɑːu
بلاؤنگا	belɔːŋgɑː
بلائے	ɪlɑːe
بلاتا	bələt̪ə
بلاتے	beːlɑːteː
بلاجھجک	bəlɑːdʒʰɪdʒk
بلاسٹ	ɪɪ̯lɑst̪
بلاشبہ	belɑːʃbeɦɑː
بلانا	ɪɾɑnɑ
بلاو	beːlɑːu
بلاوی	belɑːʋiː
بلاک	blɑk
بلاکس	blɑks
بلاگ	beːlɑːg
بلاہ	belɑː
بلایا	beːlɑːjɑː
بلبلا	bɪlbɪlɑ
بلغارین	bulgɑːrɪn
بلند	bɪlnd̪
بلندی	beːlənɖiː
بلندیوں	bɪlʌnd̪iːõː
بلنی	beːlniː
بلوایا	beːloːjɑː
بلوجی	beːloːdʒiː
بلوز	beːloːz
بلوط	beːloːt̪
بلوچی	beːloːtʃiː
بلوں	bɪlõː
بلٹ	ɪɾ
بلڈاگ	ɪɾtɑːg
بلڈنگ	ɪlɪɖɪŋ
بلڈوزر	ɪɾbalɖuːzər
بلک	bɪlək
بلکل	bɪlkəl
بلکہ	bəlkə
بلی	beli
بلین	beːlɪn
بلیو	beːloː
بلیوں	beːljʊ̃
بلیڈ	bleːɽ
بلیڈز	bleɪd̪z
بلیک	beːlɪk
بلیکمیل	beːlɪkmɪl
بلے	beːlə
بم	ɓm
بمبار	ɓʊmˈbɑːr
بمباری	ɓʊmbɑːriː
بمشکل	beːmɪʃkəl
بمقابلہ	ɓəmkɑːˈɾelɑ
بموں	ɓəmoːn
بن	beːn
بنا	benɑː
بناء	beːnɑː
بناؤ	beːnɑːo
بناؤں	benɑõ
بنائی	beːnɑːiː
بنائیں	bənɑ̃eː
بنائے	benɑːje
بناتا	beːnɑːtɑː
بناتی	beːnɑːtiː
بناتے	benɑːte
بنارہے	bənɑːɽɛː
بنالوں	benɑːloːŋ
بنانا	ɪnɑːnɑː
بنانے	ɓənɑːne
بناو	benɑːu
بناوٹ	bənɔːt
بنایا	bənɑːjɑː
بنایاگیا	benɑjɑːgiːə
بنتی	beːntiː
بنتے	beːnte
بنجر	beːŋgər
بنجمن	beɲgemən
بند	beːnd
بندا	beːnd̪ə
بندر	beːnd̪əɾ
بندروں	ɑ̃d̪roːn
بندرگاہ	ˈbəndəɾgɑː
بندش	beːnd̪ʃ
بندوا	beːnd̪ʋɑː
بندوبست	beːndʊbʌst
بندوق	ɓɑndɔx
بندوقوں	ɓənd̪oːkʰõː
بندوقین	ɓəndɔxɪn
بندوقیں	ɓənd̪oːkʰeːn
بندوں	beːnd̪oːn
بندھن	beːnd̪ʱə
بندھے	beːnd̪ʱeː
بندہ	beːnd̪ə
بندی	beːndi
بندے	beːnd̪eː
بننا	beːnə
بننے	ɓənneː
بنو	beːnuː
بنکاک	beːnkeːk
بنکر	beːŋkəɾ
بنکروں	ˈbæŋkəroː
بنگلہ	beːŋglə
بنگو	beːŋgoː
بنی	beːniː
بنیاد	beːnɑːjɑːd
بنیادی	beːniːɑːdiː
بنیامین	beːnjɑːmiːn
بنیان	beːnijɑːn
بنے	beːnɛ
به	beː
بوائے	bojə
بوب	boːb
بوتل	boːt̪əl
بوتھ	boːt̪ʰ
بوتے	boːt̪eː
بوجھ	boʊdʒʰ
بور	boːr
بورا	boːrɑː
بورنگ	boːrɪŋ
بورڈ	boːɾɖ
بورڈنگ	boːrd̪ɪŋ
بوری	boːriː
بوز	boːz
بوسٹن	boːst̪ən
بوسہ	boːsə
بوسے	boːse
بوقتِ	beːqʊt̪i
بول	boːl
بولا	boːlə
بولتا	boːlt̪ə
بولتے	boːlte
بولشوئی	boːlʃɛɪ
بولنا	boːlnɑ
بولنے	boːlnɛ
بولنےوالی	boːlnɛʋɑːliː
بولو	boːloː
بولوں	boːluːn
بولٹ	boːlʈ
بولٹن	boːlʈən
بولڈ	boːlɖ
بولی	boːli
بولیویا	boːliːviːə
بولیں	boːlɪ̃
بولے	boːlɛ
بوم	boːm
بوند	boːnd
بونڈ	boːnɖ
بونی	boːniː
بونے	boːne
بوٹ	boːt̪
بوڑھا	boːɽʱə
بوڑھے	boːɽʱe
بوکاریسٹ	boːkɑːrɪst̪
بوگی	boːgi
بویریا	bojrijɑ
بيزار	biːzɑːr
بٌ	ʔ
بُجھایا	bugʲʰɑjɑ
بُرج	buːrɪdʒ
بُو	boː
بِس	biːs
بِھیڑ	biːɖə
بْتوں	ɪt̪ʊ̃
بْرا	ɪ
بْزرگ	bezɾeg
بْزْرگ	beːzərg
بٹ	ɪt̪
بٹا	ɑt̪t̪ɑ
بٹالینوں	ɑːt̪ɑːlɪnõː
بٹس	ɑːt̪s
بٹن	ɓʊʈːən
بٹوے	ɓʊʈʊe
بپتسما	beːpt̪səma
بپتسمہ	beːpt̪səme
بچ	ɓɪtʃ
بچا	ɓətʃɑ
بچاؤ	betʃɑːo
بچائی	ɓəˈtʃɑːi
بچائیں	betʃɑːeːn
بچائے	ɪt̪seː
بچاتا	betʃɑːt̪ɑː
بچالو	betʃɑːloː
بچانا	ɓəˈtʃɑːnɑ
بچانے	ɓəʈʌne
بچاو	betʃɑːʊ
بچایا	ɓəˈtʃɑːjɑː
بچت	ɓɪt̪t̪
بچتا	ɓɪtʃt̪ə
بچنا	ɪt̪s
بچنے	ɓəʈne
بچو	ɓəˈtʃoː
بچوں	ɓəˈtʃoːn
بچپن	beʈpən
بچھانے	ɓɪtʃʰɑːne
بچھے	ɓɪtʃʰeː
بچہ	bətʃtʃɑː
بچہ	ɓəˈtʃʰə
بچی	betʃiː
بچے	ɓəˈtʃeː
بڈھا	ɓʊɖʰɑː
بڈھے	ɓʊɽʰe
بڈی	beːdiː
بڑ	ɓəɽ
بڑا	ɓəɽɑ
بڑوں	ɓəɽoːn
بڑپپن	ɓəɽpːən
بڑھ	ɓəɽʱ
بڑھا	ɓəɽʱə
بڑھائے	ɓəɽʱɑːe
بڑھاتا	ɓəɽʱət̪a
بڑھانے	ɓəɽʰɑːne
بڑھاپے	ɓəɽʱɑːpeː
بڑھتا	ɓəɽʈʰə
بڑھتی	ɓəɽʰt̪iː
بڑھتے	ɓəɽʱte
بڑھنے	ɓəɽʱne
بڑھو	ɓəɽʰoː
بڑھی	ɓəɽʱiː
بڑھیا	ɓəɽʰiːə
بڑھیں	ɓəɽʰẽː
بڑھے	ɓəɽʱe
بڑی	ɓəɽiː
بڑے	ɓəɽe
بک	beːk
بکا	bekɑː
بکاؤ	bekɑːu
بکارا	beːkɑːrɑː
بکاراٹ	bekɑːɾɑːt
بکتر	beːkt̪eːr
بکتے	beːkt̪eː
بکرا	bekɾɑ
بکری	bekri
بکس	beːks
بکسوا	beːksʋɑː
بکواس	beːkoːs
بکھر	ɓʊkʰəɾ
بکھیڑے	beːkʰɪəɽeː
بکی	beki
بگ	beg
بگاڑ	begɑːr
بگاڑلو	begɑːɽloː
بگرام	beːgəɾɑːm
بگولے	beːgoːle
بگڑتے	begəɽte
بھئی	biː
بھائی	bʱɑi
بھائی	bʱɑːi
بھائیو	βʱɑiːo
بھائیوں	bʱɑijõː
بھاری	ɓʱɑːrɪ
بھال	ɦɑːl
بھانجا	bʱɑːɲgɑː
بھاپ	ɓʱɑːp
بھاڑ	baːɽ
بھاگ	bʱɑːg
بھاگا	ɦɑːgɑː
بھاگتا	ɦɑːgt̪ə
بھاگنے	ɦɑːgne
بھاگو	ɦɑːgoː
بھاگے	bʱɑːge
بھتیجا	βʱʈɪdʒə
بھتیجے	βʱt̪ɪdʒeː
بھر	bʱəɾ
بھرا	ɓʱəɾə
بھرتی	ɓʱəɾt̪iː
بھرنے	ɓʱəɾne
بھرو	ɦɪɾoː
بھروسا	ɦroːsɑ
بھروسہ	ɦroːsə
بھری	ɦɾiː
بھریں	ɦɾeː
بھرے	ɦʊɾe
بھلا	βʱələ
بھلائی	ɪ̆ɪ̆lɑ̆ĭ
بھلایا	ɓʱəlɑːjɑː
بھلہ	ɪɪ̯lɑ
بھنی	ɓʱiː
بھوت	βʊt̪
بھوتوں	βʊtõː
بھوری	ɦoːriː
بھول	ɦoːl
بھولا	ɦuːlə
بھولنا	ɦoːlnə
بھولو	βʊlo
بھولی	ɓʰoːliː
بھولیں	ɓʰoːlẽː
بھونچال	βʊ̃ːnʧɑːl
بھوک	ɓʰoːk
بھوکا	boːkə
بھوکمپ	ɦoːkəmp
بھوکمپیی	βʊkmpiː
بھوکے	ɦoːke
بھٹک	ɦɪʈk
بھٹکا	ɦɪʈkə
بھٹکاتے	ɦɪʈkɑːte
بھکاری	ɦəkaːɾiː
بھگاؤ	ɦəgɑːo
بھگت	ɦəgʈ
بھگتنا	ɦəgt̪nə
بھگتے	ɦəgte
بھگوان	ɦəgʋɑːn
بھی	bi
بھیانک	bijɑ̃k
بھیج	big
بھیجا	bidʒɑ
بھیجتا	bigt̪ə
بھیجنا	bignə
بھیجنے	bidʒənɛ
بھیجو	bigo
بھیجی	bidʒiː
بھیجیں	bidʒeːn
بھیجے	bidʒeː
بھیس	biːs
بھیڑ	biːɽ
بھیڑیا	biɽja
بھیڑیوں	biʁɽijõː
بھیک	biːk
بھیگ	big
بہ	be
بہüءِ	beːɪ
بہüاد	beːɑːd
بہüادءز	beːɑːd̪z
بہüادءِ	beːɑːd̪eː
بہüاط	beːɣɑːt̪
بہüہ	beːh
بہا	beɑ
بہاتے	beːɑːteː
بہادر	beːɑːd̪əɾ
بہادری	beːɑːd̪riː
بہار	beːɑr
بہانا	beːɑːnɑː
بہانہ	beːɑːnə
بہانے	beːɑːne
بہاو	beːɑːu
بہایا	beːɑːjɑː
بہبود	beːɦoːd̪
بہت	beːt̪
بہتر	beːt̪ər
بہتری	beːt̪ri
بہترین	beːt̪ʃiːn
بہتی	beːt̪iː
بہج	beːʐ
بہر	beːr
بہرحال	beːrɑːɦɑːl
بہرے	beːɾeː
بہشت	beːʃt̪
بہشت	bəɦɪʃt̪
بہف	beːf
بہن	beːn
بہن	bɛɦən
بہن	bɛɦɛn
بہن	bʱɛːn
بہنا	bɛɦnäː
بہنوں	beːnõː
بہنے	beːne
بہکا	beːkə
بہہ	beː
بہی	beː
بہے	beː
بی	biː
بیئر	biːr
بیاسی	biːɑːsiː
بیان	bijɑn
بیانات	bijaːnaːt
بیاہتا	biɑːɦt̪ɑː
بیب	biːb
بیبسی	biːbəsi
بیبی	biːbiː
بیت	beːt
بیتھوون	biːt̪ʰoːn
بیج	biːdʒ
بیجنگ	beːdʒeŋ
بیجوں	beːdʒoːn
بیر	beːr
بیرل	beɪrəl
بیرنگ	biːrŋ
بیروت	biːruːt
بیرون	biːron
بیرونی	biːroːniː
بیرکوں	beːrkoːn
بیس	beːs
بیساکھیوں	beːsaːkʰiːõː
بیسد	beːsɪd
بیسمیںٹ	beːsmeːŋʈ
بیشک	biːʃk
بیضوی	beːɖʋiː
بیعانہ	biːʔɑːnə
بیل	biːl
بیلجئیم	beːlgeːm
بیلجیم	beɪlgiːm
بیلون	biːlʊn
بیلٹ	beɪl̪t̪
بیلچے	biːlʧeː
بیم	biːm
بیمار	biːmɑːr
بیماری	biːmɑːriː
بیماریوں	biːmɑːrijõː
بیمہ	biːmə
بین	beːn
بینڈ	beːnd
بینڈیج	beːnd̪iːdʒ
بینک	beːŋk
بینکاروں	biːnkɑːroːŋ
بینکر	beːnkəɾ
بینکرز	beːnkəɾz
بینگ	beːŋ
بینی	bini
بینیتو	biːniːtoː
بیوقوف	biːugof
بیونس	biːɔːns
بیوپاری	biːʋɑːɾiː
بیوکوف	biːjɔːf
بیوکوفی	biːjoːfoː
بیوہ	biːwa
بیوی	biːwiː
بیویاں	biːʋiɑ̃
بیویوں	biːʋijõː
بیٹ	beːt̪
بیٹا	beːʈə
بیٹری	biːtɾiː
بیٹریاں	biːt̪rijɑ̃
بیٹس	beːts
بیٹوں	beːʈoː
بیٹھ	beːʈʰ
بیٹھا	beːʈʰɑː
بیٹھتا	beːʈʈə
بیٹھنا	beːʈʰnɑ
بیٹھنے	beːʈne
بیٹھو	beːʈʰo
بیٹھی	beːʈʰiː
بیٹھیں	beːʈʰẽː
بیٹھے	beːʈʰe
بیٹی	beːti
بیٹیاں	beːt̪ijɑ̃
بیٹے	beːʈe
بیپ	biːp
بیپر	biːpər
بیپرواہ	biːpɾoʌɦ
بیچ	biːtʃ
بیچا	biːtʃɑː
بیچارا	biːtʃɑːrɑː
بیچاری	biːtʃɑːriː
بیچتا	beːtʃt̪ɑː
بیچلر	biːtʃələr
بیچنے	biːtʃne
بیچوں	biːtʃõː
بیچینی	biːtʃiːniː
بیڈروم	beːɽroːm
بیڑے	biːɽe
بیک	beːk
بیکابو	beːkɑːboː
بیکار	beːkɑr
بیکر	beːkər
بیکس	beːks
بیکن	beːkən
بیگ	beːg
بیگانے	biːgɑːneː
بیںچنا	beːnʧnə
بیہوش	biːɔːʃ
بے	beː
بےحوش	beːɦoːʃ
بےمعنیٰ	beːmæʋiːnɑː
بےوقوف	beːoquf
بےوقوفی	beːoquːfiː
بےکار	beːkɑːr
بےہوشی	bejoːʃi
ةء	ə
ةءِ	ə
ةاد	ɑːd
ةادءِ	ɑːdɑː
ةاز	ɑz
ةاط	ɑːt̪
ةہ	ə
ةہج	ɛg
ت	t
تµµ	teːm
تءِ	te
تأ	tɑ
تئیس	teːs
تا	tɑ
تاؤ	tɔː
تائید	tɑːʔiːd
تاب	tɑːb
تابوت	t̪ɑːboːt̪
تاثر	t̪ɑːt̪ʰər
تاج	tɑːdʒ
تاجدار	tɑːdʒd̪ɑːr
تاخیر	tɑːxɪr
تار	t̪ɑːr
تارکین	tɑːɾkɪn
تاریخ	t̪aːɾiːx
تاریخ	t̪ɑːɾɪx
تاریخی	t̪ɑːɾɪχɪ
تاریک	tɑːɾɪk
تازہ	taːze
تازی	tɑːzi
تازے	taːze
تاش	t̪ɑʃ
تال	t̪ɑːl
تالا	t̪ɑːlɑː
تالاب	t̪ɑːlɑːb
تالے	t̪ɑːl̪eː
تان	t̪ɑːn
تاوان	tɑːʋɑːn
تاکنا	tɑknɑ
تاکہ	tɑːkʰə
تاہم	tɑːhəm
تب	t̪eːb
تبادلوں	t̪əbɑːd̪ɪluːŋ
تبادلہ	t̪eːbɑːd̪ɪlə
تبادلے	t̪eːbɑːd̪ɪleː
تباہ	t̪əbɑːh
تباہی	t̪əbaːhi
تبدیل	t̪eːbd̪ɪl
تبدیلی	təbdɪliː
تبدیلیوں	t̪eːbd̪ɪliːjõː
تبصرہ	t̪eːbəsɾə
تبولی	t̪eːboːli
تجارت	tʌdʒɑːɾət
تجارتی	teːʒɑːɾeːtiː
تجاست	teːgɑːst
تجاوز	tejɑːgɑːz
تجاویز	teːgɑːʋiːz
تجدید	tegdiːd
تجربات	tegɾɑbɑt
تجرباتی	tʌʐrəbɑːtiː
تجربہ	tʌʐrəbɑ
تجربے	tʌʐɾəbɛ
تجزیہ	təʒziʌ
تجسس	tʌges
تجوری	teːguːriː
تجویز	tegoːiz
تجھ	teʒ
تجھے	teʒʰe
تحائف	t̪əɦɑːɪf
تحت	t̪əŋ
تحریر	t̪əɾiːr
تحریری	təɦɾiːɾiː
تحریک	t̪əɦɾiːk
تحریک	t̪ɛɦɾiːk
تحفظ	t̪əɦfɑz
تحفہ	t̪ʊhfɑː
تحفہ	t̪ʊhfə
تحفہ	θɑhfɑ
تحفے	t̪əɦfe
تحقیق	t̪əɣɪq
تحقیقات	t̪əɣqɪqɑːt̪
تحلیل	təɦniːl
تحول	t̪əɦuːl
تحویل	t̪əɦʋiːl
تخبوہیتا	təxbuːhiːtə
تخت	təxt
تختہ	təxtə
تخروپن	təxɾoːpən
تخرکشک	tɑxɾɪkɛʃk
تخلص	tʌlɪʃ
تخلیق	təxliːq
تخکرمن	t̪əxkərmən
تخیل	təxɪl
تدریس	tɪdrɪs
تدفین	tɪd̪fiːn
تدویر	teːd̪viːr
تدویروں	tɪdʋɪɾoː
تذکرے	teðkɪre
تر	tɪr
تربیت	t̪eɾbiːt̪
تربیتی	t̪əɾbiːtiː
ترتیب	tɪɾtɪb
ترجمان	t̪eɾʒʊˈmɑːn
ترجمہ	t̪əɾʒʊmə
ترجمے	t̪əɾdʒʊmeː
ترجیح	t̪əɾziːh
ترجیحا	t̪əɾziɦɑ
ترجیحات	təɾʒiːhɑːt̪
ترس	t̪əɾs
ترسی	t̪eɾsi
ترسیل	t̪əɾsiːl
ترقی	t̪əɾqi
ترمیم	tɪɾmiːm
ترک	t̪əɾk
ترکون	t̪əɾkoːn
ترکوں	t̪əɾkõː
ترکی	t̪eɾki
ترکیبی	t̪eːɾkiːbiː
ترین	t̪eːriːn
تزئین	teːzæːin
تسبیح	tsæbʰiː
تسلسل	t̪əseleːs
تسلی	tsɪli
تسلیم	tsɪliːm
تسمہ	tsəma
تشخیص	tɪʃhɪd̪ɪs
تشدد	tʃʰeːd̪ː
تشریح	tʃʰeːriːɦ
تشریف	tʃəɾiːf
تشویش	tʃoʊʃ
تشکیل	tʃʰeːkɪl
تصادم	təsɑːd̪əm
تصاویر	t̪əsaːʋiːr
تصدیق	t̪əsdeːq
تصور	təsaːr
تصویر	t̪əswiːɾ
تصویر	t̪əˈsˈuːɾ
تعارف	teːɑːɾiːf
تعاقب	tɑʕɑqː
تعالی	teːʋɑːliː
تعاملات	teːʕɑːmɑːlɑːt
تعاون	tɑːʕɑːwɑːn
تعجب	tɑˈɣːab
تعداد	teːdɑːbɑːr
تعدد	tedul
تعریف	tɑːrɪfɪ
تعزیتی	teːziːtiː
تعطل	teˈʋal
تعلق	teːlaːq
تعلق	t̪əllək
تعلقات	teːlaːqɑːt
تعلیم	teːlɪm
تعلیم	t̪ɑːliːm
تعمیر	teːmɪr
تعمیرات	teʕmiːrɑːt
تعمیراتی	teːmɪraːtiː
تعمیرکرکے	teːmɪrkɾeːkʰeː
تعمیل	teːmɪl
تعویذ	t̪ɑːʋiːð
تعین	teːˈɪn
تعینات	teːʋiːnɑːt
تعیناتی	t̪ɛːnɑːt̪iː
تفتشی	t̪ʊft̪ʃiː
تفتشیش	t̪ʊft̪ʃiːʃ
تفتیش	t̪eːft̪iːʃ
تفتیشی	t̪eːft̪iːʃiː
تفریح	t̪əfɾiːh
تفریحی	t̪əfeːɾɪhɪ
تفصیل	t̪əfɪsɪl
تفصیلات	t̪əfɪsɪlɑːt̪
تفصیلی	t̪əfɪsɪliː
تفویض	t̪əfoːʋɪd̪
تفہیم	t̪əfeːɦiːm
تقاضہ	t̪əqɑːdʒə
تقدیر	ʈʊqɪɾ
تقرر	tɪqɾɾ
تقریب	tɪqriːb
تقریبا	t̪əqɾiːbɑ
تقریبات	t̪əqɾiːbɑːt̪
تقریباً	tɪqriːbɑːn
تقریر	t̪eːqɾiːɾ
تقسیم	t̪əqɪziːm
تقصانات	teqsɑnɑːt̪
تقطیع	təqtiːʕ
تلاش	t̪əˈlɑːʃ
تلاشی	t̪əlaːʃiː
تلاشیاں	t̪əlaːʃjɑ̃
تلافی	teːlafɪ
تلاوت	t̪əlaːʊt̪
تلخ	t̪əlx
تلفظ	t̪əɭfɪz
تلنگانہ	t̪ɪləŋgɑːna
تلوار	t̪əlʋɑːr
تلواروں	t̪əloːɾɑ̃ː
تلواریں	t̪əloːəɾĩː
تلی	t̪eːliː
تم	t̪eːm
تمارا	t̪əˈmɑːrɑː
تماشا	t̪əmaːʃɑː
تمام	t̪æmɑːm
تمباکو	t̪əmbɑːkoː
تمغہ	t̪əmɣɑ
تمنا	t̪əmnɑ
تمھیں	tə̃meːŋ
تمہارا	t̪əmaːɾə
تمہاراتعلق	t̪əmaːɾaːt̪əɾəlɑq
تمہاری	t̪əmaːɾiː
تمہارے	t̪əmaːɾe
تمہورے	t̪əmoːɾe
تمہيں	t̪eːmɛ̃
تمہیں	t̪əmeːŋ
تمیز	t̪eːmiːz
تن	t̪ən
تناؤ	t̪ənaʊ̯
تنازعات	t̪ənaːzæˈʋæt̪
تنازعہ	t̪ənaːzeʋə
تناسْب	t̪ənaːsb
تناظر	t̪əˈnɑːzər
تنبیہہ	t̪ənbeːɦɑː
تنخواہ	t̪əŋkʰɑː
تنزل	t̪ənzel
تنزیہ	t̪ənziːɑ̃
تنصیب	t̪ənsɪb
تنظیم	t̪əneːdʒ
تنظیموں	t̪əneːdʒiːũ
تنظیمِ	t̪əneːʒiː
تنقید	t̪əŋgiːd̪
تنگ	t̪eŋ
تنگاوالا	t̪eŋgɑːʋɑːlə
تنہا	tənaː
تنہائی	t̪ənaːɪ
تنے	t̪əneː
تو	toː
توازن	ʈoːæzæn
توانائی	ʈʋɑːnɑːiː
توبہ	t̪oːbʱə
توثیقی	ʈoːθɪqiː
توجہ	toːgʌ
تورا	t̪oːrɑː
تورات	t̪oːɾɑːt̪
توری	t̪oːɾiː
توسیع	teːsuːsiːʔ
توقع	tɑːʋɑːjæ
توقف	tʊqˈfɑː
تول	t̪oːl
تولیدی	t̪oːliːdi
تولیہ	t̪oːliːɑː
تولیے	t̪oːliːe
تومعلوم	t̪oːmoːzɑːm
تومیں	t̪oːmẽː
تونہیں	t̪oːnʱẽː
تونے	t̪oːn̪e
توپ	ʈoːp
توپاک	t̪oːpɑk
توڑ	t̪oːɽ
توڑا	t̪oːɽɑː
توڑنا	t̪oːɽnɑː
توڑنے	ʈoːɽneː
توڑو	t̪oːɽoː
توک	t̪oːk
توکیا	t̪oːki̯ɑː
توگئے	t̪oːgeː
توہین	toːhɪn
تُبّع	tʊbˤb
تٹرکشک	t̪eːt̪əɾkɪʃk
تپتے	tept̪e
تپپڑ	teppəɽ
تک	t̪ek
تکالیف	t̪əkaːliːf
تکان	t̪əkaːn
تکبر	tegbeɾ
تکلفی	t̪ekl̪fi
تکلیف	t̪ekliːf
تکلیفیں	t̪ekliːfɛ̃
تکمیل	t̪əkmɪl
تکنیکی	t̪ekniːkiː
تکور	t̪əkuːr
تکڑے	təkɽe
تکی	t̪eːkiː
تھا	θɑː
تھام	θɑːm
تھامس	θɑːməs
تھاموں	θɑːmoːn
تھاپ	θɑːp
تھرتھری	θɪɾθɪɾi
تھرمل	θɛrml
تھرمین	θɛrmiːn
تھرو	θəro
تھرٹی	θʌrtiː
تھریڈنگ	θɪɾɪɖəŋ
تھلگ	θəlg
تھنڈر	θənd̪r
تھوڑا	θoɽɑ
تھوڑی	θoːɽi
تھوڑے	θoɽe
تھوکتا	θoːkəta
تھوکتے	θoːkʈe
تھپتھپائیں	θəpθəpɑ̃
تھک	θək
تھکا	θəkɑ
تھکائیں	θəkɑːẽ
تھکانے	θʊkɑːnɛ
تھکاوٹ	θəkɑːʋt̪
تھکن	θɪkən
تھکی	θəki
تھکے	θeːkə
تھی	θeː
تھیئٹر	θeːʔt̪r̪
تھیلے	θɪleː
تھیورو	θeːro
تھیٹر	θeːʈʌr
تھیں	θeːn
تھے	θeː
تہ	t̪eː
تہا	t̪ɑː
تہائی	teːhɑiː
تہارا	teːɾɑː
تہارے	teːɑːɾeː
تہخµ	teːxʊ
تہذیب	teːhziːb
تہذیبیں	teːʔziːbɪ̃ː
تہران	t̪ɛɦɾɑːn
تہمینہ	teːmɪnə
تہوار	teːɦɑːr
تہوار	t̪eɦʋɑːɾ
تہھانے	teːhɑːneː
تہہ	t̪eːh
تہیں	teː
تیار	t̪iːəɾ
تیار-کھانے	t̪iːəɾkʰɑːne
تیاری	t̪iːɑːɾiː
تیج	t̪iːdʒ
تیر	t̪iːr
تیرا	teːrɑː
تیری	t̪iːriː
تیرے	teːre
تیز	tiːz
تیزی	t̪iːziː
تیس	t̪iːs
تیسرا	teːsəɾɑ
تیسری	teːsriː
تیسرے	t̪iːsəɾe
تیل	t̪iːl
تیلا	tɪlə
تیمتیس	teːmtiːs
تیمور	teːmoːr
تین	tin
تینوں	t̪iːnuː
تے	te
ث	θ
ثءز	θeːz
ثءِ	θeː
ثؤ	θoʊ
ثإُ	θɛu
ثابت	θɑːbɪt
ثانی	θɑːniː
ثبوت	θəboːt
ثقافت	θɑqɑft
ثقافتی	θɪkɑːftiː
ثمود	θʊmʊd
ثواب	θʊˈβɑː
ثيودوسيوس	θeːoːd̪oːsiːoːs
ثہ	θɛ
ج	dʒ
جأئ	gɑː
جؤ	dʒoʊ
جا	gɑ
جاû	gɑu
جاؤ	dʒɔː
جاؤنگا	dʒɑʊ̯ŋɑ
جاؤں	ɟɑũ
جائز	gɑːɪz
جائزوں	ʒɑːɪzʊ̃ː
جائزہ	ʒɑːɪzah
جائيں	gɑːjẽː
جائیداد	gɑːʔɪdɑːd
جائیدادوں	gɑːiːd̪ɑːd̪õː
جائینگے	gɑːiŋeː
جائیں	gɑẽː
جائے	gɑːjeː
جاب	gɑːb
جات	gɑt̪
جاتا	gɑt̪ɑ
جاتاہے	gɑt̪ɑhɛ
جاتی	gɑt̪iː
جاتے	gɑːt̪eː
جادو	ʒɑːd̪uː
جادوگر	ʒɑːd̪oːgəɾ
جادوگرنی	ʒɑːd̪oːgəɾniː
جاذب	gɑːðb
جارج	gɑːɾʒ
جارحانہ	gɑːɾɑːɦɑːnə
جارحیت	gɑːɾɪhɪt̪
جارڈ	gɑːɾɖ
جارہا	gɑːrɑːhɑː
جارہاہوں	gɑːɾɑːɦɑ̃ː
جارہی	gɑːɾɑːɪ
جارہے	gɑːɾɑːe
جاری	gɑːɾiː
جاز	gɑz
جاسوس	dʒɑːsʊs
جاسوسی	dʒɑːsʊsiː
جاسکتا	dʒɑːsʋɑːt̪ɑː
جاسکتی	dʒɑːskʌtti
جاسکتیں	dʒɑːskʈeːŋ
جاسکتے	dʒɑskʌt̪eː
جام	dʒɑːm
جامد	gɑːməd
جامنی	gɑːmniː
جان	dʒɑːn
جانا	dʒɑːnɑː
جانب	ʒæŋg
جانباز	ʒɑŋbɑz
جانبدار	dʒɑːnbəˈd̪ɑːr
جانتا	gɑnt̪ɑ
جانتی	dʒɑːnt̪iː
جانتیں	dʒɑːnt̪ɪ̃
جانتے	gɑːnt̪eː
جانسن	dʒɑːns̪n̪
جاننا	dʒɑːnnɑː
جاننے	dʒɑnne
جانور	dʒɑːnʊr
جانوروں	dʒɑːnʊroːŋ
جانوں	dʒɑːnõː
جانِ	dʒɑːn
جانچ	dʒɑːntʃʰ
جانی	dʒɑːniː
جانیں	dʒɑːniː
جانے	dʒɑːne
جانے-چلو	dʒɑːneːtʃʰloː
جانےوالا	dʒɑːnweːlɑː
جاو	gɑu
جاواور	gɑːwɑːr
جاوگی	gɑugi
جاوں	gɑ̃ː
جاپان	dʒɑːpɑːn
جاپانی	ʒɑpɑniː
جاکر	dʒɑkər
جاگ	gɑːg
جاگتے	gɑːgte
جاگنا	gɑːgnɑː
جاگو	gɑːgʊ
جاگی	gɑːgi
جاگیر	gɑːgeːr
جاگیردار	gɑːjɪrdaːr
جاںگھیا	gɑ̃ːŋgʰɪ́ə
جاہ	gɑː
جاہتی	gɑːɦt̪iː
جاہل	gɑːɦɪl
جاہیں	gɑːhɛ̃ː
جایئے	gɑːjeː
جایا	gɑjɑ
جب	gʌb
جبت	gəbʈ
جبر	gʊbər
جبرائیل	gəbɾɑːɪl
جبلت	gəblət
جبڑوں	gəbɽə̃ː
جبڑے	gəbɽe
جبکہ	gʊbkʰɑ
جتا	dʒʈɑ
جتاؤں	gʌtɑ̃u̯
جتنا	gʌt̪nɑ
جتنی	gʌt̪niː
جتنے	gʊt̪ne
جتھا	gʌt̪ʰɑː
جج	gʊ
ججوں	gʊdʒoːn
جدوجہد	gʌd̪oɣʌd̪
جدید	gʌˈdiːd
جذب	gɑdʒb
جذبات	gʌd̪ˈbɑːt̪
جذباتی	gʌðˈbɑːtiː
جذبہ	gɑdʒbʌ
جذبے	gɑd̪bʱeː
جرائم	gɾɑːjɑːm
جراب	gɪɾɑːb
جرات	gɪɾɑːt
جراتمند	gɪɾɑːt̪mʌnd̪
جرسی	gʌɾsi
جرم	gɪɾm
جرمن	gɾeːmən
جرمنوں	gɾəmeːn
جرمنی	gɾəmeːni
جرمی	gʌɾmi
جرک	gɪɾk
جزائر	gʊzɑːɪr
جزوی	gʊzviː
جزیرہ	gʊzɪrə
جزیرے	gʊzɪreː
جس	dʒəs
جسم	dʒɪsm
جسمانی	dʒɪsmaːniː
جسموں	dʒɪsmoːn
جسٹس	gɑsˈtis
جسٹن	gɪsˈt̪ən
جسکا	gʊska
جسکے	dʒɪskeː
جسے	dʒʰeːsɛ
جشن	dʒɪʃn
جعل	gæml
جعلی	gɑlɪ
جل	gəl
جلا	dʒələ
جلاد	gəlɑːd
جلادیا	gəlɑːdiɑː
جلال	gʌlɑl
جلانے	gʌlɑːne
جلاوطن	dʒəlɑʊ̯t̪n
جلاوطنی	dʒɑlɑʊ̯t̪ːniː
جلتا	gʌlt̪ɑ
جلتی	gəlt̪iː
جلد	gəld̪ə
جلدی	gʌld̪iː
جلسے	gʌlsɛ
جللاد	gəlˈlɑːd
جلن	gələn
جلنے	gəlne
جلو	gʌlo
جلوگی	gʌlɔgi
جلّاد	gəlːɑːd
جلے	gʌlɛ
جم	dʒʌm
جمائیکا	dʒʌmɑːɪkɑː
جماتی	dʒʌmɑːt̪i
جماعت	dʒʌmaːʔat
جمالیاتی	dʒʌmɑːliːt̪iː
جمع	dʒʌm
جمعرات	dʒʊmeɾɑːt̪
جمعرات	dʒʌməɾɑːt
جمعہ	dʒʌmbɑ
جمعے	ʒʌmɛ
جملہ	dʒʊmlɑ
جمنا-o	dʒʌmnɑː
جمود	dʒʌmoːd
جمپنگ	dʒʌmpəŋ
جمہوری	dʒʌmɦuːriː
جمہوریت	dʒʌmɦʊɾiːt
جمہوریہ	dʒʌmɦuːɾijɑː
جن	dʒɪn
جناب	dʒənɑːb
جنات	dʒʊˈnɑːt
جنازوں	dʒənɑːzoːn
جنازہ	dʒənɑːzə
جنازے	dʒənɑːze
جنت	dʒent̪
جنرل	dʒənɾəl
جنریٹر	dʒənriːt̪ər
جنریٹرز	dʒənriːt̪ərz̪
جنس	dʒɪns
جنسی	dʒənsi
جنم	dʒənm
جنوب	dʒʊˈnoːb
جنوبی	dʒʊˈniːbi
جنوری	dʒʊˈniːri
جنگ	dʒəŋ
جنگجو	dʒəŋgdʒoː
جنگجوؤں	dʒəŋgɑːʊ̃
جنگل	dʒəŋgəl
جنگلی	dʒəŋgli
جنگوں	dʒəŋgoːŋ
جنگی	dʒəŋgiː
جنگیں	dʒəŋeː
جنھیں	gʌnheː
جنہوں	dʒənɦoːn
جنہيں	dʒənɦɛ̃
جنہیں	dʒəneː
جنیوا	dʒiniwɑ
جو	gʊ
جوئی	gʊi
جوا	gʋɑ
جوا-tare	gʋɑːt̪əɾe
جواب	dʒəʋɑːb
جواب	gʊɑːb
جوابات	gʊwɑːbɑːt̪
جوابدہ	gʊɑːbɪd̪ʰɑː
جوابی	ɟʊɑːbiː
جواز	dʒəwɑːz
جواز	gʊɑːz
جوان	gʋɑːn
جوانوں	dʒʋɑːnõː
جوانی	gʊˈɑːni
جواگر	gʊɑːgəɾ
جواہرات	gʋɑːɦɾɑːt̪
جوتا	goːt̪ə
جوتوں	gʊt̪oːŋ
جوتے	goːt̪eː
جورن	goːɾn
جوری	gʊri
جوزف	gʊdʒʊsfe
جوزفین	gʊzfəɪn
جوش	goʃ
جولائی	guːlɑːiː
جولی	gʊliː
جولیا	gʊlijɑ
جون	dʒuːn
جوناتھن	dʒoːnɑːt̪ʰən
جونک	gʊng
جونیئر	gʊniːr
جوڑا	gʊɽɑː
جوڑتوڑ	ɟoɽtoɽ
جوڑی	gʊɽiː
جوڑے	gʊɽe
جوکر	goːkəɾ
جوکہ	dʒoːkə
جوہان	gʊhɑːn
جوہانا	ɟoːɦɑːnɑː
جوہانس	goʊhɑːns
جوہر	gʊɦɾ
جوہری	goːɦriː
جَلنے	ʒəlne
جڑ	gɑɽ
جڑیں	gəɽeːn
جڑے	gɑɽe
جکڑ	dʒəgəɽ
جکڑا	gʌkɽɑ
جگ	gʊ
جگائے	gʊgɑːe
جگہ	gʊgʌ
جگہوں	gʊgʰɑ̃
جگہیں	gʊgʰeːn
جھاڑ	gʱɑːɽ
جھاڑو	dʒʰɑːɽo
جھاڑیوں	gʲʰɑːɽiːõː
جھاگ	ɟʰɑːg
جھجھک	dʒʰdʒʰk
جھلس	ɟʰəls
جھلک	ɟʰəlk
جھنڈا	dʒʰənɖɑː
جھنڈوں	dʒʰənɖõː
جھنڈے	dʒʰənɖeː
جھولی	dʒʰoːliː
جھونپڑی	gʱoːnpɽiː
جھونک	ɟʰoːŋk
جھوٹ	dʒʱuːʈ
جھوٹ	ɟʱoːʈ
جھوٹا	ɟʰoːʈə
جھوٹوں	ɟʰoːʈõː
جھوٹی	ɟʰoːʈiː
جھوٹے	ɟʰoːʈe
جھٹ	ɟʱʈ
جھٹلا	gʲʰʈəlɑ
جھٹلایا	dʒʰʈʰlɑːjɑː
جھٹکا	dʒʱəʈkə
جھٹکوں	dʒʱʈʊkõː
جھٹکے	gʌʈkeː
جھپٹا	ɟʰəpʈɑ
جھکا	gʲʈəka
جھکاو	ɟʱəkaːʋ
جھکتا	dʒʰʈkəʈə
جھکی	dʒʰki
جھگڑا	gʌɽɑ
جھگڑے	dʒʰəgəɽe
جھیل	dʒʱeːl
جہïہجµé	dʒəɦɛɦɑdʒ
جہاد	ɟəɦɑːd
جہاز	dʒɑːhɑːz
جہازوں	dʒɑːhɑːzoːn
جہالت	dʒɑːɦɑːlt
جہاندیدہ	dʒɑːhɑːnd̪ɪd̪ɑː
جہانوں	dʒɑhɑːnʊ̃
جہاں	dʒəhɑ̃ː
جہج	dʒəhdʒ
جہلم	dʒeɦləm
جہنم	dʒəhænm
جی	giː
جیئم	giːm
جیب	gɪb
جیت	dʒiːt̪
جیتا	ʒiːt̪ɑː
جیتتا	ʒɪt̪ːə
جیتنے	dʒiːt̪ne
جیج	giːdʒ
جیسا	ʒɪsə
جیسمین	ʒiːsmɪn
جیسوں	ʒɪsõː
جیسی	giːsiː
جیسیکا	ʒiːsɪkɑː
جیسے	ʒɪse
جیل	giːl
جیمز	dʒiːmz
جین	dʒiːn
جینا	dʒiːnɑː
جینرو	dʒiːnro
جینی	dʒiːniː
جینیاتی	dʒiːniːtiː
جینے	gɪneː
جیو	gɪo
جیٹ	giːt̪
جیپ	dʒiːp
جیپی	giːpiː
جیپیایس	dʒiːpiːaɪs
جیڈ	giːɖ
جیک	dʒeːk
جیکروں	dʒeːkəroː
جیکسن	dʒeːksən
جیکٹ	dʒeːkʈ
جے	dʒeː
ح	ħ
حµµ	ɦɪɪ
حµé	ɦʊɑ
حءà	ɦɑː
حءض	ɦɑːd̪
حءِ	ɦe
حءّ	ɦɑː
حأ	ɦɑ
حادثات	ħɑːd̪ˈθɑːt̪
حادثہ	ɦɑːd̪t̪ʰə
حادثے	ɦɑːd̪t̪ʃeː
حار	ɦɑːr
حاسل	ɦɑːsəl
حاصل	ɦɑːsəl
حاضر	ɦɑːjzər
حافظ	ɦɑːfiːz
حال	ɦɑːl
حالات	ɦɑːlɑːt̪
حالت	ɦɑːlɑːt
حالیہ	ɦɑːliː
حامد	ɦɑːmɪd
حامل	ɦɑːməl
حاملہ	ɦɑːmɪlə
حامی	ɦɑːmiː
حب	ɦæb
حبیب	ɦeːbiːb
حتمی	ɦt̪mi
حتی	ɦʈi
حتیٰ	ɦʌtɪ
حجر	ɦɑdʐ
حد	ɦɪd
حدود	hɑːmd
حدیں	ɦʌd̪eːn
حذف	ɦʌðf
حرارت	ɦəɾɑːɾət
حراست	ɦəɾɑːsˈt̪
حرام	ɦəˈɾɑːm
حرامی	ɦəɾɑːmi
حرج	ɦəɾdʒ
حرس	ɦərs
حرم	ɦəɾm
حرمتی	ɦəɾmiːti
حرکت	ɦəɾkət
حرکتوں	ɦəɾkətõː
حساب	ɦəsɑːb
حساس	ɦɪsɑs
حسد	ɦəsd
حسن	ɦəsn
حسنسن	ɦəsn̪s̪n̪
حسیب	ɦəsiːb
حسین	həsɪn
حسین	ɦʊsɪn
حسینہ	ɦʊsˈiːnə
حصار	ɦɪsɑːr
حصول	ɦəsˈbʊl
حصوں	ɦəsõː
حصہ	ɦəsə
حصے	ɦəsæ
حضرات	ɦʌd̪raːt̪
حضرت	ɦəzɾət̪
حضرت	ɦɪd̪ˈɾət̪
حضور	ɦəɖʊɾ
حفاظت	ɦʊfɑːzət
حفاظتی	ɦʊfɑːzt̪iː
حفظان	ɦəfzan
حق	ɦʊq
حقائق	ɦəqɑːʔeːt̪
حقدار	ɦqɑːdɑːr
حقوق	ɦʊqːʊq
حقیر	ɦəqiːr
حقیقت	həqiːqət
حقیقت	ɦəqiːqəɾ
حقیقی	ɦəqiːqiː
حل	ɦəl
حلف	ɦəlf
حلقوں	ɦəlˈkuːŋ
حلقے	ɦəlkuː
حلمے	ɦlɪme
حلوہ	ɦəluː
حلیف	ɦəliːf
حماد	ɦʊˈmɑːd
حماقت	ɦmɑːqət
حمام	ɦɑmɑm
حمایت	ɦəmiˈjæːt
حمزہ	ɦʊmzə
حمل	ɦæml
حملوں	ɑmɭeːŋ
حملہ	ɦəmˈlɑ
حملے	ɑmɾəljeː
حوا	ɦʋɑː
حوالات	ɦʋɑːlɑːt̪
حوالگی	ɦɪlɑːlgiː
حوالہ	ɑːlɑːhɑː
حوالے	ɑlɑje
حوروں	ɦoːɾuːŋ
حوریں	ɦoːreːn
حوصلہ	ɦʊsˈɑːlə
حویلی	ɦʋiːliː
حَیا	ɦɑjɑ
حُسن	ɦʊsən
حْرف	ɦərf
حْکم	ɦkʌm
حْکّام	ɦkɑːm
حکام	ɦʊkɑːm
حکم	ɦʊkmɪ
حکمت	ɦʊkmɛt
حکمرانی	ɦʊkmərɑːniː
حکومت	ɦʊkoːmət
حکومتِ	ɦʊkoːmət̪eː
حکومتی	ɦʊkoːmti
حکیم	ɦɪˈkim
حہ	ɦɑ
حہج	ɦɑdʒ
حہخ	ɦɑx
حہخہ	ɦɑxɑ
حہْ	ɦə
حیثیت	ɦɛːθiːt
حیدر	ɦɛːd̪ɪr
حیران	ɦɪːrɑːn
حیرت	ɦɪːrət
حیوان	ɦɛːwɑːn
خ	χ
خµµ	xʊ
خµé	χʊ
خµéہ	χʊˈeː
خµéہج	χʊˈɛdʒ
خء	xɑ
خءِ	χe
خؤ	χoː
خؤً	χoː
خإ	χɛ
خإح	χɑh
خإد	χɪd
خاتمہ	χɑːt̪eːməh
خاتمے	χɑːt̪eːmeː
خاتون	χɑːt̪ʊn
خادم	χɑːdim
خارج	χɑɾʒ
خارجہ	χɑɾˈʒe
خارجی	χɑɾdʒiː
خاص	kʰɑːs
خاصیت	χɑːsɪt
خاطر	χɑːtɪr
خالد	χɑːlɪd
خالص	χɑlɪs
خالق	χɑːliq
خالی	xɑːliː
خاموش	χɑːmoːʃ
خاموشی	xɑːmoːʃiː
خامی	xɑːmi
خامیوں	xɑːmijõː
خان	xɑn
خاندان	xɑːd̪ɑːn
خاندانوں	xɑːd̪ɑːnõː
خاندانی	χɑːnd̪ɑːniː
خانوں	xɑːnõː
خانہ	xɑːnɑː
خانے	χɑːnɛ
خاکروب	χɑːkɾub
خبر	xəbəɾ
خبر	xʊbər
خبردار	xɑbɾdɑːɾ
خبروں	xʌbɾoːn
خبریں	xʊbɾeːŋ
خبطی	xʌpt̪iː
ختم	χt̪əm
خد	χd
خدا	xʊdɑ
خدا	xʊdɑː
خدا	xʊd̪ɑː
خداؤں	χəˈdɑːʊ̃
خدائی	χəˈd̪ɑːi
خداحافظ	xʊdɑːɦɑːfɪz
خدارا	χdɑːrɑː
خداوند	χɪdɑːwund
خداوں	χəˈdɔ̃ː
خدایا	χʊd̪ɑːjɑː
خدشات	χəd̪ʃɑt̪
خدمات	χʊd̪maːn
خدمت	χʊmˈd̪eːt̪
خراب	χəɾɑːb
خرابا	χəɾɑːbɑː
خرابی	χʌɾɑːbiː
خراپن	χɑɾɑːpn̪
خروںچ	χɾoːnʈʃ
خرچ	χɑɾtʃ
خرچے	χəɾtʃeː
خرگوش	χɑrgoːʃ
خرید	χɾiːd
خریدا	χɾiːdɑ
خریداری	χəɾiːdɑːɾiː
خریدتا	xɪɾiːd̪t̪ɑ
خریدتے	χɪɾiːd̪teː
خریدنا	χɾiːd̪nɑ
خریدنے	xəɾiːdənə
خریدے	χɾiːde
خزانہ	xəˈzɑːnə
خزانے	χəˈzɑːne
خزاں	xʊzæ̃
خشک	xʊʃk
خشیاں	xʊʃjɑ̃
خصوصی	χʊstiʋiː
خصوصیات	χʊst̪iːqjɑːt̪
خصوصیت	χʊstiːʋiːt̪
خط	χʌt
خطاب	xʊtɑːb
خطرات	χɑt̪ɾɑt̪
خطرناک	χɑt̪ɾnɑːk
خطرہ	χʌt̪ɾə
خطرے	xət̪reː
خطے	χʊteː
خفیہ	xəfɪh
خلا	xəla
خلاء	xəlɑː
خلاصہ	χɑlɑsɑ
خلاف	χɑlɑf
خلط	χəlʈ
خلقت	xəlkət̪
خلل	xəlː
خلوت	xʊloːt
خلوص	χɑluːs
خلیات	xəliːət
خلیج	χəliːdʒ
خلیل	χɪlɪl
خمر	xʊmər
خمیر	χmɪr
خنجر	xəngər
خوا	χɔː
خواب	xɑːb
خواب	xʰwaːb
خواب	xʰwɑːb
خواب	χɔːb
خوابوں	xɑːbõː
خواتین	χʋɑːt̪iːn
خواجہ	χʋɑːdʒə
خواہ	χɔː
خواہاں	χɔɑ̃
خواہش	χɔɑːɦʃ
خواہشمند	χɔːhʃmənd
خوب	χoːb
خوبصورت	xuːbsuːɾət
خوبصورت	xʊbsʊɾt
خوبصورتی	xʊbsʊɾt̪i
خود	χoːd
خودکار	χoːd̪kɑːr
خودکشی	χoːd̪kɪʃiː
خودکشیوں	χoːd̪kʃijõː
خور	xʊr
خوراک	χoːɾɑːk
خوست	xʊst
خوش	xʊʃ
خوشبو	xʊʃbuː
خوشبودار	xɔʃboːdɑr
خوشحال	xʊʃʰɑːl
خوشحالی	xʊʃhɑliː
خوشخبری	χoːʃxʊbɾiː
خوشنما	χoːʃnəma
خوشگوار	xʊʃgʊʋɑːɾ
خوشی	xʊʃi
خوشی	xʊʃiː
خوف	χoːf
خوفزدہ	χoːfzəd̪ə
خوفناک	χoːfnɑːk
خون	χoːn
خونصورت	xʊn̪s̪oːɾt̪
خونی	xʊniː
خونیوں	xʊnijõː
خُبر	xʊbər
خْلوصت	xəlʊsˈt
خچر	χɪtʃər
خہا	xɑː
خہج	χɛdʒ
خہجءز	χɑdʒeːz
خہخ	χɑˈɦɑ
خہعµéہج	xʌɪ
خیال	xɑjɑl
خیال	xʰɪjɑːl
خیالات	xɛjɑːlɑːt
خیانت	χɛjɑːnt
خیر	χɛːr
خیرباد	χeːrˈbɑːd
خیریت	χɪˈɾiːt̪
خیز	xɪz
خیموں	χiːmoːn
خیمے	χɪmeː
د	ð
دءز	ɖeːz
دءِ	ɗeː
دآتہ	daːt̪ə
دآتہا	daːt̪ʰɑː
دئے	ɗeː
داؤ	ɗɑu
دائر	daɪr
دائرہ	daɪrɑ
دائری	ɗɑːiri
دائرے	daɪreː
دائیں	ɖɑẽːn
داخل	ɗɑkʰɪl
داخلہ	ɗɑkʰɪlə
داخلی	ɖɑːkʰliː
داخلے	ɗɑkʰle
دادا	ɖɑːd̪ɑː
دادی	ɖɑːdiː
دار	ɖɑːr
دارالحکومت	ɖɑːɾəɦʊkʊmət
دارہج	ɖɑːɾɛdʒ
داری	d̪ɑːɾiː
داز	ɗɑz
داستان	daːst̪ɑːn
داستانی	daːstaːniː
داشتہ	ɗɑːsˈteː
داغ	ɗɑːɣ
داغدار	daːɣd̪ɑːr
دال	ɗɑl
دالان	ɖɑːlɑːn
دان	d̪ɑːn
دانائی	daːnɑːiː
دانت	daːnt
دانتوں	ɖənt̪oː
دانستہ	daːn̪s̪t̪ə
دانشمند	d̪ɑːnʃmʌnd̪
دانشورانہ	ɖɑnʃoːrɑnɑ
دانو	ɖɑːnʊ
دانوں	ɖɑːnõː
دانی	daːniː
دانیال	daːnijɑːl
داڑھی	ɖɑːɽʰiː
داہنے	ɗɑːhne
دب	d̪ʌb
دبا	ɗɑbɑ
دباؤ	ɖʊbɑːu
دبائیں	ɗʊbɑːʔeːn
دباتے	ɗəbɑːt̪eː
دبانا	ɗʊbɑːnɑː
دبانے	ɗʊbɑːneː
دبلا	ɖʊblɑ
دبو	ɗʊː
دت	ɖʌt
دج	ɖʌdʒ
دججیاں	ɗʊdʒjɑ̃
دخش	ɗɑkʃ
دخل	gʌŋ
دخول	ðʊxuːl
در	ɖəɾ
درآمد	ɖəɾɑːməd
دراج	ɖəɾɑːg
دراز	ɖəɾɑz
دراصل	ɖəɾɑːl
دراندازی	ɖəɾɑːnˈd̪ɑːzi
دراڑ	ɖəɽː
دراڑوں	ɖəɽoːɳ
دراڑیں	ɖəɽeː
درج	ɖəɾeʒ
درجن	ɖəɾdʒən
درجہ	ɖəɾʒə
درجے	ɖəɾziː
درحقیقت	ɖəɾɦəqiːqət
درخت	d̪ɪrɐxt
درخت	ɖəɾxt̪
درختوں	ɖəɾxtõː
درخواست	d̪əɾxɑːst̪
درخواست	ɖəɾkʰʊˈʃiːt̪
درخواستوں	ɖəɾkʰʊˈʃiːjõː
درد	d̪əɾd̪
درد	ɖəɾd
دردِ	ɖəɾd̪i
درس	ɖəɾs
درست	ɖəɾsɪst
درمیان	ɖəɾmiˈɑːn
درمیانی	ɖəɾmiæːni
درمیانے	ɖəɾmɪɑːne
دروازوں	ɖəɾoːzõː
دروازہ	ɖəɾoːzə
دروازے	ɖəɾwaːze
درود	d̪əɾuːd̪
درپیش	ɖəɾpiːʃ
درکار	ɖəɾkɑːr
دری	ɖəɾiː
دریا	d̪əɾjɑː
دریا	ɖəɾijɑ
دریائے	ɖəɾɪjɑːe
دریافت	ɖəɾɑːɪft
دریں	ɖəɾeːn
دس	ɗəs
دستانے	ɗʌst̪ɑːneː
دستاویز	ɖəsʈɑʋeɪz
دستاویزات	dest̪oːβiːzɑːt̪
دستاویزی	ɖəstaːβiːziː
دستخط	ɗɪsˈt̪xət̪
دستور	ɖəsˈtoːr
دستک	ɗɪsˈtæk
دستہ	dest̪ə
دستی	ɖəsˈtiː
دستیاب	ɖəst̪iɑːb
دستے	deste
دسمبر	ɖəʃmɛɾ
دشاتمک	ɗɛʃmæmæk
دشمن	ɖəʃmən
دشمنوں	d̪əʃmənõː
دشواری	ɗʃɑːɾiː
دعا	d̪ʊʔɑː
دعا	ɖʋɑ
دعائیں	ɖʋɑːʔeːn
دعوت	ɖəʋuːt
دعوی	ɖəʋiː
دعوے	ɖʋeː
دفاتر	dafɑːt̪ər
دفاع	ɗɑfɑːʋ
دفاعی	dafɑːʋiː
دفتر	daft̪ər
دفتر	d̪əft̪əɾ
دفتری	daft̪eːriː
دفع	ɗəf
دفعہ	ɗəfə
دفن	ɗʊn
دفناتے	ɗʊnɑːte
دفنانے	ɗʊnɑːne
دفنایا	dafnajɑ
دل	dɪl
دل	ɗəl
دلائی	ɗɑlɑi
دلاتا	ɗʊlɑtɑ
دلاتی	ɗɛlɑti
دلاتے	ɖʊlɑːt̪eː
دلانے	ɗəlaːne
دلدل	ɗʌlɗʌl
دلواؤ	ɖʊlɔː
دلوں	ɗəlõː
دلُو	ɗəloː
دلچسب	ɗəlˈtʃʰsəb
دلچسپ	ɗəlˈtʃɪsp
دلچسپی	ɗəlʈʃəsi
دلکش	dɪlkəʃ
دلکش	ɗəlkɛʃ
دلہن	ɗəlˈɦən
دلی	ɖəliː
دلیر	ɗəliːr
دلیری	ɖəliːriː
دلیل	ɖəlɪl
دم	ɗʌm
دماغ	ɗʊmɑːɣ
دماغی	ɖʊmɑːɣiː
دمنی	damini
دمنیوں	ɖʌmnijõː
دمکانے	ɗʊmkɑːneː
دمہ	ɗʊmə
دمیتر	ɖʌmɪt̪r̪
دن	dɪn
دن	d̪ə̃
دنوں	ɖənuː
دنیا	d̪ʊnjɑː
دنیا	ɖəniːə
دنیاؤں	ɖəniɑ̃ː
دنیاقربان	d̪əniːəqɾəbɑn
دنیاوی	d̪ʊnɪjɑːʋiː
دو	duː
دوا	ɖʋɑː
دوائی	duɑi
دوائیاں	duɑ̃jɑ̃
دوائیوں	duɑːjɔ̃ː
دوبارہ	doːbɑːrɑː
دودھ	doːd̪ʱ
دودیا	duːɽiːə
دور	doːr
دوران	doːɾɑːn
دورانئے	ɖʊɾɑːnɛː
دوروں	ɖoːɾõː
دورِ	doːri
دورہ	doːrɑ
دوری	doːri
دورے	ɖoːre
دوزخ	duzɣ
دوست	doːst
دوستانہ	duːst̪ɑːnə
دوستو	doːsto
دوستوں	doːstõː
دوستی	doːst̪iː
دوسرا	ɖoːsəɾɑ
دوسروں	doːsroːn
دوسری	doːsriː
دوسرے	ɖoːsreː
دوسس	doːs
دوش	duːʃ
دولت	d̪ɔːlət
دولت	ɗɔlʊt
دونوں	doːnõː
دونگا	doːŋgə
دونگی	doŋgi
دوپہر	doːpʰeːr
دوپہر	d̪oːpɛɦɛɾ
دوچار	duːtʃʰɑːr
دوڑ	ɗoɽ
دوڑا	ɖoːɽə
دوڑنے	ɗoɽne
دوڑوں	ɽuɽoːn
دوکھیباز	duːkʰeːbɑːz
دوگلا	duːglə
دوگنی	duːgniː
دوں	ɗõː
دوہرا	doːra
ديئے	ɖeː
دِکھ	ɗɪkʰ
دِکھتا	ɗɪkʰt̪ɑ
دِینی	ɖiːniː
دکان	ɗʊkɑːn
دکھ	ɗʊkʰ
دکھا	ɗʊkʰɑ
دکھاؤ	ɗʊkʰɑːo
دکھاؤں	ɗʊkʰɑ̃ːu̯n
دکھائی	ɗəˈkʰɑːi
دکھائیں	ɗʊkʰɑ̃e̯
دکھائے	ɗʊkʰɑːe
دکھاتا	ɗʊkʰɑt̪ɑ
دکھاتی	ɗʊkʰɑːti
دکھاتے	ɗʊkʰɑːte
دکھانا	ɗʊkʰɑːnɑ
دکھانے	ɗʊkʰɑːne
دکھاو	ɗʊkʰɑːʋ
دکھاوا	ɗʊkʰɑːʋɑː
دکھاوے	ɗʊkʰɑːʋeː
دکھایا	ɗʊkʰɑjɑ
دکھاینگے	ɗʊkʰɛːŋeː
دکھتا	ɗʊkʰt̪ɑ
دکھتے	ɗʊkt̪eː
دکھی	ɗəkʰiː
دگگج	ɗʊggeː
دھات	ɗʰɑːt̪
دھاتیں	ðɑːt̪eːŋ
دھار	ɗʌːr
دھاریں	ɗʰɑːrɪ̃
دھاوے	ɗɑːweː
دھبوں	ɗʰəbõː
دھماکہ	ðʱəmɑːkʰ
دھماکے	ðʌmɑːkeː
دھمکی	ðʌmki
دھند	ðʌnd
دھندلی	ðʌnd̪liː
دھندہ	ɗʱənd̪ə
دھو	ðʊ
دھواں	ðʋɑ̃ː
دھول	ɗʰoːl
دھونے	ɗʰoːne
دھوپ	ðʊp
دھوکا	ðoːkə
دھوکہ	ɗoːkə
دھوکے	ðoːke
دھچکا	ɗɪtʃkə
دھڑوں	ɗʌɽoːŋ
دھڑک	ɗʌɽk
دھڑکتا	ɗʌɽkəʈə
دھڑکن	ɗʌɽkən
دھڑے	ɗʌɽe
دھکا	ðʌkɑ
دھیان	ðɪjɑːn
دھیرے	ɗʰiːreː
دھیما	ðɪmɑ
دہ	ðə
دہü	ɗə
دہüب	ɗɛɦuːb
دہائی	ɗɛɦɑːi
دہانی	ɗʰɑːni
دہاڑ	ɗʌɦɑːɽ
دہراؤ	ɖʱəɾɑʊ
دہراتا	ɖəɾɑːt̪ə
دہراتی	ðəɾɑːt̪iː
دہرانی	ɗəɾɑːni
دہرانے	ðəɾɑːnɛ
دہشت	ðəʃt̪
دہشتگردوں	ɗɛʃt̪gʊɾd̪oːŋ
دہف	ɗʌf
دہلی	d̪eɦliː
دہلیز	ɗʰəliːz
دہنا	ðəna
دہندگان	ðəɣənˈd̪ʌŋ
دہندہ	ɖəɦɪnd̪ə
دہی	ɗʰeː
دی	ɖiː
دیئے	ɗiːe
دیا	ɖɪɑ
دیالی	ɗiɑːliː
دیانا	ɖiːɑːnɑː
دیتا	ɗiːtə
دیتی	ɖiːt̪iː
دیتے	ɖiːt̪eː
دیجئے	ɗɪdʒeː
دیدی	ɗiːdiː
دیر	ɖeːr
دیرپا	ɖiːɾpɑː
دین	ɖiːn
دینا	ɖiːnə
دیناچاہتے	ɖiːnɑːtʃɑːɦteː
دینی	ɖiːniː
دینے	ɖiːnɛ
دیو	ɗiːu
دیوار	ɖiːʋɑːr
دیواروں	ɗiːʋɑːroːn
دیواریں	ɖiːʋaːrɪ̃
دیوالیہ	ɖiːʋəliː
دیوانہ	ɗiːʋɑːnə
دیوتاؤں	ɗiːʋtɔ̃ː
دیوتاوں	ɖiːt̪ʊt̪ɑ̃ː
دیور	ɖiːʋəɾ
دیوی	ɖiːʋiː
دیویوں	ɗiːvijõː
دیکھ	ɗɪkʰ
دیکھا	ɗɪkʰɑ
دیکھتا	ɗɪkʰt̪ə
دیکھتی	ɗɪkʰt̪i
دیکھتیں	ɗɪkʰt̪iː
دیکھتے	ɗɪkʰt̪eː
دیکھنا	ɗɪkʰnɑ
دیکھنے	ɗɪkʰneː
دیکھنےکی	ɗɪkʰneːki
دیکھو	ɗɪkʰoː
دیکھی	ɗɪkʰi
دیکھیئے	ɗɪkʰiːe
دیکھیں	ɗɪkʰeːn
دیکھے	ɗɪkʰe
دیگر	ɪɾ
دیگں	ɖɪgən
دیں	ɖeː
دیہات	ɖiːɦɑːt̪
دیہاتوں	ɗiːɦɑːtõː
دیہاتی	ɗiːɑːt̪iː
دیے	ɗiː
دے	ɖeː
ذ	ð
ذµµ	ðɪ
ذµه	ðʊ
ذء	ðe
ذءُ	ðʊ
ذائقہ	ðɑːqɪhɑː
ذاتی	ðɑti
ذاد	ðɑːd
ذار	ðɑr
ذاط	ðɑːt
ذب	ðʊb
ذبح	ðʊbʱ
ذخائر	ðˈxɑːiːr
ذخیرہ	ðəxeːrɑ
ذرا	ðəɾə
ذرائع	ðɑɾiːɑː
ذریعہ	ðɾɑːjjə
ذریعے	ðəɾɑːjje
ذلالت	ðʌlɑːt
ذلت	ðʊlt̪ə
ذلیل	ðɪliː
ذمہ	ðəma
ذمے	ðʊme
ذکر	ðɪkər
ذہ	ðə
ذہا	ðə
ذہج	ðəʐ
ذہجءز	ðəgʲeːz
ذہن	ðəɦən
ذہنوں	ðəɦoːn
ذہنیت	ðəɦniːt
ذہین	ðəiːn
ذی	ðɪ
ذیادتی	ðɪɑːd̪tiː
ذیل	ðɪl
ذیلی	ðɪliː
ر	ɾ
رئڈ	ɾeːɖ
رئیل	ɾeːl
راؤنڈ	ɾɔ̃ːnd̪
راؤنڈز	ɾɔ̃ːndz
رائفل	ɾɑːɪfəl
رائل	ɾɑːɪl
رائلز	ɾɑːɪlz
رائے	ɾɑːjeː
رابرٹ	ɾɑːbɛɾt̪
رابطوں	ɾɑːbɪt̪oːŋ
رابطہ	ɾɑːbɪt̪ʰɑː
رابطے	ɾɑːbɪt̪eː
رابعہ	ɾɑːbiːɣɑː
رابن	ɾɑːbɪn
رات	ɾɑːt
راتوں	ɾɑːtõː
راج	ɾɑːdʒ
راجاساہب	ɾɑːʒɑːsɑ̄ʔɪb
راجر	roːgər
راجرز	ɾoːgəɾeːz
راجن	ɾɑːdʒn
راجکمار	ɾɑdʒkʋɑmɑɾ
راجکماری	ɾɑdʒkʌmɑːɾiː
راز	ɾɑz
رازدارانہ	ɾɑːzd̪əɾɑːniə
رازداری	ɾɑzɑdɑɾi
راست	ɾɑːst̪
راستوں	ɾɑːst̪oːŋ
راستہ	rɑːstə
راستہ	ɾɑst̪ʰɑ
راستے	ɾɑːsˈteː
راشن	ɾɑʃn
راضی	ɾɑːdʒi
رافٹنگ	ɾɑːft̪ɪŋ
رالف	ɾəlf
رامادہ	ɾɑːmɑːd̪ə
راماڈہ	ɾɑːmɑːɖə
رانڈ	ɾɑ̃ːnd̪
رانڈیل	ɾɑːnɖɛl
رانی	ɾɑːniː
راولپنڈی	ɾɑʊlpənɖiː
راک	ɾɑk
راکشس	ɾɑːkəʃs
راکشسوں	ɾɑːkʃsõː
راکٹس	ɾɑkːʌts
راکھ	ɾɑkʰ
راکی	ɾɑːkiː
راںبنا	ɾɑ̃ːbənɑː
راہ	ɾɑh
راہباؤں	ɾɑːɦbɑːʊ̃
راہبوں	ɾɑːɦbõː
راہداریاں	ɾɑːhɑːd̪əɾɪ̃ː
راہنمائی	ɾɑhənmɑːi
راہیں	ɾɑːɦeːn
رایلٹی	ɾɑɪlɪt̪iː
رب	ɾəb
ربع	ɾəˈβ
ربڑ	ɾəbɽ
ربیکا	ɾəbɪkɑ
رتبہ	ɾʌt̪bʌ
رج	ɾɪdʒ
رجحان	ɾʒɑˈɦɑn
رجمنٹ	ɾʊdʒmɛ̃ːʈ
رجوع	ɾʊˈgoː
رحم	ɾɑm
رحمت	ɾəɦmət
رحمدلی	ɾəhmeːdliː
رحمہ	ɾəhmə
رحمی	ɾəxmi
رخ	ɾək
رخصت	ɾəxˈsət
رخنہ	ɾəxnə
رد	ɾəd
ردعمل	ɾədæmːəl
ردوکد	ɾʊd̪okːe
ردی	ɾʊdi
رزق	ɾɪsˈq
رزق	ɾɪzq
رزو	ɾezo
رس	ɾəs
رسائی	ɾəsɑːiː
رسالت	ɾəsɑːlɪt
رسانی	ɾəsaːniː
رستے	ɾəsteː
رسد	ɾəsɪd
رسمی	ɾɑsmɪ
رسوخ	ɾəsʊx
رسول	ɾəsʊl
رسّی	ɾəsːiː
رسپانس	ɾəspəns
رسک	ɾəsk
رسی	ɾəsi
رسید	ɾəsɪd
رسیلی	ɾəsiˈli
رسیوں	ɾəsiõː
رش	ɾɪʃ
رشاد	ɾəʃɑːd
رشتہ	ɾəʃt̪ə
رشتہ	ɾɪʃt̪ɑː
رشتے	ɾəʃt̪eː
رشوت	ɾəʃoːt
رشک	ɾəʃk
رضا	ɾəza
رضامند	ɾɪzɑːmɪnd
رضامندی	ɾəzaːmendi
رضاکار	ɾəzaːkɑːr
رضاکارانہ	ɾəɣɑkɑrɑnə
رضاکاروں	ɾəzaːkɑːroː
رعایا	ɾəʋɑːjɑː
رعایت	ɾəʋɑːʔeːt
رفت	ɾaft
رفتار	ɾəftɑːr
رقاص	ɾəqɑːs
رقص	ɾʊqs
رقم	ɾʊqmʊ
رقوم	ɾʊqoːm
رمزی	ɾʌmzi
رن	ɾən
رنز	ɾənz
رنڈی	ɾəŋɖiː
رنگ	ɾəŋ
رنگروٹ	ɾəŋgɾoːt
رو	roː
روؤ	ɾoʊ
روابط	ɾɑwɑbɪt
روانہ	ɾoːnɑː
رواں	ɾʋɑ̃
روایات	ɾoːʔɑːjɑːt̪
روایت	ɾoːɑɪt̪
روایتی	roːɑːjtiː
روبوٹ	ɾʊboːʈ
روبوٹس	ɾoːˈboːʈs
روتا	ɾoːt̪ə
روتے	ɾoʈe
روح	ɾoːh
روحانی	ɾuːɦɑːni
روحوں	ɾoʊɦʊ̃
روز	ɾoːz
روزا	ɾoːzə
روزانہ	ɾoːzaːnə
روزمرہ	ɾoːzməɾə
روزگار	ɾoːzgɑːr
روزہ	ɾoːze
روزی	ɾoːzi
روزے	ɾoːze
روس	ɾoːs
روسٹ	ɾoːsʈ
روسی	ɾoːsiː
روشن	ɾoːʃn
روشنی	roʃniː
روشنی	ɾoʃni
روشنی	ɾoʃniː
رول	ɾoːl
رولنڈ	ɾoːlənɖ
رولنگ	ɾoːlɪŋ
روم	ɾoːm
رومال	ɾoːmɑl
رومانوی	roːmɑːnʋiː
رومانٹک	ɾomənt̪k
رومانی	ɾoːmaːniː
رومانیوں	ɾoːmɑːnijoːn
رومانیہ	ɾoːmaːniːɑː
رومن	ɾoːmən
رومی	ruːmiː
رومیو-بھارت	ruːmiːoːbʱɑːrt̪
رونا	roːnə
روندنے	ɾʊndne
رونلڈ	ɾʊnləɽ
رونے	ɾoːne
روٹر	ɾoʈəɾ
روٹری	ɾoːt̪ɾiː
روٹی	ɾoːtiː
روپوش	ɾoːpuːʃ
روپیہ	ɾuːpəjjɑː
روپیہ	ɾuːpɪjɑː
روپے	ɾoːpə
روڈ	ɾoːɖ
روک	ɾoːk
روکا	ɾoːkɑ
روکتا	ɾoːkəta
روکساک	ɾoːkɑsɑk
روکنا	ɾoːknɑː
روکنے	ɾoːkneː
روکو	ɾoːkuː
روکے	ɾoːkeː
روگردانی	ɾoːgəɾdɑːniː
رویا	rujɑ
رویہ	ɾoi
رویے	ɾoi
رُک	ɾʊk
رْتبےدانوں	ɾət̪beːd̪ɑːnuːn
رْک	ɾək
رْکیے	ɾkiːe
رپورٹ	ɾəpoːɾəʈ
رپورٹر	ɾəpoːɾt̪əɾ
رپورٹنگ	ɾəpoːɾʈeŋ
رپورٹیں	ɾpʊɾʈeː
رچرڈ	ɾɪtʃʰəɾɪt̪ʃ
رک	ɾek
رکئے	ɾəkɪe
رکا	ɾʊkɑ
رکاوٹ	ɾəkɑːʋʈ
رکاوٹوں	ɾəkɑʊʈoːn
رکن	ɾʊkən
رکنا	ɾəknɑ
رکنیت	ɾəkəˈniːt
رکنیتی	ɾəkniːt̪iː
رکو	ɾoːkʊ
رکوع	ɾekoːʋ
رکھ	ɾəkʰ
رکھا	ɾəkʰɑ
رکھتا	ɾəkʰt̪ə
رکھتی	ɾəkʰt̪i
رکھتے	ɾəkʰt̪eː
رکھنا	ɾəkʰnə
رکھنی	ɾəkʰniː
رکھنے	ɾəkʰne
رکھو	ɾəkʰo
رکھوگے	ɾəkʰoːgeː
رکھوں	ɾəkʰõː
رکھی	ɾəkʰiː
رکھینگے	ɾəkʰɪŋeː
رکھیں	ɾəkʰeːn
رکھے	ɾəkʰeː
رکی	ɾiki
رکیں	ɾəkẽː
رکیے	ɾekjɛ
رکے	ɾeːkə
رگ	ɾʊg
رگوں	ɾəgoːn
رگڑا	ɾəgəɽə
رگڑتا	ɾəgəɽt̪ə
رہ	ɾə
رہا	ɾəɦɑ
رہائش	ɾəɦɑːɪtʃ
رہائشی	ɾəɦɑːʃi
رہائی	ɾəɦɑːi
رہبر	ɾɛɦbəɾ
رہت	ɾəɦt
رہتا	ɾəɦt̪ɑ
رہتی	ɾəɦt̪i
رہتے	ɾehte
رہسی	ɾəhʃiː
رہن	ɾəhn
رہنا	ɾəɦnə
رہنما	ɾəhnmɑ
رہنماؤں	ɾəɦnæmɔ̃ː
رہنمائی	ɾəhnɑːmɑːiː
رہنی	ɾəɦniː
رہنے	ɾəne
رہو	ɾo
رہوگے	roːɣe
رہوں	ɾɑɦoː
رہيں	ɾeːɦẽː
رہی	ɾəɦiː
رہیں	ɾeːɦẽː
رہے	ɾəhe
رہےہیں	ɾeːɦeːɦĩː
ری	riː
ریاست	ɾɛːʔɑːst̪
ریاستہائے	ɾeːʔɑːsˈt̪ʰɑːe̯
ریاستی	ɾeːʔɑːst̪iː
ریاضی	ɾɛˈɑːdʒi
ریاضیاتی	ɾɛɑːdʒiːɑːtiː
ریت	ɾeːt̪
ریجنل	ɾeːgnəl
ریخ	ɾeːx
ریز	ɾeːz
ریزرو	ɾeːzəroː
ریزولوشن	ɾeɪzoːluːʃən
ریزیومے	ɾeːziːmeː
ریس	ɾeːs
ریستوران	ɾeːstʊɾɑːn
ریستورانون	ɾeːst̪oːɾɑːnʊn
ریسرچ	ɾeɪsɑɾtʃ
ریسلنگ	ɾeɪsəlɪŋ
ریسورسز	ɾeːsʊɾs
ریسپانس	ɾɪspɑːns
ریسکیو	ɾeːskiːu
ریشمی	ɾiːʃmi
ریفرنس	ɾɪfɾəns
ریفری	ɾeːfɾiː
ریلوے	ɾɪlʋeː
ریلی	ɾiːliː
ریلے	ɾeːleː
ریمانڈ	ɾeːmɑːnd̪
ریمزے	ɾeːmaːzeː
ریمسی	ɾeːmɪsɪ
ریمنڈ	ɾeːmənd̪
ریمپ	ɾeːmpə
رینالٹ	ɾɪnɑːl̪t̪
رینج	ɾeːŋ
رینجرز	ɾeːngəɾs
رینو	ɾeːnoː
رینڈ	ɾeːnd̪
ریو	ɾiːoː
ریورس	ɾeːʋɑːs
ریویالی	ɾeːʋɑːliː
ریوین	ɾeːʋɪn
ریٹا	ɾeːt̪ɑː
ریٹائر	ɾeːtɑɪɾ
ریٹائرڈ	ɾeːt̪ɑɪɾeːd̪
ریپبلک	ɾeːpblɪk
ریپبلکن	ɾeːpblɪkən
ریپر	ɾeːpəɾ
ریپسیڈ	ɾeːpʰsɪd
ریپیٹر	ɾeːpɪt̪əɾ
ریچھ	ɾeːtʃ
ریڈ	ɾiːɽ
ریڈار	ɾiːɖɑːr
ریڈیو	ɾiːɖoː
ریڑھ	ɾɪɑɽʰ
ریڑھیاں	ɾiːɽʰijɑ̃
ریکارڈ	ɾeːkɑːɾɪd̪
ریکارڈز	ɾeːkɑːɾɪd̪z
ریکارڈنگ	ɾeːkɑːɾɖɪŋ
ریکٹر	ɾeːkʈəɾ
ریگستان	ɾeːgɪsˈt̪ɑːn
رے	ɾeː
ز	z
زµ	zɪ
زءز	zeːz
زءِ	zeː
زإآ	zɑ
زاàاد	zɑːd
زائد	zɑːiːd
زائرین	zɑːireːn
زادہـ	zɑːd̪ə
زانٹی	zɑːnt̪iː
زاویہ	zɑːʋɪh
زاہد	zɑːhəd
زبان	zæbʌn
زبان	zʊbɑːn
زبانوں	zɑβʊ̃nõː
زبانیں	zʊbɑːniː
زبردست	zəbɾd̪est̪
زبردستی	zəbɾd̪eːst̪i
زحمت	zɑhmət
زخم	zɪkm
زخموں	zəkmõː
زخمی	zəkmi
زخمیوں	zəkʰmijõː
زد	zɑd
زدہ	zɑːd̪ə
زرد	zɑrɾd
زرعی	zɑrʋeː
زلزلوں	zəlzəlõː
زلزلہ	zəlzələ
زلزلیات	zəlzəlɪɑːt
زلزلے	zəlzələ
زمانے	zɪmɑːne
زمرہ	zʊmərə
زمرے	zʊmre
زمین	zæmɪn
زمین	zəmiːn
زمین	zəmˈiːn
زمینوں	zæmɪ̃ːŋ
زنا	zəna
زندگی	zɪndəgɪ
زندگی	zɪnd̪giː
زندگی	zɪnd̪əgiː
زندگی	zɪnd̪əgɪ
زندگیاں	zɪnd̪gijɑ̃
زندگیوں	zɪndgɪjõː
زندہ	zɪnˈd̪eː
زوال	zʊɑːl
زور	zɔːr
زولا	zɔːlɑː
زولو	zuːloː
زوم	zuːm
زون	zun
زکر	zɪkəɾ
زگانے	zgɑːnɛ
زہ	ze
زہر	zɛr
زہرہ	zəhra
زہریلا	zəhɪrɪlə
زہریلے	zəhɪlɛ
زہیب	zoɦeːb
زیادتی	zĕjäːtt̪iː
زیادتیاں	ziːɑːd̪tȋã
زیادہ	ziɑːd̪ə
زیر	zɪr
زیرو	ziːroː
زیرِ	zɪrɪ
زیور	ziːr
زیورات	ziwɑːrɑːt
س	s
سµµ	sɪng
سا	sɑ
ساؤ	sɑuː
سائبر	sɑɪbɾ
سائبرسپیس	sɑːɪbɾəspiːs
سائرل	sɑːɪrəl
سائرن	sɑːɪrən
سائز	saːiz
سائن	sɛ̃ːn
سائنس	sɑːjɪns
سائنس	sɑːʔɪns
سائنسدان	sɑːʔɪnsd̪ɑːn
سائنسدانوں	saːʔɪnsd̪ɑːnuː
سائنسی	sɛːnsiː
سائنیسِس	saːiːnisis
سائٹ	sɑɪt
سائڈ	saɪd
سائینائیڈ	saːɪnɑːɪd
سائینسِس	ˈsɑːʔɪnsɪs
سائینیسِس	saːʔiːnɪs
سائیکل	saːɪkəl
سائے	saːje
سابق	sɑbeq
سابقہ	sɑːbɪqɑː
سات	sɑːt
ساتویں	sɑːtʊjə̃
ساتھ	sɑːt̪ʰ
ساتھی	sɑːt̪ʰiː
ساتھیوں	sɑːt̪ʰijõː
ساحل	sɑːhɪl
ساحلوں	saːxɪlõː
ساحلی	saːɦliː
ساختہ	sɑːxt̪ʰɑː
سادءِ	sɑːd̪eː
سادگی	saːd̪giː
سادہ	sɑːd̪ə
سادے	sɑːd̪eː
سار	sɑːr
سارا	sɑːrɑː
سارج	sɑːɾdʒ
سارجنٹ	sɑːɾdʒənt
سارس	sɑːɾs
سارہ	sɑːɾɑː
ساری	sɑːriː
سارے	sɑːɾeː
ساز	sɑːz
سازش	sɑːzəʃ
سازی	səˈnɑːji
ساس	sɑs
ساسیں	sɑːsẽː
ساشا	sɑːʃɑː
سافٹ	sɑːft
سافٹبال	sɑːft̪bɑːl
سافٹویئر	sɑːftʋiːr
ساك	sɑk
سال	sɑl
سالا	sɑlɑ
سالار	sɑlɑr
سالاری	sɑlɑːriː
سالانہ	sɑlɑnə
سالسا	sɑlsɑ
سالوں	sɑlõː
سالچک	sɑltʃək
سالگرہ	saːlgəɾə
سالہ	sɑlɑ
سالی	sɑːliː
سالے	sɑlɛ
سام	sɑːm
سامان	sɑːmɑːn
سامبو	sɑːmbʊ
سامری	saːmriː
سامعین	sɑːmeːn
سامن	sɑːmən
سامنا	sɑːmnɑː
سامنے	sɑːmne
سامپ	sɑːmp
سان	sɑːn
سانتا	sɑːntɑː
سانتانا	sɑːntɑːnɑː
سانحہ	sɑːnɦɑː
سانحے	sɑnɦeː
سانس	sɑːns
سانپ	sɑːnpʰ
سانپوں	sɑːnpõː
سانی	sɑːniː
ساٹھ	sɑːʈʰ
ساکھ	sɑkʰ
سایبان	sɑjbɑn
سایہ	sɑjɑ
سب	səb
سبارو	səbɑːroː
سباق	sʊbɑːq
سبب	sɪbɑːg
سبت	sɑbt̪
سبز	sɑbz
سبزی	səbˈziː
سبق	sæbɪg
ستا	sɪtɑː
ستاروں	səˈtɑːrõː
ستارہ	sətɑːɾɑː
ستارہ	sɪtɑːrɑː
ستارہ	sɪt̪aːɾɑː
ستارے	sət̪əɾeː
ستر	st̪eːr
سترہ	sətɾə
سترہویں	stəɾəhəʋẽː
ستم	stæm
ستمبر	septɪmbər
ستیا	sɪt̪jɑː
سجایا	sʊdʒɑːjɑː
سججن	sɪdʒdʒən
سججنوں	sʊdʒdʒuːn
سحر	səhɾ
سحری	sɛɦɛɾiː
سحری	sɛɦɾiː
سحری	sɛɾiː
سخاوت	səkɑːʊt
سخت	ʃɪxt
سختی	səkʰtiː
سخی	ʃəki
سر	sər
سرا	səɾɑː
سراسر	səɾɑːsər
سراغ	səɾɑːɣ
سراہا	səɾɑːhɑ
سربراہ	sərbɾɑh
سربراہان	sərbɾɑːhɑːn
سربراہی	sərbərɑːhiː
سرجری	səɾdʒiː
سرحد	sərˈhəd
سرحدوں	sərɦədõː
سرحدی	sərˈɦɛd̪i
سرخ	sɑrɑx
سرخی	səɾɣiː
سرخیوں	səɾkʰijõː
سرد	sɑɾd
سردار	səɾd̪ɑːr
سردی	sɐɾdiː
سردی	sərdi
سردی	səɾd̪iː
سرزمین	sərˈzæːniː
سرسبز	sərsəbz
سرسوں	sərsõː
سرغنہ	sərɣənə
سرف	sərf
سرمئی	səɾmeɪ
سرما	sɪrmɑ
سرمایہ	səɾmɑːjə
سرنگ	səɾəŋ
سرنگوں	səɾəŋgõː
سرور	səruːr
سرورز	sərˈruːz
سرورق	səruq
سروس	sɪɾoːs
سروسز	sɾoːs
سروں	səɾoːŋ
سروے	sɪroːe
سرپرست	sərpəɾəst
سرپرستوں	sərpərest̪oː
سرپھرے	sərpʰʌre
سرچ	sɛɾtʃ
سرکاری	səɾkɑːɾiː
سرکسوں	səɾkɪsõː
سرکش	sɪɾkɛʃ
سرکشی	sɛɾkʃi
سرکل	sɛɾkəl
سرکٹس	sərkɪts
سرگرمی	sərgəɾmi
سرگرمیوں	sərgəɾmijõː
سرگوشی	sərgoːʃi
سرینا	səɾiːnɑː
سزا	səza
سزایابی	səzɑjɑːbiː
سست	sɪst
سستا	sɪstɑ
سستی	sɑsti
سستے	səsˈteː
سسٹم	sɪst̪əm
سسٹمز	sɪst̪mz
سسکنا	sɪskənɑ
سطح	sɑt̪ʰ
سطحی	sətˈhɪ
سطحیں	sət̪ɦeːŋ
سعودی	sɑuːdiː
سعودیوں	sɑuːdijõː
سعودیہ	sɑʊdɪjɑ
سعید	sɛːʔiːd
سعیدکے	sɛːɪdkeː
سفارت	səfɑːrt
سفارتی	səfɑːrtiː
سفارش	səfɑːrɪʃ
سفاکانہ	səfɑkɑnə
سفر	səfɐɾ
سفر	səfɾ
سفری	səfri
سفید	sfeːd
سفیر	səfɪr
سلائڈ	sɑlɑɪɖ
سلائڈنگ	sɑlɑɪɖɪŋ
سلام	sɑlɑm
سلامت	sælɑmət
سلامتی	sælɑmti
سلسلوں	səlseːŋoː
سلسلہ	səlseːŋɑ
سلسلے	sɛlsæŋgeː
سلطان	sʊlˈt̪ɑːn
سلطنت	səlˈt̪ənt̪
سلطنتوں	səlʈn̪t̪oːŋ
سلطنتِ	səlt̪ənt̪eː
سلمی	salmi
سلوا	sɪlwɑ
سلوک	sɪluːk
سلویو	səlʋiː
سلیش	səliːʃ
سلیپر	səliːpər
سلیکس	sɪlɪkʰ
سلیکٹر	sɪlikt̪əɾ
سلیکٹرز	sɪlikt̪əɾz
سم	sɪm
سماجی	səmɑːdʒi
سمارکا	səmaːrka
سماعت	sʌmɑːt
سماعتوں	səmaːt̪oːn
سمبھالتا	ɪmbʱɑːl̪ɪt̪ɑː
سمت	sɪmət
سمتار	sʌmtɑːr
سمتبر	sʌmt̪eːbɾ
سمجھ	sʊmɟʱ
سمجھا	sʊmgʌ
سمجھاؤنگا	səmɟʱɔːŋgə
سمجھانا	sʊmɟʱɑːnɑ
سمجھتا	səmgʱt̪ə
سمجھتی	səmˈgʱt̪i
سمجھتیں	sʊmgʱt̪iː
سمجھتے	səmgʱt̪eː
سمجھدار	səmɟʱd̪ɑːr
سمجھنا	səmˈgɑ̃nɑ
سمجھنے	sʌmgʱne
سمجھوتا	səmɟʱoːt̪ə
سمجھوتہ	sʊmɟʱoːt̪ʰə
سمجھوتے	səmɟʱoːt̪eː
سمجھی	sʊmgʱi
سمجھیں	səmgʱẽː
سمجھے	sʌmɟʱe
سمز	sɪmz
سمسٹر	sʌmsʌt̪r̪
سمعی	sɪmʔiː
سمن	sɪmn
سمندر	səmandəɾ
سمندروں	səmənˈd̪əroː
سمندری	səmənˈd̪riː
سمنوی	sʌmnoːi
سمٹی	sʌmtiː
سمیت	səmiːt
سمیٹ	sɪmɪt
سن	sən
سنئے	sənɛ
سنا	sɪnɑː
سناؤ	sənɑːu
سنائی	sənɑːi
سناتا	sənɑːtɑː
سنانے	sənɑːne
سنایا	sənɑːjɑː
سنبل	sənˈbəl
سنبھال	sənbɑl
سنبھالتے	sənbʱɑːlte
سنبھالو	sənbʱɑːloː
سنبھالیں	sənbʱɑːlẽː
سنبھل	sənbʱəl
سنتا	sɪntə
سنتان	sɪntɑn
سنتری	sənˈt̪riː
سنتے	sənte
سنجیدگی	səndʒiːd̪giː
سنجیدہ	səngiːðə
سنسنی	sənsəni
سنن	sənː
سننا	sənnə
سننی	sənniː
سننے	sənne
سنو	sɪnu
سنوڈن	sʊnʊd̪n
سنوگی	səˈnʊgi
سنوگے	səˈnʊge
سنٹرل	sənteːɾəl
سنچری	səntʃəriː
سنڈریلا	sənɖrɪlə
سنڈی	sʌnɪ
سنک	sɪŋk
سنکیتوں	sɪŋkɪtõː
سنگتراشی	səŋgt̪əɾɑːʃiː
سنگسار	səŋgsɑr
سنگل	səŋgəl
سنگین	səŋgiːn
سنہ	sənə
سنہری	sənɦəɾiː
سنہرے	sənɦeɾeː
سنی	səniː
سنیں	səniː
سنیے	səniː
سنے	səne
سو	sɔ
سوئمنگ	soːɪmŋ
سوئنگ	sojŋ
سوئٹزرلینڈ	soʔeːt̪zəɾlɑːnd̪
سوئچ	soj
سوئیاں	sojjɑ̃
سوا	sɑwɑ
سوائے	soɑe
سوات	suːəʈ
سوادج	soʊdʒ
سوار	sʋɑːr
سوارتی	sʋaːɾtiː
سواروں	sʋɑːrʊ̃ː
سواری	soɑri
سوال	sɑwɑl
سوال	səʋɑːl
سوالات	soʊɑːlɑːt̪
سوتیلی	soːtiːliː
سوتیلے	soːtɪleː
سوتے	soːt̪eː
سوجانا	soːdʒɑːnɑː
سودا	soːd̪ə
سودے	soːd̪eː
سور	sɔːr
سوراخ	soːrɑːx
سورج	soːɾdʒ
سوری	sʊriː
سوریکی	sɔːɾɪki
سوزاک	soːzæk
سوسن	soːsən
سوشل	ʃoːʃl
سول	sɔl
سولو	soːloː
سولہ	soːlə
سولی	sʊli
سوم	sɔːm
سوموار	soːmoːrɑː
سونا	sʊnɑ
سونامی	soːnamiː
سونورا	sʊnʊrɑ
سونپ	sõːnp
سونگھتے	soŋgʱte
سونے	sʊnne
سوویت	soːʋeːt
سوٹ	sʊʈ
سوٹکیس	sʊʈkɪs
سوچ	soːtʃ
سوچا	soːtʃə
سوچتا	soːtʃt̪ə
سوچتی	soːtʃt̪iː
سوچتے	sʊtʃt̪e
سوچلو	soːtʃloː
سوچنا	sʊtʃnɑ
سوچنی	soːtʃniː
سوچنے	soːtʃne
سوچو	sʊtʃo
سوچیں	sʊtʃeː
سوچے	soːtʃe
سوڈا	soːɖə
سوڈان	soːɖɑːn
سوک	sɔk
سویا	sojə
سویرے	soːiraː
سویلین	səwilɪn
سویوستیت	sojʋiːst̪eːt̪
سویٹی	soːiːtiː
سْلجھا	səlgʱɑ
سْن	sɪn
سْنا	sɪnə
سْنتا	sɪntə
سْنتے	sənte
سْنو	sɪnʊ
سْنّے	sɪnːe
سٹائل	ʃtɪɑːl
سٹار	sɪtɑːr
سٹارک	stɑːɾk
سٹاپ	stɑp
سٹرائیکر	ɪsˈtɾɑːɪkəɾ
سٹرپ	st̪əɾp
سٹریٹ	strɛːt
سٹریچر	strɛtʃər
سٹو	ʃt̪oː
سٹور	ɪsˈtoːr
سٹوریج	sʈoːɾɪdʒ
سٹول	ʃt̪oːl
سٹون	st̪oːn
سٹی	sʈiː
سٹیئرنگ	sʈeːɾeŋ
سٹیرائڈز	ɪsʈiːɾɑːɪd̪z
سٹیشن	ʃtɪʃən
سٹیشنوں	ɪsʈɪʃɔ̃ː
سٹیفن	sʈeːfən
سٹیفین	steːfeːn
سٹیل	ʃt̪iːl
سٹیمپ	stɪmp
سٹینڈ	stæ̃ːnd̪
سٹیو	steɪvo
سٹیون	sʈeːʋən
سٹیوی	sʈiːʋiː
سٹیٹ	sɪt̪ːeːt̪
سٹیٹس	sɪt̪ːeːt̪s
سٹیک	st̪eːk
سپارٹا	spɑːɾt̪ɑː
سپانسرز	spɑːnsɑːrɪz
سپاٹ	spɑːʈ
سپاہی	spəɦiː
سپاہیو	spəhɪo
سپاہیوں	spəhɪjõː
سپجوادی	spəˈgoʊɑːd̪iː
سپر	səpər
سپرد	spəɾd
سپرمین	spəɾmiːn
سپرنٹنڈنٹ	spəɾn̪t̪n̪d̪ənt̪
سپریم	spəɾeːmiː
سپلائی	spəlɑi
سپنج	spəŋdʒ
سپورٹس	spuːɾts
سپوٹار	spoːt̪əɾ
سپیس	spiːs
سپیشل	spiːʃəl
سپیل	spiːl
سچ	sətʃ
سچ	sɪtʃ
سچا	sɪtʃɑː
سچائی	sɪtʃɑːi
سچے	sɪtʃeː
سڈنی	sɪɳɪ
سڑ	səɽ
سڑا	səɽə
سڑک	səɽk
سڑکوں	səɽkõː
سڑی	səɽiː
سڑے	səɽe
سکا	skɑː
سکاؤٹ	skɑːuʈ
سکارف	skɑːɾf
سکتا	skɪt̪ə
سکتی	skɪt̪i
سکتیں	skɪt̪iːŋ
سکتے	skʌt̪eː
سکرٹ	skɪrʈ
سکرپٹ	skɪrɪpt
سکرین	skɪɾiːn
سکریپ	skɪɾeːp
سکریچ	skɪɾɪtʃ
سکس	sɛks
سکو	skʊ
سکواڈرن	skɔːɽən
سکور	skoːr
سکول	skʊl
سکول	sʊkuːl
سکون	skun
سکون	sʊkuːn
سکوپ	skoːp
سکوں	skõː
سکڈ	skɑd
سکھا	skʰɑː
سکھاؤ	skɑːxɑːu
سکھائیں	skɑːˈhɛ̃ː
سکھانے	skʰɑːne
سکھایا	skɪɣɑːjɑː
سکی	ski
سکیل	skɪl
سکیٹ	skɪt
سکیں	skẽː
سکے	skɛ
سگار	sɪgɑr
سگرٹ	sɪgəɾt
سگریٹ	sɛgɪɾət
سگنل	sɛngəl
سگنلز	sɪgnəlz
سہ	sə
سہا	səɦɑː
سہارا	səhɑːrɑː
سہارے	səhɑːre
سہاونا	səhɑuːnə
سہتے	səht̪eː
سہج	səhɑdʒ
سہنا	səhnɑ
سہولت	suːlət̪
سہولت	səhʊlt
سہولیات	səhʊljɑːt̪
سہکارمی	səhkɑːrmiː
سہی	səhiː
سی	siː
سیاح	sɪɑːh
سیاحت	siːɑːt̪
سیاحوں	siɑːɦõː
سیاروں	sɪɑːroː
سیارہ	siːɑːrɑː
سیارے	siːɑːreː
سیاست	siːʔɑːsˈt̪
سیاسی	siʔiː
سیاق	siːɑq
سیال	siːɑːl
سیاہ	siɑː
سیب	siːb
سید	sɛɪd
سیدھا	sɪdeːhɑː
سیدھی	ˈsɛːd̪ʱiː
سیدھے	sɪdeː
سیر	sɪr
سیرم	sɪrm
سیریز	siːriz
سیریس	siːɾiːs
سیسو	sɪsoː
سیشن	siːʃn
سیفٹیز	siːftiːz
سیل	siːl
سیلاب	siːlɑːb
سیلاس	siːlɑs
سیلفون	sɪlfʊn
سیلمن	sɪləmən
سیلولر	siːluːr
سیم	sɪm
سیمانکن	siːmɑːnkənek
سیمسٹرز	sɪmsʈərz
سیمپل	sɪmpəl
سیمیںٹ	siːmẽːʈ
سینئر	sɪneːr
سینتیس	sɪntis
سیندائی	siːnd̪ɑːiː
سینٹ	sɛ̃ːt̪
سینٹر	sɪnt̪ər
سینٹوس	sɪnːoːs
سینڈوچ	sɛ̃ːnd̪ʊtʃ
سینکا	sɪnkə
سینکڑوں	sɪŋkəɽõː
سینگ	sɪŋ
سینہ	sɪnə
سینیٹ	sɪniːt
سینیٹر	sɪnɪt̪ər
سینیٹرز	sɪneːt̪ərz
سینے	sɪneː
سیون	sijun
سیٹ	siːt̪
سیٹل	siːtəl
سیٹلائٹ	siːt̪lɑɪt̪
سیٹی	sɪtiː
سیٹیں	siːt̪eːn
سیڈان	siːd̪ɑːn
سیڑھیاں	siɽʰiæ̃
سیڑھیوں	siːɽʰiːõː
سیکرٹ	siːkəɾət
سیکرٹری	siːkərt̪riː
سیکسوفوں	siːksʊfuːŋ
سیکسی	siːkʃiː
سیکشن	siːkʃən
سیکنڈ	sɪkə̃ːnd̪
سیکورٹی	siːkuːrtiː
سیکوریٹی	siːkoːriːtiː
سیکڑوں	siːkəɽoː
سیکھ	siːkʰ
سیکھا	siːkʰɑː
سیکھتے	siːkʰteː
سیکھنا	siːkʰnə
سیکھنے	siːkʰne
سیکیورٹی	sɪkiːuɾt̪iː
سیکیوریٹی	siːkiːuːriːtiː
سییلی	siːliː
سے	seː
ش	ʃ
شµµ	ʃɪk
شµé	ʃɪk
شءِ	ʃɛ
شا	ʃɑː
شاؤلن	ʃɑːʊlən
شائد	ʃɑːɪd
شائستہ	ʃɑːɪsˈt̪ʰe
شائع	ʃɑːʔiː
شائقین	ʃɑːɪqɪn
شائِستہ	ʃɑːɪst̪ə
شاباش	ʃɑbɑʃ
شاخ	ʃɑx
شادی	ʃɑːdiː
شاذ	ʃɑːd̪
شارامن	ʃɑːrɑːmɪn
شارمین	ʃɑːɾmiːn
شارٹ	ʃɑːɾʈ
شارک	ʃɑːɾk
شافٹ	ʃɑfːt
شالوم	ʃɑːlʊm
شام	ʃɑːm
شامل	ʃɑːmɪl
شان	ʃɑːn
شاندار	ʃɑːnd̪ɑːr
شانہ	ʃɑːnɑː
شاٹ	ʃɑːʈ
شاٹس	ʃɑːʈs
شاٹگن	ʃɑːʈgən
شاپنگ	ʃɑːpɪŋ
شاگرد	ʃɑːgəɾd
شاگردوں	ʃɑːgʌɾd̪oːŋ
شاہ	ʃɑː
شاہانہ	ʃɑːhɑːnɑː
شاہراہ	ʃɑːɦɑːɾɑː
شاہکار	ʃɑːhkɑːr
شاہی	ʃɑːɦiː
شاید	ʃɑːjɪd
شب	ʃæb
شبدانش	ʃəbd̪ɑːnʃ
شبدجال	ʃəbdʒɑl
شبہ	ʃæbʌ
شبہے	ʃɛbeː
شبے	ʃbeː
شتر	ʃt̪r
شترمرغ	ʃt̪əɾmərɣ
شجوفرینیا	ʃʊdʊfeːniːjə
شخس	ʃɪxɪs
شخص	ʃʌx
شخصیات	ʃəkɪlɪjɑːt̪
شخصیت	ʃəxsiːt
شدت	ʃɪd̪t̪
شدہ	ʃɪd̪ə
شدید	ʃɪdiːd
شراب	ʃəɾɑːb
شرابا	ʃəɾɑːbɑː
شرابی	ʃəɾɑːbiː
شرافت	ʃəɾɑːft
شراکت	ʃəɾɑkət
شرح	ʃəɾɣ
شرط	ʃɑɾt
شرطیہ	ʃəɾt̪iə
شرفا	ʃəɾfɑ
شرفاوں	ʃəɾfɑ̃ː
شرم	ʃəɾm
شرماو	ʃəɾmɑːu
شرمن	ʃɛrmən
شرمناک	ʃəɾmənɑk
شرمندا	ʃəɾmənɽɑ
شرمندگی	ʃəɾməndgi
شرمندہ	ʃərməndə
شرمگاہوں	ʃəɾməgɑːɦõː
شروع	ʃəroʊ
شروعات	ʃəruʋɑːt̪
شروعاتی	ʃəruːʋɑːtiː
شرٹ	ʃɛɾt
شرٹوں	ʃɪɾt̪oːŋ
شرکت	ʃəɾkət
شریان	ʃəɾijɑːn
شریمان	ʃɪɾiːmɑːn
شریمتی	ʃɪɾeːmɪtiː
شش	ʃɪʃ
ششش	ʃɪʃ
شعبہ	ʃæbɑ
شعبے	ʃæbæ
شعر	ʃɛɾ
شعلوں	ʃoːleː
شعلوں	ʃəɭoːn
شعلہ	ʃoːlɑː
شعلے	ʃoːleː
شعلے	ʃəleː
شعور	ʃɑʋuːr
شفا	ʃɪfɑː
شفاف	ʃɪfɑːf
شفافیت	ʃəfɑːfɪt
شفقت	ʃəfqət
شفٹ	ʃɪft
شق	ʃq
شقیں	ʃqeːŋ
شمار	ʃmɑr
شمال	ʃɑmɑl
شمالی	ʃɑmɑliː
شمس	ʃæms
شمعیں	ʃəmeː
شمولیت	ʃmoːlɪt
شمٹ	ʃmɪt
شناخت	ʃənaːxt
شناختی	ʃɪnɑːxt̪iː
شنید	ʃnɪd
شو	ʃoː
شور	ʃoːr
شورش	ʃuːɾaʃ
شورویروں	ʃoːɾʋiːɾoːn
شوریٰ	ʃʊriː
شوز	ʃoːz
شوقین	ʃoːqɪn
شوٹ	ʃoːt
شوٹر	ʃʊt̪əɾ
شوٹنگ	ʃoːʈŋ
شوکیا	ʃoːkijɑː
شوہر	ʃoːɦər
شٹ	ʃʈ
شپ	ʃɪp
شپنگ	ʃpəŋ
شک	ʃɪk
شکار	ʃɑkɑr
شکاری	ʃəkɑːriː
شکاگو	ʃkɑːgoʊ
شکایات	ʃkɑjɑt
شکایت	ʃkɑːʔt̪
شکایت	ʃɪkɑːjɪt̪
شکر	ʃkər
شکر	ʃʊkɾ
شکرگزار	ʃəkəgzɑr
شکریہ	ʃəkɾiː
شکست	ʃəkst
شکل	ʃkəl
شکلوں	ʃkəlõː
شکلیں	ʃkəlī̃
شکن	ʃkən
شکنی	ʃkni
شکنیں	ʃkənẽ
شکوک	ʃʊkoːk
شکیل	ʃɪkɪl
شگاف	ʃəgɑːf
شگاگو	ʃəgəgʊ
شہ	ʃɛ
شہا	ʃɑhɑ
شہادت	ʃɑhɑːd̪t̪
شہباز	ʃɑɦbɑːz
شہباز	ʃɛɦbɑːz
شہج	ʃɛɣ
شہد	ʃɛɦd
شہر	ʃæɦɾ
شہر	ʃɛɾ
شہر	ʃɛːɾ
شہرت	ʃɛɦɾət
شہروں	ʃɛɦɾoːn
شہرِ	ʃɛɾ
شہری	ʃəhriː
شہری	ʃɛʱɾiː
شہریوں	ʃəhrijoːn
شہزادہ	ʃɛˈzɑːd̪ə
شہزادی	ʃɛhzɑːdiː
شہزادے	ʃɛhzaːd̪eː
شہس	ʃɛhs
شہسµµ	ʃɛhsɛh
شہسہ	ʃɛhsɛ
شہسہا	ʃɛhsɛhɑ
شہع	ʃɑhɑ
شہنشاہ	ʃɛhənˈʃɑːh
شہوت	ʃɛɦoːt
شہید	ʃɛːɪd
شیئرنگ	ʃɛːɾeŋ
شیاطین	ʃɑjɑːtɪn
شیخ	ʃɛx
شیخی	ʃɪxɪ
شیر	ʃiːr
شیرف	ʃɪɾf
شیروں	ʃɪˈɾoːn
شیشہ	ʃɪʃə
شیشے	ʃɪʃe
شیطان	ʃɪt̪t̪ɑːn
شیطانی	ʃɪtɑːni
شیعہ	ʃiːʕə
شیلف	ʃɪlf
شیلٹر	ʃɪlt̪ər
شیلیوں	ʃɪlijõː
شیمپین	ʃɪmpɪn
شین	ʃiːn
شیپرڈ	ʃɛpərɖ
شیڈو	ʃɛːɖoː
شیڈول	ʃɛːɽuːl
ص	s
صµµ	sɪn
صµذ	sʊd̪ʒ
صاحب	sɑhɑːb
صاحبان	sɑːhbɑːn
صارفین	sɑːrfiːn
صاف	sɑːf
صافی	sɑːfiː
صبح	sʊbh
صبح	sʊbʱeː
صبح	sʊbʱoː
صبح	sʊbʱɑː
صبر	səbr
صبر	səbɾ
صحارا	səˈɦɑːɾɑː
صحافی	səˈɦɑːfi
صحافیوں	səɣɑːfijõː
صحت	sˁɑt
صحرا	sɑhɾɑ
صحراء	θaːɾiːb
صحن	sɑhn
صحیح	səˈɦɪ
صد	sɪd
صدارتی	ɪsɑːd̪ʌt̪iː
صداق	sɪdɑːq
صدام	θɑːdɑːm
صدر	sˈd̪r
صدمے	səd̪me
صدی	sɪdɪ
صدیوں	sɪdɪ̃ː
صراط	sˈrɑt̪
صرف	sərf
صف	səf
صفائی	səfɑːiː
صفایا	səfɑːjɑː
صفحات	səfɑhɑt̪s̪
صفحہ	səfə
صفر	sˈfɪr
صفوں	səfõː
صلاح	sɑlɑħ
صلاحیت	səlɑɦiːt̪
صلاحیت	səlɑːɦɪjət̪
صلاحیتوں	səlɑhɪtiːõː
صلی	sɪli
صلیب	sɪliːb
صندوق	sʊnˈdɔːŋ
صنعت	sənˈʔet
صوبوں	sɔbɔ̃
صوبہ	sʊbeh
صوبے	sɔbe
صور	sʊr
صورت	sɑrʊt
صورتحال	sʊrt̪əɦɑːl
صورتیں	sʊɾt̪iːŋ
صہ	sɑh
صہْ	sɑh
ض	ð
ضµé	ɖʊ
ضµéارإ	ɖʊm
ضء	ðə
ضآؤاط	ɖɑɑʔɑːt̪
ضآؤب	ɗɑoːb
ضأت	ðəʔ
ضائع	ɖɑːɪs
ضار	ɖɑr
ضامن	ðɑːmine
ضبط	ɖəpʈ
ضد	ðˈʌd
ضدی	ɖʊɖiː
ضرر	ðərr
ضروت	ɖʌroːt
ضرور	ðəroːr
ضرورت	ðəroːt̪
ضروری	ðəɾuːriː
ضروریات	ðəɾuːɾijɑːt
ضلع	ɖəlʋ
ضم	ðʊm
ضمانت	ðʊmɑːnət
ضمنی	ɪnðʊmiː
ضمیر	ðʊmɪr
ضوابط	ɖʊɑːbɪt̪s
ضہخہج	ðʌxʌdʒ
ط	ʈ
طأç	ʈɑːʔ
طار	t̪ɑːr
طاری	ʈɑːɾiː
طاس	ʈɑːs
طاقت	taːqt̪
طاقت	t̪ɑːqət
طاقتور	taːqt̪uːr
طاقتوں	taːqt̪õː
طاقتیں	taːqt̪iːŋ
طالاب	ʈɑːlɑːb
طالب	ʈɑːlɪb
طالبان	ʈɑːlɪbɑːn
طالو	tɑːlʊ
طب	t̪b
طبعی	ʈəbeːʋiː
طبقہ	ʈaːbɪɣɑː
طبقے	ˈt̪əbleɪ
طبی	ʈəbi
طبیعیات	ʈəbiːʕijɑːt
طرح	θɑɾʒ
طرخ	t̪əɾx
طرز	t̪əɾz
طرزِ	t̪əɾzi
طرف	t̪əɾf
طرفہ	ˈt̪əɾfeh
طریق	ʈəɾɪq
طریقوں	ʈɪɾɪqʊ̃
طریقہ	ʈəɾɪqə
طریقے	ʈɪɾɪkeː
ططرف	ʈʊɾɾəf
طلائی	t̪əlaːi
طلاق	t̪ɑːlɑːq
طلب	t̪əlæd̪
طلسمی	ˈt̪əlsəmi
طلوع	t̪əˈluː
طور	t̪uːr
طوفان	ʈoʊfɑːn
طوفانوں	ʈoʊfɑːnõː
طول	ʈoːl
طویل	ʈʷiːl
طہهہ	t̪əɦɛ
طیاروں	ʈɑjɑːroːŋ
طیارہ	ʈɛːɑːɾɑː
طیارے	ʈɑːjɑːrɛ
طیبہ	ʈiːbə
طے	ʈeː
ظ	ðˈʐ
ظµ	ð
ظµé	ð¨
ظء	ð¨
ظءظ	ðð
ظأئ	ðˁɑːʔ
ظؤ	ðð
ظاàب	ðʌb
ظاàہج	ðˈzɑːhɑːdʒ
ظاد	ðˈzɑːd
ظالم	ðˁælæm
ظالمانہ	ðˁɑlmɑnɑ
ظالموں	ˈʒɑːlmẽ
ظاہر	ðˁɑːhɪr
ظریفی	ðˁɾiːfi
ظفر	θafɪr
ظلم	ðʒælm
ظم	ðʒ
ظن	zun
ظہ	ðˁɑ
ظہâءِ	ðʌhɑː
ظہبی	ðˁæbi
ظہج	ðˁɑdʒ
ظہرانہ	zoɦɾɑːnɑː
ظہور	θɔkʊr
ع	ə
عءز	əˈzæz
عءِ	əj
عأؤ	əʔoʊ
عؤ	əʊ
عائد	əjɪd
عاجزی	əjzi
عاد	ɑːd
عادت	əˈd̪ət̪
عادل	ədaːl
عادی	əˈɑːdi
عارضی	ɑːɾɪdʒiː
عالم	ælæm
عالمِ	ɑlɑmɪ
عالمی	əˈlɑmɪ
عالمین	ælɑmɪn
عالی	ɑːliː
عالیشان	əˈlɪʃɑːn
عالیہ	ɑːliːɑː
عام	æm
عام	ʕä̃ːm
عبادات	əbɑːd̪ət̪
عبادت	əbd̪ət̪
عبادتیں	əbaːd̪tiːŋ
عبدالحئی	ˈʔabdulxɛː
عبدالرحمان	ˈʔabdulrɑhˈmɑn
عبداللہ	ˈʔabdullɑh
عبرت	əbraːt
عبور	ɑbʊr
عجائبات	ədʒɑːbɑːt̪
عجلت	əgʌɭt
عجیب	əˈdʒiːb
عدالت	əd̪ɑːlɪt̪
عدالتوں	əd̪ʌl̪t̪oːn
عدالتی	ədaːlɪti
عدم	ʔɪd̪m
عدولی	əɽuːliː
عذاب	əzaːb
عذر	əˈðɾ
عراق	ʔɪˈrɑq
عراقی	ʔɪˈrɑqi
عراقیوں	ʔɪrɑːqijõː
عرب	ɑrəb
عربوں	əɾbõː
عربیوں	ʔaːrbijoːn
عرش	əɾʃ
عرصہ	ɑrsə
عرصے	əɾsə
عرضی	ɪɾsɑː
عرفی	ʔɪrfi
عروج	əroːdʒ
عریاں	əɾɪjɑ̃
عزائم	ʔazɑːm
عزت	ʔɪzzət
عزت	ˈʔɪzzət
عزم	ˈʔazm
عزیز	əziːz
عسکری	əskəriː
عسکریت	əskiriːt
عصمت	əsˈmət
عضام	ʊsˈsɑm
عطا	əʈɑ
عطیہ	əttiə
عظمت	əzmət
عظیم	əˈziːm
عقائد	əqɑːʔiːd
عقابوں	əqɑːbõː
عقل	ɑqːl
عقل	ʔəql
عقلمند	əqəlmənd
عقیدہ	əqɪdə
عقیدے	əqɪdeː
علاج	ʋɪlɑːʒ
علاقوں	əlaːqõː
علاقہ	əˈlɑːqə
علاقے	əlaːkeː
علامات	əlɑmɑkɑt̪
علامت	əˈlɑːmət
علامتوں	əlaːmətõː
علامتی	ɑːlɑːmɑːtiː
علان	əˈlɑːn
علاوہ	əlaːwa
علم	ælɪm
علم	ʔɪlm
علمدار	æləmd̪ɑːr
علموں	ælmoːn
علیحدہ	əliːɦd̪ə
علیکم	ɑlɪkæm
علیہ	əɭɪ
عما	əˈmɑ
عمار	ʔamˈmaːr
عمارت	ʔʊmɑːrət
عمارتوں	ʔʊmɑːɾtõː
عمارتیں	ʔɑmɑrˈt̪iːŋ
عمان	ʔʊmɑːn
عمدہ	əmd̪ə
عمر	ʔomr
عمرہدئی	ʔʊmɾeɦdeː
عمل	ʔamal
عملدار	ʔamald̪ɑːr
عملدرآمد	ʔamlaːdraːməd
عملوں	ʔamloːŋ
عملہ	ʔamla
عملی	ʔamli
عملے	ʔamle
عنصر	ʔənsˈlˤ
عنقریب	ʔʊnqiːb
عنوان	əntɑːn
عنوانات	əˈnɑːnɑːt
عوام	əˈvɑːm
عوامی	əˈʋæːmi
عورت	əʊrət
عورت	ʔɔːɾət
عورتوں	əʊɾtõː
عورتيں	ʔuːrt̪eːŋ
عورتیں	əʋəɾt̪iːŋ
عوض	ʔuːdʒ
عکاسی	əˈkɑːsi
عکس	əks
عہ	ə
عہج	əɣ
عہد	əɣəd
عہد	ɛɦɛd̪
عہدوں	əɦd̪oːŋ
عہدہ	əħd̪ə
عہدیدار	əɦd̪iːd̪ɑːr
عہدیداروں	əɦd̪iːd̪ɑːroːŋ
عہدے	əɣəd̪eː
عیسائی	əjsɑːiː
عیسائیت	əjsɑːjiːt
عیسائیوں	əjsɑːjõː
عیسی	əjsi
عیسیٰ	əjˈsiː
عیش	əjʃ
عین	əjn
عینک	əɪŋk
غ	ɣ
غµéہج	ɣʊmɛɣ
غµéہد	ɣʊmɑːd
غأ	ɣɑː
غائب	ɣɑːiːb
غار	ɣɑːr
غارت	ɣɑːɾt
غازہ	gɑːzə
غاص	ɣɑs
غاط	ɣɑːt
غافل	ɣɑːfɪl
غالب	ɣɑlɪb
غبارے	ɣʊbɑːre
غدار	ɣɑːd̪ɑːr
غداری	ɣɑːdɑːri
غذا	ɣɑːd̪ɑː
غرائب	gʁɑːɪb
غربت	ɣʌɾˈbɪt
غرض	ɣɑrɖ
غرضی	ɣəɾsəɪ
غرق	ɦʌq
غروب	ɣʊrob
غرور	gʁoːr
غریب	ɣəɾiːb
غریب	ɣɪˈɾiːb
غزہ	ɣəza
غسل	ɣəsəl
غصہ	ɣʊsə
غصیلے	ɣəsɪle
غصے	ɣʌsɛ
غلام	ɣlɑm
غلاموں	ɣʌləmoː
غلبہ	ɣʌlbe
غلبے	ɣʌlbe
غلط	gʌlt̪
غلطی	gʊlti
غلطیوں	gʌlʈijõː
غلیظ	ɣəliʐ
غم	ɣəm
غم	ɣʌm
غمزدہ	ɣʊmzde
غموں	ɣʊmõ
غمگین	ɣʌmgiːn
غنڈا	ɣə̃ɳɖɑ
غنڈوں	gʌɳɖõː
غوتا	ɣoʈɑ
غور	ɣoːr
غْصل	ɣəsˈsˁːl
غْصّہ	ɣəsːə
غٹاغٹ	ɣʈɑɣʈ
غہ	ɣə
غہا	ɣɑː
غہج	ɣəɣ
غیر	ɣɪˈri
غیرت	gʱɪrət
غیرتی	gʱɪrti
ـ	ʔ
ـء	ʔ
ـءِ	ʔi
ـؤ	ʔoː
ـئاہجءز	əɪhɟəz
ـئاہش	əɪʃ
ـار	ɑr
ـاط	ɑːt̪
ـب	b
ف	f
فءِ	feː
فآëہ	fəɑːh
فاؤنڈیشن	foʊnˈdiːʃən
فائدہ	fəˈʔiːd̪ə
فائدے	fəid̪eː
فائر	feɪr
فائرنگ	feɑːrɪŋ
فائز	feːz
فائل	fæɪl
فائلوں	fæɪlõː
فائو	fəʔoː
فائٹر	feɪt̪ər
فائی	fəi
فائیو	fəɪvoː
فاتح	faːt̪ʰ
فاد	fəɽ
فار	fɑr
فارس	fɑːrɪs
فارسی	fæɾˈsiː
فارسیوں	fəɾˈsijõː
فارغ	fəɾɣ
فارم	faːrm
فارما	fɑːrmɑː
فارمولے	fərmuːlə
فارمیسی	fəɾmiːsi
فارمیسیوں	fɑːrmeːsɪ̃oː
فارورڈ	faːroːɾɑːɾd
فاریسٹر	fəɾɪsʈəɾ
فاسفورس	fɑːsfʊrs
فاسٹ	fəˈsːt
فاصلوں	fəsəlɔ̃
فاصلہ	fəsələ
فاصلے	fəsəlleː
فاط	fəˈt̪ɑː
فاك	fəˈk
فالو	foluː
فالٹ	foːlʈ
فانی	fəniː
فاڑ	fəɽ
فتح	fəˈtɑː
فتنہ	feːt̪nə
فجر	fəgər
فجی	feːgiː
فخر	fəxər
فدیہ	fɪd̪ɪjɑː
فرائض	fəɾɑːɪs
فرات	fəˈrɑːt
فراج	fəˈrɑdʒ
فرار	fəˈrɑr
فراز	fəˈrɑz
فراموش	fəɾɑːmoːʃ
فرانس	fəˈrɑːns
فرانسسکو	fəˈrɑːnsəskoː
فرانسیسی	fəˈrɑːnsiːsiː
فراڈ	fəˈɾɑːd
فراہم	fəɾɑːm
فراہمی	fəɾɑːmi
فرتیلی	fəɾtɪli
فرد	fəɾd
فرسودہ	ɪ̃sˈɾoːd̪ə
فرش	fəɾʃ
فرشتوں	fəɾʃtõː
فرشتہ	fɪrʃt̪ə
فرشتے	fəɾʃt̪eː
فرض	fəɾdʒ
فرعون	fəɾˈʔɑuːn
فرق	fəɾq
فرقے	fəɾqe
فرما	fəɾmɑː
فرمائیں	fəɾmɑ̃ẽː
فرمائیے	fəɾmɑːjeː
فرمائے	fəɾmɑːe
فرمان	fəɾˈmɑːn
فرمانبرداری	fəɾmɑːnbərdɑːɾiː
فرمانی	fəɾmɑːni
فرمایا	fəɾˈmɑːjɑː
فرمایے	fəɾmɑːjeː
فرنانڈیج	fəɾnɑːnɪdʒ
فرنٹ	fɾənt
فرنٹیئر	fəɾn̪t̪eːɾ
فروخت	fəɾoxt
فروری	fəˈruːriː
فروغ	fəˈɾoːɣ
فرٹز	fɪrːts
فرہاد	fɪɾɑːd
فری	fəɾiː
فریب	fəˈɾeːb
فرید	fəˈɾiːd
فریسنو	fəɾɪsˈnʊ
فریق	fəɾɪk
فریقین	fəɾiːqɪn
فریم	frɛːm
فرینڈ	fɾeːɳɖ
فرینک	fəɾɪŋk
فرینکفرٹ	fəɾɪŋkfɪɾt
فریڈ	fəˈɾeːd
فریڈرک	fəˈɾɪk
فریگمنٹ	fəɾɪgmənt
فزکس	fɪkʰs
فسادات	fsɑːdɑːt̪
فشنگ	fəʃæŋ
فصل	fɑsˈl
فضا	fəˈdʒɑ
فضا	fɪzaː
فضائی	fəˈsɑi
فضل	fəɽl
فضلہ	fəɽlɑ
فضلے	fəɽe
فضول	fəˈd̪oːl
فضیح	fəˈziːh
فضیلت	fəˈsɪlːət
فطرت	faʈɾə
فطری	fəʈriː
فعال	fəˈkæl
فلائٹ	fəˈlɑːt
فلائی	fəˈlɑːi
فلافيوس	fəˈlæviːʊs
فلاپ	flɑp
فلاڈلفیا	flɑːdəlfiːjɑː
فلاڈیلفیا	flɑːdɪlfɪjɑː
فلر	fɪlɾ
فلسطین	filasˈtin
فلسطینی	filasˈtini
فلسطینیوں	fəlasˈtɪnijõː
فلسفہ	ɪsɪfɑː
فلسفے	ɸɪlsɪfeː
فلم	fɪlm
فلموں	filmoːn
فلمیں	filmẽ
فلور	fɔːlɔːr
فلورجنوب	flɔːrgʊnub
فلوریڈا	flɔːriːɽɑː
فلوٹ	foːlɔːt
فلٹرز	filteːrzə
فلپ	ɸəlp
فلپس	filips
فلکیات	fulkijɑːt
فلی	feːli
فلیش	feːliʃ
فلیٹ	feːlɪt
فلیپ	feːlip
فن	fən
فن	fɪn
فنا	fɪnɑː
فنتاسیوں	feːntɑːsijoː
فندا	fɪndɑ
فنسانا	fɪnsɑːnɑː
فنڈ	ɪnɖ
فنڈز	ɪngz
فنڈنگ	ɸʊnd̪ɪŋ
فوائد	foɑːjɪd
فوارہ	fəˈwɑːrɑː
فوارے	fəˈʋɑːɾeː
فوبیا	foːbijɑ
فوج	foːg
فوجداروں	foːɣd̪ɑːroːŋ
فوجوں	foːgoːŋ
فوجی	foːdʒiː
فوجیوں	foːdʒiːõː
فوجیں	foːgeːn
فور	fɔːr
فورا	foːrɑ
فوراً	foːrəm
فورس	foːɾs
فورسز	foːɾs
فورنیا	fʊrnɪjɑ
فورٹ	fɔːɾt
فورڈ	fɔːɾɖ
فوری	foːri
فولادی	foːlɑːdiː
فولڈر	foːld̪əɾ
فون	foːn
فونز	foːnz
فونٹ	foːnt̪
فوٹو	foːtoː
فوٹوشاپ	foːʈoʃæp
فوٹوگرافر	foːʈoːgrɑːfər
فوٹیج	foːtiːdʒ
فوڈ	foːɖ
فيلسوف	filsoːf
فٹ	ɸʊʈ
فٹس	ɸʊʈs
فڈرل	fəɽlɾ
فکر	fɪkər
فکرمندی	fəkrʌmːeːdi
فکسنگ	feːksəŋ
فہ	fə
فہûہخ	fəɣɑx
فہج	fəɣ
فہخµ	fəxʊ
فہرست	fəɾsət
فہم	fəˈɦæm
فہمی	fəmi
فی	fiː
فیدم	feːd̪m
فیس	feːs
فیسٹیول	feɪstɪuːl
فیصد	feːsad
فیصلوں	feːsəlõː
فیصلہ	feːsəlɑ
فیصلے	feːsɑle
فیلو	feːloː
فیلڈ	filːd
فیما	feːmɑː
فیملی	feːmɪliː
فینکس	feːnks
فیوہرر	feːuɦər
فیٹ	feːt̪
فیڈ	feːd
فیڈر	feːd̪əɾ
فیڈرل	feɪd̪ɾəl
فیڈریشن	feːd̪eːʃən
فیڈز	feːd̪z
فیکٹری	feːkʈeːriː
فیکٹریوں	feːkʈəɾiːõː
فیںکنا	feːŋkə
ق	q
قءُاك	qɔːk
قءِ	qɛ
قؤ	qoʊ
قئبہج	qɛbɑhɑdʒ
قا	qɑ
قائدانہ	qɑːiːdɑːnə
قائل	qɑːil
قائم	qɑːim
قابل	qɑːbɪl
قابلِ	qɑːbɪl
قابو	qɑːboː
قاتل	qɑːt̪əl
قاتلانہ	qɑːt̪lɑːnə
قاتلوں	qɑːt̪əlõː
قاصر	qɑːsˈsˈiːr
قاضی	qɑːzi
قاعدہ	qɑːˈeːd̪ə
قافلوں	qɑːfeːlõː
قافلے	qɑːfeː
قالین	qɑːlɪn
قانون	qɑːnʉn
قانونی	qɑnʊnˈiː
قبائلی	qɑbɑːiːliː
قبر	qɑβr
قبضہ	qʊbɑdʒə
قبضے	qəbɖə
قبل	qɑbɪl
قبول	qɑbuːl
قبیلہ	qɪˈbɪlə
قبیلے	qɪbɪleː
قتل	qɪtəl
قتلِ	qɪtˈlɪ
قد	qɑd
قدر	qɑdˈr
قدرت	qudrət
قدرت	qɑd̪eɾt̪
قدرتی	qɑdˈɾəti
قدردانی	qɑd̪rəd̪ɑːniː
قدرے	qɑdˈɾe
قدم	qɑdːem
قدموں	qɑd̪moːn
قدمی	qɑdˈmi
قدیم	qɑd̪iːm
قذافی	qəðafi
قرآن	qɑˈrɑːn
قرار	qɑrɑr
قربان	qɪrˈbɑːn
قربانی	qərbɑːniː
قرض	qɑɾd̪
قرضدار	qɑɾzˈd̪ɑːr
قرضہ	qəɾzə
قرضے	qəɾse
قریب	qɪɾiːb
قریبا	qɪɾiːbɑ
قریباً	qɪɾiːbɑːlɑː
قریبی	qɪɾiːbiː
قسط	qɪsˈt
قسطنطنیہ	qʊst̪ʊnt̪ʊnɪjɑːɦ
قسم	qɑsmɑ
قسمت	qɪsˈmɛt
قسمتی	qɑsˈmɛti
قسمیں	qɪsˈmeːn
قصائی	qɑsɑːi
قصاص	qɑsɑs
قصبے	qʌsbeː
قصہ	qəsa
قضاء	qɑːdʒɑː
قضیب	qəziːb
قطار	qɑtɑr
قطاروں	qɑːtɑːroː
قطبی	qɑt̪bɪ
قطرہ	qɑt̪rəh
قطرے	qʊt̪reː
قطع	qɛːt̪
قطعی	qɑtˈʕiː
قفقاز	qɑfqɑz
قلعہ	qəlæ
قلعے	qɪlə
قلم	qɪlm
قلم	qʌləm
قلیل	qɑliːl
قمر	qəməɾ
قمیص	qɪmɪs
قمیض	qʊmiːð
قواعد	qɑːˈʋɑːd̪eː
قوانین	qʷɑːnɪːn
قوت	qoːt
قوف	qoːf
قول	goːl
قوم	qɔːm
قوموں	qɔːmʊ̃
قومی	qʊmiː
قومیت	quːmɪt
قونصلیٹ	qʊnsəlɪt
قيروانی	qɪrʋɑːni
قْربانیاں	qɪrbɑːnijɑ̃
قٓ	q
قہ	qəh
قہج	qəhɑdʒ
قہجءِ	qəhˈdʒe
قہر	qɑr
قیادت	qɪɑːd̪eːt̪
قیام	qiːm
قیامت	qɪjɑːmət
قید	qɪd
قیدی	qɪdiː
قیدیوں	qɪdijoːn
قیف	qɪf
قیقاوٴس	qiːqɑːʋs
قیمت	qɪmət
قیمتی	qɪmti
ك	k
كµô	gʊ
كءز	kɑz
كءِ	keː
كأ	kaː
كؤع	koʊʔ
كاك	kɑk
كہü	kʰeː
ل	l
لµة	ləmə
لء	lə
لإُ	ləu
لئے	liː
لا	lə
لاء	lə
لاؤ	ləu
لاؤنج	ɭɑuːɲdʒ
لاؤڈ	ɭɑʊɖ
لائبریری	ləɪbɾiːriː
لائسنس	lɑːɪsəns
لائق	ləi̯q
لائن	lɑːɪn
لائنز	lɑːɪ̃ːz
لائنوں	lɑːɪnõː
لائنیں	ɭɑːĩẽ
لائٹ	lɑɪt
لائٹر	ɭɑɪt̪əɾ
لائٹس	ɭɑɪts
لائیسنس	lɑɪsɪns
لائیو	ləiwo
لائیوسٹاک	ɭɑjʊsˈtɑk
لائیں	ləɛ̃ː
لائیے	ləiːe
لائے	ləjɛ
لابسٹر	ləbɑst̪ər
لابی	ləbi
لات	lɑːt
لاتا	ləˈt̪aː
لاتوں	ləːtõː
لاتے	ləːt̪eː
لاجواب	ləʒʋɑb
لاد	ləd
لادن	ləd̪ən
لادینیت	lədiːnɪt
لار	ləɾ
لارنس	ləɾəns
لارڈ	ləɾɖ
لاری	ləɾi
لاریسا	ləɾiːsə
لاریڈو	ləɾɪɖo
لازم	ləzm
لازما	lɑːzmɑː
لازمی	ləzmɪ
لازوال	ləzoːʋəl
لاس	lɑs
لاسن	lɑːsən
لاش	ləʃ
لاشیں	ləʃeːn
لاطینی	ləɪt̪iːniː
لافلن	ləfələn
لال	lɑl
لالچ	ləːtʃ
لالچی	ləːtʃiː
لامتناہی	ləmt̪əneːhiː
لامحالہ	ləːməhɑːlə
لانا	ləˈnɑ
لانت	lɑːnt
لانس	ləns
لانگ	lɑːŋ
لانے	lənaː
لاو	ləʊ
لاوں	lɑ̃ː
لاٹ	ləʈ
لاٹوں	ləːʈoːn
لاٹھی	ləʈʰiː
لاپتہ	ləpʈə
لاپرواہ	ləproːəh
لاکٹ	ləkt
لاکھ	ləkʰ
لاکھوں	ləkʰoːn
لاگ	ləg
لاگت	ləgʌt
لاگز	ləgz
لاگو	ləˈgoː
لاگڈ	ləgːɪd
لاہور	ləɣoːr
لایا	ləjɑ
لب	ləp
لباس	ləˈbɑs
لباس	lɪbɑːs
لباسِ	ləbɑsɪ
لبرل	ɪbɾəl
لبرٹی	ləbɾətiː
لبنان	ləbˈnɑːn
لججاجنک	ləgʒəgənek
لحاظ	ləxɑːz
لرز	ɾeɾz
لرزاں	ɭəɾzɑ̃
لرس	ɾəs
لسٹ	lɪsʈ
لشکر	ləʃkər
لطف	ləf
لطیفے	ləˈt̪iːfe
لعنت	ləˈnːt
لعنتی	ləˈnːti
لغوی	ləɣoi
لفظ	ləfˈʒ
لفظوں	ləfɣoːn
لفظی	ləfʐiː
لفٹ	lɪft
لفٹیں	ləft̪eːn
للہ	ɑllə
لمبا	ləmbɑ
لمبورگینی	ləmpuːrgiːniː
لمبی	lʌmbiː
لمبے	ləmbɛː
لمحات	ləmˈhɑːt̪ʰ
لمحوں	ləmhoːn
لمحہ	ləməh
لمحے	ləmaːhɛ
لمو	ləmo
لمٹس	ləmt̪s
لن	lən
لندن	lənd̪ən
لنڈ	lə̃ɳɖ
لنڈا	lənd̪ə
لنڈبرگ	lənd̪bɛɾg
لنڈسے	lənd̪se
لنک	lənk
لنکاسٹر	ləŋkɑːst̪ər
لنگر	ləŋgər
لنگوٹ	ləŋgoːt
لنگڑے	ləŋgəɽe
لو	loː
لوئر	ɭoːər
لوئس	loːɪs
لوث	loːθ
لورا	ləroː
لورین	loːriːn
لوسرن	loːsɪrn
لوط	loːt̪
لوقا	loːgə
لولا	loːlɑ
لومبارڈ	ɭoːmbɑːɾɖ
لومس	lomːs
لومڑی	loːmɽiː
لونگا	loːŋgə
لونی	lʊni
لوٹ	loːʈ
لوٹنا	ɭoːʈnə
لوٹنے	ɭoːʈne
لوٹی	loːtiː
لوپ	loːp
لوڈ	ɭoːɖ
لوڈنگ	ɭoːɖəŋ
لوکیٹر	loːkɪt̪ər
لوگ	loːg
لوگو	loːgoː
لوگوں	loːgoːŋ
لوں	ɭoːŋ
لوہے	loːɑe
لُٹ	ɭʊʈ
لٹل	ɭʌt̪ːəl
لٹکا	ləɭt̪kə
لٹکانے	ləʈkɑːnɛ
لٹکتی	ləʈkʈi
لٹکی	ɭʈkɪ
لپ	ləp
لپیٹ	ləpiːt
لپیٹا	ləpiːt̪ə
لچک	lətʃk
لڑ	ləɽ
لڑا	ləɽɑ
لڑائی	ləɽɑːi
لڑاکا	ləɽɑkɑ
لڑتا	ləɽt̪ə
لڑتے	ləɽte
لڑرہے	ləɽəɽʰe
لڑنا	ɭəɽnə
لڑنی	ləɽni
لڑنے	ləɽne
لڑو	ɭəɽo
لڑونگا	ləɽoŋgə
لڑکا	ləɽkə
لڑکوں	ləɽkõː
لڑکھڑاتے	ləɽkʰəɽɑːte
لڑکی	ləɽki
لڑکیاں	ləɽkiˑæ̃
لڑکیوں	ləɽkɪ̃oː
لڑکے	ɭəɽkʰeː
لڑھک	ləɽʈk
لڑی	ləɽiː
لڑیں	ləɽeːn
لڑے	ləɽe
لک	lək
لکڑی	ləkrɪː
لکڑیوں	ləkɽijõː
لکھ	ləkʰ
لکھا	ləkʰə
لکھتے	ləkʰte
لکھنا	ləkʰnə
لکھنے	ləkʰne
لکھواتے	ləkʰʋɑːt̪eː
لکھی	ləkiː
لکھیں	ləkʰeːn
لکھے	ləkʰe
لکی	l̪eːki
لکیر	ləkiːr
لگ	ləg
لگا	ləgɑ
لگاؤ	ləgɑːo
لگائی	ləˈgɑːi
لگائیں	ləgɑ̃eː
لگائے	ləgɑːe
لگاتا	ləgətɑ
لگاتار	ləgətɑr
لگاتی	ləgəti
لگاتے	ləgɑːte
لگالیں	ləgɑːlẽː
لگام	ləgəm
لگانا	ləgɑːnɑː
لگانی	ləˈgɑːni
لگانے	ləgɑːne
لگایا	ləgɑjɑ
لگتا	ləgtə
لگتی	ləgti
لگتے	ləgte
لگرہا	ləgəɾhɑ
لگنے	ləgne
لگو	loːgoː
لگوا	ləgʋɑː
لگوں	ləgoːŋ
لگی	ləgi
لگیں	ləgeː
لگے	ləge
لہجہ	ləhˈdʒə
لہخµ	ləxʊ
لہخءِ	ləxə
لہذا	ləhðə
لہر	ləɾ
لہراتے	ləɦɾɑːt̪eː
لہرایا	ləɾɑjɑ
لہروں	ləɾoːn
لہٰذا	ləhɑːzə
لی	liː
لیا	liː
لیب	lɪb
لیبارٹری	liːbɑːrtrɪ
لیبل	liːbəl
لیبوریٹری	liːbuːrɪt̪riː
لیبیا	liːbijɑː
لیتا	liːt̪ɑː
لیتی	liːti
لیتے	liːte
لیجئے	liːdʒeː
لیجنڈ	leːgənɖ
لیزر	leɪzər
لیس	liːs
لیفٹیننٹ	liːft̪eːnənt̪
لیلن	liːn
لین	liːn
لینا	liːnə
لینس	lɪns
لینو	liːno
لینڈ	lɛːnd
لینڈنگ	lɛːnd̪ɪŋ
لینی	liːniː
لینے	liːne
لیوا	liːʋɑː
لیور	liːvər
لیوس	liːʊs
لیون	liːʊ̯n
لیٹ	liːʈ
لیٹرین	liːt̪rɛːn
لیٹش	liːʈʃ
لیٹے	liːʈeː
لیپ	lɪp
لیڈ	liːɖ
لیڈر	liːɖəɾ
لیڈی	liːɖiː
لیک	lɪk
لیکر	liːkər
لیکس	lɪkʃ
لیکن	liːkən
لیگ	lig
لیگزنگٹن	liːgeːsɪŋgʈən
لیں	lɪ̃
لیے	liːe
لے	lə
م	m
مآب	maːb
مؤثر	ɑːt̪sər
مئی	mai
ماؤس	maʊs
ماؤنٹ	maʊ̃ːnt
ماؤنٹین	maʊ̃ːt̪eːn
مائشٹھیت	maːiʃt̪ʰiːt̪
مائع	maːɪf
مائن	maɪn
مائنس	maːjns
مائچترت	maːɪtʃt̪eːɾt̪
مائک	maɪk
مائکرو	maɪkɾo
مائکروفون	maːjoːfʊn
مائکروویو	maɪkɾoʊwiː
مائیک	maːɪk
مائیکروسافٹ	maːɪkrʊsoːft
مائیکروفون	maɪkroːfun
مائیکل	maːɪkəl
مابین	maːbiːn
ماتحت	maːt̪hʌt̪
ماتمی	maːtmɪ
ماجد	maːdʒid̪
ماحول	maːɦoːl
ماحولیاتی	maːɦuːliːɑːtiː
ماخذ	məkxəz
ماد	maːd
مادہ	maːd̪ə
مادے	maːd̪eː
مار	maːr
مارا	maːɾɑː
مارتا	maːɾt̪ə
مارتھا	maːɾt̪ʰɑː
مارتے	maːɾteː
مارجن	maːɾdʒn
مارشل	maːɾʃɪl
مارفین	maːrfiːn
مارلین	maːrlin
مارنا	maːrnə
مارننگ	maːrənŋ
مارنے	maːrɳe
مارو	maːroː
مارونگا	maːroːŋgə
ماروں	maːroːn
مارٹر	maːɾt̪ər
مارٹم	maːɾt̪m
مارٹن	maːɾt̪ən
مارٹینی	maːɾt̪iːniː
مارچ	maːɾtʃ
مارک	maːɾk
مارکس	maːɾks
مارکو	maːɾkoː
مارکیٹ	maːɾkiːt̪
مارگی	maːrgi
ماری	maːriː
ماریں	məɾiːŋ
مارے	maːre
ماسوائے	maːsoːe
ماسٹر	ˈmɑːstər
ماسٹرز	ˈmɑːst̪r̪eːz
ماسک	ˈmɑːsk
ماسکو	ˈmɑːskoː
ماضی	məˈziː
مافیا	maːfijɑː
مال	maːl
مالبرداری	maːlbaːɾdaːriː
مالدار	maːld̪ɑːr
مالش	maːlʃ
مالک	maːlək
مالکان	maːlkaːn
مالکن	maːlˈkən
مالکوں	maːləkõː
مالی	maːliː
مالیاتی	maːliːəti
مالیت	maːliːt̪
مان	maːn
مانا	maːnə
مانتا	məntɑ
مانتی	maːnti
مانتے	maːn̪teː
ماند	mɑːnd̪
ماندہ	mɑːnd̪ə
ماننا	maːnnə
مانند	maːnand
ماننی	maːnːiː
ماننیی	maːnːiː
ماننے	maːnne
مانو	maːnuː
مانوں	maːnõː
مانچسٹر	mɑ̃ːtʃesʈəɾ
مانچسٹر	mɑ̃ːtʃəsʈəɾ
مانگ	maːŋ
مانگنے	maːŋgəneː
مانگو	ˈmɑːŋgoː
مانگے	maːŋgeː
مانی	maːniː
مانیٹر	maːnɪt̪ər
مانیں	maːneː
مانے	maːne
ماٹی	maːtiː
ماڈل	maːɽɗəl
ماڈلنگ	maːɖəlɪŋ
ماگتا	maːgt̪ə
ماں	mɑ̃ː
ماہ	maː
ماہانہ	maːɦɑːnə
ماہر	maːɪr
ماہرانہ	maːɦɾɑːnə
ماہرِ	maːɦɪr
ماہرین	maːɦeːrɪn
ماہی	maːɦiː
مایا	majɑ
مایاوی	majɑːʋiː
مایوس	maɪus
مایوسی	maɪoːsi
مبارک	ˈmʊbɑːrək
مبارکباد	ˈmʊbɑːrəkbɑːd
مباشرت	məbaːʃəɾt
مبالغہ	məbaːɣlə
مبتلا	ɪbt̪lɑ
مبدل	mbæd̪l
مبلغ	mbʌlɣ
مبنی	məˈbɪni
مبھی	mbʱi
مبہم	məbeːm
مبینہ	ˈmbiːnə
مت	mət
متاثر	mətaːsər
متاثرین	mətaːsɪrɪn
متبادل	mʊtæbɑːdil
متجسس	ˈmətʒgɛsː
متحد	ˈmʊt̪ʰɑd̪
متحدہ	ɪt̪ʰɑd̪ʱə
متحرک	məθɦɾik
متحمل	mətɑɦməl
مترجم	ˈmɪtɾʊdʒ
متروک	ˈmɪt̪roːk
متصور	ˈmʌt̪s̪oːr
متضاد	mət̪ədʒɑːd̪
متعارف	mətɑːʋɑːɾəf
متعلق	məteːləg
متعین	məteːʋiːn
متغیر	ˈmətɣiːr
متفق	ˈmətfaq
متقی	ˈmətqi
متن	ˈmət̪n
متنازعہ	ˈmʊt̪nɑːzeʋə
متوازی	mətoːʊziː
متوجہ	mətoʊdʒə
متوسط	ˈmʊtɑwsˤɪt
متوقع	məˈtɪqɑː
متک	ˈmətək
مثال	məθl
مثالکے	maːθlaːkeː
مثالی	maθlaːi
مثبت	ˈmʊbθɪd
مثلث	miθl̪əθ
مجاز	məˈdʒɑz
مجازی	məˈdʒɑːzi
مجبور	məgboːr
مجرجیئ	məgɾdʒiː
مجرم	məgʐəm
مجرمانہ	məgɾmɑːnə
مجرموں	məgɾʊmõː
مجروح	məʒruː
مجسموں	məzmʊŋ
مجلس	məglɛs
مجلسِ	məʒlisɪ
مجموعہ	məgɑːmʊɾɑː
مجموعی	məgːɔːli
مجھ	məʐ
مجھے	məʐʱe
مجید	məˈgiːd
محافظ	maːɦafiːz
محافظوں	məɦɑːfɪzʊ̃ː
محب	məkb
محبت	moˈhəbbət
محبت	məˈbɛt
محبت	mʊɦəbbət
محبت	mʊˈhəbbət
محبوب	məhˈbuːb
محبوبوں	məkhoːboːŋ
محتاط	maɦtɑːt
محتاظ	mʌɦtɑːs
محترم	məˈt̪ɾəm
محترمہ	məɦt̪əɾmə
محدود	məhˈhɑːd
محراب	mɛʱɾɑːb
محروم	məɦɾuːm
محروم	mɛɦɾuːm
محرکات	məɦrəkɑːt
محسوس	məhsus
محسوس	məsuːs
محسوس	mɛɦsuːs
محض	maħd
محفل	məħful
محفوظ	mafɔːz
محقق	məˈhɪq
محل	məɦl
محلوں	məɦlõː
محلے	məɦlɛ
محمد	mʊhəmməd
محمدی	moɦəmməd̪iː
محنت	məˈhɪnt
محور	maːhuːr
محکمہ	məˈɦkʌmə
محیط	məˈɦiːq
مخالف	məkɦɑːlif
مخالفت	məkɑlˈfæt
مخبر	məkˈbər
مخبری	məkʰbəri
مختار	məkt̪ɑːr
مختاری	məkt̪ɑːriː
مختتم	məkʰt̪t̪əm
مختصر	məkʰt̪s̪ər
مختصراً	məkʰt̪sˤɾæŋ
مختلف	ˈmʌxtəlɪf
مخروط	məkruːt̪
مخصوص	məxːsʊs
مخفی	məkfi
مخلص	məkˈleʃ
مخلوط	məkɦuːt
مخلوق	məkɦluːq
مخلوقات	məkħluːqɑːt
مخواہ	məkʰwɑːh
مداح	mədaːh
مداحوں	mədaːɦõː
مداخلت	mədɑːxələt
مداخلتوں	mədɑːxəlt̪oːŋ
مدار	məˈdɑːr
مداروں	məd̪ɑːɾoːŋ
مداوا	mədɑːʋɑː
مدت	ˈmɪd̪t̪
مدتی	ˈmʌd̪t̪iː
مدد	məd̪əd̪
مدد	ˈmɛdː
مددگار	ˈmʌdːɪgɑːr
مدراس	mʌd̪ɾɑːs
مدرانکن	ˈmɑːdrənkən
مدعا	məɖɑː
مدعو	ˈmʌd̪oː
مدفون	ˈmʌd̪foːn
مدمقابل	ˈmʌdmʊqɑːbəl
مدنظر	mɪdˈnɑjr
مذاق	məˈðɑːq
مذاکرات	məðɑkɾɑːt̪
مذمت	maðmət
مذموم	ˈmɑðmum
مذہب	məðʱæb
مذہبی	məðʱeːbiː
مر	mər
مراحل	məɾɑːhəl
مراد	məˈɾɑːd
مرادانکل	məɾɑːd̪ɑːkəl
مراعات	məɾɑːʋɑːt̪
مراقبے	məɾɑːqɪbɛː
مراکز	məɾɑːkʊz
مربع	maːrbaʕ
مربوط	mɪɾbuːt
مرتا	məɾtə
مرتبان	məɾt̪eːbɑːn
مرتبہ	məɾt̪eːbɑː
مرتھا	ɾʊt̪ʰɑː
مرتے	məɾte
مرجاؤں	məɾdʒɑːʊ̯ŋ
مرجھا	məɾdʒʰɑ
مرحلہ	məɾhəlɑ
مرحلے	məɾhɑlɛ
مرحوم	məɾˈɦuːm
مرد	məɾd
مرد	məɾd̪
مردار	məɾd̪ɑːr
مردوں	ɾəɽd̪oːŋ
مردہ	ˈmərðə
مرسیڈیز	məɾsiːd̪eːs
مرض	məɾd̪
مرضی	məɾzi
مرغ	məɾɣ
مرغوں	məɾɣoːŋ
مرغی	məɾɣiː
مرفی	məɾfi
مرلے	məɾleː
مرمت	məɾmət
مرموز	məɾmoːz
مرنا	məɾnɑ
مرنے	məɾne
مرو	məɾo
مروا	məɾə
مروان	məɾuːən
مروانی	məɾuːəniː
مرچ	məɾtʃ
مرچکا	məɾtʃkə
مرکب	məɾkəb
مرکت	məɾkət
مرکز	məɾˈzɛɾ
مرکزي	məɾkəzi
مرکزی	məɾkəzi
مرکوز	məɾkoːz
مرگئے	məɾgeː
مرگی	məɾgi
مرہون	məɾɑːhʊn
مریخ	məɾɪx
مریض	məɾiːdʒ
مریم	məɾɪjəm
مریگا	məɾiːgɑ
مریں	məɾeːŋ
مرے	məɾe
مزاج	mazaːʁ
مزاح	mazaːh
مزاحمت	məzaːhmat
مزاحیہ	məzaːɦiːə
مزاکرات	mazɑkɑɾɑːt
مزدور	mazd̪oːr
مزدور	məzd̪uːɾ
مزہ	maːzə
مزید	məˈziːd
مزیدار	məziːd̪əɾ
مزے	maze
مس	ms
مسئل	msɛl
مسئلہ	msɛlɑ
مسئلے	msɛle
مسائل	msɑːɪlə
مسافر	msɑfɑr
مسافراں	msɑfɑrɑ̃
مسالیدار	msɑlɪd̪ɑr
مستثنی	ˈmʌst̪s̪t̪ʰeːni
مستحق	ˈmʊstehɪq
مستحکم	ˈmʊst̪ʰəkəm
مسترد	ʋɪst̪eːɾd̪
مستعد	ˈmʌsteʔd
مستعدی	ˈmʌstæɽiː
مستعمل	ˈmʌsteːmble
مستقبل	ˈmʊstɑqbəl
مستقل	ˈmʊstɪql
مستند	ˈmʊstand̪ʌd̪
مستول	ˈmʊstul
مستی	məstiː
مسجد	msægd
مسجد	məsˈdʒɪd̪
مسح	msˈħ
مسخ	msx
مسخروں	msxɾoːn
مسدود	msd̪oːd̪
مسز	msuz
مسلح	msəlh
مسلسل	mslˈsˁl
مسلمان	msəlˈmɑːn
مسلمانوں	msəlˈmɑːnõː
مسلموں	msəlˈmoːn
مسمار	msmɑːr
مسودہ	msʊd̪ə
مسوری	msuːɾiː
مسوڑھوں	msuɽʰoːn
مسٹر	msɪt̪ər
مسٹرد	msɪt̪əɾd̪
مسکرا	mskɾɑ
مسکرانا	mskɾɑnɑ
مسکراہٹ	mskɾɑɦət
مسیح	msiːh
مسیحائی	msiɦɑːiː
مسیحی	msiɦiː
مشاغل	məʃɑːɣəl
مشاورت	məʃɑːɾt
مشاہدات	məʃɑːɪdɑːt
مشاہدہ	məʃɑːhɪdə
مشاہدے	məʃɑːɦɪde
مشتبہ	məʃt̪eːbʰə
مشترک	məʃt̪əɾk
مشترکہ	məʃt̪əɾkʰeg
مشتمل	məʃtʌml
مشرف	məʃraf
مشرق	msrɪq
مشرقی	məʃriː
مشروب	məʃruːb
مشروط	məʃruːf
مشرکین	məʃriːkin
مشعل	məʃˈʔæl
مشغول	məʃɣuːl
مشغولیت	məʃɣʊlɪt
مشق	məʃq
مشقت	məʃqɪt
مشن	məʃn
مشنز	məʃnz
مشورہ	məʃuːrə
مشکل	məʃkəl
مشکلات	məʃkəlɑːt
مشکوک	məʃkoːq
مشہور	məʃuːɾ
مشہور	məʃɦuːr
مشیر	məˈʃiːr
مشیروں	məʃiːɾoː
مشیل	məʃɪl
مشین	məʃɪn
مشینری	məʃɪnˈriː
مشینوں	məʃɪnõː
مشینیں	məʃiːnɪŋ
مصائب	ˈmʌsɑːib
مصالحت	ˈmʌsɑːlɪt
مصدر	ˈmɑsˌdˈr
مصروف	msˈruːf
مصری	ˈmʌsɾiː
مصلحت	msəlˈhət
مصنف	ˈmʌsˌnif
مصنوعات	ˈmʌsnuːvaːt
مصنوعی	msənˈʋiː
مصیبت	ˈməsɪbət
مصیبتیں	ˈmʊsɪbtiːŋ
مضامین	məðɑːmiːn
مضبوط	mbɑːbʊt
مضحکہ	mad̪əxə
مضمون	ˈmɑzmʊn
مطابق	mʌtɑːb
مطالبات	ɪmtɑːlɑːbɑːt
مطالبہ	ɪt̪ɑːlɑːbʱe
مطالعہ	ˈmʌtʰɑːlɪə
مطالعے	maʈɑːleɪ
مطلب	maːtlab
مطلع	matˁlˤu
مطلق	ˈmʌtlɑq
مطلوب	matluːb
مطلوبہ	ˈmətɫoːbə
مطمئن	ˈmʊtmiːn
مطمعن	ɪtˈmaːʋən
مظاہرہ	məˈzɑːhɪrɑ
مظلوم	maʐˈlum
معائنہ	məɪnə
معائنے	maːʔɪne
معاشرت	məʋɑːʃəɾt
معاشرہ	məɑːʃɪrə
معاشرے	məɑːʃɪreː
معاشی	maːʃiː
معاف	məˈɑːf
معافی	məˈɑːfi
معالج	maːlɑdʒ
معاملات	maːʕaːmilaːt
معاملہ	məʋɑːmilə
معاملے	məʋɑːmilɛ
معاندانہ	məʋɑːdənɑ̃
معاوضہ	məʋɑːdʒʌ
معاوضے	məʋɑːdʒe
معاھدے	məʋɑːhde
معاہدوں	məʔɑːd̪oːn
معاہدہ	məʔɑːd̪ə
معاہدے	məɑːhɪdeː
معبد	maːbɪd
معبد	mɑːbəd̪
معبود	maːbuːd
معبودوں	məβʊdõː
معجزات	maːdʒzaːt̪
معجزانہ	məˈzʒɑːnə
معجزہ	məˈzɑdʒə
معدنی	məʋd̪niː
معدنیات	məʋd̪niːjɑːt̪
معدہ	məˈʋə
معذرت	məzəɾt
معذور	mɑːzuːɾ
معذور	məzuːɾ
معرفت	məˈɾaft
معروف	mɑːɾuːf
معروف	məˈruːf
معزرت	maːzəɾt
معزز	maːzˈz
معزِّز	maʕzːiz
معصوم	maʕsuːm
معطل	maʈl
معطلی	maʈli
معظم	maːzam
معلوم	mɑːluːm
معلوم	məˈlɑːʊm
معلومات	məˈlaːqɑːt
معمر	moʔməɾ
معمول	maːmoːl
معمولی	maʋmuːliː
معموں	məmoːŋ
معمے	ɪmɑːme
معنوں	məˈnɔ̃ː
معنی	məˈniː
معیار	maɪjɑːr
معیار	mejɑːɾ
معیار	mɑjɑːɾ
معیار	məjɑːɾ
معیارات	məjɑːrɑːt̪
معیاری	maɪjɑːɾiː
مغرب	məgʁib
مغربی	məɣərbi
مغرور	maɣruːr
مغفرت	məɣfɪrət
مغل	məɣl
مفادات	mʊfɑːd̪eːt̪
مفت	ɱʊft
مفرور	ɪfroːr
مفروضہ	mafruːzə
مفلوج	ɪfloːg
مفید	məfɪd
مقابل	məkɑbəl
مقابلہ	məkɑbɪlə
مقابلے	məkɑbɑleː
مقاصد	məqɑːsɪd
مقالعہ	məqɑːləʋə
مقالہ	məqɑːlə
مقام	məkɑm
مقامات	məqɑːmɑːt
مقامی	məqɑːmi
مقبول	məkbuːl
مقدار	məkdɑːr
مقدس	məkˈqɑs
مقدم	məkdʒam
مقدمات	məkdaːmaːt
مقدموں	məkdaːmõː
مقدمہ	məkdama
مقدمے	məkdaːgeː
مقرر	məqˈrər
مقررین	məqɾəɾiːn
مقصد	məqsid
مقفل	məqfəl
مقلہوں	məkqəlɑ̃
مقناطیسی	məqnɑːt̪sɪ
مقید	məqiːd
مقیم	məqiːm
مل	məl
ملا	məla
ملائیشیا	məlaːʔiːʃiɑː
ملاتے	məlaːte
ملاحظات	məlaːxɑːɾɑːt
ملاحظہ	məlaːxɑːhi
ملازم	məlaːzəm
ملازمت	mələzəmt
ملازمتوں	mələzəmətõː
ملازمتیں	məlaːzəmiːt̪eː
ملازمہ	məlaːzmih
ملازمین	məlɑzmɪn
ملاقات	məlaːqət
ملانے	məlaːne
ملاپ	məˈlɑp
ملاکر	məlɑkər
ملایا	məlaːjɑː
ملبے	məlbeː
ملتا	məltɑ
ملتوی	ˈmɪlt̪oːi
ملتی	mʌlt̪iː
ملتے	məlte
ملحقہ	məɭɦəqə
ملرائے	məleːraːe
ملز	məɭz
ملزم	məlzæm
ملط	məlʈ
ملعون	məlɑʋõ
ملنا	məlnɑ
ملنہ	məlna
ملنے	məlnə
ملو	məloː
ملوث	məloːt̪ʃ
ملوں	məˈloːŋ
ملٹری	məleːtriː
ملک	məlk
ملکر	məleːkər
ملکہ	məlkə
ملکی	məlki
ملکیت	ˈməlkiːt
ملی	mɪliː
ملین	məlin
ملیں	məlɛ̃ː
ملے	məle
مم	m
مم-مم	mːmː
مم-ہمم	ɾʊmɾʊm
مماثلت	mʌmɑːθlɪt
ممالک	mɑmɑlɪk
ممباکہ	ˈmʊmbɑkʌ
ممبر	mɑmbər
ممبران	ˈmʊmbrɑːn
مملکت	məmləkət
ممنوع	mʊmnuːʋ
ممکن	ɪmˈkɪn
ممکنہ	ɪmˈkɪnə
ممی	miː
ممیز	miːz
من	mən
منا	mɑnɑ
منائیں	mənɑːɪ̃
مناسب	mənɑːsɪb
مناظر	məˈnɑːt̪sər
منافق	manɑfɪq
منانے	ˈmənɑːne
منایا	mənajə
منت	ment
منتخب	menteɣ
منتر	ˈmʌnt̪r
منتشر	menteʃr
منتضر	menteɽ
منتظر	mentsɪr
منتظم	mentɑdʒm
منتقل	mentɑqəl
منتقلی	mant̪qli
منتیں	mʌnt̪iː
منجمد	mandʒemd̪ʌ
منحصر	manɦəsr
منحنیات	ˈmənɦəniːjət
منحوس	manɦoːs
مند	mənd
مندانہ	ˈmʌnd̪əne
مندر	ˈmʌndəɾ
مندرجہ	mənd̪əɾədʒə
مندروں	mʌnd̪roːn
مندمل	ˈməndməl
مندی	mʌndi
منزل	menzel
منزلہ	menzələ
منسلک	ˈmənsələk
منسلکہ	mansəlkə
منسوب	mənsoːb
منسوخ	ˈmənsuːx
منسوخی	ˈmənsʊxɪ
منشیات	ˈmənʃiːjɑːt
منصفانہ	ˈmənsəfɑnɑ
منصوبوں	mansʊboː
منصوبہ	mansuːbuɑ
منصوبے	ˈmənsʊbe
منطقی	mant̪qɪ
منظر	mantʃər
منظم	manˈzɪm
منظور	ˈmənzuːr
منظوری	manzuːriː
منع	mənʋ
منعقد	manɪqəd
منعقدہ	mənˈʋʊqːə
منفرد	manfird̪ə
منفی	mənfiː
منقطع	mənqɑːʋ
منٹ	mənt
منٹوں	ˈmənʈoːn
منڈی	mənɖiː
منگل	məŋgəl
منگوایا	məŋguːjɑː
منہ	mən
منہدم	manɦɛm
منی	mɪni
منیجر	mɪnɪdʒər
مواد	moːɑːd
موازنہ	muːˈzɑnə
مواصلات	moːsɑːlɑːt
مواصلاتی	muːɑːsɪlɑːt̪iː
مواقع	moːqɪqɑːt
موبائل	moːbiːl
موت	moːt
موتی	moːtiː
موج	moʊg
موجود	muːdʒoːz
موجودگی	moːˈzɪŋdʒi
موجودہ	moːzʊd̪ʒə
موخر	moːxər
مور	moːr
مورتی	moːrt̪iː
مورد	muːɾd
موروثی	muːroːθiː
موروکو	ˈmuːrʊkoː
مورٹز	moːɾt̪s
مورچوں	muːrtʃoː
مورگن	muːrgən
مورھ	moːrɪ
موزا	moːza
موزوں	muːzõː
موزے	muːze
موساد	ˈmusɑːd
موسم	mosːm
موسم	mɔːsəm
موسی	muːsi
موسیقی	muːsɪqiː
موشے	muːʃe
موصل	moːsəl
موصول	muːsɔl
موصولہ	muːsɔlə
موضوع	muːdʒuːʔ
موقع	moqɪʔ
موقع	mɔːqə
موقف	muːqɑːf
مولوی	moːlʋiː
مولویوں	moːlʋijõː
مومن	moːmən
مون	moːn
مونٹیری	moːnʈeːriː
مونگ	moːŋ
مونیکا	moːnɪkɑː
موونگ	muːŋ
موٹر	moːt̪ər
موٹی	moːti
موٹے	moːʈe
موڈ	moːɖ
موڑ	moːɽ
موڑنے	moːɽne
موہ	moː
مویشی	moːiʃi
مویشیوں	moːɪʃoː
مَشورہ	məʃuːrə
مُلک	mʊlək
مُکافی	mʊkɑːfi
مِل	miːl
مِلا	milɑ
مِلنا	miːlnə
مْجرم	ɪmgʐɪm
مْزاکرات	ˈmzɑkɾɑt
مْشِیر	ʋɪʃɪr
مْلحِد	mlɪɦɪd
مْنحنی	ˈmənɦəniː
مٹا	məʈə
مٹانے	məʈɑːne
مٹھائی	məʈʰɑːi
مٹھائیاں	miʈʰɑijɑ̃
مٹھاس	məθɑːs
مٹھی	məʈʰiː
مٹی	mɪt̪iː
مچا	mətʃɑ
مچان	mətʃɑːn
مچانا	mətʃɑːnɑ
مچل	məʃl
مچلی	məʈʂliː
مچگن	məʈːegn
مچھلی	məʈʂli
مچھلیوں	məʈɭijõː
مڈل	ˈmɑɽl
مڈنائٹس	ˈmɪɽnɑɪts
مڑو	məɽo
مڑیں	məɽeːn
مک	mək
مکئی	məkɛː
مکا	məkə
مکالمات	məkɑlːmɑt
مکان	məkɑn
مکانی	məkɑːniː
مکاوت	məkɑːʊt
مکر	məkər
مکروہات	məkɾoːhɑːt
مکمل	məkməl
مککیبازی	məkkiːbɑːziː
مکھی	məkʰi
مکھیاں	məkʰjɑ̃
مکھیوں	məkʰɪ̃õː
مکی	məkɪ
مکین	məkɪn
مگر	magər
مگرمچرچھ	məgərmɪtʃərtʃʰ
مہ	mə
مہاجر	məɦɑːdʒəɾ
مہاراج	məɦɑːɾɑːdʒ
مہارت	məɦɑːɾt
مہاشی	məɦɑːʃi
مہاکاوی	məɦɑːkɑːʋiː
مہتواکانکشی	məhtɑːʋɑːkɑnʃiː
مہدہ	məɣd̪ə
مہذب	məˈðʐ
مہر	məɦr
مہربان	məɾbaːn
مہربانی	meɦɾbɑːniː
مہربانی	məɾbɑːni
مہرہ	mɛɾɦɑ
مہریں	məɾeːn
مہلک	məɦlək
مہم	məɣ
مہمان	məɦmɑːn
مہمان	məɦəmɑːn
مہمانوں	məhmɑːnõː
مہنگا	məɦəŋgə
مہنگے	məɦŋe
مہودی	məhuːdi
مہودیا	məɦuːdɪə
مہیا	məhiːə
مہینوں	məɦiːnuːn
مہینہ	məhiːnə
مہینے	məɦiːneː
میئر	miːr
میا	miɑ
میجر	migər
میدان	miːd̪ɑːn
میدانوں	miːd̪ɑːnuː
میدانی	miːd̪ɑːniː
میرا	miːrɑ
میرااحمد	miːɾɑːħməd
میراث	miːrɑːθ
میران	miːrɑːn
میرٹ	miːɾʈ
میری	miri
میرین	miːɾeːn
میرینز	miːrɪ̃ːz
میریٹ	miːriːʈ
میرے	miːre
میز	miːz
میزائل	miːzɑːɪl
میزبان	miːzæbæːn
میزبانی	miːzˈbɑːni
میزیں	miːzɪ̃
میسر	miːsər
میسوری	miːsuːriː
میل	miːl
میلز	miːlz
میلنگ	miːlɪŋ
میلوڈراگو	miːloːdraːgoː
میلویئر	miːloːjər
میلہ	miːlə
میم	mɛːm
میماتی	miːmɑːtiː
میمبر	miːmbər
میمساہب	miːmsɑːɦɪb
میموری	miːmoːriː
مین	miːn
مینار	miːnɑːr
مینامی	miːnɑːmiː
مینجمنٹ	ˈmɪndʒmɛnʈ
مینلینڈ	miːnlənd
مینوئل	miːnuːl
مینڈارن	miːnɖəɾən
مینڈی	miːndi
مینڈیٹ	miːnd̪eːt̪
مینی	miːniː
مینیجر	miːnigər
میوزک	miːzɪk
میوہ	miw
میوے	miːuɛ
میٹ	miːʈ
میٹا	miːt̪ə
میٹر	miːt̪əɾ
میٹرو	miːtro
میٹل	miːt̪əl
میٹنگ	miːʈeŋ
میٹھی	miːʈʰiː
میچ	miːtʃ
میڈرڈ	miːɖəɽ
میڈم	miːd̪əm
میڈیا	miːɖiːə
میڈیلن	miːɖeːlən
میکر	miːkər
میکس	miːks
میکسیکن	miːksɪkän
میکسیکو	miːksɪkuː
میگا	miːgɑː
میں	mɛ̃ː
میں	mẽː
میںسائن	miːnsɛ̃ːn
ن	n
نئا	neː
نئی	neː
نئے	neː
نا	nɑ
نائب	naːʔib
نائبِ	nɑːʔibɪ
نائن	nɑːɪn
نائٹ	neːʔt̪
نائیکی	naːʔiːki
نااہل	naːɦəl
نابود	nɑːboːd
نابینا	nɑːbiːnɑː
ناخن	nɑxən
ناخوشگوار	nɑːxʊʃgʋɑːr
ناد	nɑːd
نادان	nɑːd̪ɑːn
نادانستہ	nɑːd̪ɑːn̪st̪ʰɑː
نادر	nɑːd̪eɾ
نادیہ	nɑːdɪh
نار	nɑːr
ناراض	nɑːrɑːdʒ
نارمل	nɑːrməl
ناروے	nɑːroːe
ناز	nɑːz
نازل	nɑːzel
نازک	nɑːzek
نازی	nɑːzi
نازیوں	nɑːzijõː
ناس	nɑs
ناستے	nɑːsteː
ناشتا	nɑʃtɑ
ناشکرے	nɑːʃkɪreː
ناص	nɑːs
ناطے	nɑːt̪eː
ناظرین	nɑːzeːrɪn
ناظم	nɑːzɪm
نافذ	nɑːfɪz
نافرمان	nɑːfeɾmɑːn
نافرمانی	nɑːfeɾmɑːni
ناقابل	nɑːqɑːbəl
ناقوس	nɑːqʊs
نالی	nɑːli
نام	nɑm
نامزد	nɑːmzəd
نامساوات	nɑːmsɑːʋɑːt̪
نامعلوم	nɑːmoːlɪm
ناممکن	nɑːmməkn
نامناسب	nɑmənɑsab
ناموں	nɑːmoː
نامکمل	namkæml̪
نامہ	nɑːmə
نامی	nɑːmi
نانبائی	nɑːnbɑːi
نانبائیوں	nɑːnbɑːɪjõː
نانی	nɑːniː
ناو	naʊ
ناوررسکی	naʊrɾɪsɪki
ناورسکی	naʊrski
ناٹ	naːʈ
ناپ	nap
ناپا	nɑpɑ
ناپاک	naːpɑːk
ناپسند	naːpsənɪd
ناچ	nɑtʃ
ناچتی	ˈnɑːtʃt̪i
ناک	naːk
ناکام	naːkɑːm
ناکامی	naːkɑːmi
ناکامی	nɑːkɑːmiː
ناکہ	nɑkə
ناگزیر	naːgzeːr
ناں	nɑ̃
نایاب	nai̯æb
نببی	næbːiː
نبٹنا	nʌbʈnə
نبھاتے	nəbʱɑːte
نبی	nəbi
نتائج	ˈnʌtɑːjɪ
نتھالی	nəθɑːliː
نتیجہ	nɪt̪iːdʒʌ
نتیجے	nɪtɪdʒe
نجات	nəɣɑt
نجی	nɪʤi
نخلستان	nɪxt̪ʃɪt̪ɑn
ندیم	nɪd̪iːm
نذاف	nəðɑf
نذر	nəðr
نذرانہ	nəðəɾəna
نذرانے	nəðəraːne
نراشا	nɪɾɑʃɑ
نرد	nɪɾd
نرس	nɪɾs
نرسنگ	nərsəŋ
نرم	nɪrm
نروئواد	ˈnəroːʊʋɑːd
نروس	n̪əroːs
نرک	nɛɾk
نزدیک	ˈnzədɪk
نسخہ	nɪsxə
نسخے	nɪsxɛ
نسل	nesl
نسلوں	neslʊ̃
نسوانیت	nɪsʋɑːnɪt
نشان	nəʃɑːn
نشانات	nɪʃɑːnɑːt̪
نشاندہی	nəʃɑːnd̪ʱiː
نشانہ	nəʃɑːnə
نشانی	nəʃɑːniː
نشانیاں	nəʃɑːnɪjɑ̃
نشانے	nəʃɑːnɛ
نشتر	nɪʃt̪ər
نشر	nəʃr
نشست	nɪʃt
نشکریتا	nəʃkəɾiːtə
نشین	nɪʃɪn
نشے	nəʃe
نصب	nəzb
نصف	nəʃf
نصوص	nʌsˈsʌ
نصیحت	ˈnəsiːħat
نطام	ɳʌtɑm
نطر	nɑtəɾ
نظام	nisɑm
نظر	nəɣər
نظرانداز	nəɣɑːndɑːz
نظربند	nɪˈʐɪbʌnd
نظرثانی	nəɣərˈθɑːni
نظریات	nɪˈʐɪjɑːt
نظریں	ˈnəʈɾeɪ̯n
نظریہ	ˈnəʒɾijɑː
نظم	nɑzm
نظیر	nəˈzɪr
نعمت	nɪmət
نغمے	ŋɣme
نفرت	nəfɾt
نفسیات	nəfsiˑjɑːt̪
نفسیاتی	ˈnəfsiːɪti
نفیس	nəfɪs
نقاب	nʌgɑːb
نقاط	nɑqɑːt
نقب	nɪqb
نقد	nɪqd
نقشہ	ŋʊʃə
نقشے	ŋʊʃe
نقصان	nʌqsɑːn
نقصانات	nʌqsɑːnɑːt̪
نقطہ	nʊqt̪ə
نقطے	nʊqt̪eː
نقل	nɪql
نقلی	ŋʌli
نل	nəl
نلکاوں	nəlkɑ̃
نلکے	nɪlke
نلی	nɪli
نما	nəmə
نمائش	nʌmɑːiʃ
نمائندگی	nʌmɑːɑ̃dʒʰi
نمائندہ	nəmɑːiːndə
نمائندے	nɑmɑːĩnde
نماز	nəmaːz
نماز	nəmɑːz
نمبر	nɪmbəɾ
نمبرز	ˈnʌmbəɾs
نمبروں	nʌmbɾoː
نمونہ	nʌmoːnə
نمونے	nʌmoːni
نمٹ	nʌmʈ
نمٹا	nʌmʈɑ
نمٹنے	ˈnəmt̪ne
نمک	næmæk
نمیبیا	nəmiːbiːə
ننگا	ŋə
ننگی	ŋi
ننگے	ŋe
ننھا	nənɑ
ننھی	nənɪ
نو	nʊ
نوازی	nuːzi
نوبیاہتا	nuːbiɑːt̪ə
نوجوان	nuːgʋɑːn
نوجوانوں	nuːgʋɑːnõː
نوح	nuː
نوحہ	nuːhə
نوش	nuːʃ
نوشتہ	nuːʃtə
نوشی	nuːʃi
نوع	nɔʊ
نوعیت	naːu̯eːt̪
نولن	nuːlən
نومبر	ˈnʊmbəɾ
نون	nʊn
نوورسکی	nuːɾsɪki
نوٹ	nuːʈ
نوٹس	nuːʈs
نوٹوں	nuːʈoː
نوک	nuːk
نوکدار	nuːkɑːɽɑːr
نوکرانی	nuːkəɾɑːniː
نوکری	nuːkɾi
نوے	nuːe
نِتریہ	nɪt̪riːə
نٹ	n̪ʌt̪
نپل	nɑpɪl
نپلس	neːpl̪s
نپولین	nəpoːlɪn
نچلے	nəʈʃleː
نچوڑ	ɳəʈʈʊɽ
نچوڑنا	nətʃoɽnə
نکال	nekɑl
نکالا	nekɑlɑ
نکالنا	ŋkɑlnɑ
نکالنے	nekɑlne
نکالو	nəkɑːloː
نکالوگے	nəkɑːloːgeː
نکالوں	nekɑːlõː
نکالی	nekɑli
نکالیں	nəkɑːlẽː
نکالے	nekæle
نکل	ŋkəl
نکلا	neklə
نکلتا	nekletɑ
نکلتے	nekleːt̪eː
نکلنا	ŋkəlˈnə
نکلنے	ŋkəlne
نکلو	neklo
نکلینگے	ŋkəlɪŋe
نکلیں	ŋkəlẽ
نکلے	ŋkəlɛ
نکولس	nekol̪s
نکی	nʌki
نکیلی	nekɪli
نگاری	ŋɑːɾɪ
نگاہ	ŋɑːɣɑː
نگاہیں	ŋɑːhɪ̃
نگرانی	ŋɛɾɑːni
نگل	ŋɛl
نگلنا	ŋɛlna
نگہبان	ŋəbaːn
نہ	nə
نہاد	nəɦɑːd
نہایت	nəɪˈhɑːt
نہلے	nəɦle
نہه	nəhe
نہين	nəɪ̯n
نہيں	neːhɪ̃
نہیں	nĩː
نہیں	nəiː
نہیں	nəĩː
نہیں	nəɦẽː
نہیںجاسکو	nəɪɦɛndʒɑskʊ
نیا	niːə
نیبو	niːboː
نیت	niːt
نیروبی	neːroːbiː
نیزہ	neːza
نیزے	neːze
نیشن	nɪʃɒn
نیشنل	ˈnɪːʃnəl
نیل	niːl
نیلا	niːlə
نیلی	nɪliː
نیلے	niːlə
نیم	nɪm
نیند	nind
نیند	nĩːnd̪
نیو	niːu
نیوارک	niːwaːrək
نیواڈا	niːʋɑːɽɑː
نیورمبرگ	neːuɾmɛɾg
نیوز	neːz
نیوٹن	niːʈʈʌn
نیویارک	niːviːjɑːrg
نیٹ	neːʈ
نیٹلی	nɛːt̪li
نیچ	neːtʃ
نیچا	neːtʃɑː
نیچے	neːtʃeː
نیڈ	niːɖ
نیک	niːk
نیکدل	niːkd̪əl
نیکی	neːkiː
نیکی	niːki
نے	neː
نےترگولک	neːt̪əɾgoːlək
نےن	neːn
نےٹلی	neːʈli
ه	h
هإءµé	ɛː
هيبارخوس	ɦeːbɑːrɣoːs
هہ	he
و	ʋ
وµ	ʋ
وءِ	ʊ
وآû	ʋɑː
وآûہج	ʋɑːɽ
وآلہ	ʋɑːlə
وؤ	ʋoː
وئذ	ʋeːð
وائبریٹر	ʋɑːiːbriːt̪ər
وائر	ʋɛːr
وائرس	ʋɑːɪrs
وائن	ʋɛ̃ː
وائٹ	ʋɑɪt
وائٹل	ʋɑɪt̪əl
وائڈ	ʋɑːɪd
وائی	ʋɑi
وائیٹ	ʋɑɪt̪
وابستگی	ʋɑbɑst̪i
واجب	ʋɑːdʒb
واحد	ʋɑhɪd
وادی	ʋɑːdiː
واذ	ʋɑːð
وار	ʋɑːr
وارث	ʋɑːrθ
وارن	ʋɑːrən
وارننگ	ʋɑːrəng
وارنٹ	ʋɑːrɪnt̪
وارڈ	ʋɑːɾɪd̪
واریر	ʋɑːɾeːɾ
واستکار	ʋɑstkɑr
واش	ʋɑːʃ
واشنگٹن	ʋɑːʃɪŋgʈən
واضح	ʋɑːdʒah
واضع	woːðˈiːs
واقع	waːqʰiː
واقعات	ʋɑːqɑːt̪
واقعہ	waːqih
واقعی	ʋɑːqʰiː
واقعے	waːqiː
واقف	ʋɑːqɪf
وال	ʋɑl
والا	ʋɑːlɑː
والد	ʋɑːlɪd
والدہ	ʋɑːld̪ə
والدین	ʋɑːld̪iːn
والوں	ʋɑːlõː
والٹ	ʋɑːlʈ
والکر	ʋɑlɪkəɾ
والی	ʋɑːliː
والیس	ʋɑːlɪs
والے	ʋɑːleː
والےہيں	ʋɑːleːhɪ̃
وان	ʋɑːn
واٹرلو	ʋɑːtəɾloː
واپس	ʋɑːpʰs
واپسی	ʋɑːpsiː
واچ	ʋɑtʃ
واک	ʋɑk
واکر	ʋɑkər
واگزار	ʋɑːgzɑːr
واگوباگن	ʋɑːgʊbɑːgʊn
واہ	ʋɑh
وایٹ	ʋɛːt
وبالا	ʋɪbɑlə
وبستان	ʋebst̪ɑːn
وجرپات	ʋədʒəpɑt
وجود	ʔɔːgʊz
وجوہات	ʋodʒoɦɑːt
وجہ	ʋədʒə
وحشی	ʋɑʃiː
وراست	ʋəɾɑːsət
ورانہ	ʋəɾɑːnə
ورتکنجی	ʋəɾt̪kənɟi
ورتھ	ʋɾəθ
ورجن	ʋəɾdʒən
ورجینیا	ʋərdʒiːniːə
وردی	ʋəɾdiː
ورزش	ʋeɾz
ورزی	ʋəɾzi
ورزیوں	ʋəɾzijoː
ورق	ʋəɾq
ورلڈ	ʋəɾlɪd̪
ورنن	ʋəɾnən
ورنہ	ʋərnə
وروں	ʋəroːn
ورڈ	ʋəɾɖ
ورڈز	ʋəɾɖz
ورژن	ʋəɾdʒən
ورک	ʋəɾk
ورکشاپ	ʋəɾkɛʃɑp
ورکنگ	ʋəɾkəŋ
وزارتِ	ʋəzaːɾt̪iː
وزن	ʋæzən
وزٹرز	ʋɪst̪əɾz
وزیر	ʋəziɾ
وزیرستان	ʋəziːrɪsˈtɑːn
وزیٹر	ʋeːzɪt̪ər
وسائل	ʋəsɑːiːl
وسط	usˈtˁa
وسطی	ʋusˈt̪iː
وسلم	ʋəsˈlæm
وسیع	ʋəsiːʔ
وشال	ʋɪʃɑl
وشالکای	ʋɪʃɑlkɑi
وصول	ʋasuːl
وصولی	ʋasʌlɪ
وصیت	ʋəsɪt
وضاحت	ʋɑsɑħt
وضع	ʊðˈba
وطن	ʋət̪n
وعدوں	ʋəɽɑː
وعدہ	ʋɑd̪ʌ
وعدے	ʋəɽeː
وعلیکم	ʋælɪkæm
وعید	əˈʋiːd
وغیرہ	ʋɛɣɪrɑ
وفات	ʋɑfɑt
وفادار	wofɑːd̪ɑːr
وفاداری	wofɑːd̪ɑːriː
وفاقی	ʋəfɑːqiː
وففوہ	ʋəfʋoʔ
وقار	ʋɑqɑr
وقت	ʋaːkʰt̪
وقت	ʋɑqt
وقتوں	ʋɪkt̪oːŋ
وقعت	ʋoqɑːt
وقف	ʋɑqf
وقفہ	ʋəfæ
وقفے	ʋəfæ
وقوع	ʋoːqoːʋ
وقوعہ	ʋoːqoʋə
وقوف	ʋoːqoːf
ول	ʋəl
ولادیمیر	ʋəlɑːdɪmiːr
ولف	ʋælf
ولمنگٹن	ʋəlməngʈən
ولو	ʋoːloː
ولید	ʋəliːd
ولیم	ʋəliːm
ولینٹ	ʋəliːnt
ون	ʋ
ونڈر	ʋʌnɖəɾ
ونڈشیلڈ	ʋʊnɖʃɪlː
ونڈو	ʋə̃ɳɖo
ونڈوز	ʋõːd̪oːs
ونگز	ʋəŋz
وو	ʋ
وولف	ʋʊlf
وولٹ	ʋoːlʈ
ووٹ	ʋoːt
ووڈ	ʋoːd
ووین	woːvin
وویک	ʋeːk
وچ	ʋəʈʈ
وڈ	ʋəɖ
وڈمبنا	ʋɘd̪m̪b̪n̪ɑ
وڈمبناوں	ʋəɗmʋbɑ̃o̯ː
وڈمبناپورن	ʋɘd̪mʋn̪aːpʊrn̪
وژن	ʋeːn
وک	ʋɔk
وکاست	ʋəkɑst̪
وکر	ʋkəɾ
وکلاء	ʋəkɑːlə
وکٹر	ʋɪkt̪əɾ
وکٹوریہ	ʋɪkʈoːɾɪjə
وکی	ʋeːkiː
وکیل	ʋəkɪl
وکیلوں	ʋəkɪlõː
وہ	ʋə
وہا	ʋɑ
وہاں	ʋɑhɑ̃
وہج	ʋəg
وہف	ʋəɦf
وہو	ʋoː
وہہ	ʋə
وہی	ʋəi
وہیل	ʋɛɪl
وہیں	ʋəɪ̃
وی	ʋiː
ویئر	ʋeːr
ویب	ʋeːb
ویتا	ʋiːt̪ə
ویجی	ʋiːdʒi
ویدر	ʋɪd̪r̪
ویر	ʋeːr
ویران	ʋiːrɑːn
ویرانے	ʋɪraːne
ویریزون	ʋiːɾiz̪oːn
ویزا	ʋɪzɑ
ویزہ	ʋeːze
ویسا	ʋeɪsə
ویسٹرن	ʋɪst̪əɾən
ویسے	ʋɪseː
ویشیا	ʋɪʃjə
ویل	ʋeːl
ویلن	ʋɪlən
ویلی	ʋiːliː
وین	ʋeːn
وینزویلا	ʋeːnzʋiːlə
وینٹیلیشن	ʋɪntiːlɪʃən
ویو	ʋiː
ویوردت	ʋeːrɪɾd̪t̪
ویٹا	ʋɪt̪aː
ویچارشیل	ʋɪtʃʰaːrʃɪl
ویچرچھیدن	ʋɪtʃrətʃʰɪd̪ːən
ویچلن	ʋɪtʃlən
ویڈیو	ʋiːd̪iːoː
ویڈیوز	ʋiːd̪iːz
ویژن	ʋɪzˈjɑn
ویکد	ʋeːkɪd
ویکسی	ʋɪksiː
ویکسین	ʋɪksɪn
ویگاس	ʋeːgɑːs
ویگن	ʋeːgən
ویگھٹنکاری	ʋiːgʱʈənkɑːrɪ
وے	ʋeː
ىء	ɪ
ىءز	ɛz
ىءض	ɪdʒ
ىءِµµ	ɪɪ
ىءّ	ɛ
ىأثہج	ɑːθɑːgʲ
ىاد	ɛːd
ىاطار	ɪɑːt̪ɑːr
ىہ	ə
ىہج	ɛhdʒ
ي	j
يµµ	ɪɾʈɑː
يµé	jeː
يµîاذ	jiːmɑːð
يµئ	ɪɾaː
يأؤ	jaːʔ
يؤ	jɔː
يإë	jeː
يإëہ	jeː
يئؤ	jeːo
ياد	jɑːd
يار	jɑːr
ياز	jaːz
ياص	jaːs
ياط	jaːt̪
ياطء	jaːt̪eː
يبنيوس	ɪbniːus
يہ	jeː
يہا	jeːhɑː
يہع	jeː
يہه	jeː
ً	ə
ًµç	ɑːr
ًµé	ʊrːdʊ
ًµخ	ʊrːdʊ
ًµخµé	ɪkʰe
ًµً	ɑːɾɑː
ًء	ʔ
ًارإ	ɑrɪ
ًہ	ə
ًہا	ɦɑː
ًہج	ɦɪdʒ
ًہع	ɦɑː
ٌµéہ	ʊn
ٌµئ	ʊn
ٌµا	ɪmɑːr
ٌµً	ɪnʈɑzɑr
ٌء	ʔ
ٌءِ	ʔi
ٌؤر	ʊr
ٌاد	ɑːd
ٌادءِ	ʔaːdi
ٌاط	ɑːt̪
ٌاك	ɑk
ٌاكءِ	ʔɑkɪ
ٌہ	ə
ٌہû	ʔʊ
ٌہüہ	ɑː
ٌہا	ʔɑː
ٌہخ	ɦɪkʰ
ٍء	ɛ
ٍءز	ɑz
ٍءِ	ə
ٍہ	ɪh
ٍہا	ɑː
ٍہج	ɦɪdʒ
ٍہف	ɦəf
َ	ə
َµµ	ɑːɾʊ
َµً	ɑː
َأ	ɑ
َإ	ə
َإآ	əɪ
َإن	ɪn
َار	ɑr
َاط	ɑːt̪
َاك	ɑk
َب	ɑb
َہ	ə
َہûہخ	əhuːx
َہا	ɑː
َہج	ɦɪdʒ
َہه	əhe
َہهہ	əheː
ُ	ʊ
ُء	ʔ
ُءî	ʊ
ُءِ	ʔi
ُأئ	ɑːi
ُہ	ə
ُہج	ʔɑdʒ
ِ	ə
ِµµ	ɪt̪ʰaːr
ِµخ	ɪkʰ
ِµه	ɪm
ِµهارإ	ɪmaːr
ِء	ə
ِءِ	ə
ِأ	ə
ِإ	ə
ِئ	ɛ
ِاتµه	ɪt̪ʰe
ِاد	ɪd
ِادہف	ɑːd̪ʌhf
ِار	ɑr
ِاط	ɪt̪ː
ِاك	ɪk
ِہا	ɪhɑ
ِہجءِ	ɦɪdʒeː
ِہغہج	ɪɣɑdʒ
ّ	ʔ
ّµ	ɑːr
ّءض	ɑdʒ
ّءك	ɑk
ّءِ	ʔi
ّآ	ɑː
ّاü	ɑː
ّاد	ɑːd
ّادءّ	ɑːdɑː
ّار	ɑr
ّاز	ɑz
ّاط	ɑːt̪
ّاكہ	ɑːkə
ّہ	ə
ّہا	ɦɑː
ّہج	ɦɪdʒ
ّہجءِ	ɦɪdʒeː
ّہخہ	ɦɪkʰ
ّہف	ɦəf
ْءز	əzm
ْءِ	ə
ْءّ	ə
ْؤ	ɔː
ْؤہ	ɔː
ْاد	ɑːd
ْاط	ɑːt̪
ْہ	ə
ْہا	ə
ْہج	ɦɪdʒ
ْہف	ɦəf
ٹا	ʈɑː
ٹائر	ʈɑɪr
ٹائم	ʈɑːɪm
ٹائمر	ʈɑːɪmər
ٹائمز	ʈɑːimeːz
ٹائٹس	ʈɑɪt̪s
ٹائٹن	ʈɑɪt̪n
ٹائی	ʈɑi
ٹائیگر	ʈɑɪgər
ٹار	t̪ɑːr
ٹارگٹ	ʈɑːɾgəʈ
ٹارگیٹ	ʈɑːɾgɪt̪
ٹاسک	ʈɑːsk
ٹافٹ	ʈɑːfʈ
ٹام	ʈɑːm
ٹامی	ʈəmi
ٹانگ	ʈaŋ
ٹانگوں	ʈaːŋgoːn
ٹانگیں	ʈəŋgeː
ٹاور	ʈɑuːr
ٹاورز	ʈɔːʋəɾz
ٹاپ	ʈɑp
ٹاک	ʈɑk
ٹاکنگ	ʈɑːkɪŋ
ٹرائل	tɾɑɪl
ٹرائلز	tɾɑɪlz
ٹرالی	tɾɑːli
ٹرانزٹ	ʈrɑnzɪt̪
ٹرانسفر	t̪rənsfeɾ
ٹرانسمیشن	ʈrɑnsmiːʃɑn
ٹرانسمیٹر	ʈrɑnsəmɪt̪r
ٹرانسپورٹ	ʈrɑːnspʊɾt̪
ٹرانسپورٹر	ʈɾənspʊɾt̪əɾ
ٹرانسپونڈر	ʈrɑnspʊnɖəɾ
ٹرانسپیرنسی	ʈɾənsəpɪrnsi
ٹربو	ʈʊɾboː
ٹرسٹ	ʈəɾsət
ٹرف	ʈəɾf
ٹرم	ʈəɾm
ٹرمنیٹر	tɾʊmɪnɪt̪ɾ
ٹرمینل	ʈɾeːmiːnəl
ٹرن	t̪rən
ٹرناراؤنڈ	ʈɾənɑːɾoʊ̯nd
ٹرنک	tɾənk
ٹروجن	ʈroːgən
ٹرپل	tɾʊpəl
ٹرک	ʈʊɾk
ٹرکوں	tɾəkõː
ٹرگر	tɪgɾ
ٹریس	tɾeːs
ٹریفک	ʈɾɪfɪk
ٹریلر	t̪ɾeːlɾ
ٹرین	ʈɾeːn
ٹرینر	t̪ɾeːnɾ
ٹریننگ	ʈɾeːnɪŋ
ٹرینوں	t̪ɾeːnõː
ٹریور	t̪ɾeːoɾ
ٹریول	tɾeːol
ٹریٹمنٹ	treːt̪mən̪t̪
ٹریڈ	tɾeːɽ
ٹریڈنگ	ʈɾeːɖiŋ
ٹریک	ʈɾeːk
ٹریکر	tɾeːkəɾ
ٹریکنگ	ʈɾeːkɪŋ
ٹریکی	t̪ɾeːki
ٹشو	ʈʃo
ٹمٹمانے	ʈʊmt̪mʊnɛ
ٹن	t̪ə̃
ٹنکر	ʈəŋkəɾ
ٹو	ʈʊ
ٹوئن	təʋn
ٹوائی	ʈʋɑi
ٹوبیس	ʈʊbeɪs
ٹور	ʈoːr
ٹورز	ʈoːɾz
ٹورس	ʈoːrɪs
ٹورنامنٹ	ʈoːrnaːmɛ̃ːt̪
ٹورنٹو	ʈoːrˈn̪ʈoː
ٹوسٹ	ʈoːst
ٹومی	t̪oːmi
ٹون	ʈoːn
ٹونگا	t̪oːŋgɑː
ٹونی	ʈoːniː
ٹوٹ	ʈoːʈ
ٹوٹا	ʈoːʈɑː
ٹوٹتا	ʈoːʈt̪ə
ٹوٹنے	ʈoːʈne
ٹوٹے	ʈoːʈe
ٹوپی	ʈoːpi
ٹوک	ʈoːk
ٹوکری	ʈoːkɾi
ٹوکساون	ʈoːksɔːn
ٹوکن	ʈoːkən
ٹوکیو	ʈoːkiːoː
ٹویٹر	ʈʋiːt̪əɾ
ٹپکاو	ʈʊpkaʊ
ٹچ	ʈɪtʃ
ٹکتا	ʈʰkʈʰt̪ɑ
ٹکرا	ʈkɾɑ
ٹکرانا	ʈʊkɾɑːnɑ
ٹکرانے	ʈkɾɑːne
ٹکرایا	ʈʊkɾɑːjɑː
ٹکٹ	ʈkʌt̪
ٹکٹکی	ʈʌkʈi
ٹکڑا	ʈkəɽɑ
ٹکڑے	ʈkəɽe
ٹکی	ʈʰkiː
ٹھاک	ʈʰaːk
ٹھنڈا	ʈʰə̃ɳɖɑ
ٹھنڈی	ʈʰənd̪iː
ٹھنڈے	ʈʰənde
ٹھوس	ʈʰoːs
ٹھوڑی	ʈʰoːɽiː
ٹھوکر	ʈʰoːkəɾ
ٹھٹھہ	ʈʈʰə
ٹھکانہ	ʈʰkɑːnə
ٹھکانے	ʈʰkəne
ٹھگ	ʈʰəg
ٹھہر	ʈʰʰeːr
ٹھہرئے	ʈʰʰeːrɛː
ٹھہرایا	ʈʰʰeːɾɑːjɑː
ٹھہرنا	ʈʰɛːɾnɑː
ٹھہرو	ʈʰəro
ٹھہریئے	ʈʰəɾiːe
ٹھہریں	ʈʰəɾeːn
ٹھہرے	ʈʰʰeːre
ٹھیرو	ʈʰiːroː
ٹھیری	ʈʰiːriː
ٹھیس	ʈʰeːs
ٹھیک	ʈʰeːk
ٹھیکیدار	ʈʰiːkiːd̪əɾ
ٹھیکیداروں	ʈʰiːkiːd̪əroːn
ٹھیکے	ʈʰiːke
ٹہرو	ʈʰəroː
ٹہلتا	ʈʰɛlt̪ɑ
ٹہلنے	ʈʰəlne
ٹی	t̪iː
ٹیب	t̪iːb
ٹیبل	teːbəl
ٹیس	ʈeːs
ٹیسٹ	ʈeːsʈ
ٹیسٹنگ	ʈeːsʈɪŋ
ٹیلا	t̪iːlə
ٹیلر	teɪlɑr
ٹیلنٹ	teɪlən̪t̪
ٹیلی	t̪eːliː
ٹیلیفون	teːlifɔn
ٹیم	t̪iːm
ٹیموں	teːmoːn
ٹین	t̪eːn
ٹینا	ʈiːnə
ٹینڈر	ʈeːnd̪əɾ
ٹینک	ʈeːŋk
ٹیوب	ʈʊːb
ٹیوٹنک	ʈeːʈʊnk
ٹیٹ	ʈeːʈ
ٹیٹو	ʈiːʈʊ
ٹیپ	ʈeːp
ٹیپو	teːpoː
ٹیچر	ʈeːtʃər
ٹیڈ	teːd
ٹیڈی	ʈeːdiː
ٹیڑھی	ʈeːɽʰiː
ٹیک	ʈeːk
ٹیکس	ʈɪks
ٹیکسی	ʈɪksiː
ٹیکنالوجی	ʈɛːkənɑːlɔdʒi
ٹیکو	ʈiːkoː
ٹیکٹونک	ʈɪkʈʊn̪k
ٹیکے	ʈeːke
پ	p
پئیں	peː
پا	pa
پاؤلو	paːuːloː
پاؤنڈ	poːnd̪
پاؤڈر	poːɽɪr
پاؤں	põ
پائلٹ	piːlɛːt
پائلٹوں	piːlɛːtoːŋ
پائپ	paːɪp
پائی	peɪ
پائے	peː
پابند	paːbənd
پابندی	paːbənɪd̪i
پاتا	paːt̪aː
پاتال	paːt̪əl
پاتھ	paːt̪ʰ
پاتی	paːti
پاتے	paːteː
پادری	paːd̪riː
پادریوں	paːd̪ɾijõː
پار	pɑːr
پارلیمنٹ	paːrliːmənt
پارٹنر	pɑːɾt̪nɾ
پارٹی	paːɾtiː
پارٹیشن	pɑːɾt̪iːʃən
پارٹیوں	paːɾtiːõː
پارک	pɑːɾk
پارکنگ	pɑːɾkɪŋ
پاس	pɑs
پاسبان	pɑːsbɑːn
پاستا	pɑːstɑː
پاسداری	pɑs̪d̪ɑːri
پاسز	paːs
پاسورڈس	pɑːsʊɾɖs
پاسپورٹ	paːspʊɾː
پاسپورٹس	paːspʊːɾʈs
پال	pɑːl
پالا	paːlɑː
پالتا	paːlt̪ə
پالنے	paːlnɛ
پالو	paːloː
پالی	paːliː
پالیدار	paːlɪd̪ɑːr
پالیسی	paːliːsiː
پالیسیوں	paːliːsɪ̃oː
پالیمر	pɑlɪmɪr
پامال	pɑːmɑːl
پامیلا	pəmɪlɑ
پانسہ	pɑ̃ːsə
پانچ	pɑːntʃ
پانچویں	pɑːntʃʰeːn
پانی	pɑːniː
پانی	pəniː
پانے	paːne
پاو	poː
پاور	poːr
پاوں	pɑ̃ː
پاٹ	paːt̪
پاپ	pɑp
پاپا	pɑpɑ
پاک	paːk
پاکستان	pɑkɪstɑːn
پاکستانی	paːkɪstɑːniː
پاکستن	pɑkst̪en
پاگل	paːgəl
پاگلپن	paːgəlpən
پاھنڈی	paːɦnɪd̪iː
پایا	pajɑ
پبلشنگ	peːbl̪əʃeŋ
پتا	peːt̪ə
پتائی	peːtɑːiː
پتروں	peːt̪roːŋ
پتلون	peːt̪loːn
پتلی	peːt̪liː
پتوار	peːt̪waːr
پتھر	pət̪ʰər
پتھراؤ	peːt̪ʰəroː
پتھروں	peːt̪ʰroː
پتہ	peːt̪ə
پتی	peːti
پتیوں	peːtijõː
پتے	peːte
پجاما	peːdʒɑːmɑː
پذیر	peːziɾ
پذیری	peːdʒiːriː
پر	pər
پرائر	peːraɪr
پرائیویسی	peːɾɑːiːviːsiː
پرائیویٹ	peːɾɑːɪʋeːt
پراسرار	peɾɑsɑɾɑr
پراسیکیوٹر	pəɾɑːsiːkuːt̪əɾ
پرامن	peɾɑːmn̪eː
پرامڈ	peːɾɑːmɪd
پرانا	pɾɑːnɑː
پرانی	pəɾəni
پرانے	prɑːnɛ
پراپرٹی	peːɾəppeːɾiː
پربامنڈل	pɾəbəmd̪əl
پربل	peɾbəl
پربووں	pɾəboːŋ
پرت	peɾt
پرتگالی	peɾtgɑːliː
پرتیاورتن	peːrt̪ijɑːʋəɾt̪n
پرتیبھا	peːrt̪eːbʱɑː
پرجوش	peːrgoːʃ
پرخلوص	peːrxəloːs
پردافاش	peɾd̪ɑːfɑːʃ
پردہ	pərd̪ə
پرزہ	peːɾze
پرس	peɾs
پرست	pɾəste
پرستار	peɾst̪əɾ
پرستی	pɾɛst̪i
پرسکون	pɛrsəkʊn
پرفیکٹ	pɪɾfeːkʰt̪
پرل	peːrl
پرندوں	peːɾən̪d̪oː
پرندہ	pərn̪d̪ə
پرندہ	pəɾɪnd̪a
پرندے	peːɾənɖeː
پرنس	prəns
پرنسپل	prənsɪl
پرنٹرز	pɾənt̪ɾeːz
پرنٹروں	peːrn̪t̪əroː
پرنٹنگ	pɾənt̪ɪŋ
پروا	pɪɾɑː
پرواز	puːrɑːz
پروازوں	puːrɑːzoːn
پروازیں	puːrɑːzɪ̃ː
پرواہ	puːɑːh
پروردگار	peːroːrdaːgəɾ
پرورش	peːɾoːʃ
پروسیسنگ	puːroːsɪsŋ
پروف	puːroːf
پروفائل	puːroːfɑːil
پروفیسر	puːroːfiːsər
پروموٹر	puːroːmʊt̪r̪
پرووڈنس	puːroːd̪əns
پروٹوٹائپ	puːroːt̪oːt̪ɑːɪp
پروٹوکول	puːroːt̪oːkɔl
پروٹیکشن	puːroːt̪eɪkʃn̪
پروپیگنڈہ	puroːpɪgænɖə
پروڈجی	puːɽoːdʒiː
پروڈکشن	puːɽɪkʃən
پروڈیوسر	pruːdiːʊsər
پروگرام	puːɾoːgɾɑːm
پروگرامز	prəʊgrɑːmz
پروگرامنگ	puːroːgrɑːmɪŋ
پروگراموں	puroːgəɾɑːmõː
پروں	peːroː
پرچم	pɑrtʃəm
پرچی	peːɾtʃiː
پرکشیپوکر	peːrkeːʃiːpuːkər
پرکشیپی	peːrkeːʃiːpiː
پرہار	pɾəɦɑːɾ
پرہیز	peːɾhɛz
پرہیزگاروں	peːɾeːzaːgɑːɾoːn
پری	peːriː
پریزنٹیشن	prɪzənˈteːʃən
پریس	prɪs
پریشان	peːriːʃɑːn
پریشانی	peːriːʃɑːniː
پریمکا	peːɾiːmkə
پریمی	prɪmi
پریمیم	peːriːmiː
پریوں	peːrijõː
پریڈ	peːɾɪɖ
پریی	peːriː
پرے	peː
پزا	peːzə
پزیر	peːziːr
پس	pɪs
پست	peːst
پستول	peːst̪oːl
پسسٹ	peːsːeʈ
پسند	pəˈsənd
پسندی	psənˈdiː
پسندیدہ	psənˈdiːd̪ə
پسٹن	psɪt̪n
پسینہ	psɪnə
پسینے	psɪneː
پش	pəʃ
پشاور	peːʃɑːʋəɾ
پشت	pʊʃt
پف	pʰ
پل	pəl
پلا	pəlɑ
پلازما	ˈplɑːzmɑː
پلان	pəlɑːn
پلانٹ	pəlɑ̃ːt̪
پلاٹون	ˈpəlɑːt̪ʊn
پلایا	pulɑːjɑː
پلس	pɛls
پلندے	ɛl̪ʌn̪d̪e
پلٹ	puːlʈ
پلٹا	ɽəʈə
پلٹانے	puːlʈɑːne
پلٹن	puːlʈən
پلگ	puɭ
پلی	piːli
پلیز	pleɪz
پلیٹ	peːliːt̪
پلیٹوں	piːlɪʈoː
پلے	peːle
پمپ	pʌmp
پن	pən
پناہ	peːnɑː
پناہی	peːnɑːɦiː
پنجرا	peːŋgrɑ
پنجری	pənɟri
پنجرے	peːŋgreː
پنجی	pəndʒi
پنجے	pəndʒeː
پندرہ	peːnd̪əɾə
پنرجہرن	pənɾeʒɾən
پنرجیویت	peːnɾdʒiːʋeːt
پنرملن	pənɾəmələn
پنپتی	peːnpʈiː
پنڈ	pə̃ɳɖ
پنڈت	pənd̪d̪eːt̪
پنکھوں	pɪŋkʰoː
پنکھے	peːŋkʰeː
پنگا	peːŋgə
پنیر	peːniːr
پو	po
پوائنٹ	poːɪ̃ːt̪
پوائنٹس	poːɪ̃ːʈs
پوتی	poːti
پوتے	poːt̪eː
پوجھو	poːʈʈʰo
پورا	poːrɑ
پورانیک	puːɾɑːnɪk
پورش	puːrʃ
پورٹ	pɔːɾt
پورٹریٹ	puːrt̪eːɾət̪
پورٹل	pɔːrʈəl
پورٹو	puːɾtoː
پوری	puːriː
پورے	pʊreː
پوزیشن	poːziːʃən
پوسٹ	poːst
پوسٹر	poːst̪ər
پوشیدہ	puːʃɪd̪ə
پول	pɔːl
پولارڈ	poːlɑːɾɪd
پولس	pɔːlɪs
پولستانی	poːlɑsˈtɑːniː
پولیس	poːlɪs
پولینڈ	poːlɪ̃ːd̪
پولیو	poːliːoː
پولیگراف	poːliːgʌɾəf
پونڈ	pʊ̃ːɳɖ
پوٹن	poːʈən
پوپ	poːp
پوچھ	poːtʃ
پوچھا	poːtʃʰɑː
پوچھتا	poːtʃt̪ɑː
پوچھتے	poːtʃʰteː
پوچھنا	poːtʃnɑ
پوچھنے	poːtʃne
پوچھو	poːtʃo
پوچھوں	poːtʃʰõ
پوچھیں	poːtʃʰeːn
پوچھے	poːtʃʰe
پویلین	peːʋɪlɪn
پَھس	ɸəs
پِچھلے	piːtʃlə
پْہنچی	peɪntʃiː
پٹ	pəʈ
پٹا	pəʈə
پٹائی	peːʈɑːiː
پٹاخہ	peːtɑːxə
پٹانگ	peːʈəŋ
پٹاکھی	peːʈɑkʰiː
پٹریوں	peːtɾiːõ
پٹسبرگ	pɪtsbɛɾg
پٹھوں	puːʈʰõː
پٹہ	pəʈʰə
پٹی	peːti
پٹیشن	peːʈiːʃən
پٹے	peːʈe
پپہنچنے	peːpəɳtʃne
پچ	peːtʃ
پچارا	petʃɑːɾɑː
پچاس	peːtʃɑs
پچاسی	pəʧɑːsi
پچھتاوا	pɪtʃt̪ɑːʋɑː
پچھلا	pɪtʃlɑ
پچھلی	pɪtʃli
پچھلے	pɪʈʰle
پچھواڑے	pɪtʃʰʋɑːɽe
پچیس	peːtʃɪs
پڑ	pəɽ
پڑا	pəɽɑ
پڑتا	peɽt̪ə
پڑتال	pəɽt̪ɑl
پڑتی	peɽt̪iː
پڑرہا	pəɽɾəɦɑ
پڑنا	peɽna
پڑنے	peɽne
پڑوس	peɽoːs
پڑوسیوں	peɽoːsɪ̃oː
پڑھ	peɽʰ
پڑھا	pəɽʰɑ
پڑھائیں	peɽʰɑ̃e̯i̯
پڑھاتی	pəɽʰɑːti
پڑھانے	peɽʰɑːne
پڑھتا	pəɽʈʰt̪ə
پڑھتی	pəɽʈʰti
پڑھتے	pəɽʈeː
پڑھنا	peɽʰnə
پڑھنے	pəɽʰne
پڑھو	peɽʰo
پڑھی	pəɽʰiː
پڑھیں	pəɽʰẽː
پڑی	peːɽiː
پڑیں	pəɽeː
پڑے	peɽe
پک	pɪk
پکا	pəka
پکار	pɪkɑːr
پکارا	pɪkɑːrɑ
پکارنے	peːkɑːrˈneː
پکارے	peːkɑːreː
پکانا	pɪkɑːnɑː
پکانے	peːkɑːneː
پکاکر	pəkɑkər
پکایا	peːkɑːjɑː
پکرے	peːkɾeː
پکوان	peːkʊɑːn
پکڑ	pəkəɽ
پکڑا	peːkəɽɑ
پکڑنا	pəkɽnə
پکڑنے	pəkɽne
پکڑو	pəkɽo
پکڑوں	peːkəɽõː
پکڑے	peːkəɽeː
پکی	peːki
پکے	pɪkːe
پگڈنڈی	pegɖənɖiː
پگھلا	peːɣlə
پھانسی	ɸɑ̃ːsi
پھاٹک	pʰɑːʈk
پھاڑ	fəɽ
پھاڑنا	fəɽnə
پھر	pʰəɾ
پھرتھوڑا	ɸəɾt̪ʰoɽɑ
پھرجب	ɸəɾdʒb
پھرحوالات	ɸəɾɦəwaːlɑːt
پھرنے	ɸəɾne
پھریں	ɸəɾẽː
پھسل	ɸəsl
پھسلائیں	ɸəslɑːẽː
پھل	ɸəl
پھلی	ɸəli
پھلیاں	ɸəliæ̃
پھلیوں	ɸəliːõ
پھنس	ɸəns
پھنسا	ɸɛnsə
پھنسایا	ɸənsɑjɑ
پھنسے	ɸənse
پھول	puɽ
پھولوں	puːlõː
پھونکا	ɸoːŋkə
پھوڑ	ɸoɽ
پھوڑا	ɸoːɽə
پھٹ	ɸəʈ
پھٹے	ɸəʈe
پھیر	ɸɪr
پھیری	peːriː
پھیل	feːl
پھیلا	peːlə
پھیلاؤ	feːlɑːo
پھیلایا	feːlɑːjɑː
پھیلتی	feːlt̪iː
پھیلی	pʰɪliː
پھینک	ɸɪ̃k
پھینکتا	ɸeːŋkəta
پھینکنے	ɸeːŋkneː
پھینکو	ɸeːŋkoː
پھینکی	ɸeːŋki
پھینکے	ɸeːŋkeː
پہ	pe
پہاڑ	peːɑːɽ
پہاڑ	pəɦɑːɽ
پہاڑوں	peːɑːɽõː
پہاڑی	peːɑːɽiː
پہاڑیاں	peːɑːɽjɑ̃
پہاڑیوں	peːɑːɽiːõː
پہر	peːr
پہرہ	peːɾə
پہل	peːl
پہلا	peːlə
پہلو	peːloː
پہلوٹھا	peːloːʈʰɑː
پہلی	peːli
پہلے	peːlə
پہن	peːn
پہنا	peːnə
پہنتے	pəɳt̪e
پہننے	peːnneː
پہنوگے	peːnʊgeː
پہنچ	peːnʧ
پہنچا	pəɲtʃə
پہنچاؤ	peːntʃɑːoː
پہنچائی	peːntʃɑːiː
پہنچائے	peːntʃɑːeː
پہنچاتا	peːnʧɑːt̪ɑː
پہنچاتی	peːntʃɑːt̪iː
پہنچانا	peːntʃɑːnɑː
پہنچانے	peːntʃɑːneː
پہنچاو	peːntʃɑːu
پہنچاو-مجھے	peːntʃɑːʊmʊdʒheː
پہنچایا	peːntʃɑːjɑː
پہنچنا	peːnʧnɑ
پہنچنے	peːnʧneː
پہنچوں	pəɳtʃʊ̃
پہنچی	peːntʃiː
پہنچیں	peːnʧiː
پہنچے	peːntʃeː
پہنی	peːni
پہنیں	peːɲːeː
پہنے	peːɳeː
پہچ	peːtʃ
پہچان	peːtʃɑːn
پہچانا	peːtʃɑːnɑː
پہیلی	peːɪliː
پہیلیوں	peːɪliːõ
پہیوں	peɪɦoː
پی	pi
پیئرس	piːɑːrɪs
پیئرسن	piːr̩sən
پیئے	piːe
پیار	pijɑr
پیار	pjaːɾ
پیارا	piːəɾə
پیاری	peːɑːriː
پیارے	pijəɾeː
پیاسا	piːsɑː
پیاسے	piːɑːse
پیانو	pijɑːnoː
پیتا	piːt̪ə
پیتھالوجیکل	piːθɑːlɔːdʒɪkəl
پیتے	piːt̪eː
پیج	peːdʒ
پیجر	peːgər
پیدا	piːd̪ə
پیدائش	piːdɑːʃ
پیداش	piːdɑːʃ
پیداوار	piːdɑːʋɑːr
پیداواری	piːdɑːʋɑːriː
پیدل	piːdəl
پیر	peːr
پیراشوٹ	peːɾɑːʃɔːt
پیراگراف	peːrɑːgrɑːf
پیرس	peːrs
پیروکاروں	piːroːkɑːroːn
پیروں	piːɾoː
پیروی	peːriː
پیری	peːriː
پیزا	piːzə
پیس	peːs
پیسنا	peːsˈnə
پیسوں	piːsõː
پیسٹ	peɪst̪
پیسہ	piːsə
پیسیفک	piːsiːfɪk
پیسے	piːse
پیش	piːʃ
پیشاب	piːʃæb
پیشانی	piːʃɑːniː
پیشن	piːʃn
پیشکش	piːʃkɪʃ
پیشگی	piːʃgiː
پیشہ	piːʃə
پیشے	piːʃe
پیغام	piːɣɑm
پیغام	pæɪˈɣɑːm
پیغامات	piːɣɑmɑt̪
پیغمبر	piɣæmbər
پیغمبروں	piːɣæmbəroːn
پیلوڈ	piːloːd
پیلی	piːliː
پیلے	piːlə
پیمانہ	piːmɑːnə
پیمانے	piːmɑːnɛ
پینا	piːnə
پینتیس	piːnːtis
پینسل	piːnsəl
پینسلوانیا	piːnsəlʋɑːniɑː
پینشن	piːnʃən
پینل	piːnəl
پینٹ	peːnt
پینٹاگن	piːn̪t̪əgən
پینٹاگون	piːn̪t̪əgoːn
پینے	peːne
پیوست	piːoːst
پیوں	piːõ
پیٹ	peːʈ
پیٹا	peːt̪aː
پیٹر	peːt̪r
پیٹرسن	peːt̪ɾʌsən
پیٹرن	peːt̪ərn
پیٹرک	peːt̪rək
پیٹن	peːʈən
پیٹنا	peːʈnə
پیٹنے	peːʈneː
پیٹو	peːʈoː
پیٹھ	peːʈʰ
پیٹیو	peːtiːu
پیپا	piːpə
پیپر	piːpər
پیپلز	piːpəlz
پیچ	piːtʃ
پیچھ	piːtʃː
پیچھا	piːtʃʰɑː
پیچھے	piːtʃʰeː
پیچیدہ	piːtʃɪd̪ə
پیڑوں	peːɽoːŋ
پیک	piːk
پیکج	peːkɑdʒ
پیکجوں	piːkʲdʒoːn
پیکٹ	peːkʈ
پیگی	piːgiː
پے	peː
چاؤ	tʃɑːʊ̯
چائیے	tʃɑːɪe
چائے	tʃɑːe
چائے	tʃɑːʲ
چابی	tʃɑːbi
چابیاں	tʃɑːbijɑ̃
چادر	tʃɑːd̪əɾ
چار	tʃʰɑːr
چارا	tʃɑːɾɑː
چارج	tʃɑːɾʒ
چارجر	tʃʰɑːɾgɑɾ
چارلس	tʃʰɑːɾəls
چاروں	tʃɑːɾõ
چارٹ	tʃɑːɾt̪
چارہ	tʃəɾɑ
چاری	tʃɑːɾi
چارے	tʃʰɑːɾe
چاقو	tʃɑːqo
چال	tʃɑl
چالاک	tʃɑːlɑːk
چالو	tʃɑːloː
چالوں	tʃɑːlõː
چالیس	ʃɑːlɪs
چاند	tʃɑːnd
چاند	tʃɑːnd̪
چاندی	tʃɑːnd̪iː
چانسلر	tʃɑːnsəlɾ
چاوڈر	tʃɔːɽ
چاپلوسی	tʃɑpɫuːsi
چاچی	tʃɑːtʃi
چاکلیٹ	tʃɑkliːt̪
چاہ	tʃɑː
چاہئیں	tʃɑːɛ̃ː
چاہئے	tʃɑːɦiːe
چاہا	tʃɑːhɑː
چاہتا	tʃɑːɦt̪ɑː
چاہتی	tʃɑːɦt̪i
چاہتے	tʃɑːɦte
چاہنے	tʃɑːɦne
چاہو	tʃɑːho
چاہوں	tʃɑːɦõ
چاہیئں	tʃɑːʔiːə̃
چاہیئے	tʃʰɑːdʒʰiːe
چاہیں	tʃɑ̃heːn
چاہیے	tʃʰɑːdʒʰeː
چاہے	tʃɑːhe
چتا	tʃʰət̪ə
چجرسی	tʃʰəd̪z̪i
چرا	tʃəɾɑ
چرایا	tʃəɾɑːjə
چربی	tʃɛɾbi
چرخی	tʃəɾki
چرس	tʃɪɾs
چرواہا	tʃroːɑːhɑː
چروکی	tʃɾoːki
چرچ	tʃɛɾtʃ
چرچا	tʃɛɾtʃɑ
چرھتا	tʃəɾʰt̪ə
چشمہ	tʃʃʰmɛ
چشمیں	tʃʃʰmeːn
چغد	tʃʰəgd̪
چل	tʃəl
چلئے	tʃʰəliː
چلا	tʃəla
چلاؤ	tʃəlɑːu
چلاؤں	tʃəlɑ̃ː
چلائی	tʃəlɑːi
چلائیں	tʃɑlɑẽː
چلائے	tʃəlɑːe
چلاتا	tʃʰəlɑːt̪ə
چلاتی	tʃʰəlɑːt̪i
چلاتے	tʃʰəlɑːt̪e
چلاجاؤں	tʃəlɑːdʒoːŋ
چلانا	tʃəlɑːnɑː
چلانی	tʃəlɑːniː
چلانے	tʃəlɑːne
چلاو	tʃəloː
چلاوں	tʃəlɑ̃ː
چلایا	tʃəlɑːjɑː
چلتا	ʃəlt̪ə
چلتی	tʃʰəɭti
چلتے	tʃʰəl̪t̪eː
چللا	tʃəllə
چللایا	tʃʰɪllɑːjɑː
چلنا	tʃəlnə
چلنے	tʃəlne
چلو	tʃʰlo
چلوں	tʃʰlõː
چلی	tʃʰeːli
چلیں	tʃeːlɪ̃
چلے	tʃʰle
چمتکار	tʃʌmətkɑr
چمن	tʃʰmən
چمڑی	tʃʌmɾi
چمک	tʃʌmʌk
چمکو	tʃəmko
چمکی	tʃʌmki
چمکیں	tʃʌmkiːɳ
چنانچہ	tʃɛnɑtʃʰe
چند	tʃʌnd
چننا	tʃənːə
چنو	tʃəno
چنیں	tʃəɳ
چوبن	tʃoʊbən
چوبیس	tʃoːbɪs
چوتڑ	tʃoʈʈə
چوتھا	tʃoːtʰɑː
چوتھائی	ʈʊtʰɛ
چوتھی	tʃoːtʰi
چوتھے	tʃoːtʰe
چودھری	tʃoːd̪ʱri
چودہ	tʃoːd̪ə
چور	tʃoːr
چوروں	tʃoːɾoː
چوری	tʃoːriː
چوغے	tʃoɣe
چولہا	tʃoːləɦɑː
چولی	tʃoːli
چوم	tʃom
چومنے	tʃomne
چومو	tʃomo
چونکا	tʃʰoŋkə
چونکہ	tʃʰʊŋkæ
چوٹ	tʃoːʈ
چوٹوں	tʃoʈoː
چوٹی	tʃoʈi
چوڑیل	tʃoɽiːl
چوڑیلوں	tʃoɽiːlõ
چوک	tʃoːk
چوکر	tʃoːkəɾ
چوکس	tʃoːk
چوکنا	tʃoːknə
چوکوں	tʃoːkõː
چوکی	tʃoːki
چوکیدار	tʃoːkɪd̪əɾ
چوہا	tʃoʊɦɑː
چوہوں	tʃoʊɦoː
چَل	tʃəl
چَلتی	tʃʌlt̪iː
چُغہ	tʃʰʊɣə
چُھری	tʃʰri
چُھوا	tʃʰʊɑː
چِلّائے	tʃɪlːɑːe
چْڑیل	tʃɽiːl
چْکا	tʃʰkɑ
چْھپی	tʃʰpɪ
چٹانوں	tʃʰət̪ɑːnõː
چٹنی	tʃʰəʈni
چپ	tʃʰeːp
چپس	tʃʰeːpʰs
چپٹی	tʃʰeːpt̪iː
چپچپا	tʃʰeːptʃʰeːpə
چپکی	tʃʰeːbki
چپہ	ʈʃpeː
چچا	tʃtʃɑ
چڑھ	tʃəɽʰ
چڑھا	tʃɽʰɑː
چڑھانے	tʃɽʰɑːne
چڑھنا	ʈʂəɽʱnə
چڑھنے	tʃəɽʰne
چڑھو	tʃəɽʰo
چڑھیں	tʃəɽʱẽː
چکا	tʃkɑ
چکانی	tʃəkɑːni
چکاگو	tʃɛkɑːgʊ
چکایا	tʃəkɑːjɑː
چکر	tʃkər
چکروات	tʃkɾoʔɑːt
چکمہ	tʃekmɑ
چکن	tʃkən
چکنا	tʃʰeknə
چکنائی	tʃkənɑːi
چکو	tʃko
چکھ	tʃʰkʰ
چکی	tʃeːki
چکے	tʃʰʊke
چھ	tʃʰ
چھاتی	tʃʰɑːt̪iː
چھاننا	tʃʰɑːnnɑː
چھاپ	ʈʃɑp
چھاپا	ʈʃɑpɑ
چھاپہ	ʈʃɑpʰə
چھاپے	ʈʃɑpe
چھبیس	ʈʃʰbeːs
چھت	ʈʂʰt̪
چھتری	tʃʰt̪riː
چھتوں	ʈʂʰt̪oːŋ
چھدرت	ʃɪɽɾət
چھرا	ʈʃrɑ
چھری	ʈʃri
چھریوں	ʈʃʁijõː
چھلانگ	ʈʃʰlɑːŋ
چھلاورن	ʃɪlɑːuɾn
چھو	ʈʃoː
چھوئے	tʃʰoe
چھوا	ʈʃʋɑː
چھوری	ʈʃoːriː
چھونا	ʈʃoːnə
چھونے	ʈʃoːne
چھوٹ	ʈʂoːʈ
چھوٹا	ʈʂoːʈɑ
چھوٹی	ʈʃoːʈiː
چھوٹے	ʈʂoːʈe
چھوڑ	ʈʂoɽ
چھوڑا	ʈʂoːɽə
چھوڑتا	ʈʂoɽt̪ə
چھوڑتے	tʃʰoɽt̪e
چھوڑدی	ʈʂoːɽɖi
چھوڑنا	ʈʂoɽnə
چھوڑنی	ʈʂoːɽniː
چھوڑنے	ʈʂoːɽne
چھوڑو	ʈʃoːɽoː
چھوڑولگتا	ʈʃoːɽoːgt̪ə
چھوڑوں	ʈʃoːɽoːŋ
چھوڑیں	ʈʃoːɽeːn
چھوڑے	ʈʂoɽe
چھوکری	ʈʃoːkɾiː
چھْپا	ʈʂʰpə
چھٹکارا	ʈʂʈkɑːrɑ
چھٹی	tʃʰʈiː
چھٹیوں	ʈʂʈiːõː
چھٹے	ʈʂʈeː
چھپ	ʈʂʰp
چھپا	ʈʂpə
چھپائیں	ʈʂpɑːẽː
چھپاتا	ʈʂʰpət̪ə
چھپانے	ʈʂpɑːne
چھپایا	ʈʂpɑːjɑː
چھپنے	ʈʂʰpne
چھپی	tʃʰpiː
چھپے	ʈʂʰpeː
چھچھوراپن	ʈʂʈʰoːɾəpən
چھڑاو	ʈʂɽɑːʋ
چھڑی	ʈʂɽiː
چھید	tʃʰiːd̪
چھیدنے	ʈʃɪd̪ne
چھین	tʃʰiːn
چھینک	tʃʰiːŋk
چھیڑ	tʃʰɪɽ
چھیڑنے	tʃʰɪɽnɛ
چھیڑچھاڑ	tʃʰiːɽtʃʰɑːɽ
چہروں	tʃʰeːroː
چہرہ	tʃɛɦɾɑ
چہرہ	tʃʰeːɾə
چہرے	tʃʰeːre
چہچہانا	tʃʰɑdʒʰɑːnɑː
چیئر	ʃiːr
چیئرز	ʃiːɾz
چیت	tʃeːt̪
چیخ	çɪx
چیخا	ʈʃʰɑː
چیخنا	ʃɪxnə
چیخنے	ʈʃʰɪkʰne
چیخو	ʃɪxʊ
چیر	tʃeɪɾ
چیرس	tʃɪɾs
چیری	tʃiːɾi
چیز	tʃiːz
چیزوں	tʃiːzõː
چیزيں	tʃiːzɪ̃
چیزیں	tʃiːzẽ
چیف	tʃeːf
چیلنج	tʃɪlɪndʒ
چیلنجز	tʃɪləngz
چیمبر	tʃeːmbər
چیمپئن	tʃeːmpiːn
چین	tʃɪn
چینل	tʃɪnəl
چینلز	tʃɪnlæz
چینگ	tʃeːŋ
چینی	tʃiːniː
چیٹ	tʃʰeːt̪
چیٹنگ	ʃɪt̪ːɪŋ
چیک	tʃiːk
چیکنا	tʃiːkənɑː
چیکوں	tʃiːkoːn
ڈاؤن	ɗəʊn
ڈاؤننگ	ɖəʊ̃ŋ
ڈاؤنہل	ɗəʊnɑɦl
ڈائرکٹر	ɖɑɪɾɛkt̪ɾə
ڈائریکٹ	ɖɑɪɾɪkt̪
ڈائریکٹر	ɗɑɪɾɪkt̪əɾ
ڈائریکٹرز	ɖɑɪɾɪkt̪əɾz
ڈائل	ɗɑɪl
ڈائلسس	ɗɑɪlɛs
ڈائلنگ	ɖɛɪlɪŋ
ڈائمنڈ	ɗɑɪmɛ̃ːɳɪd
ڈائن	ɖɛn
ڈاج	ɖɑdʒ
ڈارت	ɗɑːɾt
ڈارلنگ	ɖɑːrlɪŋ
ڈارون	ɖɑːrʊn
ڈارک	ɖɑːɾk
ڈاس	ɗɑs
ڈال	ɖɑl
ڈالا	ɖɑːlɑː
ڈالتا	ɗɑlt̪ɑ
ڈالتے	ɗɑlte
ڈالر	ɖɑlɑr
ڈالرز	ɖɑːlɑːrɛs
ڈالنا	ɗɑlnɑ
ڈالنے	ɗɑːlnɛ
ڈالو	ɖɑːloː
ڈالونگا	ɗɑlʊŋgɑ
ڈالوں	ɗɑːlõː
ڈالی	ɗɑːliː
ڈالیں	ɗɑːlẽː
ڈامنو	ɖəmeːnoː
ڈان	ɖɑːn
ڈاٹ	ɗɑːʈ
ڈاک	ɖɑk
ڈاکو	ɗɑːkoː
ڈاکوؤں	ɗɑːkoːɳ
ڈاکٹر	ɖɑkʈəɾ
ڈاکٹرز	ɖɑkʈəɾz
ڈاکٹروں	ɗɑkʈəɾoːn
ڈاگ	ɗɑːg
ڈبل	ɖʌbəl
ڈبلیو	ɖʋəli
ڈبہ	ɖʊbʌ
ڈبے	ɗʊbeː
ڈر	ɖəɾ
ڈرا	ɖəɾɑ
ڈراؤنا	ɖəɾɔːnə
ڈرائنگ	ɖəɾɑɪŋ
ڈرائیو	ɖəɾɑɪʋ
ڈرائیور	ɖəɾɑːɪʋəɾ
ڈرائیوروں	ɖəɾɑːjʋəɾoːŋ
ڈرائیونگ	ɖəɾɑːjʊŋ
ڈرائیں	ɖəɾɑ̃ẽː
ڈرامائی	ɖɾɑːmɑːi
ڈرامہ	ɖəɾɑːmə
ڈرامے	ɖɾɑːme
ڈرانا	ɖəɾɑːnɑ
ڈرانے	ɖəɾɑːne
ڈراونا	ɖəɾoːnə
ڈراونی	ɖəɾɔ̃ːni
ڈراپ	ɖəɾɑp
ڈرتا	ɖəɾt̪ə
ڈرتے	ɗəɾteː
ڈرل	ɖʌrəl
ڈرنے	ɖəɾneː
ڈرو	ɖroː
ڈرون	ɖɾoːn
ڈرپوک	ɖəɾpoːk
ڈرگز	ɖəɾguz
ڈری	ɖəɾiː
ڈریسر	ɖɾeːsər
ڈریک	ɖəɾɪk
ڈریکولا	ɖəɾɪkoːlə
ڈریگن	ɖɾeːgn
ڈرے	ɖəɾeː
ڈزنی	ɖʌzniː
ڈسپلے	ɖəspɭeː
ڈسپیچر	ɗəspɪtʃər
ڈسچارج	ɗəʃɑːɾʒ
ڈسک	ɖəsk
ڈسکاونٹ	ɗɪskɔːnt
ڈسکوری	ɗɪsˈkuːɾi
ڈلیوری	ɖəliːʋiː
ڈمپ	ɗəmp
ڈمپنگ	ɗʊmpɪŋ
ڈمی	ɗʊmi
ڈنڈوں	ɖʌnɖoːŋ
ڈنڈی	ɖʌnɖi
ڈنڈے	ɖʌnɖe
ڈنگ	ɖəŋ
ڈو	ɖoː
ڈوئچے	ɗoːɪtʃeː
ڈوب	ɗoːb
ڈوبانے	ɗoːbɑːne
ڈوبکی	ɗʊbki
ڈور	ɖoːr
ڈوراین	ɖoːɾɛn
ڈوروتی	ɖoːɾʊtiː
ڈوم	ɗom
ڈومز	ɗomz
ڈومینک	ɖoːmɪnɪk
ڈومینیکن	ɗoːmineːkɑːn
ڈونا	ɖoːnə
ڈونگ	ɗoŋ
ڈوور	ɗoːr
ڈوپ	ɖoːp
ڈویژن	ɗʋiːzə̃n
ڈویژنوں	ɗʋiːzɪ̃oːŋ
ڈپارٹمنٹ	ɗəpɑːrt̪mɛ̃ːt̪
ڈپازٹس	ɖʊpɑːzʈs
ڈپلومہ	ɖʊplomə
ڈپلومیٹک	ɗʊplomɪt̪k
ڈپٹی	ɗʊpt̪iː
ڈکارڈ	ɖəkaːɾɪd
ڈکرپشن	ɗʊkəɾpəʃn
ڈکسن	ɗɪksən
ڈکی	ɖəki
ڈگری	ɖʌgriː
ڈھادو	ɖʱɑːɖʊ
ڈھال	ɖʰɑːl
ڈھانپو	ɖʰɑ̃po
ڈھانپیں	ɖʰɑ̃ːpeː
ڈھانچہ	ɖʰɑːnʈʃe
ڈھانچے	ɖʰɑ̃tʃe
ڈھنگ	ɗʰəŋ
ڈھول	ɗʰoːl
ڈھونڈ	ɖʰoːɳɖ
ڈھونڈتے	ɖʰoːɳɖ̪teː
ڈھونڈنا	ɖʰoːɳɖənə
ڈھونڈنے	ɖʰoːnɖne
ڈھونڈو	ɖʰoːɳɖoː
ڈھونڈھو	ɖʰoːɳɖʰoː
ڈھکنا	ɖʱkənə
ڈھکنے	ɗʰkʌneː
ڈھکی	ɖʱkɪ
ڈھکے	ɖʱkʰe
ڈھیر	ɗʱeːr
ڈھیلے	ɖʱeːl̪eː
ڈی	ɗiː
ڈیاز	ɖiːz
ڈیاگو	ɖɪjɑːgʊ
ڈیبی	ɗiːbiː
ڈیجیٹل	gɪˈgɪtəl
ڈیز	ɖeːz
ڈیزائن	ɖeːzɑːɪn
ڈیزائنز	ɖeːzɑːɪnz
ڈیسمنڈ	ɗeːsmənd
ڈیش	ɖɛːʃ
ڈیفالٹ	ɗeːfɑːlʌt
ڈیفنبرٹ	ɖeːfənbɛːɾt
ڈیل	ɗeːl
ڈیلر	ɖeːlɾ
ڈیلس	ɗɪls
ڈیلورس	ɗɛːlʊrʌs
ڈیلٹا	ɖɛlʈɑ
ڈیلی	ɖiːliː
ڈیم	ɗiːm
ڈیمن	ɗeːmɪn
ڈیموں	ɗiːmoːn
ڈیمین	ɖiːmɪn
ڈین	ɖeːn
ڈینئیل	ɖeːnɛɪl
ڈینس	ɖeːn̪s
ڈینش	ɖeːnɪʃ
ڈینیل	ɖeːniːl
ڈیو	ɗiːu
ڈیوائس	ɗiːwaɪs
ڈیوس	ɖeːʋs
ڈیووس	ɗɪuːs
ڈیوٹی	ɗiːuːtiː
ڈیٹ	ɗeːt̪
ڈیٹا	ɖiːt̪ə
ڈیٹرائیٹ	ɖeːt̪ɾɑɪt̪
ڈیٹرایٹ	ɖeːt̪əɾɑːɪt̪
ڈیٹرنس	ɖeːt̪rəns
ڈیٹس	ɗeːʈs
ڈیٹنگ	ɗeːʈeŋ
ڈیپارٹمنٹ	ɛːpɑːrt̪mɛ̃ːt̪
ڈیپلومیٹ	ɖiːpɫoːmɪt̪
ڈیڈی	ɖiːɖiː
ڈیڑھ	ɖeːɽʰ
ڈیک	ɖeːk
ڈے	ɖeː
ڑلان	ɽɑlɑn
کئی	keː
کئے	keː
کا	kə
کاؤبای	koːbɑɪ
کاؤنٹس	koːnʈs
کاؤنٹی	koːnʈiː
کاؤنٹیوں	koːnʈijoː
کائنات	kiˈnɑːjət
کابل	kɑːbəl
کابلِ	kɑːbɪlɪ
کابک	kaːbʊk
کاتجربہ	kɑːtʒɪrbɑː
کاج	kɑːdʒ
کار	kɑːr
کاربن	kɑːrˈbən
کارتوس	kɑːɾt̪us
کارخانہ	kɑːɾxɑːnə
کارخانے	kɑːɾkʰɑːnɛ
کارروائی	kɑːroːʔɑːi
کارسن	kɑːɾsən
کارن	kɑːrən
کارندوں	kɑːrənd̪oː
کارندہ	kɑːrən̪d̪ə
کارنیول	kɑːrniːuːl
کاروائی	kɑːɾʋɑːiː
کاروان	kɑːrʋɑːn
کاروبار	kɑːrʊbɑːr
کاروباروں	kɑːrʊbɑːrõ
کاروباری	kɑːrʊbɑːri
کاروں	kɑːroː
کارٹر	kɑːɾt̪əɾ
کارٹون	kɑːɾt̪oːn
کارٹیجنا	kaːɾteːdʒnɑː
کارپورل	kɑːɾpʊɾəl
کارپوریشن	kɑːɾpʊɾiːʃən
کارپوریشنز	kaːɾbʊɾiʃnz
کارڈ	kɑːɾɪd
کارکردگی	kɑːɾkʊɾd̪ɪ
کارکن	kɑːɾkən
کارکنوں	kɑːɾkʊnõː
کارکوژیہ	kɑːɾkoːʒiəh
کارکْن	kɑːɾkən
کارگو	kɑːrgoː
کاری	kɑːriː
کاریں	kɑːɾiːŋ
کاز	kaːz
کاسٹیوم	kɑːst̪iːʊm
کاش	kɑʃ
کاشت	kaɪʃt
کاشکریہ	kɑːʃkɪriːɑː
کاغذ	kɑːɣəð
کاغذات	kɑːɣɑːðɑːt
کاغذی	kɑːɣɪzi
کافر	kɑːfeɾ
کافروں	kɑːfɾoː
کافرین	kɑːfeːrɪn
کافی	kɑːfiː
کال	kɑːl
کالب	kɑlbʊ
کالج	kɑːlɛʒ
کالز	kalz
کالفیکس	kalfeːkʰs
کالنگ	kɑːlɪŋ
کالی	kɑːliː
کام	kɑːm
کامریڈ	kɑːmriːɽ
کامل	kaːməl
کاموں	kɑːmoːn
کامیاب	kɑːmiːɑːb
کامیابی	kɑːmjɑːbiː
کامیابی	kɑːmɪɑːbiː
کامیابیوں	kɑːmɪɑːbijõː
کان	kɑːn
کانرائے	kɑːnɾɑːeː
کانفرنس	kɑːnfərnes
کانفرنسوں	kɑːnfəɾənsõː
کانوائے	kɑnʋɑːe
کانوں	kɑːnõː
کانٹا	kɑ̃ːt̪ɑː
کانٹوں	kɑ̃ːʈõː
کانٹے	kɑ̃ːt̪eː
کانگ	kɑːŋ
کانگریس	kɑːŋgɾɛs
کاْ	kə
کاٹ	kaːʈ
کاٹنا-کاٹنا	kaːʈnaːkaːʈnaː
کاٹنے	kaʈne
کاٹو	kaːʈoː
کاٹیج	kaːtiːdʒ
کاٹیں	kaːʈeː
کاپتہ	kɑːpʈə
کاپٹر	kɑːpʈəɾ
کاپٹرز	kɑːpt̪əɾz
کاپی	kaːpiː
کاچ	kɑtʃ
کاڈر	kaːɽɾ
کاک	kɑk
کاہن	kaːɦən
کا۴۰	kaːɾoː
کب	kʌb
کباب	kʌbɑːb
کبھی	kəβʱi
کتا	kʌt̪ɑː
کتاب	kɪtaːb
کتاب	kɪtɑb
کتاب	kɪt̪ɑːb
کتابوں	kɪtɑːbʊ̃
کتابیں	kɪtɑːbɪ̃ː
کتب	kɪt̪b
کتنا	kʌt̪nɑ
کتنوں	kʊt̪nõː
کتنی	kʌt̪niː
کتنے	kʊt̪neː
کتوں	kʌt̪oːŋ
کتیا	kʊt̪iːə
کتے	kʌt̪eː
کثرت	kʰɛʃtʰeɾ
کجھ	kəʒʰ
کدھر	kɪd̪ʱəɾ
کر	kər
کرا	kəɾɑ
کراؤ	krɑːu
کراؤں	krɑːʊ̃
کرائم	krɑːim
کرائی	kəɾɑːi
کرائیں	kɾɑːeːn
کراتی	krɑːti
کراس	krɑs
کرافٹ	krɑːfʈ
کرال	kɾɑːl
کرانے	krɑːnɛ
کراو	kɑːɾɑːu
کراچی	kəɾɑːtʃi
کراکوژین	kɾɑːkoʒɪn
کراکوژیہ	kɪɾɑkoːʒɪhɑ
کراہنا	kəɾɑːhəna
کرایا	kʊɾɑjɑ
کرایہ	kɾɑːjə
کرتا	kɪɾtɑ
کرتی	kɪɾti
کرتے	kəɾt̪eː
کرتے-چلو	kɾeːt̪etʃʰloː
کردار	kurd̪ɑːr
کردو	kurduː
کردوں	kurduːŋ
کردہ	kɪɾd̪ə
کردی	kurd̪iː
کردیا	kurdiə
کردیتا	kurd̪iːt̪ə
کردیتے	kurd̪iːt̪eː
کردینا	kurdiːnɑː
کردینگے	kurd̪iŋgeː
کردینے	kurd̪iːneː
کردیں	kurdeːn
کردیے	kurd̪iː
کررہا	kɪrɾɑhɑ
کررہی	kɪrɾəhiː
کررہے	kɪrɾəhɛ
کرس	krɪs
کرسمس	krɪsməs
کرسٹن	krɪst̪ən
کرسٹینا	krɪsˈtɪnə
کرسکتا	krɪsˈkɪt̪ə
کرسکتے	krɪskeːt̪eː
کرسکو	krɪskoː
کرسکوں	krɪskoːn
کرسکیں	krɪsˈkẽː
کرسی	kɪrsi
کرش	kɾəʃ
کرشمائی	kɪrʃəmaɪ
کرفیو	kɑːrfiːu
کرلو	kɪrloː
کرلوں	kɪɾloːŋ
کرلی	kɪrli
کرلیا	kɪlɪjə
کرلیتے	kɪɾliːt̪eː
کرلینا	kɪɾlɪnɑ
کرلینگے	kɪɾleːŋeː
کرلینی	kɪɾliːniː
کرلیں	kɪrleːn
کرلے	kɾleː
کرم	kɑːɾəm
کرمنل	kɪrmənəl
کرن	kəɾn
کرنا	kəɾnə
کرنسی	kɑːrnisɪ
کرنل	kɑːrˈnɛl
کرنکل	kəɾnkəl
کرنی	kəɾni
کرنیں	kəɾnẽː
کرنے	kəɾne
کرو	krʊ
کروئیسینٹ	krʊweːsɪnt
کروا	krɔː
کرواؤ	krɔːu
کرواؤں	krɔɔ̃
کروائی	krʊɑːi
کروانا	krʊˈɑːnə
کروانے	krɔːne
کروز	krʊz
کرونگا	krʊngə
کروڑوں	krʊɽoːŋ
کروگی	krʊgi
کروگے	krʊge
کروں	kəroː
کرپا	krəpa
کرچکیں	krətʃkẽː
کرک	kɪɾk
کرکرا	kɪɾkɾɑ
کرکٹ	krɪkʈ
کرکے	krəkɛ
کرہا	kəɾhɑ
کرہی	kɪɾəɦiː
کرہے	kəɾhe
کری	krɪ
کریسٹن	krɪsˈt̪ən
کریش	krɪʃ
کریم	kɑɾiːm
کرین	kɪɾeːn
کرینگے	kɪɾɪŋe
کریٹ	krɪt̪
کریڈٹ	krɪd̪ʌt̪
کریگا	krɪgɑ
کریں	krɪ̃
کریے	krɪe
کرے	kɪɾeː
کزن	kəzn
کس	kʌs
کسان	kʰəˈsɑːn
کسٹم	kɪst̪m
کسی	kʰəsi
کسے	kʰəsæ
کش	kɪʃ
کشائی	kɪʃɑːi
کشتی	kəʃt̪iː
کشتی	kɪʃti
کشش	kɪʃ
کشف	kɪʃf
کشمیر	kəʃmiːr
کشنیری	kɪʃniːriː
کشی	kɪʃi
کشیدگی	kɪʃɪdgiː
کفار	kəfɑr
کفارہ	kʊfəɾɑ
کفن	kɑfɪn
کل	kəl
کلارک	klɑːɾɑk
کلاس	kəlɑs
کلاسک	kəlɑːs
کلاسیکی	kɪlɑːsɪki
کلام	kɑləm
کلب	kəlb
کلف	klɪf
کلنگ	kəlæŋ
کلو	kɭoː
کلوزڈ	klɔːzɪd
کلوننگ	kɪlɔːnɪŋ
کلپ	kəlp
کلپنا	kalpənə
کلک	kəlk
کلکس	kəlkʌs
کلی	kɪli
کلیئرنس	klɪːrəns
کلیئرنگ	klɪjəɾŋ
کلید	kɪlɛd
کلیدی	kɪˈliːdi
کلین	kɪˈliːn
کلیکشن	klɪkɪʃn
کلے	kɪleː
کم	kʌm
کما	kʌmɑː
کمائیں	kʌmɑ̃ẽː
کماتا	kʌmaːt̪aː
کماتے	kʌmɑːte
کمال	kəˈmaːl
کمانا	kʊmɑːnɑː
کمانوں	kʊmɑːnõː
کمانڈ	kʊmɑːnɖ
کمانڈر	kʊmɑːnɖəɾ
کمانڈنگ	kʊmɑːnɖɪŋ
کمانڈوز	kʊmɑːnɖoːz
کمانیں	kʊmɑːneː
کمانے	kʊmɑːne
کماو	kəmoː
کمایا	kʌmɑːjɑː
کمبل	kʌmbəl
کمبھت	kʌmbʱt̪
کمر	kʊmər
کمروں	kʌmroː
کمرہ	kʊmˈɾə
کمرے	kʊmˈreː
کمزور	kʌmzʊr
کمزوری	kʊmzʊri
کمشنر	kəmsɪnəɾ
کمپاؤنڈ	kəmpauːɳɖ
کمپارٹمیںٹ	kʌmpɑːɾt̪meːɳʈ
کمپن	kʌmpən
کمپنی	kʌmpəniː
کمپنیوں	kʌmpənijõː
کمپیوٹر	kʌmpɪʊʈər
کمپیوٹرز	kʌmpɪʊt̪ɾeːz
کمک	kʌmkʌ
کمی	kʌmi
کمیشن	kəmiʃən
کمینوں	kəminõː
کمینہ	kʊmiːnə
کمینی	kʌmiːniː
کمینے	kəminɛ
کمیونٹی	kʊmjʊnːtiː
کمیونٹیز	kʌmiːjəntiːz
کمیٹی	kʌmiːtiː
کمیٹیوں	kʌmiːt̪iːõː
کن	kʌn
کنارہ	kʊnɑːrɑː
کنارے	kənɑːre
کندھے	kʌn̪d̪ʱeː
کنزرویٹوز	kənzɾoɪtɔs
کنسلٹنٹ	kənsəlˈt̪ənt̪
کنوؤں	kʊnʊə̃
کنوئیں	kʊnʊeːn
کنواری	kʌnʋaːriː
کنورٹ	kənʊɾʈ
کنونشن	kʌnʊnʃən
کنویں	kʊnʋẽ
کنٹرول	kənt̪roːl
کنٹریکٹر	kənt̪rɪkʈəɾ
کنٹریکٹرز	kənt̪rəkʈəɾz
کنڈیشن	kənɖɪʃən
کنکریٹ	kʌnkɾiːt
کنکشن	kənkəʃn
کنگ	kəŋg
کنگز	kəŋz
کنگس	kəŋgs
کنہار	kənɑːr
کنیازیف	kəˈniːzɪf
کو	ko
کوئنز	koːɪns
کوئی	kojɪ
کوائف	koːɑːf
کوارٹر	koʊɑːrt̪əɾ
کواس	koːs
کوالیفائی	koʋɑlɪfɑi
کوبا	koːbɑː
کوبڑ	koːbɽ
کوبھی	koːbʱi
کود	koːd
کودنے	koːd̪neː
کور	kɔːr
کورس	koːrs
کورٹ	koːɾʈ
کوریڈور	koːɾiːɖoːr
کوسٹ	koːst
کوش	koːʃ
کوشاں	koːʃɑ̃
کوشش	koːʃʃ
کوششوں	koːʃʃoː
کوششیں	koːʃʃeːn
کوشکان	koːʃkɑːn
کولمبیا	koːlʌmbiːjə
کولمبیائی	koːlmbɪbɑːiː
کولوراڈو	koːloːɾɑːɽoː
کولڈ	koːld
کولہوں	koːlə̃
کوم	koːm
کومل	koːməl
کون	koːn
کونر	koːnəɾ
کونسا	koːnsə
کونسل	koːnsəl
کونسلر	koːnsəlɾə
کونسی	koːnsiː
کونسے	koːnse
کونوائے	koːnuːeː
کونور	koːnʊr
کونوں	koːnõː
کونکانٹراک	koːŋkɑːnʈɑːrɑːk
کونہ	koːnə
کونے	koːneː
کووئی	koːʋiː
کووں	koː̃
کوٹ	koːʈ
کوپرنیکس	koːpəɾniːk
کوپن	koːpən
کوچ	koːtʃ
کوڈ	kɔːɽ
کوڑا	koːɽɑː
کوڑاکرٹ	koːɽɑːkɾɪt̪
کوڑوں	koːɽoːŋ
کوڑھی	koːɽʰiː
کوڑے	koːɽeː
کوژیہ	koʒɪhɑ
کوک	koːk
کویت	kujɪt
کویتی	koːʏtiː
کویقینی	koːiqiːni
کوینسبارو	koːɪ̃sˈbɑːro
کوےک	kojek
کيے	kiː
کَس	kəs
کْھلے	kʰɽeː
کٹ	kʌʈ
کٹا	kʌʈɑ
کٹر	kʊʈəɾ
کٹک	kʌʈk
کٹھور	gʈʰoːr
کٹہرے	kʈʰeːrʌ
کٹی	kʊʈiː
کپ	kʌp
کپتان	kəpˈt̪ɑːn
کپتانوں	kəpt̪ɑːnõː
کپولوں	kəpoːlõː
کپٹپورن	kəpʈpɔːrən
کپڑا	kəpɽɑ
کپڑوں	kəpɽõː
کپڑے	kəpɽe
کچرے	kəʈʂreː
کچل	kɪtʃəl
کچلا	kəʧlə
کچلنے	kɪtʃlne
کچن	kəʈʈən
کچھ	kɪtʃ
کچھوں	kɪtʃʰõː
کڈ	kəɖ
کڑی	kəɽiː
کک	kʊk
کھا	kʰɑː
کھاؤ	kʰɔː
کھائی	xɑi
کھائیں	χɛ̃ː
کھائیے	kʰɑːi
کھابہ	χɑːbɑː
کھاتا	xʌt̪ɑː
کھاتی	kʰɑːti
کھاتے	kʰɑːteː
کھال	xɑːl
کھالوں	χɑːlõː
کھالیں	xɑːlẽː
کھانا	kʰɑːnɑː
کھانسی	χɑːnsiː
کھانوں	χɑːnõː
کھانے	kʰɑːne
کھایا	kʰɑjɑ
کھتا	xʈə
کھجور	χʊdʒoːr
کھجوروں	χʊdʒoːɾoːŋ
کھجوریں	χʊdʒoːrẽ
کھدائی	khɪdɑːi
کھدی	khɪd̪iː
کھروں	χəroː
کھسکی	khɪskiː
کھل	xəl
کھلا	kʰələ
کھلاؤ	xəlɑu
کھلاؤں	xəlɑ̃ː
کھلانا	kʰəlɑːnɑː
کھلانے	xəlɑːne
کھلاڑی	xəlɑːɽiː
کھلایا	χəlɑːjɑː
کھلتا	xəlˈt̪ə
کھلنے	xəlne
کھلونا	kʰɪloːnɑː
کھلونا	χʊlʊnɑ
کھلونوں	χʊlʊnõː
کھلونے	χʊlɔːne
کھلّا	χəlɑː
کھلی	kʰliː
کھلے	xɪlə
کھم	xʊm
کھمبے	χʌmbeː
کھو	kʰoː
کھوج	χog
کھوجیوں	χodʒijõː
کھود	χoːd
کھودتا	χoːd̪t̪ə
کھودنے	kʰoːd̪ne
کھودو	χoːdoː
کھول	xʊl
کھولا	kʰoːlə
کھولتا	χoːlʈə
کھولتے	χoːləte
کھولنا	χoːlna
کھولنی	χoːlniː
کھولنے	χoːlnɛ
کھولو	kʰoːloː
کھولوں	χoːlõː
کھولیں	χoːlẽː
کھولے	χoːlə
کھونا	xʊnə
کھونے	χoːne
کھوپڑی	χoːpɽiː
کھٹک	χʈʈk
کھچڑی	kʰɪtʃɽiː
کھڑا	kʰəɽɑ
کھڑکی	khəɽkɪ
کھڑکیا	χəɽkiə
کھڑی	kʰɽiː
کھڑے	kʰɑɽe
کھیت	χeːt̪
کھیتوں	χeːt̪oː
کھیتی	kʰɛːti
کھیل	χeːl
کھیلا	kʰɪlɑ
کھیلتا	χeːlt̪ə
کھیلتی	χɛːlti
کھیلتے	χeːlte
کھیلنا	χɛːlnɑ
کھیلنے	χeːlnɛ
کھیلو	χeːlo
کھیلوں	χɛːloː
کھیلیں	kʰɛːlɪ̃
کھیلے	χeːle
کھینچ	χeːnʈ
کھینچتے	χɪ̃ːtʃt̪eː
کھینچنا	χeːnʈtʃnɑ
کھینچیں	χɪ̃ːtʃẽː
کھینچے	χɪ̃ːtʃe
کھیپ	kʰɛp
کھےلا	χeːlə
کہ	kʰ
کہا	kʰɑ
کہانی	kʰɑːniː
کہانیاں	kʰɑːnɪjɑ̃
کہانیوں	kʰɑːnɪjõː
کہاوت	kɑːʊt
کہاَ	kʰɑː
کہاں	kʰɑ̃ː
کہاہے	kɑːɦɑːe
کہتا	kʰət̪ə
کہتی	kʰət̪iː
کہتے	kʰeːt̪eː
کہلانے	kʰəlɑːnə
کہلوانا	kɑlʋɑnɑ
کہنا	kʰənə
کہنی	kʰeːniː
کہنے	kʰeːne
کہو	koː
کہونگا	kɑːʋʊŋgə
کہوں	kʰɔ̃ː
کہيں	keː̃
کہکشاں	kɛɦkəʃɑ̃ː
کہہ	kə
کہی	kʰeː
کہیں	kʰeːn
کہے	kʰeː
کی	kiː
کیا	kijɑ
کیامت	kiːəmt
کیاکریں	kiːɑːkrɪ̃
کیاہے	kijɑː
کیبل	keːbəl
کیبلز	kiːbəlz
کیبن-گینگوی	kiːbəngeːŋgoi
کیبنٹ	kiːbɛːnt
کیتھ	keːt̪ʰ
کیجئے	kiːdʒeː
کیجیے	kiːdʒeː
کیرولینا	kiːroːlɪnə
کیری	kiːri
کیریئر	kiːriːr
کیس	kiːs
کیسا	kiːsə
کیسل	kiːsəl
کیسی	kiːsiː
کیسے	kiːse
کیش	kiːʃ
کیطرف	kiːraːfɪ
کیفیت	kiːfiːt
کیل	keːl
کیلئے	kilje
کیلبر	kilbər
کیلون	kiːlɔːn
کیلی	kiːliː
کیلیفورنیا	kiːlifɔːrniːə
کیم	kim
کیمبل	kimˈbəl
کیمرا	kimɾɑ
کیمروں	kimroːn
کیمرہ	kiməra
کیمرے	kiːməɾeː
کیمز	kimz
کیمورا	kimuːrɑ
کیمپ	kimpʰ
کیمپس	kimps
کیمپوں	kimpoːn
کیمڈن	kimd̪ən
کیمیکل	kimikəl
کیمیکلز	kimikəls
کین	kin
کینالونی	kinɑlʊniː
کینریز	kinɾiz
کینساس	kinsɑs
کینن	kinːn
کینٹ	kin̪t̪
کینٹالونی	kiːn̪t̪ɑːlʊniː
کینٹکی	kiːnʈkiː
کینٹین	kɪn̪t̪eːn
کینچی	kintʃi
کینڈی	kəːndiː
کینیلونی	kiːnɪloːniː
کینیڈا	kiːnɪdɑː
کیو	kiːo
کیوبا	kiːʊbɑː
کیولری	kiːuːlriː
کیون	kijon
کیونکر	kijʊnkəɾ
کیونکہ	kiːŋkə
کیوں	kijõː
کیوںکہ	kiːŋkə
کیویار	kiːvaɪər
کیٹ	kiːʈ
کیٹا	kiːt̪ə
کیٹس	kiːts
کیٹلوگ	kiːʈloːg
کیٹیا	kiːʈiːə
کیپ	kiːp
کیپلر	keːplɛr
کیپٹل	keːpʈəl
کیپٹن	kiːpʈən
کیڑا	kiːɽɑː
کیڑے	kiːɽeː
کیک	kiːk
کیں	kɪ̃ː
کیے	kiːe
کے	keː
کےلئے	keːliːe
گ	g
گئر	gɛːr
گئی	geː
گئیں	geː
گئے	geː
گا	gɑ
گاؤن	gɔ̃ːuːn
گاؤں	gɑ̃ːo̯
گائیڈ	gɑːiːɖ
گائے	gɑːe
گابھا	gɑːbʱə
گاتے	gɑːteː
گار	gɑːr
گارسِیو	gəɾsɪjoː
گارسیو	gɑːɾsiːu
گارڈ	gɑːɾɖ
گارڈز	gɑːɾɖz
گارڈین	gɑːɾd̪ɪn
گال	gɑl
گالیاں	gɑlɪɑ̃
گانا	gɑːnɑː
گانٹھ	gɑːnʈʰ
گانڈ	gãːɳɖ
گانڈ	gä̃ːɳɖ
گاڑی	gɑːɽi
گاڑیاں	gɑɽjɑ̃
گاڑیوں	gɑːɽiːõː
گاکمینو	gɑkmiːnoː
گاکہ	gɑkə
گاہ	gɑː
گاہوں	gɑːɦõː
گاہکوں	gɑːɦkõː
گدا	gəd̪ə
گدھا	gʌd̪ʰɑ
گدھے	gəɖʱe
گدی	gʌd̪iː
گذارشات	gəɖɑːrʃɑːt
گذشتہ	gʊlɑs
گر	gəɾ
گرا	gəɾɑ
گراؤنڈ	gəˈɾau̯nd̪
گرائیں	gɑɾɑʔẽ
گراتے	gɾɑːte
گرادیں	gɾɑːd̪eːn
گرافر	gʌrɑːfɪr
گرافی	gʌrɑːfi
گرام	gɾɑːm
گرانے	gɾɑːnɛ
گراو	gəɾɑu
گراں	gəɾɑ̃ː
گرایا	gɪɾɑːjɑː
گرجہ	gəɾdʒə
گرد	gʊɾd
گردانہ	gʊɾd̪ɑːnə
گردش	gʊɾd̪ʃ
گردن	gʌɾd̪n
گردنوں	gʊɾd̪oːn
گردوں	gʊɾd̪oːn
گردی	gʊɾdi
گردے	gʊɾde
گرفت	gʌrəf
گرفتار	gʌrəfˈt̪ɑːr
گرفتارکرتے	gʁəpʰt̪əɾkəɾt̪eː
گرفتاری	gʌrəft̪ɑːriː
گرل	gəɾəl
گرم	gəɾm
گرما	gəɾmɑ
گرمی	gɐɾmiː
گرمی	gəɾmiː
گرمی	gʌɾmi
گرنٹس	gəɾn̪t̪s
گرنے	gəɾne
گروپ	gɾoːp
گروپوں	gɾoːpõː
گروہ	groː
گروہی	gəroːɪ
گروی	gʁoi
گرڈ	gəɾɖ
گرہ	gəɾə
گرہوں	gəɾɑ̃
گرہیں	gəɾhɛ̃
گری	gɾiː
گریجویشن	gɾeːdʒoːɪʃn
گریز	gɾiːz
گریس	gɾeːs
گرین	gɾiːn
گرینس	gɪɾeːns
گرینڈ	gɾæːnd̪
گرینگے	gɪɾeːŋeː
گرینیڈ	gɪɾiːnɪd
گریڈ	gɾiːɖ
گریگ	gɾiːg
گریں	gɾeɪ̃
گرے	gɾeː
گز	geːz
گزار	gəzaːr
گزارا	gəzaːrɑː
گزارتے	gəzɑːɾte
گزارنے	gəzaːrne
گزارو	gəzaːroː
گزاریں	geːzɑːrẽ
گزارے	gʌzɑːreː
گزر	gʊzər
گزرا	gʊzəɾɑ
گزرتا	gezretɑ
گزرتے	gezɾte
گزرنا	gʌzəɾnə
گزرگاہ	gʊzəɾgɑː
گزریں	gəˈzəɾeːn
گزشتہ	gezʃt̪ə
گزین	geːzɪn
گزینوں	gəˈzɪnʊ̃
گشت	gəʃt
گفت	gʊft
گفتگو	gʊftgʊ
گلا	gəlɑ
گلاب	glɑːb
گلاب	gʊlɑːb
گلابی	gʊlɑːbiː
گلاس	gʊlɑs
گلبرٹ	gʊlbəɾt
گلدستے	gʊld̪əsteː
گلرمو	gʊlɾəmo
گلمور	gəlmoːr
گلو	gloː
گلہ	gələ
گلی	gəliː
گلین	gʊliːn
گلیوں	gəliːõ
گلے	glə
گم	gʊm
گمبھیر	gəmbʱiːr
گمراہ	gʊməɾɑːh
گمشدگی	gʊmʃɪdgi
گمشدہ	gʊmʃɪd̪ʰə
گمنام	gʊmnaːm
گن	gʊn
گنا	gənɑ
گناہ	gənaː
گناہ	gʊnɑː
گناہ	gʊnɑːh
گناہوں	gənɑːhõː
گناہگار	gənɑːɦgɑːr
گناہی	gənɑːhiː
گنبد	gʌnbɛd
گنتی	gəntiː
گنجائش	gəndʒɑːʃeː
گنجایش	gəndʒɑːʃɪ
گندا	gʌnd̪ə
گندگی	gʊŋd̪i
گندی	gʌnd̪iː
گندے	gənde
گنوانی	gʊnʋɑːni
گنڈا	gʊnd̪ɑ
گنڈالف	gʊnɖəlf
گنڈوں	gʊnɖõ
گنگنا	gəŋgənə
گنیز	gəniːz
گوئی	goːi
گواہ	gʋɑːh
گواہوں	gʋɑːɦõː
گواہی	gʋɑːhiː
گودا	goːd̪ə
گودام	goːd̪əm
گورداسپور	gʊɾd̪ɑːspuːɾ
گورن	goːrən
گورنر	goːrner
گوروں	goːroːŋ
گورچیٹسا	goːɾtʃeːtsɑː
گورڈن	goːɾd̪ən
گورییا	goːɾijɑː
گورے	goːre
گوشت	goʃt
گوشت	goːʃ
گوفن	goːfən
گول	goːl
گولاردق	goːlɑːɾd̪əq
گولسن	goːlsən
گولڈ	goːld
گولڈن	goːld̪n
گولہ	goːlə
گولی	goːli
گولیاں	goːlijɑ̃
گولیوں	goːlijõ
گومڑ	goːmɽ
گونگے	goːŋeː
گوگل	goːgəl
گيا	gɪjɑ
گِرنا	gɪrnə
گْھس	gʱəs
گْھسنے	gʱəsne
گْھما	gʱəmə
گْھٹنے	gʱəʈne
گٹر	gʊt̪ːər
گپتا	gʌpt̪ə
گپیں	gʊpẽː
گچھ	gɪtʃ
گڈ	gəɖ
گڈانسک	gəɳɖə̃s
گڑ	gəɽ
گڑبڑ	gəɽbəɽ
گڑھ	gəɽʱ
گڑھا	gəɽʰɑ
گڑھوالی	gəɽʱʋɑːli
گڑیا	gəɽiə
گھائل	gʱɛɪl
گھات	gʱɑːt̪
گھاس	gʱɑs
گھاٹ	gʱɑːʈ
گھبرا	gʱʊrbɑː
گھبراؤ	gʱəbɾɑːo
گھبراتے	gʱəbɾɑːte
گھبرانے	gʱʊɾbɑːne
گھبراہٹ	gʱʊbɾɑːɦət
گھر	gʌɾ
گھر	gʱəɾ
گھرا	gʁə
گھروالوں	gʁoːlõː
گھروں	gʱəroː
گھرگرادیتے	gʜəɾgəɾɑːdɪt̪e
گھرگھرانا	gʰəɾgʰəɾɑːnɑ
گھریلو	gʱəɾɪloː
گھس	gʱəs
گھسنا	gʱəsnə
گھسنے	gʱəsnɛ
گھسپیٹھیوں	gʱəspiːt̪ʰeːõ
گھسپیٹھیی	gʱʌspiːtiː
گھسیٹ	gʱəsiːt
گھسیٹا	gʱəsiːt̪a
گھل	gʱəl
گھلنے	gʱəlne
گھمائیں	gʌmɑ̃eː
گھماتا	gʱʊmɑːt̪ə
گھمایا	gʱəmɑːjɑː
گھمنڈی	gʱʊmnd̪iː
گھنونا	gʱənʊnə
گھنٹوں	gʱəɳʈoːn
گھنٹہ	gʱəɳʈʰə
گھنٹہ	g⁽ʱ⁾ɜːnʈɑː
گھنٹی	gʱənt̪i
گھنٹی	gʱəɳʈiː
گھنٹیاں	gʱəɳʈiɑ̃
گھنٹے	gʱəɳʈe
گھور	gʊɾ
گھورتے	gʊɾt̪e
گھوسٹ	gʊsʈ
گھوم	gʊm
گھومتا	gʊmˈt̪a
گھومتی	gʊmti
گھومتے	gʊmeːte
گھومنا	gʊmnə
گھومنے	gʊmne
گھومے	gʊmeː
گھونٹ	gʊ̃ːɳʈ
گھونٹنا	gʊnʈnə
گھونپ	gʊnpʰ
گھونپنے	gʊn̪pne
گھوٹنوں	gʊʈʈoːn
گھوڑا	gʊɽɑ
گھوڑوں	gʊɽoːɳ
گھوڑی	gʊɽi
گھوڑے	gʊɽe
گھٹ	gʌʈ
گھٹتی	gʱʈʈiː
گھٹنوں	gʌʈnõː
گھٹنے	gʱʈəne
گھٹیا	gʌʈʲɑ
گھڑ	gʌɽ
گھڑسوار	gʌɽs̪ʋaːɾ
گھڑی	gʱɽiː
گھیر	gʱiːr
گہرا	gəɦɾə
گہرائی	gʌɦɑːɾɑːi
گہرائیوں	gəɦɑɾɑːjoː
گہری	gəhriː
گہرے	gəɽe
گہما	gəhmɑ
گی	gi
گیئر	gɪːɾ
گیا	gɪjɑ
گیارہ	gɪɑːɾɑː
گیت	giːt̪
گیر	giːr
گیراج	giːrɑːdʒ
گیس	gɪs
گیلا	gɪlɑ
گیلے	gɪle
گیم	geːm
گیمز	giːmz
گیند	gɪnd
گیندوں	gɪnd̪oːn
گیٹ	gɪt̪
گیٹس	gɪt̪s
گیکس	gɪkʰs
گے	geː
ں	ŋ
ںہیں	ŋeɪ̯
ھ	h
ھµµ	ɦɪɳ
ھµç	ɦɪs
ھµéءِ	ɦʊɑː
ھءك	ɦɛk
ھءِ	ə
ھإ	ə
ھائے	ɦɑːe
ھار	ɦɑːr
ھارإ	ɦɑːr
ھاں	ɦɑ̃
ھاںسی	ɦɑ̃ːsiː
ھدف	ɦɪd̪f
ھمممم	ɦʊmˈmʊm
ھو	ho
ھوئی	hoeː
ھوگا	ɦoːgə
ھہ	ɦe
ھہا	ɦɑ
ھہج	heːdʒ
ھہخ	ɦɛx
ھہخµ	ɦɛːx
ھہع	ɦeː
ھہعµéہ	ɦɛɑː
ھینی	hiːniː
ھیپاتيا	ɦiːpətɪə
ھیپاتیا	ɦeːpaːtiːə
ھیں	ɦẽː
ھیںچ	ɦeːntʃ
ھیںچتی	ɦeːntʃʰiːt̪iː
ھیںچو	ɦeːntʃoː
ھیںچیں	ɦeːntʃeːn
ھے	ə
ہ	ə
ہµµ	ɦɪɳ
ہâ	ɑː
ہâءِ	ɛ
ہâب	ɦɑːb
ہâبù	ɦɑːbʊ
ہâہ	ɦɑː
ہç	ɦɪs
ہû	ɦuː
ہûءّ	ɦuːɑs
ہûاô	ɦuɑː
ہûاصاد	ɦuːsɑːd
ہûہ	ɦuː
ہûہا	ɦuːɦɑː
ہûہج	ɦuːɑdʒ
ہü	ə
ہüء	ɦʊə
ہüءِ	ɦuː
ہüإُ	əʊ
ہüاô	ɦuɑː
ہüاد	ɦʊɑːd
ہüاط	ɦuːɑːt̪
ہüاطءض	ɦuɑːt̪ɑd̪
ہüب	ɦʊb
ہüہïہا	ɦʊɑɪ
ہء	ə
ہءِ	ə
ہءْ	ə
ہؤا	ɦoːə
ہؤں	ɦoː̃
ہإ	ə
ہئغ	ɦɛɣ
ہا	ɦɑː
ہاؤس	ɦɑus
ہاؤسنگ	ɦɑusɪŋ
ہائر	ɦɛːr
ہائڈرا	ɦɑːɪd̪rɑː
ہائی	ɦɑi
ہائے	ɦɑːe
ہابس	ɦɑːbɪs
ہاتھ	ɦɑːt̪ʰ
ہاتھوں	ɦɑːt̪ʰoːn
ہار	ɦɑːr
ہاربر	ɦɑːrˈbər
ہارنے	ɦɑːrnɛ
ہارپون	ɦɑːɾpuːn
ہارڈ	ɦɑːɾɖ
ہارڈویئر	ɦɑːɾd̪ʋiəɾ
ہارے	ɦɑːre
ہاسپٹل	ɦɑːspt̪əl
ہاف	ɦɑːf
ہال	ɦɑːl
ہالہ	ɦɑːlɑː
ہالی	ɦɑːliː
ہالینڈ	ɦɑːlɪ̃ːd̪
ہامیوں	ɦɑːmijõː
ہان	ɦɑːn
ہانک	ɦɑ̃k
ہانگ	ɦɑːŋ
ہاورڈ	ɦɑːʊɾd̪
ہاول	ɦɑuːl
ہاٹ	ɦɑːt̪
ہاپ	ɦɑːp
ہاک	ɦɑːk
ہاکنگ	ɦɑːkɪŋ
ہاں	ɦɑ̃ː
ہاںفتے	ɦɑ̃ːfeːt̪eː
ہاہ	ɦɑː
ہای	ɦɑːj
ہتکڑی	ɦʊt̪kɾiː
ہتھوڑا	ɦʈʰoːɽə
ہتھیار	ɦətʰiɑːr
ہتھیاروں	ɦʈʰiɑːɾõː
ہج	ɦeːdʒ
ہجµé	ɦəˈdʒʊ
ہجµéہ	ɦɪdʒɾe
ہجء	ɦɪɟ
ہجءز	ɦɪdʒeːz
ہجءِ	ɦedʒeː
ہجآتہ	ɦədʒɑːt̪ə
ہجؤ	ɦɪdʒoː
ہجؤع	ɦʊdʒoʊʔ
ہجإ	ɦɪdʒ
ہجإح	ɦɪdʒɦ
ہجئ	ɦedʒeː
ہجاط	ɦəˈdʒɑːt̪
ہجاطاد	ɦəjɑːt̪ɑːd̪
ہجاطاص	ɦəjɑːt̪ɑːs̪
ہجاطاك	ɦəˈdʒɑːt̪ɑk
ہجبؤ	ɦɪbɔː
ہجوم	ɦʐum
ہجہ	ɦədʒə
ہجہعµéہ	ɦɪdʒɑʋɑ
ہجہْ	ɦədʒə
ہخ	ɦɪk
ہخµ	ɦɪk
ہخµµ	ɦɪkʰˈmʊkʰ
ہخµé	ɦɪkʰe
ہخµéہج	ɦəkʌɦɪ
ہخء	ɦɪkʰ
ہخءِ	ɦɪkʰe
ہخاد	ɦəxɑːd
ہخہ	ɦɪɦɪ
ہخہج	ɦɪɦɟ
ہخہش	ɦɪɦɪʃ
ہد	ɦɛd
ہدء	ɦɛɖeː
ہدءضہدؤ	ɦɛɖɛɖɛɦ
ہدآë	ɦɛːdɑː
ہدآï	ɦɛːdɑː
ہدایات	ɦɛːdɑːjɑːt̪
ہدایت	ɦɛːdɑːjət
ہدف	ɦɛd̪f
ہدہ	ɦɛːd̪ə
ہدہج	ɦɛɖɦɛdʒ
ہدہجءز	ɦɛɖɦɛdʒeːz
ہدہخءِ	ɦɛd̪ɦɛ
ہدہد	ɦɛɖɦɛɖ
ہذ	ɦɪz
ہذلولی	ɦʌzɾuːliː
ہذہ	ɦʌzə
ہر	ɦəɾ
ہرا	ɦəɾɑ
ہرب	ɦəɾb
ہرغمال	ɦəɾgəˈmɑl
ہرن	ɦəɾn
ہرنی	ɦəɾni
ہرٹج	ɦəɾt̪dʒ
ہرڈ	ɦəɾɖ
ہرکارے	ɦəɾkɑːɾe
ہرگز	ɦəɾgez
ہز	ɦeːz
ہزار	ɦɑzɑr
ہزاروں	ɦɑːzɑːrʊ̃ː
ہسئرئ	ɦɪsɛrɪ
ہستی	ɦəst̪iː
ہسپانوی	ɦəspɑːnʋiː
ہسپتال	ɦəspəˈtɑːl
ہسپتالوں	ɦəspətɑːlõː
ہسہ	ɦəsə
ہش	ɦɪʃ
ہض	ɦɪdʒ
ہضءز	ɦɪdʒz
ہضءِ	ɦɪs
ہضہ	ɦəɖə
ہضہف	ɦɪd̪ʱəf
ہط	ɦʊt̪
ہطہ	ɦʊt̪ʰ
ہع	ɦeː
ہعµµ	ɦɛːʋæ
ہعµç	ɦɛːʈ
ہعµéہا	ɦɛːʋæːhɑː
ہعµéہج	ɦɛːʋæːdʒ
ہعہ	ɦɛ
ہعہü	ɦɛʔ
ہغ	ɦʌ
ہغہ	ɦəɣə
ہغہع	ɦəɣə
ہـ	ə
ہف	ɦəf
ہفتوں	ɦʊftõː
ہفتہ	ɦʊftə
ہفتے	ɦʊfte
ہك	ɦɪk
ہكµئ	ɦɪkmɪ
ہكاد	ɦɑkɑd
ہكاك	ɦɪkɑk
ہل	ɦəl
ہلا	ɦələ
ہلاتا	ɦəlaːtə
ہلاک	ɦəˈlɑk
ہلاکت	ɦəˈlɑːkt̪
ہلاکتیں	ɦɛlɑːkt̪ɪ̃
ہلتا	ɦəlˈt̪aː
ہلنا	ɦəlnə
ہلچل	ɦəltʃəl
ہلکا	ɦəlkə
ہلکے	ɦəlkɛ
ہلہ	ɦəlɑ
ہلے	ɦələ
ہم	ɦəm
ہمار	ɦəˈmɑːr
ہمارا	ɦəˈmaːrɑ
ہماری	ɦəmɑːɾiː
ہمارے	ɦəˈmaːre
ہمت	ɦɪmət
ہمدرد	ɦəmd̪əɾd̪
ہمدرد	ɦʊmd̪əɾd̪
ہمدردوں	ɦməd̪rəd̪oːn
ہمدردی	ɦʊmd̪əɾd̪iː
ہمس	ɦəms
ہمشوےت	ɦəmʃoeːt
ہمم	ɦʊm
ہممم	hʌmmʌ
ہمممم	hɪmɪmɪm
ہموار	ɦəmˈwaːr
ہمہے	hʌmæ
ہمیشگی	ɦəmiʃgiː
ہمیشہ	ɦəmiʃə
ہمیں	ɦeːmẽː
ہند	ɦɪnd
ہندسی	ɦənd̪siː
ہندو	ɦɪnd̪ʊ
ہندوستانی	ɦɪnd̪usʈɑːniː
ہنر	ɦəneɾ
ہنس	ɦəns
ہنستے	ɦənst̪eː
ہنسلی	ɦənsli
ہنسنا	ɦənsnə
ہنسی	ɦənsi
ہنسیں	ɦənsiːn
ہنگامہ	ɦəŋɑːmə
ہنگامی	ɦəŋɑːmi
ہنگامے	ɦəŋɑːme
ہنگرین	ɦəŋreːn
ہنی	ɦəniː
ہه	he
ہهؤ	heʊ
ہهاز	heːz
ہو	ɦoː
ہوئی	ɦoːi
ہوئے	ɦoeː
ہوا	həʋɑː
ہوا	ɦʋɑ
ہواء	ɦʋɑː
ہواؤں	hoɑ̃
ہوائی	ɦoɑi
ہواتھا	ɦʋɑːt̪ʰɑː
ہوتا	ɦoːt̪ə
ہوتم	ɦoːt̪m
ہوتی	ɦoːt̪iː
ہوتیں	ɦoːt̪eːn
ہوتے	ɦoːt̪eː
ہوج	hoʊdʒ
ہوجا	ɦoʊdʒɑ
ہوجاؤ	ɦoːdʒɑːʊ
ہوجاؤگے	ɦoːdʒɑːugeː
ہوجائیں	ɦoːdʒɑːẽː
ہوجائے	ɦoːdʒɑːe
ہوجاتے	ɦoːʔɑːteː
ہوجانا	ɦoːdʒɑːnɑː
ہوجانے	ɦoʊdʒɑːne
ہوجاو	ɦoːdʒɑːʋ
ہورہا	ɦoːɾɑː
ہورہی	ɦoːɾəɦi
ہوسٹنگ	ɦoːst̪ɪŋ
ہوسکا	ɦoːskə
ہوسکتا	ɦoːskət̪ə
ہوسکتی	ɦoːskʈi
ہوسکتے	ɦoːskət̪eː
ہوسکے	ɦoːskeː
ہوش	hoʃ
ہوشی	hoːʃi
ہوشیار	hoːʃjaːr
ہول	ɦoːl
ہولدار	ɦoːld̪əɾ
ہولناک	ɦoːlnɑk
ہولناکیوں	ɦoːlnɑːkiːõ
ہولڈ	ɦoːlɪd
ہوم	ɦoːm
ہون	ɦoːn
ہونا	ɦoːnə
ہونٹ	ɦoːnʈ
ہونگی	ɦoŋgi
ہونگے	ɦoːŋeː
ہونی	ɦoːniː
ہونے	ɦoːne
ہوور	ɦoːr
ہوٹل	ɦoːʈəl
ہوٹلوں	ɦoːt̪lõː
ہوچکا	ɦoːtʃkɑː
ہوچکے	ɦoːtʃkeː
ہوکر	ɦoːkəɾ
ہوگئی	hoːgeː
ہوگئے	ɦoːgeː
ہوگا	ɦoːgə
ہوگو	hoːgoː
ہوگی	hoːgi
ہوگیا	ɦoːgiə
ہوگیاہے	hoːgiɑːe
ہوگے	ɦoːgeː
ہوں	ɦoːn
ہوںگے	ɦoːŋeː
ہيں	ɦeː̃
ہِل	ɦɪl
ہْ	ə
ہْµé	ə
ہْµéہ	ɦɪˈɾɑː
ہْµéہا	ɦɪˈɾʌ
ہْµéہج	ɦɪɟ
ہْآتہ	ɦɑːt̪ə
ہْارإ	ɦɑːr
ہٹ	ɦʈ
ہٹا	ɦəʈə
ہٹاؤ	ɦʈɑːʊ
ہٹائی	ɦʈɑi
ہٹاو	ɦʈɑʋ
ہٹتی	ɦəʈːi
ہٹلر	ɦʈlɪr
ہٹنا	ɦəʈnə
ہٹو	ɦʈo
ہٹیئے	ɦətiːe
ہپ	ɦp
ہچ	ɦɪtʃ
ہڈ	ɦəɖ
ہڈی	ɦəɖi
ہڈیوں	ɦəɖiːõː
ہڑتال	ɦəɽt̪ɑːl
ہڑپ	ɦəɽp
ہک	ɦɪk
ہکا	ɦəˈkɑ
ہکس	ɦɪks̪
ہں	ə̃
ہںس	ɦə̃s
ہںسنا	ɦənsnə
ہہ	ɦə
ہہخہ	ɦɑɦkʰɑ
ہہض	ɦɛːɖ
ہہضءِ	ɦɛːɖə
ہی	hi
ہیتھرو	ɦeːt̪ʰroː
ہیج	ɦeːdʒ
ہیر	heːr
ہیرا	heːra
ہیرس	heːrs
ہیرو	ɦiːroː
ہیروشیما	ɦiːroːʃiːmə
ہیری	ɦiːriː
ہیریسن	heːrɪsən
ہیرے	heːre
ہیز	ɦeːz
ہیسٹنگر	heɪstɪŋgəɾ
ہیسٹینگر	ɦeːst̪eːŋgəɾ
ہیش	heːʃ
ہیل	heːl
ہیلس	ɦeɪls
ہیلمیٹ	ɦiːləmeːt
ہیلو	heːloː
ہیلی	ɦiːliː
ہیلینا	heːlɪnɑ
ہیملٹن	ɦɪməlʈən
ہیمپشائر	ɦeːmpʃɛːɾ
ہین	hein
ہینری	henriː
ہینز	heːnz
ہینڈل	ɦeːndəl
ہینک	hein̪k
ہینگر	ɦeːŋgər
ہیوسٹن	ɦeːosːt̪ən
ہیومن	ɦeːmən
ہیون	ɦeːoːn
ہیوگو	ɦeːugoː
ہیٹ	ɦeːt̪
ہیپا	hiːpə
ہیچ	hiːtʃ
ہیڈ	ɦeːd
ہیڈلائٹس	ɦeːd̪lɑɪ̯t̪s
ہیڈن	ɦeːɖən
ہیک	ɦeːk
ہیکر	ɦeːkəɾ
ہیکرز	ɦeːkəɾs
ہیکروں	ɦeːkəroː
ہیکل	ɦeːkəl
ہیکنگ	ɦeːkɪŋ
ہیکٹر	ɦɪkʈəɾ
ہیگ	ɦeːg
ہیگن	ɦiːgən
ہیں	əɪ̯n
ہیںاورکس	ɦẽːoːrkʰɑs
ہیہں	ɦiː
ہے	ə
ہے	ɦeː
یا	jɑ
یابی	jaːbi
یاترہ	jaːt̪əɾə
یاتنا	jaːt̪nə
یاتھ	jaːt̪ʰ
یاد	jɑːd
یاداشت	jɑːd̪ɑːʃt̪
یادداشت	jɑːd̪d̪ɑːs̪t̪
یادوں	jɑːdõː
یادگار	jaːd̪gɑr
یادیں	jaːd̪eːn
یار	jɑːr
یارک	jɑːɾk
یاسمین	jɑːsmiːn
یافتہ	ɑːfətə
یانترک	jaːn̪t̪əɾk̪
یاہو	jɑːho
یتیم	jiːt̪ɪm
یرغمال	ɪrgʱəmal
یرغمالی	ɪrɣəmiˈli
یرغمالیوں	ɪɾgʱəmaːlijõː
یروشلم	jeːruːʃlæm
یس	jɪs
یسوع	jeːsuː
یشوع	iːʃoʊ
یعنی	ɛn
یقین	ɪqɪn
یقینا	ɪqɪnɑ
یقیناً	ɪqɪnɑ̃
یقینی	ɪqɪniː
یلئڈی	ɪlæɖi
یلرجی	ɪlɾədʒi
یلغار	ilgɑːr
یلگن	ilgən
یلی	ɪljə
یما	jɪmɑ
یملی	ɪmli
یمین	ɪmɪn
ین	jɪn
ینا	iːnɑː
ینگسٹن	ɪŋgɪst̪ən
یه	jeː
یو	joː
یوحنا	jɔhɑnɑ
یوراج	jʊɾɑːdʒ
یورپ	jɔːrp
یورپی	joːrpiː
یوز	jɪz
یوسف	jʊsəf
یولن	joːlən
یوم	jom
یونائٹڈ	joːnɑːɪt̪ːeːd̪
یونائیٹڈ	jʊnɑːʔiːt̪ːeːd̪
یونانی	jʊnɑːni
یونٹ	jʊ̃ːɳʈ
یونٹس	jʊnʈs
یونین	jʊnɪn
یونیورسٹی	jʊnɪvɛrsɪtɪ
یووتی	joːti
یوٹوپیا	joːtoːpiːə
یوٹیوب	joːtiːb
یوپی	jʊpi
یوں	jõː
یک	ɪk
یکسل	ɪksəl
یکطرفہ	ɪkt̪əɾfə
یکم	ɪkm
یں	ə̃
یہ	jeː
یہ1742	jeː
یہان	jɑːn
یہاں	jɑ̃
یہسان	jeːsɑːn
یہود	jeːoːd
یہودی	jeːʊdiː
یہودیت	jeːwɪdɪt
یہودیوں	jeːʊdijoː
یہوواہ	jɑːʋɑːh
یہيں	jɛ̃
یہی	jɛː
یہیں	jeː
ییومن	jiːmən
ے	ə
ےدے	ɛːdeː
ےڈائریکٹرز	əɪɽɪkt̪əɾs
۔	ʔ
۱۲۰۰سال	ɪɾɑːsɑːl
۵۲بیس	beːs
