ئا	a
ئائىت	ʔɑʔit
ئائىلە	ʔɑʔilɛ
ئابلىز	ʔɑbliz
ئابنۇس	ʔɑbnus
ئات	ɑt
ئاتا	ʔɑtɑ
ئاتالمىش	ʔɑtɑlmɪʃ
ئاتاپ	ʔɑtɑp
ئاتمىش	ɑtmiʃ
ئاتنى	ʔɑtni
ئاتوم	ʔɑtom
ئاتوملار	ʔɑtomlar
ئاتىغا	ʔɑtiʁɑ
ئاجايىپ	ʔɑdʒɑjip
ئاجىز	ʔɑdʒiz
ئاخشام	ʔɑχʃɑm
ئاخىرەت	ʔɑχirɛt
ئاخۇنۇم	ʔɑχunum
ئادا	ʔɑdɑ
ئادالاپ	ʔɑdɑlɑp
ئادالەت	ʔɑdɑlɛt
ئادرىس	ʔɑdris
ئادىل	ʔɑdil
ئادىمى	ʔɑdimi
ئادۋوكات	ʔɑdwokɑt
ئادەت	ʔɑdɛt
ئادەم	ɑdæm
ئادەمدۇر	ʔɑdɛmdur
ئادەملەر	ʔɑdɛmlɛr
ئادەممۇ	ʔɑdɛmmu
ئارا	ʔɑra
ئارال	ʔɑrɑl
ئارام	ʔɑrɑm
ئارتۇق	ʔɑrtuq
ئارزۇ	ʔɑrzu
ئارسىن	ʔɑrsin
ئارغىماق	ʔɑrʁimɑq
ئارغۇن	ʔɑrʁun
ئارقا	ʔɑrqɑ
ئارماغان	ʔɑrmɑʁɑn
ئارمان	ʔɑrmɑn
ئارىسى	ʔɑrisɪ
ئارىسىدا	ʔɑrisidɑ
ئارىسىدىن	ʔarisidin
ئارىفمېتىكا	ʔɑrifmetikɑ
ئارگون	ʔɑrgon
ئاز	ʔɑz
ئاز؛	ʔɑz
ئازات	ʔɑzɑt
ئازادە	ʔɑzɑdɑ
ئازار	ʔɑzɑr
ئازاپ	ʔɑzɑp
ئازراق	ʔazrɑq
ئازلاپ	ʔɑzlɑp
ئازوت	ʔɑzot
ئازگال	ʔɑzgɑl
ئاساس	ʔɑsɑs
ئاساسەن	ʔɑsɑsɛm
ئاسان	ʔɑsɑn
ئاسايىش	ʔɑsɑjiʃ
ئاستا	ʔɑstɑ
ئاستاتىن	ʔɑstɑtin
ئاستى	ʔɑsti
ئاستىلاپ	ʔɑstilɑp
ئاسفالت	ʔɑsfɑlt
ئاسلان	ʔɑslɑn
ئاسمان	ɑsmɑn
ئاسماندىن	ʔɑsmɑndɨm
ئاسمىنى	ʔɑsmini
ئاسى	ʔɑsi
ئاسىيا	ʔɑsijɑ
ئاش	ʔɑʃ
ئاشار	ʔaʃɑr
ئاشتا	ʔaʃtɑ
ئاشقا	ʔɑʃqɑ
ئاشقان	ʔɑʃqɑn
ئاشىدۇ	ʔɑʃidu
ئاشيان	ʔɑʃjɑn
ئاشپەز	ʔɑʃpɛz
ئاشپەزنىڭ	ʔɑʃpɛznɪŋ
ئاشپەزگە	ʔɑʃpɛzgɛ
ئاشۇ	ʔɑʃu
ئاغ	ʔɑʁ
ئاغرىق	ʔɑʁriq
ئافغان	ʔɑfʁɑn
ئاق	ɑq
ئاقرابا	ʔɑqrɑbɑ
ئاقراپ	ʔɑqrɑp
ئاققان	su
ئاققۇ	ʔɑqqu
ئاقلاش	jɛni
ئاقىۋەت	ʔɑqiwɛt
ئاكا	ʔɑkɑ
ئاكتىنىي	ʔɑktinij
ئال	ʔɑl
ئالا	ʔɑlɑ
ئالار	ʔalar
ئالارمىش	ʔɑlɑrmiʃ
ئالاقە	ʔɑlɑqɛ
ئالالماي	ʔɑlɑlmɑj
ئالامەت	ʔɑlɑmɛt
ئالاي	ʔalɑj
ئالايلى	ʔɑlɑjli
ئالاڭ	ʔɑlɑŋ
ئالتاي	ʔɑltɑj
ئالتىنچى	ɑltintʃi
ئالتە	altæ
ئالتە	altɛ
ئالتە	ɑltæ
ئالتە	ɑltɛ
ئالدام	ʔɑldɑm
ئالدايدۇ	ʔɑldajdu
ئالداپ	ʔɑldɑp
ئالدىراش	ʔɑldirɑʃ
ئالدىغا	kɛldi
ئالدىم	qɑp
ئالدىم	ʔɑldɨm
ئالدىمىزدا	ʔɑldɨmizdɑ
ئالسام	ʔɑlsam
ئالساڭ	ʔɑlsɑŋ
ئالسىلا	ʔɑlsɨlɑ
ئالسۇن	ʔɑlsun
ئالغىلى	ʔalʁɪlɪ
ئالقىش	ʔɑlqiʃ
ئاللا	ʔɑllɑ
ئالما	ɑlmɑ
ئالماس	ʔɑlmɑs
ئالماق	ʔɑlmɑq
ئالماي	ʔɑlmɑj
ئالىم	ʔɑlim
ئالىملارنىڭ	ʔalimlɑrniŋ
ئاليۇمىن	ʔɑljumin
ئالپ	ʔɑlp
ئالچاڭلاپ	ʔɑltʃɑŋlɑp
ئالگېبرا	ʔɑlgebrɑ
ئالەت	ʔɑlɛt
ئالەم	ʔɑlɛm
ئامال	ʔɑmɑl
ئامالسىز	ʔɑmɑlsɪz
ئامان	qɑldi
ئامانەت	ʔɑmɑnɛt
ئامراق	ʔɑmrɑq
ئامىل	ʔɑmil
ئامىللىرىنىڭ	biri
ئامىلى	ʔɑmili
ئامېرىتسىي	ʔɑmeritsij
ئامەت	ʔɑmɛt
ئان	ʔɑn
ئانا	ɑnɑ
ئاناتومىيە	ʔɑnɑtomijɛ
ئانار	ʔɑnɑr
ئانارلار	ʔɑnɑrlɑr
ئانام	qɑldi
ئانام	sɨz
ئانام	ʔanɑm
ئانت	ʔɑnt
ئاندىن	ʔandɪm
ئانىلار	ʔɑnilɑr
ئاي	ʔɑj
ئاياز	ʔɑjɑz
ئاياق	ʔɑjɑq
ئاياللار	ʔɑjallɑr
ئايالمۇ	ʔɑjɑlmu
ئايالى	ʔɑjali
ئايران	ʔɑjrɑn
ئايغىر	ʔɑjʁir
ئايلار	ʔɑjlɑr
ئايلىق	ʔɑjliq
ئايماق	ʔɑjmɑq
ئاپئاق	ʔɑpʔaq
ئاپا	ʔapa
ئاپام	ʔɑpɑm
ئاپتاپ	ʔaptɑp
ئاپتور	ʔɑptor
ئاپتوموبىل	ʔɑptomobil
ئاپتوۋۇز	ʔɑptowuz
ئاپرېل	ʔɑprel
ئاپىرىن	ʔɑpirin
ئاپىيەت	ʔɑpijɛt
ئاپەت	ʔɑpɛt
ئاپەتمۇ	ʔɑpɛtmu
ئاپەتنى	ʔɑpɛtni
ئاچ	ʔɑtʃ
ئاچا	ʔɑtʃɑ
ئاچام	ʔɑtʃɑm
ئاڭلاپ	ʔɑŋlɑp
ئاڭلىنىدۇ	ʔaŋlinɨdu
ئاھالىنى	ʔɑhɑlini
ئاھالە	ʔɑhɑlɛ
ئاھاڭ	ʔɑhɑŋ
ئاۋات	ʔɑwɑt
ئاۋارە	ʔɑwɑrɛ
ئاۋاز	ʔɑwɑz
ئاۋازى	kɛldi
ئاۋام	ʔɑwɑm
ئاۋايلاپ	ʔɑvɑjlɑp
ئاۋغۇست	ʔɑwʁust
ئاۋۇچ	ʔɑwutʃ
ئو	o
ئوت	ʔot
ئوتتۇز	ottuz
ئوتلاپ	ʔotlɑp
ئوتۇن	ʔotun
ئوخشاش	ʔoχʃaʃ
ئوخشىماق	ʔoχʃimɑq
ئورتاق	ʔortɑq
ئورنى	ʔɔrni
ئورنىدىن	turup
ئوسال	ʔosal
ئوغا	ʔoʁɑ
ئوغرى	ʔoʁri
ئوغلاق	ʔoʁlɑq
ئوغلى	ʔoʁli
ئوغۇت	ʔoʁut
ئوغۇز	ʔoʁuz
ئوغۇل	bɑlɑ
ئوغۇل	oʁul
ئوغۇلنى	ʔoʁulni
ئوق	ʔoq
ئوقۇتقۇچىسى	ɑnɑ
ئوقۇتىدىغاندۇ	tɛp
ئوقۇتۇپ	ʔoqutup
ئوقۇر	ʔoqur
ئوقۇماق	ʔoqumɑq
ئوم	ʔom
ئوماق	ʔomɑq
ئومۇم	ʔomum
ئون	on
ئون	ɔn
ئونىنچى	onintʃi
ئوي	ʔoj
ئويدا	ʔojda
ئويلايدۇ	ʔojlajdu
ئويلايمەن	ʔojlajmɛn
ئويلاپ	ʔojlɑp
ئويلىمايدۇ	ʔojlimajdu
ئويۇن	ʔojun
ئويۇپ	ʔojup
ئوچاق	ʔotʃɑq
ئوچۇقچىلىق	bɑr
ئوچۇملاپ	ʔotʃumlɑp
ئوڭ	bolur
ئوڭ	ʔɔŋ
ئى	i
ئىبادەت	ʔibɑdɛt
ئىبادەتخانا	ʔibɑdɛtχɑnɑ
ئىبارە	ʔibɑrɛ
ئىبارەت	ʔibarɛt
ئىبراھىم	ʔibrɑhim
ئىبرەت	ʔibrɛt
ئىبلىس	ʔiblis
ئىت	it
ئىتائەت	ʔitɑʔɛt
ئىتترىي	ʔittrij
ئىتتېربىي	ʔitterbij
ئىتلار	ʔitlar
ئىتمىكىن	ʔitmikin
ئىتنىڭ	ʔɪtnɪŋ
ئىجات	ʔidʒɑt
ئىجتىمائىي	ʔidʒtimɑʔij
ئىجرا	ʔidʒra
ئىدراك	ʔidrɑk
ئىدى	ʔiti
ئىدىكى	ʔɪdikɪ
ئىرادە	ʔirɑdɛ
ئىراق	ʔirɑq
ئىرق	ʔirq
ئىرىدىي	ʔiridij
ئىز	ʔiz
ئىزاھ	ʔizɑh
ئىزاھاتمۇ	ʔizɑhɑtmu
ئىزدەش	ʔizdeʃ
ئىزدەپ	ʔizdɛp
ئىس	ʔis
ئىستىراھەت	ʔistirɑhɛt
ئىستىسنا	ʔistisnɑ
ئىستىقبال	ʔistiqbɑl
ئىستىقلال	ʔistiqlɑl
ئىستىلا	ʔistilɑ
ئىستەك	ʔistɛk
ئىسراپ	ʔisrɑp
ئىسلام	ʔislɑm
ئىسلاند	ʔislɑnd
ئىسلاپ	ʔislɑp
ئىسىم	ʔisim
ئىسيان	ʔisjɑn
ئىسيانچى	ʔisjɑntʃi
ئىسپات	bilɛn
ئىسپات	ʔispɑt
ئىش	iʃ
ئىشارەت	ʔiʃɑrɛt
ئىشتا	ʔiʃtɑ
ئىشتىن	ʔɪʃtɨn
ئىشتۇر	ʔiʃtur
ئىشغال	ʔiʃʁɑl
ئىشق	ʔiʃq
ئىشقا	ʔiʃqɑ
ئىشلار	ʔiʃlɑr
ئىشلارمۇ	ʔiʃlɑrmu
ئىشلارنى	ʔiʃlɑrmi
ئىشلىرى	bilɛn
ئىشلىرىنىڭ	ʔiʃlirinɨŋ
ئىشلىسەك	ʔiʃlisɛk
ئىشلىمەس	ʔiʃlimes
ئىشلە	ʔiʃlɛ
ئىشلەش	ʔɪʃlɛʃ
ئىشلەپ	ʔɪʃlɛp
ئىشى	ʔiʃi
ئىشىتمەك	ʔiʃitmɛk
ئىشىغا	ʔiʃiʁɑ
ئىشىم	ʔiʃim
ئىشىنى	ʔiʃinɪ
ئىشچى	iʃtʃi
ئىشەك	ʔiʃɛk
ئىشەن	ʔɨʃɛn
ئىقبال	ʔiqbɑl
ئىقتىدار	ʔiqtidɑr
ئىقتىدارلىق	ʔɑlim
ئىقتىسات	ʔiqtisɑt
ئىقلىم	ʔiqlim
ئىككى	ikːi
ئىككىنچى	ikːintʃi
ئىل	ʔil
ئىلاج	ʔilɑdʒ
ئىلاجى	ʔilɑdʒɪ
ئىلاھ	ʔilɑh
ئىلتىپات	ʔiltipɑt
ئىلدام	ʔildam
ئىللىپ	ʔillip
ئىلى	ʔili
ئىلىك	ʔilik
ئىلىم	bilɛn
ئىلىم	ʔilim
ئىلھام	ʔilhɑm
ئىلھامى	ʔilhɑmi
ئىم	ʔim
ئىمزا	ʔimza
ئىمكان	ʔimkɑn
ئىن	ʔin
ئىنتىزام	ʔintizɑm
ئىنتىقام	ʔintiqɑm
ئىنجىل	ʔindʒil
ئىندىي	ʔindij
ئىنسان	ʔinsɑn
ئىنسانلارنى	bir
ئىنسانىيەت	ʔinsɑnijɛt
ئىنساپ	ʔinsɑp
ئىنساپنى	ʔinsapni
ئىنكار	ʔinkɑr
ئىنى	ʔini
ئىنەك	inæk
ئىيۇل	ʔijul
ئىيۇن	ʔijun
ئىپادىلەشنى	tɛlɛp
ئىپادە	ʔipɑdɛ
ئىپتار	ʔiptɑr
ئىپپەت	ʔippɛt
ئىچ	ʔitʃ
ئىچكى	ʔitʃkɨ
ئىچمەك	ʔitʃmɛk
ئىچىدە	ʔitʃɨdɛ
ئىچىمگە	ʔitʃimgɛ
ئىچىپ	ʔitʃip
ئىچىگە	ʔitʃigɛ
ئىچىۋالدىم	ʔitʃiwaldim
ئىڭەك	ʔiŋɛk
ئىگىلىك	ʔigilɪk
ئىگە	bir
ئىگە	ʔigɛ
ئىگەر	ʔigɛr
ئۆ	ø
ئۆت	ʔøt
ئۆتكۈزمەيلى	ʔøtkyzmɛjli
ئۆتكەنتىم	ʔøtkɛntim
ئۆتمۈشكە	bɛk
ئۆتمە	ʔøtmɛ
ئۆتمەي	ʔøtmɛj
ئۆتى	ʔøti
ئۆتۈش	ʔøtyʃ
ئۆتۈكۈمنىڭ	ʔøtykymniŋ
ئۆتۈپ	ʔøtyp
ئۆتە	ʔøtɛ
ئۆتەر	ʔøtɛr
ئۆتەي	ʔøtɛj
ئۆرلەپ	ʔørlɛp
ئۆرنەك	boluʃtur
ئۆرۈپ	tɑʃlɑp
ئۆرە	turmɑjdu
ئۆرە	ʔørɛ
ئۆز	ʔøz
ئۆزرە	ʔøzrɛ
ئۆزىدە	ʔøzidɛ
ئۆزىمىزدىن	ʔøzimizdim
ئۆزىنى	ʔizdɛp
ئۆزىنى	ʔøzɪnɪ
ئۆزىگە	ʔøzigɛ
ئۆزگىچە	ʔøzgitʃɑ
ئۆزگە	ʔøzgɛ
ئۆزگەرتمەڭ	søz
ئۆزگەرتىش	ʔøzgɛrtiʃ
ئۆزگەرمەس	ʔøzgɛrmɛs
ئۆزۈم	ʔøzym
ئۆزۈممۇ	bir
ئۆستەڭ	østɛŋ
ئۆسكەن	ʔøskɛn
ئۆسكەندە	ʔøskɛndɛ
ئۆسمە	ʔøsmɛ
ئۆسىدۇ	ʔøsidu
ئۆسۈك	ʔøsyk
ئۆسۈم	ʔøsim
ئۆسۈپ	ʔøsip
ئۆشكە	ʔøʃkɛ
ئۆكتەبر	ʔøktɛbr
ئۆكۈز	ʔøkyz
ئۆكۈزلەر	ʔøkizlɛr
ئۆل	ʔøl
ئۆلدى	ʔøldi
ئۆلدۈم	ʔøldim
ئۆلمىدىم	ʔølmidim
ئۆلچىمىدىن	ʔøltʃimidin
ئۆلچەشتە	ʔøltʃɛʃtɛ
ئۆلگەن	ʔølgɛn
ئۆلۈم	ʔølym
ئۆلۈپ	ʔølyp
ئۆم	ʔøm
ئۆمرى	ʔømri
ئۆمرۈم	ʔømrim
ئۆمۈر	køriʃnɪŋ
ئۆمۈچۈك	ʔømytʃyk
ئۆمەر	ʔømɛr
ئۆي	jɑsɑp
ئۆي	øj
ئۆيدىن	ʔøjtin
ئۆيدە	ʔøjdæ
ئۆيلەر	øjlær
ئۆيلەر	øjlæː
ئۆيمۇ	ʔøjmu
ئۆيى	ʔøji
ئۆپكە	ʔøpkɛ
ئۆچ	ʔøtʃ
ئۆچكە	ʔøtʃkɛ
ئۆگزىنىڭ	bir
ئۆگۈن	ʔøgyn
ئۆگەن	ʔøgɛm
ئۆگەندىم	ʔøgændim
ئۆگەي	ʔøgɛj
ئۇ	u
ئۇتۇق	ʔutuq
ئۇجرەت	ʔudʒrɛt
ئۇد	ʔud
ئۇران	ʔurɑn
ئۇراي	ʔurɑj
ئۇرغۇپ	ʔurʁup
ئۇرپ	ʔurp
ئۇرۇش	ʔuruʃ
ئۇرۇق	ʔuruq
ئۇرۇنغان	ʔurunʁɑn
ئۇز	ʔuz
ئۇزاق	ʔuzɑq
ئۇزۇن	bolup
ئۇزۇن	ʔuzun
ئۇزۇندا	ʔuzumdɑ
ئۇستا	ʔustɑ
ئۇستات	ʔustɑt
ئۇستۇرا	ʔusturɑ
ئۇسقاندا	ʔusqɑndɑ
ئۇسلۇپ	ʔuslup
ئۇسۇل	ʔusul
ئۇسۇللار	bilɛn
ئۇسۇلى	ʔusulɪ
ئۇسۇلىمىز	turmuʃ
ئۇسۇپ	ʔusup
ئۇل	ʔul
ئۇلار	ulɑr
ئۇلارمۇ	ʔulɑrmu
ئۇلارنى	ʔulɑrni
ئۇلارنىڭ	bir
ئۇلارچە	ʔulɑrtʃe
ئۇلاش	ʔulɑʃ
ئۇلۇغ	ʔuluʁ
ئۇمۇ	ʔumu
ئۇمۇرتقا	ʔumurtqɑ
ئۇن	ʔun
ئۇنسۇر	ʔunsur
ئۇنناپ	ʔunnɑp
ئۇنى	bir
ئۇنى	uni
ئۇنىڭ	bilɛn
ئۇنىڭ	ʔuniŋ
ئۇنىڭغا	bu
ئۇنىڭغا	uniŋʁɑ
ئۇنىۋېرسىتېت	ʔuniwersitet
ئۇنىۋېرسىتېتى	ʔuniwersiteti
ئۇنۋان	ʔunwɑn
ئۇي	ʔuj
ئۇياقتا	tursun
ئۇيالماس	ʔujɑlmɑs
ئۇيغۇر	ʔujʁur
ئۇيغۇرنىڭ	bɑʃ
ئۇيغۇرچە	ujʁurtʃɛ
ئۇيقۇ	ʔujqu
ئۇپۇق	ʔupuq
ئۇچار	ʔutʃɑr
ئۇچالماس	ʔutʃɑlmas
ئۇچالماي	qɑldi
ئۇچراشقان	jipɛk
ئۇچقۇن	ʔutʃqun
ئۇۋا	ʔuwɑ
ئۇۋاق	ʔuwɑq
ئۈ	y
ئۈجمە	ʔydʒmɛ
ئۈزمە	ʔyzmɛ
ئۈزمەي	ʔyzmɛj
ئۈزۈش	ʔyzyʃ
ئۈزۈك	ʔyzyk
ئۈزۈلمەي	ʔyzilmɛj
ئۈزۈم	ʔyzym
ئۈزەڭگە	ʔyzɛŋgɛ
ئۈستىدە	ʔystidɛ
ئۈلپەت	ʔylpɛt
ئۈندەك	ʔyŋdɛk
ئۈنسىز	ʔynsɪz
ئۈنلۈك	ʔynlyk
ئۈچ	ʔytʃ
ئۈچىمىز	ʔytʃimiz
ئۈچىنچى	ytʃintʃi
ئۈچۈن	jumulsa
ئۈچۈن	ʔytʃin
ئې	e
ئېتىدىن	ʔitidin
ئېتىراز	ʔetirɑz
ئېتىراپ	ʔetirɑp
ئېتىزلار	ʔetizlɑr
ئېتىقات	ʔetiqɑt
ئېتىقاد	ʔetiqɑd
ئېتىۋار	ʔetiwɑr
ئېرا	ʔerɑ
ئېربىي	ʔerbij
ئېرىق	ʔeriq
ئېرىمەك	ʔerimɛk
ئېسىلىپ	ʔisilip
ئېسىپ	ʔesip
ئېشى	ʔeʃi
ئېشىم	ʔeʃim
ئېشىپ	ʔeʃip
ئېشەك	ʔiʃɛk
ئېغىر	ʔeʁir
ئېغىرلىق	ʔeʁirliq
ئېغىز	ʔeʁiz
ئېغىل	ʔeʁil
ئېكران	ʔekrɑn
ئېكىن	ʔekin
ئېكۋاتور	ʔekwɑtor
ئېلان	ʔelɑn
ئېلىش	ʔilɨʃ
ئېلىپ	ʔelip
ئېلىپبە	ʔelipbɛ
ئېلېمېنت	ʔelement
ئېنقىلاب	ʔenqilɑb
ئېنېرگىيە	ʔenergijɛ
ئېينشتېينىي	ʔejnʃtejnij
ئېيىق	ejiq
ئېپىدە	jɛr
ئېپىك	ʔepik
ئېچىش	ʔetʃiʃ
ئېچىلار	ʔetʃilɑr
ئېچىنىشلىق	bir
ئېچىپ	ʔetʃip
ئېگىز	ʔegiz
ئېگىل	ʔegil
ئېھاتە	ʔehɑtɛ
ئېھتىرام	ʔehtirɑm
ئېھتىمال	ʔehtimɑl
ئېھتىيات	ʔehtijɑt
ئېھسان	ʔehsɑn
ئە	ɛ
ئەبۇ	ʔebu
ئەت	ʔɛt
ئەتىۋار	ʔɛtiwɑr
ئەتەي	bir
ئەجىر	ʔɛdʒir
ئەجەل	ʔɛdʒɛl
ئەخلەت	bu
ئەخلەت	ʔɛxlɑt
ئەر	ʔɛr
ئەرزىگەن	ʔɛrzigɛn
ئەرلا	ʔɛrlɑ
ئەرنى	ʔɛrni
ئەزا	ʔɛzɑ
ئەزان	ʔɛzɑn
ئەزمە	ʔɛzmɛ
ئەزىز	ʔɛziz
ئەسل	ʔɛsl
ئەسلا	ʔɛslɑ
ئەسلى	ʔɑslɪ
ئەسلىمە	ʔɛslimɛ
ئەسلەش	ʔɛslɛʃ
ئەسلەيمەن	ʔɛslɛjmɛn
ئەسلەپ	ʔɑslɛp
ئەسنادا	ʔɛsnɑdɑ
ئەسنەپ	ʔɛsnɛp
ئەسىر	ʔɛsir
ئەسۋاپ	ʔɛswɑp
ئەسەر	ʔɛsɛr
ئەسەرگە	ʔɛsɛrgɛ
ئەقىل	ʔɛqil
ئەكسىنى	ʔɛksini
ئەل	æl
ئەلا	ʔɛlɑ
ئەللىك	ællik̚
ئەللىك	ɛllik̚
ئەلنىڭ	ʔɛlniŋ
ئەلى	ʔɛli
ئەلەم	ʔɛlɛm
ئەمدى	ʔɛmdɪ
ئەمىلى	bɑr
ئەمگەك	ʔɛmgɛk
ئەمەك	bolup
ئەمەل	ʔɛmɑl
ئەمەلنىڭ	ʔɛmɛlniŋ
ئەنسىرىگەن	ʔɛnsirigɛm
ئەنسىرەپ	bir
ئەپ	ʔɛp
ئەپسۇس	æpsus
ئەپلىك	ʔɛplik
ئەپلەپ	ʔɛplɛp
ئەپەندى	ʔɛpɛndi
ئەپەندىم	bu
ئەڭ	muhim
ئەڭ	tʃoŋ
ئەڭ	ʔɛŋ
ئەگەر	ɛgɛr
ئەھلىنىڭ	bu
ئەھمەد	ʔɛhmɛd
ئەھۋالنى	ʔɛhwɑlni
ئەھەد	ʔɛhɛd
ئەۋلىيا	tɛp
ب	b
ب	be
باتارى	bɑtɑri
باتراق	bɑtrɑq
باتىل	bɑtɪl
باتۇر	bɑtur
باج	bɑdʒ
بادام	bɑdɑm
بار	bɑr
بار	iʃ
بار	sɛn
بار-دە	bɑrdɛ
بار؛	bɑr
بارا	bɑra
باراي	barɑj
باردى	bɑrdi
باردىم	bɑrdim
باردۇ	bɑrdu
باردۇق	bɑrduq
بارسا	bɑrsɑ
بارسام	bɑrsam
باركى	bɑrki
بارلار	bɑrlɑr
بارلارنى	bɑrlɑrni
بارلىق	bɑrliq
بارما	bɑrmɑ
بارماق	bɑrmɑq
بارماي	bɑrmɑj
بارمايلا	bɑrmɑjlɑ
بارمۇ	bɑrmu
بارىي	bɑrij
بازار	bɑzɑː
بازارلا	bɑzɑrla
بازىرى	bɑzirɨ
باس	bɑs
باسالماي	bɑsɑlmɑj
باستى	basti
باستىم	bastim
باسسا	bɑssɑ
باسقان	bɑsqɑn
باش	bɑʃ
باشاق	bɑʃɑq
باشتا	baʃtɑ
باشقا	bɑʃqɑ
باشقىلار	bilɛn
باشقىلار	sɛn
باشقۇرسا	baʃqursɑ
باشلاندى	bɑʃlɑnti
باشلاپ	bɑʃlɑp
باشلاپتۇ	bɑʃlɑptu
باشلاڭ	bɑʃlɑŋ
باغ	wɑrɑn
باغدا	baʁdɑ
باقار	bɑqɑr
باقاي	bɑqɑj
باقساق	bɑqsɑq
باققال	bɑqqɑl
باققان	bɑqqɑn
باققۇم	bɑqqum
باقما	bɑqmɑ
باقماي	bɑqmɑj
باقى	bɑqi
باقىدۇ	bɑqɪdu
بال	bɑl
بالا	bir
بالا	bɑlɑ
بالام	bɑlɑm
بالامنى	bɑlɑmni
بالاڭ	bɑlɑŋ
بالكون	bɑlkon
بالىلار	bɑlilɑr
بالىلارمۇ	bɑlilɑrmu
بالىلارنىڭ	biri
بالىنى	bɑlini
بالېت	bɑlet
بانا	bɑnɑ
بانان	bɑnɑn
بانداژ	bɑndɑʒ
باي	bilɛn
باي	bɑj
بايا	bɑjɑ
بايانلار	bɑjɑnlɑr
باياۋان	bɑjɑwɑn
بايراق	bɑjrɑq
بايرام	bɑjrɑm
بايغا	bajʁa
بايقاش	bɑjqɑʃ
بايقالدى	bɑjqɑldi
بايقاپ	bɑjqɑp
بايقۇش	bɑjquʃ
بايلار	bɑjlɑr
بايلىق	bɑjlɪq
بايمۇ	bɑjmu
باپ	bɑp
باچكا	batʃkɑ
باھا	bɑhɑ
باھارى	bɑhɑri
باھانە	bɑhɑnɛ
بروم	brom
بوخچا	boχtʃɑ
بور	bor
بورچ	bortʃ
بوز	boz
بوستان	bostɑn
بوسەي	bosɛj
بوش	boʃ
بوشاپ	boʃɑp
بول	bol
بولاتتى	bolatti
بولار	bolɑr
بولارمىش	bolɑrmiʃ
بولالماي	bolɑlmaj
بولالمايدۇ	bolɑlmɑjdu
بولامدۇ	bɔlɑmdu
بولايلى	bolɑjli
بولدى	bir
بولدى	bɔldɨ
بولدۇم	boldum
بولسا	bɔlsɑ
بولسا	mɛrhumɛ
بولسا	sɛn
بولساق	bolsɑq
بولسام	bɔlsɑm
بولساڭ	bolsaŋ
بولسىلا	bolsɪla
بولسىلا	u
بولغان	bir
بولغان	bolʁan
بولغانىكەنمەن	bu
بولغاچقا	ulɑr
بولغىن	bolʁin
بولكا	bolkɑ
بولما	bolmɑ
بولماس	bɔlmas
بولماسلىقى	bilɛn
بولماق	bolmɑq
بولماي	bolmɑj
بولمايدۇ	polmɑjdu
بولمىدى	bolmidi
بولمىسا	bolmɪsɑ
بولمىغان	bolmɨʁan
بولىسىلەر	bolɪsilɛr
بولۇر	bolur
بولۇشتۇر	boluʃtur
بولۇشنى	boluʃni
بولۇشنىڭ	boluʃniŋ
بولۇشىنى	boluʃinɨ
بولۇو	boluo
بولۇپ	bolup
بولۇپ	qɑldi
بولۇپ	qɑlmɑmdu
بولۇپتۇ	boluptu
بومبا	bombɑ
بوي	boj
بويتاق	bojtɑq
بويلاپ	bɔjlɑp
بويى	bɔji
بويىدا	bojidɑ
بويىچە	bojitʃɛ
بويۇن	bojun
بوپتىكەن	poptikɛn
بوۋاممۇ	bowɑmmu
بوۋاي	bowaj
بوۋاڭ	bilɛn
بىتون	biton
بىر	bir
بىر	dʒyp
بىر	pɛn
بىر-بىر	birbir
بىراق	bɤrɑq
بىرلەپ	birlɛp
بىرى	biri
بىرىليانت	biriljɑnt
بىرىنى	birɪni
بىرىنچى	birintʃi
بىرىگە	zit
بىرىگە	ʔot
بىرەر	bɪrɛr
بىز	piz
بىزار	bɪzɑr
بىزدىن	bizdin
بىزدە	bizdɛ
بىزدەك	pɨzdɛk
بىزلەر	bizlɛr
بىزمۇ	bɨzmu
بىزنىمۇ	biznimu
بىزگە	bizgɑ
بىسمۇت	bismut
بىشەم	biʃɛm
بىكار	pikɑr
بىل	bil
بىلال	bilɑl
بىلسە	bɪlse
بىللە	bu
بىللە	bɪllæ
بىلمىگەن	bilmigɛn
بىلمەسنى	bir
بىلمەيلا	bilmɛjla
بىلىم	bilɪm
بىلىپ	bɨlip
بىلگىلى	bilgɪlɪ
بىلەتتى	bilɛttɨ
بىلەر	bilɛr
بىلەلمەي	bɪlɛlmɛj
بىلەن	bilɛn
بىلەن	gɛp
بىلەن	kirip
بىلەن	ʔuzun
بىلەنمۇ	bilɛnmu
بىنالار	bɪnɑlar
بىچارە	bitʃare
بىڭگۇر	biŋgur
بىگىز	bigiz
بىگۇناھ	bɑlɑ
بۆرە	børɛ
بۆرەك	børɛk
بۆز	bøz
بۆسۈپ	bøsip
بۆشۈك	bøʃyk
بۆك	bøk
بۆھران	bøhrɑn
بۇ	bu
بۇ	jɛrdɛ
بۇ	tɑzɑ
بۇت	but
بۇتپەرەس	butpɛrɛs
بۇدجېت	buddʒet
بۇرادەر	burɑdɛr
بۇراپ	burɑp
بۇرچۇم	burtʃum
بۇرژۇئا	burʒuʔɑ
بۇرژۇئازىيە	burʒuʔɑzijɛ
بۇرۇت	burut
بۇرۇن	burun
بۇزسا	buzsa
بۇزمايلى	buzmɑjli
بۇزۇلار	buzulɑr
بۇزۇلسا	buzulsa
بۇغ	buʁ
بۇغداي	buʁdɑj
بۇقا	buqɑ
بۇلارنى	bulɑrni
بۇلاق	bulɑq
بۇلبۇل	bulbul
بۇلجۇڭ	buldʒuŋ
بۇلغارىيە	bulʁɑrijɛ
بۇلماق	bulmɑq
بۇلۇت	bulut
بۇمۇ	bumu
بۇنداق	bundaq
بۇنداق	iʃ
بۇنى	bunɪ
بۇنچە	buntʃɛ
بۇيرۇ	bujru
بۇيرۇق	bujruq
بۇيرۇپ	bujrup
بۈيۈك	byjyk
بۈگۈن	bigyn
بۈگۈندىن	bɑʃlɑp
بېركلىي	berklij
بېرى	beri
بېرى	tur
بېرىدۇ	beridu
بېرىشىم	beriʃim
بېرىلدى	birildi
بېرىللىي	berillij
بېرىپ	berɪp
بېرىپسىزغۇ	bu
بېزى	bezi
بېزەك	bizɛk
بېزەلسۇن	bezɛlsum
بېسىش	besiʃ
بېشىغا	beʃiʁɑ
بېشىڭ	beʃɨŋ
بېغىر	beʁir
بېلوك	belok
بېلى	beli
بېلىق	beliq
بېلىقچى	beliqtʃi
بېلىم	bilim
بېلەت	belɛt
بېنزىن	benzin
بېگېموت	begemot
بەتلىرى	bɛtlɪri
بەختىيار	bɛχtijɑr
بەخش	bɛχʃ
بەدەل	bɛdɛl
بەدەن	bɛdɛn
بەدەن	wɛ
بەر	bɛr
بەردى	bɛrdi
بەردىم	bærdim
بەردىڭ	pɛrdɪŋ
بەرسۇن	bɛrsun
بەرسە	bɛrsɛ
بەرسەم	bɛrsɛm
بەركە	bɛrkɛ
بەرمىدىم	bɛrmidim
بەرمەك	bɛrmɛk
بەرىبىر	bɛribir
بەرپاچى	u
بەرگەن	bɛrgɛn
بەز	bɛz
بەزى	bɛzɨ
بەس	bɛs
بەسەي	bɛsɛj
بەش	bilɛn
بەش	bæʃ
بەش	bɛʃ
بەشتىن	bɛʃtin
بەشىنچى	bɛʃintʃi
بەك	bɛk
بەل	bɛl
بەلغەم	bɛlʁɛm
بەلكى	u
بەلگە	bɛlgɑ
بەنزە	bɛnzɛ
بەنسىيۇەن	bɛnsijuɛn
بەنسىچۇ	bɛnsitʃu
بەياز	bɛjɑz
بەگ	bɛg
بەھۇزۇر	ʔɑŋlitim
ت	t
ت	te
تا	tɑ
تائەت	tɑʔɑt
تاتارچە	tatartʃɛ
تاتلىق	tɑtlɪq
تاجاۋۇز	tɑdʒɑwuz
تاجى	tɑdʒɨ
تار	tɑr
تارازا	tɑrɑzɑ
تاراقلايدۇ	tɑrɑqlɑjdu
تارام	jɑʃ
تاراپ	tɑrap
تاراپ	uni
تاراۋى	tɑrɑwi
تارت	tɑrt
تارتۇق	tɑrtuq
تارقىتىپ	tɑrqitip
تارماق	tɑrmɑq
تارىخ	tɑrɪx
تارىخىنى	tɑrixini
تاز	tɑz
تازا	tɑzɑ
تازىلايدىغان	tɑzɨlɑjdɪʁɑn
تاس	tɑs
تاسقاپ	tɑsqɑp
تاسلا	tɑslɑ
تاسما	tɑsmɑ
تاش	tɑʃ
تاشلار	tɑʃlɑr
تاشلاش	taʃlɑʃ
تاشلاپ	tɑʃlɑp
تاغ	tɑzɑ
تاغ	tɑʁ
تاق	tɑq
تاقا	tɑqɑ
تاقىر	tɑqɪr
تال	tɑl
تالادەك	tɑlɑdɛk
تالاشتى	tɑlɑʃti
تالدا	tɑldɑ
تاللا	tɑllɑ
تاللاپ	tɑllɑp
تاللاڭ	tɑllɑŋ
تالماي	tɑlmɑj
تالىشىپ	ʔotʃɑq
تام	tɑm
تاما	køl
تاما	tɑmɑ
تاماق	tɑmɑq
تاماققا	tɑmɑqqɑ
تامام	tɑmɑm
تامامەن	tamɑmɛn
تامدەك	tɑmdɛk
تاملار	tʰamlɑː
تاملار	tʰɑmlɑr
تاملىرى	tɑmliri
تاياق	tɑjɑq
تاياققا	tɑjɑqqɑ
تاپ	tɑp
تاپاتتىم	tɑpɑttɪm
تاپالايسىز	tɑpɑlɑjsɪz
تاپالماپتۇ	tapalmaptu
تاپاۋەت	tɑpɑwɛt
تاپتى	tɑpti
تاپتىم	tɑptɨm
تاپسام	jɛjmɛn
تاپسۇن	tɑpsum
تاپشۇرۇپ	tɑpʃurup
تاپقان	tɑpqɑn
تاپماس	tɑpmas
تاپماپتۇ	tɑpmɑptu
تاپماڭ	tɑpmɑŋ
تاڭ	tɑŋ
تاھىر	tɑhir
ترامپ	trɑmp
توختام	tɔχtɑm
تور	tor
توردا	tordɑ
تورداشلار	tordɑʃlɑr
تورلاشقان	torlaʃqɑn
تورنى	torni
تورۇس	torus
تورۇق	toruq
توزۇپ	tɔzup
توسۇن	tosun
توشقان	toʃqɑn
توشۇپ	toʃup
توغرا	tɔʁrɑ
توغرىسىدىكى	bilɪm
توق	toq
توقال	tɔqɑl
توقاي	toqɑj
توقسان	toqsɑn
توققۇز	toqquz
توققۇز	tɔqquz
توققۇزىنچى	toqquzintʃi
توقلاپ	toqlɑp
توقۇم	tɔqum
توقۇمنى	toqumni
توقۇپ	toqup
توك-توك	toktok
تولا	tolɑ
تولماي	tɔlmɑj
تولى	tɔli
تومۇز	tɔmuz
تونۇر	tɔnur
تونۇشقا	tonuʃqɑ
تونۇشنى	wɛ
توي	toj
تويسىمۇ	tojsimu
تويلار	tojlɑr
تويماس	tojmɑs
تويمۇ	tojmu
توپ	top
توپا	topɑ
توپتا	toptɑ
توپلاش	toplɑʃ
توپلاش؛	toplɑʃ
توپلام	toplɑm
توپلايدۇ	toplɑjdu
توپلۇم	tɔplum
توپۇق	topuq
توۋا	tɔwa
تىترەپ	put
تىرناق	tirnɑq
تىرىك	tirɨk
تىرىكلىك	tirɪklɪk
تىز	tɪz
تىزىملاش	tizimlaʃ
تىكىپ	tikip
تىل	til
تىلى	turup
تىلىدىن	bilɛr
تىلەك	tilɛk
تىلەيدىغان	bolup
تىلەيمەن	tilɛjmɛn
تىمساخ	timsɑχ
تىمەن	timɛn
تىيىن	tijin
تۆت	tøt̚
تۆت	tœt̚
تۆتنى	ʔɑlsɑ
تۆتىنچى	tøtintʃi
تۆتىنچى	tœtintʃi
تۆش	tøʃ
تۆكۈلەر	tøkylɛr
تۆمۈر	tømyr
تۆپە	tøpɛ
تۆگە	tøgæ
تۆگە	tøgɛ
تۆگە	tœgæ
تۆگە	tœgɛ
تۆۋەن	tøwɛn
تۇت	tut
تۇتاي	tutɑj
تۇتماق	tutmɑq
تۇتۇپ	sɛl
تۇخۇم	tuχum
تۇر	tur
تۇرامدۇ	turɑmdu
تۇراي	turɑj
تۇرايلى	turɑjli
تۇردۇق	turduq
تۇرساڭ	tursɑŋ
تۇرسۇن	tursun
تۇرسۇن	turup
تۇرغىن	mæn
تۇرغىنى	bilɛn
تۇرماق	turmɑq
تۇرمايدۇ	turmɑjdu
تۇرمۇش	turmuʃ
تۇرمۇشتا	bɑr
تۇرمۇشتا	turmuʃtɑ
تۇرمۇشنى	turmuʃni
تۇرمۇشى	turmuʃi
تۇرمۇشىمىز	turmuʃimiz
تۇرۇس	turus
تۇرۇش	turuʃ
تۇرۇشسا	turuʃsa
تۇرۇشى	turuʃi
تۇرۇپ	turup
تۇرۇپ	u
تۇرۇپ	uni
تۇرۇپتۇ	turuptu
تۇز	tuz
تۇزاق	tuzɑq
تۇزلار	tuzlɑr
تۇغقان	jɑr
تۇغقانلار	bilɛn
تۇغما	tuʁmɑ
تۇلۇمدەك	tulumdɛk
تۇمار	tumar
تۇنجى	tor
تۇياق	tujɑq
تۇچ	tutʃ
تۈتۈن	tytyn
تۈرمىدىن	qɑtʃqɑn
تۈز	tyz
تۈك	tyk
تۈكى	tyki
تۈلكە	tylkæ
تۈلكە	tylkɛ
تۈگمىدەك	tygmidɛk
تۈگەر	tygɛr
تۈگەپ	tygɛp
تېرىپ	terip
تېز	tez
تېزلا	tezlɑ
تېشى	teʃi
تېكە	tekɛ
تېما	temɑ
تېمىنى	timini
تېنى	teni
تېپىپ	ʔømri
تېگىدىن	tegidin
تېگىشلىك	tegɪʃlɪk
تەبلىغ	tɛbliʁ
تەتىلدە	tætɨldæ
تەخسە	tækʰsæ
تەخسە	tæxsæ
تەخسە	tɛkʰsɛ
تەخسە	tɛxsɛ
تەخمىن	tɛχmin
تەدبىر	tɛdbir
تەر	tɛr
تەربىيەسىنى	ʔøz
تەرتىپ	tɛrtip
تەرجىمان	tɛrdʒimɑn
تەرجىمە	tærdʒimæ
تەرجىمە	tɛrdʒimɛ
تەرلەپ	tɛrlɛp
تەز	tɛz
تەس	tɛs
تەسنىپ	tɛsnip
تەسىر	tɛsir
تەسىرلىك	tɛsirlik
تەسۋىر	tɛswɪr
تەشنا	teʃnɑ
تەق	tɛq
تەقسىر	tɑqsir
تەكتى	tɛkti
تەكلىپ	tɑklɪp
تەلىيى	jɑr
تەلىپى	tɛlipi
تەلپەك	tɛlpɛk
تەلھە	tɛlɦɛ
تەلۋە	tɛlwɛ
تەلەپ	tɛlɛp
تەمبۇر	tɛmbur
تەمبەل	tɛmbɛl
تەمنى	tɛmni
تەن	tɛn
تەندە	tɛndɛ
تەنھا	tɛmhɑ
تەنە	tɛnɛ
تەييار	tɛjjar
تەپ	tɛp
تەپتى	tɛpti
تەپتىش	tɛptiʃ
تەپتىم	tɛptɨm
تەپەككۇر	tɛpɛkkur
تەڭ	tɛŋ
تەڭدېشى	joq
تەڭرى	tɛŋri
تەڭلا	tɑŋlɑ
تەھدىت	tɛhdit
تەۋە	tɛvɛ
ج	dʒ
ج	dʒe
جاز	dʒɑz
جازا	dʒɑzɑ
جازاسى	dʒɑzɑsi
جازالار	dʒazɑlɑr
جازالاش	dʒɑzɑlɑʃ
جامائەت	dʒɑmɑʔɛt
جان	dʒɑm
جانان	dʒɑnɑn
جانسىز	dʒɑnsɪz
جاي	dʒɑj
جاپاكەش	dʒɑpɑkɛʃ
جاڭ	dʒɑŋ
جاڭيۇ	dʒɑŋju
جاڭگال	dʒɑŋgɑl
جاھان	dʒɑhɑm
جاۋابى	dʒɑwɑbi
جاۋاپ	dʒɑwɑp
جوزا	dʒozɑ
جىق	bu
جىق	dʒiq
جىمجىت	dʒɨmdʒɨt
جىمىپ	dʒɨmip
جىن	dʒin
جىنازا	dʒinɑzɑ
جىنايىتى	dʒinajiti
جىنايەت	dʒinɑjɛt
جىگىرى	dʒigiri
جىگەر	dʒigɛr
جىگەرنى	dʒigɛrni
جۇدا	dʒudɑ
جۇڭگو	dʒuŋgo
جۇۋا	dʒuwa
جۈمە	dʒymæ
جۈمە	dʒymɛ
جۈپ	dʒyp
جېنىم	dʒenim
جەزمەن	dʒɛzmɛn
جەسۇر	dʒɛsur
جەم	dʒɑm
جەڭ	dʒɛŋ
جەڭلەردە	bolup
جەڭچى	dʒæŋtʃi
جەڭچى	dʒɛŋtʃi
جەھلى	bilɛn
خ	χ
خ	χe
خاس	χas
خاسىيەتنىڭ	xɑsijɛtnɪŋ
خالاس	xɑlas
خالايىق	ɛgɛr
خالىس	xɑlɪs
خامۇش	xɑmuʃ
خانىۋەيران	bolatti
خوتەن	χotɛn
خوجام	xodʒɑm
خوراز	χorɑz
خورۋاتىيە	χorwɑtijɛ
خوش	qɑq
خوش	xoʃ
خوش	xɔʃ
خىت	χit
خىزمەتچى	χizmɛttʃi
خىش	xiʃ
خىلى	xili
خىيال	χɨjɑl
خۇدا	xudɑ
خۇرسەن	xursɛn
خۇمار	xumɑr
خېلى	χili
خېچىر	χetʃir
خەت	χæt
خەتنىمۇ	xɑtnimu
خەنزۇ	χɛnzu
خەپ	xɛp
د	d
د	de
دا	dɑ
دات	dɑt
داتلاشماس	dɑtlɑʃmɑs
دادا	dɑdɑ
دادا	dɑp
دادام	tɑtɑm
دادامنىڭ	dɑdɑmniŋ
دار	dɑr
داستان	dɑstɑn
داستانىمۇ	dɑstɑnimu
داشۈئې	dɑʃyʔe
داق	dɑq
دام	dɑm
دان	dɑn
دانا	danɑ
دانە	dɑnɛ
داپ	dɑp
داڭگال	dɑŋgɑl
داۋا	dɑwɑ
داۋالاش	dɑwɑlɑʃ
داۋام	tɑwɑm
داۋان	dɑwɑn
داۋۇت	dɑwut
دورا	torɑ
دوست	dost
دوستانە	dostɑnɛ
دولان	dɔlɑn
دومبىرا	dombirɑ
دىل	dɨl
دىل	søzi
دىلبەر	dilbɛr
دىلى	bilɛn
دىن	din
دىنى	dini
دىڭ	dɨŋ
دۆشە	døʃɛ
دۆلىتى	dølɪti
دۆلەت	dølɛt
دۆلەتتە	dølɛttɛ
دۆلەتلىك	dølɛtlik
دۆلەتلەرنىڭ	dølɛtlɛrniŋ
دۆۋە	døwɛ
دۇئا	duʔɑ
دۇتار	dutɑr
دۇتتار	duttɑr
دۇنيا	wɛ
دۇچ	dutʃ
دۈدۈك	dydyk
دۈشمەن	tyʃmen
دۈشمەنگە	zar
دۈشەنبە	dyʃænbæ
دۈشەنبە	dyʃɛnbɛ
دېدى	biri
دېدىم	tidim
دېسىلە	disilɛ
دېسەم	qɑrɑ
دېكابر	dekɑbr
دېمەك	demɛk
دېمەيدىغان	gɛp
دېڭىز	deŋiz
دېگەن	qɑrɑp
دېگەننىمۇ	tɑʃlɑp
دېگەننىڭ	tɑzɑ
دېھقانچىلىق	bilɛn
دە	dɑ
دەتالاش	dɛtɑlɑʃ
دەر	dɛr
دەردى	turup
دەردىدە	dɛrdidɛ
دەردىگە	dærdɨgɛ
دەرس	dɛrs
دەرمانىم	bɑlɑm
دەريا	dɑrjɑ
دەريالار	dɛrjɑlɑr
دەرۋازا	dɛrwɑzɑ
دەرۋەقە	dærwɛqɛ
دەرەخ	dærɛx
دەرەخلىكتىن	bir
دەس	dɛs
دەستىلىك	dɛstilik
دەسسەيدۇ	dɛssɛjdu
دەسلەپ	dɛslɛp
دەل	dɛl
دەملەپ	dɛmlɛp
دەيدىغان	gɛp
دەيمىز	dɛjmiz
دەپ	turmɑj
دەپ	tɛp
دەپتۇ	dɛptu
دەپتۇ	ʔøtʃkɛ
دەپتەر	dæp̚tær
دەپتەر	dɛp̚tɛr
دەپسەندە	dɛpsɛndɑ
دەپلا	dɛplɑ
دەپمۇ	tɛpmu
دەۋر	bu
ر	r
ر	re
رازى	bolup
رازى	rɑzi
راسا	rɑsɑ
راستلا	rɑstlɑ
راستما	rastmɑ
راسلاپ	rɑslɑp
راك	rɑk
رام	rɑm
روبرۇ	robru
روشەن	rɔʃɛn
رومال	romal
رومان	romɑn
رومانلار	romɑnlɑr
روھى	roɦi
روھىڭ	rohiŋ
رىم	rim
رۇخسەت	ruχsɛt
رۇسىيە	rúsijɛ
رەت	rɛt
رەسىم	ræsim
رەكەت	rɛkɛt
رەنا	rɑnɑ
رەھمەت	ræhmɛt
رەھمەت	sɨz
ز	z
ز	ze
زات	zat
زار	zar
زال	zɑl
زامان	zɑmɑm
زامانى	zɑmɑni
زامىن	zɑmin
زاپاس	zɑpɑs
زاھىر	zahir
زاۋال	zɑwɑl
زور	zɔr
زوردۇن	zordun
زوق	zoq
زىت	zit
زىرە	zirɛ
زىل	zil
زىننەت	zinnɛt
زۇكام	zukɑm
زۇلۇم	zulum
زۇمرەت	zumrɛt
زۇۋان	zuwɑn
زېرىكىپ	zerikip
زېرەك	zerɛk
زېمىن	zimin
زېمىندار	zimindɑr
زېمىننىڭ	ʔɑwɑt
زەئىپ	zɛʔip
زەبەردەس	zɛbɛrdɛs
زەر	zɛr
زەربە	zɛrbɛ
زەررە	zɛrrɛ
زەرەر	zɛrɛr
زەمبىرەك	zɛmbirɛk
زەن	zɛn
زەنجىر	zɛndʒir
زەنجىۋىل	zɛndʒiwil
زەپمۇ	zɛpmu
زەھەر	zɛhɛr
س	s
س	se
سائەت	saʔɛt
ساتىراش	tɛp
ساختا	sɑχtɑ
سادا	sɑdɑ
ساداسى	sadasi
ساداق	sɑdɑq
ساددا	sɑddɑ
سادىر	sadɪr
سار	sɑr
ساراي	sɑrɑj
سارايلاردىن	wɛ
ساراڭ	sɑraŋ
سارراپ	sɑrrɑp
سارنى	sɑrni
ساز	sɑz
سازاۋەر	turup
ساغلام	jɑʃɑp
ساغلاملىقى	wɛ
سافا	sɑfɑ
ساق	sɑq
ساقاق	sɑqɑq
ساقال	søz
ساقال	sɑqɑl
ساقلايدۇ	sɑqlɑjdu
ساقلاپ	sɑqlap
ساقلاڭلار	saqlɑŋlɑr
ساقىت	sɑqɪt
ساقچى	sɑqtʃi
سال	sɑl
سالا	sɑlɑ
سالام	salɑm
سالدى	sɑldi
سالدىم	sɑldim
سالدۇق	sɑlduq
سالماي	sɑlmɑj
سالچىلار	sɑltʃilɑr
ساما	sɑmɑ
سامان	sɑmɑn
ساماۋار	sɑmɑwɑr
سان	sɑn
سانالمايدۇ	sɑnɑlmɑjdu
سانايدۇ	sɑnɑjdu
سانايمەن	sɑnɑjmæn
ساندا	sɑndɑ
ساندىن	sɑndin
ساندۇق	sɑnduq
سانلار	sɑnlar
سانىسا	sɑnisa
ساي	sɑj
سايرام	sɑjrɑm
سايىسى	joq
سايە	sɑjɛ
سايەڭ	sɑjɛŋ
ساپ	sɑp
ساپا	sɑpɑ
ساپال	sɑpɑl
ساپان	sɑpɑn
ساپتۇ	sɑptu
ساڭا	sɑŋa
ساھە	sɑhæ
ساۋاتلار	sɑwɑtlɑr
سوئالنى	køp
سوت	sot
سوتقا	sotqa
سوراي	soraj
سوراپ	qɑldi
سوراپ	sorɑp
سوراپتۇ	u
سورىغان	bilɪm
سوقۇپ	soqup
سول	sol
سولا	sɔlɑ
سوم	sɔm
سىر	sir
سىركە	sirkɛ
سىرەك	sirɛk
سىز	sɨz
سىزدىن	sizdin
سىزلەر	sɨzlɛr
سىزمۇ	sizmu
سىزنى	sizni
سىزنىڭ	siznɨŋ
سىزىش	siziʃ
سىزگە	sizgæ
سىلى	sili
سىلەر	silær
سىناپ	sinap
سىنىپ	sɨnip
سىنىپتىن	sɪnɪptin
سىياسەت	sijɑsɛt
سىيىر	sijir
سىڭىر	siŋir
سۆز	søz
سۆزلىرى	bilɛn
سۆزلىسەم	søzlisɛm
سۆزلىشىپ	søzliʃɪp
سۆزلە	søzlɛ
سۆزلەر	søzlɛr
سۆزلەردە	søzlɛrdɛ
سۆزلەرلا	søzlɛrlɑ
سۆزلەرنى	søzlɑrni
سۆزلەش	søzlɛʃ
سۆزلەپ	søzlɑp
سۆزلەپتۇ	søzlɛptu
سۆزنى	søzni
سۆزى	søzi
سۆزىڭىزنى	tɑllɑp
سۆزىگە	søzɪgɛ
سۆزگە	søzgɛ
سۆك	søk
سۆيمەك	søjmɛk
سۆيگەن	søjgɛn
سۆيۈپ	søjip
سۆيەرلىكى	wɛ
سۆگەت	søgɛt
سۆگەل	søgɛl
سۆھبەت	søhbɛt
سۇ	bolup
سۇ	su
سۇدا	suda
سۇدان	sudan
سۇس	sus
سۇلار	sulɑr
سۇمباتلىق	bir
سۇمبۇل	sumbul
سۇناي	sunɑj
سۇنايلى	sunɑjli
سۇندى	sundi
سۇندۇم	sundum
سۇنۇپ	suŋup
سۈبھى	sybhi
سۈت	syt
سۈرگۈنگە	syrgyngɛ
سۈرۈشتە	syryʃtɛ
سۈرەت	syrɛt
سۈرەي	syrɛj
سۈزۈك	syzyk
سۈلھ	sylh
سۈمۈرمەك	symyrmɛk
سۈيدۈك	syjdyk
سۈپەتلەردۇر	sypɛtlɛrdur
سېغىزخان	seʁizχɑn
سېمىز	semiz
سېمىزئوت	semizʔot
سېنتەبر	sentɛbr
سېپى	sepi
سەت	sɛt
سەدىقە	sɛdiqɑ
سەرخىلى	sɛrxili
سەرخۇش	sɛrχuʃ
سەركە	sɛrkɛ
سەكسەن	sɛksɛn
سەكسەنپۇت	sɛksɛnput
سەككىز	sækkiz
سەككىز	sæk̚kiz
سەككىز	sɛkkiz
سەككىز	sɛk̚kiz
سەككىزىنچى	sɛkkizintʃi
سەل	sɛl
سەمىمىيلىك	wɛ
سەمەرقەند	sɛmɛrqɛnd
سەن	sɛn
سەنئەت	sɛnʔɛt
سەي	sɛj
سەيشەنبە	sæjʃænbæ
سەيشەنبە	sɛjʃɛnbɛ
سەپ	sɛp
سەپسەتە	sɛpsɛtɛ
سەپلەپ	bɑj
سەپەر	sɛpɛr
سەپەرنى	sɛpɛrni
سەھىپىلىرىدىكى	bir
ش	ʃ
ش	ʃe
شار	ʃɑr
شارى	ʃɑri
شارپا	ʃɑrpa
شاكىر	ʃɑkir
شاكىلى	ʃɑkili
شال	ʃɑl
شالاڭلاپ	ʃɑlɑŋlɑp
شالدىرلاپ	ʃɑldirlɑp
شام	ʃɑm
شامال	ʃɑmɑl
شامال-ھە	ʃɑmɑlhɛ
شامالدىن	ʃɑmɑldin
شاماللار	ʃɑmɑllar
شامالمۇ	ʃɑmɑlmu
شامان	ʃɑmɑn
شاملىرى	ʃɑmliri
شامنىڭ	ʃɑmnɨŋ
شان	ʃɑn
شايار	ʃɑjɑr
شاپ	ʃɑp
شاپتۇل	ʃɑptul
شاھ	ʃɑh
شاھنى	ʃɑhni
شوخ	ʃox
شور	ʃor
شورپا	ʃɔrpɑ
شولا	ʃolɑ
شوپۇر	ʃopur
شىر	ʃir
شىركەت	ʃirkæt
شىرىن	ʃirin
شىرە	ʃirɑ
شىرەدىكى	ʃirɛdikɪ
شىسەي	ʃisɛj
شىمال	ʃimal
شىنجاڭ	ʃindʒɑŋ
شياڭگاڭ	ʃjɑŋgɑŋ
شۆھرەت	ʃøhrɛt
شۆھرەتكە	rɛzɪl
شۇكى	ʃuki
شۇلار	ʃulɑr
شۇلاردەك	ʃulɑrdɛk
شۇلارنى	ʃulɑrni
شۇم	ʃum
شۇنداق	kitʃik
شۇنداق	tʃoŋ
شۇنىسى	ʃunisi
شۇڭ	ʃuŋ
شۇڭا	ʃuʁɑ
شۇڭلاشقا	ʃuŋlaʃqɑ
شۈبھە	ʃybhɛ
شۈك	ʃyk
شۈكۈر	ʃykyr
شېكەر	ʃekɛr
شەربىتى	bilɛn
شەرت	ʃɛrt
شەرق	ʃɛrq
شەرمى	ʃɛrmi
شەكلىم	ʃɛklim
شەكىللەر	ʃɛkillɛr
شەنبە	ʃænbæ
شەنبە	ʃɛnbɛ
شەيتان	ʃɛjtɑn
شەپكە	ʃɛpkɛ
شەھەر	ʃɛhɛr
شەھەركەن	ʃɛhɛrkɛn
غ	ʁ
غ	ʁe
غازاڭدەك	ʁɑzɑʁdæk
غازى	ʁɑzi
غالىپ	ʁɑlip
غايىلا	ʁɑjilɑ
غايىپ	ʁɑjip
غايە	ʁɑjɛ
غايەت	ʁɑjɛt
غاپىل	ʁɑpil
غوجامنىڭ	tɛp
غىجەك	ʁidʒɛk
غۇربەت	ʁurbɛt
غۇرۇر	ʁurur
غۇلاچ	ʁulɑtʃ
غەددار	ʁɛddɑr
غەرپ	ʁɛrp
غەرەز	ʁɛrɛz
غەزەپ	ʁɛzɛp
غەلىبىسى	bilɛn
غەلىبە	ʁɛlibɛ
غەلىتە	bu
غەلۋىر	ʁɛlwir
غەم	jɛp
غەم	ʁɛm
غەمزە	ʁɛmzɛ
غەنى	ʁɛni
غەنىمەت	ʁɛnimɛt
غەيرەت	ʁɛjrɛt
غەيۋەت	ʁɛjwɛt
غەپلەت	ʁɛplɛt
غەۋغا	ʁɛwʁɑ
ف	f
ف	fe
فاشىست	fɑʃist
فرانسىيە	frɑnsijɛ
فوتو	fotɔ
فوتوگراف	fɔtɔgraf
فېۋرال	fewrɑl
ق	q
ق	qe
قائىدە	qɑʔidɛ
قابىلىيىتىڭ	bolup
قابىلىيەت	qɑbilijɛt
قات	qɑt
قاتارلىق	qɑtɑrlɪq
قاتارلىقلار	bɑr
قاتتىق	qɑttɤq
قاتقان	qɑtqɑn
قاتناش	qɑtmɑʃ
قاتىل	qɑtil
قاداق	qɑdɑq
قاداپ	qɑdɑp
قادىر	qɑdir
قار	qɑr
قار-مۇز	qɑrmuz
قارا	qɑrɑ
قارار	qɑrɑr
قارارگاھ	qɑrɑrgɑh
قاراش	qɑrɑʃ
قاراقاش	qɑrɑqaʃ
قاراقچى	qɑrɑqtʃi
قارايمىز	qɑrɑjmiz
قارايمەن	qɑrɑjmɛn
قاراپ	qɑrɑp
قاراچاي	tʃɑj
قاراڭ	qaraŋ
قارت	qɑrt
قارشى	qɑrʃi
قارشى	turuʃ
قارلار	qɑrlɑr
قارلىغاچ	qɑrliʁɑtʃ
قارلىق	qɑrlɪq
قارنىم	qɑrnim
قارى	qɑri
قارىسا	qɑrisɑ
قارىسام	qɑrisɑm
قارىشى	qɑrɨʃi
قارىغاي	ʃɑptul
قارىغايلار	sɑmɑ
قارىماي	qɑrimaj
قارىن	qɑrin
قازا	qɑzɑ
قازاغىستان	qɑzɑʁistɑn
قازاق	qɑzɑq
قازاقلار	qɑzɑqlɑr
قازى	qɑzi
قاساپ	qɑsɑp
قاسساپ	qɑssɑp
قاسقان	qɑsqɑn
قاسىم	qɑsim
قاسىمى	qɑsimi
قاش	qɑʃ
قاشا	qɑʃɑ
قاشلاپ	qaʃlɑp
قاغا	qɑʁɑ
قاق	qɑq
قاقاقلار	bir
قاقماي	qɑqmɑj
قال	qɑl
قالاتتى	qɑlɑtti
قالار	qɑlɑr
قالاي	qɑlɑj
قالاپ	qɑlɑp
قالتىس	qɑltis
قالدى	qɑldi
قالدىم	qɑltim
قالدۇردى	qɑldurdi
قالدۇرماي	qɑldurmɑj
قالدۇرۇپ	qɑldurup
قالسا	ʔɑmu
قالساڭ	qɑlsɑŋ
قالغان	qɑlʁɑn
قالقان	qɑlqɑn
قالما	qalmɑ
قالماي	qɑlmɑj
قالماڭلار	qɑlmɑŋlɑr
قالىدۇ	qɑlɯdu
قالىدۇ	tɛp
قالىسىز	qɑlisɪz
قالپاق	qɑlpɑq
قالۇن	qɑlun
قامال	qɑmɑl
قامچا	qɑmtʃɑ
قان	qɑn
قانائەت	qɑnɑʔɛt
قانات	qɑnɑt
قانال	qɑnɑl
قانجۇق	qɑndʒuq
قانچە	qɑntʃɛ
قانۇن	qɑnun
قايتاتتىم	qɑjtɑttim
قايتىپ	qɑjtɪp
قايتۇرۇپ	qɑjturup
قايسى	qɑjsi
قايغۇ	qɑjʁu
قايماق	qɑjmɑq
قاينار	qajnɑr
قايىل	qɑjil
قاپ	qɑp
قاپقارا	qɑpqɑrɑ
قاپقاق	qɑpqɑq
قاپقان	qɑpqɑn
قاپلان	qɑplɑn
قاپلاپ	qɑplɑp
قاچ	qɑtʃ
قاچا	qɑtʃɑ
قاچاق	qɑtʃɑq
قاچقان	qɑtʃqɑn
قاچىدۇ	qɑtʃidu
قاھىرە	qɑhirɛ
قوبۇل	qobul
قوتۇر	qotur
قورال	qoral
قورساق	pɑqɑ
قورقاق	qorqɑq
قورقىدۇ	qɔrqɪdu
قورقۇنچ	qorquntʃ
قورچاق	qɔrtʃɑq
قوزا	qozɑ
قوزغاپ	tɑpmɑj
قوزىقۇلاق	qoziqulɑq
قوزۇق	qozuq
قوساق	qosɑq
قوش	qoʃ
قوشاق	qoʃɑq
قوشاققا	qoʃɑqqɑ
قوشۇق	qoʃuq
قوشۇپ	qɔʃup
قوغۇن	qoʁun
قول	qɔl
قول	ʔyzyʃtur
قوللاش	qɔllɑʃ
قوللاپ	qɔllɑp
قولى	qolɨ
قولىدىكى	qolidiki
قومۇش	qomuʃ
قوناق	qonɑq
قونچ	qontʃ
قوي	sɛn
قويدى	qɔjdi
قوينى	qojni
قويۇق	qojuq
قويۇن	qojun
قويۇپ	qojup
قوپ	qop
قوپال	qopɑl
قوپۇرۇپ	qopurup
قوڭغۇز	qoŋʁuz
قوۋم	qowm
قوۋۇرغا	qowurʁɑ
قىر	qir
قىرغۇل	qirʁul
قىرو	qiro
قىرىق	qiriq
قىرىم	qirɨm
قىز	qɤz
قىزنى	qɨznɨ
قىزى	qizi
قىزىل	qizil
قىزىلغاز	qizilʁɑz
قىزىمىز	qizimiz
قىس	qis
قىساس	qisɑs
قىسقا	qisqɑ
قىسقاچ	qisqɑtʃ
قىسمى	qismi
قىسمەت	qismɛt
قىسمەتتىن	søz
قىسىر	qisir
قىسىپ	qɨsip
قىش	qiʃ
قىشلاق	qiʃlɑq
قىل	qil
قىلار	qɪlɑr
قىلالايدۇ	qilɑlɑjdu
قىلالماس	qɑrɑ
قىلاي	qilaj
قىلدىم	qildim
قىلدۇق	qɪlduq
قىلسا	qɪlsɑ
قىلساق	qɪlsɑq
قىلسام	qilsam
قىلسىڭىز	bu
قىلما	qɪlmɑ
قىلماق	qilmɑq
قىلماق	turmuʃtɑ
قىلماقتا	qilmɑqtɑ
قىلماي	qilmɑj
قىلمىش	qilmiʃ
قىلى	qili
قىلىدىغان	bolup
قىلىدىغان	pɛn
قىلىش	qilɪʃ
قىلىشىپ	qiliʃip
قىلىق	qiliq
قىلىپ	bir
قىلىپ	qɪlip
قىلىپ	ʔɑʃu
قىلىچ	qilitʃ
قىلىڭ	qilɪŋ
قىلۇر	qilur
قىمار	qimɑr
قىن	qin
قىيامەت	qijɑmɛt
قىياپەت	qijɑpɛt
قىيما	qijmɑ
قىچىق	qitʃiq
قۇببە	qubbɛ
قۇت	qut
قۇتلۇق	qutluq
قۇتۇلار	qutulɑr
قۇتۇلۇپ	qutulup
قۇتۇپ	qutup
قۇتۇپلۇق	qutupluq
قۇدرەت	qudrɛt
قۇدۇق	quduq
قۇرئان	qurʔɑn
قۇرغاق	qurʁɑq
قۇرغان	qurʁɑn
قۇزغۇن	quzʁun
قۇسۇر	qusur
قۇش	quʃ
قۇلاق	qulɑq
قۇلۇم	qulum
قۇلۇن	qulun
قۇم	qum
قۇمچاق	qumtʃɑq
قۇمۇل	qumul
قۇياشقا	kɑwɑp
قۇيرۇق	qujruq
قۇيۇپ	qujup
قۇچاق	qutʃɑq
قۇۋانچ	quwɑntʃ
قېتىم	qitim
قېرىنداش	qerimdɑʃ
قېلىپ	qelip
قېنى	qeni
قېيىق	qejiq
قېيىن	qejin
قەبرە	qɛbrɛ
قەتئى	qɛtʔi
قەترە	qɛtrɛ
قەدىم	qɛdim
قەدەھ	qɛdɛh
قەرزى	qɑrzi
قەرەللىك	qɛrɛllik
قەرەلى	joq
قەرەنفىل	qɛrɛnfil
قەستەن	qɛstɛn
قەسىدە	qɛsidɛ
قەسىر	qɛsir
قەغەز	qæʁæz
قەلئە	qɛlʔɛ
قەلەم	qælæm
قەلەي	qɛlɛj
قەمەر	qɛmɛr
قەندىل	qɛndil
قەيسەر	qɛjsɛr
قەپەز	qɛpɛz
قەھر	qɛhr
قەھرىۋا	qɛhriwɑ
قەۋرە	qɛwrɛ
ك	k
ك	ke
كائىنات	kɑʔinɑt
كابىل	kɑbil
كابىنېت	kɑbinet
كات	kɑt
كاتالوگ	kɑtɑlog
كاتالىزاتور	kɑtɑlizɑtor
كاتولىك	kɑtolik
كاتىپ	kɑtip
كاتېگورىيە	kɑtegorijɛ
كادمىي	kɑdmij
كارانتىن	kɑrɑntin
كاركىراپ	kɑrkɪrɑp
كارىدور	kɑridor
كارۋات	kɑrwɑt
كاسا	kɑsɑ
كاسات	kɑsɑt
كاستۇم	kɑstum
كاشكى	kɑʃki
كاكاۋۇ	kɑkɑwu
كالا	kɑlɑ
كالاڭ	kɑlɑŋ
كالتسىي	kɑltsij
كالتەك	kɑltɛk
كاللا	kɑllɑ
كاللام	kɑllɑm
كالىفورنىي	kɑlifornij
كالىي	kɑlij
كام	kɑm
كامار	kɑmɑr
كامال	kɑmɑl
كامال؛	kɑmɑl
كاپىر	kɑpir
كاپۇستا	kɑpustɑ
كاھىن	kɑhin
كاۋا	kɑwɑ
كاۋاك	kawak
كاۋاپ	kɑwɑp
كاۋكاز	kɑwkɑz
كاۋچۇك	kɑwtʃuk
كرىمنىي	krimnij
كرىپتون	kripton
كسېنون	ksenon
كوبالت	kobɑlt
كور	kor
كورلۇق	korluq
كوسا	kosɑ
كوفېيىن	kofejin
كوكائىن	kokɑʔin
كولخوز	kolχoz
كومپاس	kompɑs
كونترول	kontrol
كونسۇل	konsul
كونىلاردا	konilɑrdɑ
كويدا	kojda
كويزا	kojzɑ
كوچا	kotʃɑ
كى	ki
كىبىر	kibir
كىت	kit
كىتاب	kitɑp
كىر	kir
كىرا	kirɑ
كىرسە	kirse
كىرىپ	kirip
كىرىپتۇ	kirɪptu
كىرىچ	kiritʃ
كىرپىك	kirpik
كىرپىچ	kirpitʃ
كىرپە	kirpɛ
كىرگەنلەردىن	biri
كىرەر	kirɑr
كىسلاتاسى	bɑr
كىشنەمەك	kiʃnɛmɛk
كىشى	kiʃi
كىشىلەر	bilɛn
كىشىلەر	kiʃilɛr
كىلو	kilo
كىلومېتىر	kilometir
كىلوگىرام	kilogirɑm
كىلىمات	kilimɑt
كىلەر	kilɛr
كىم	u
كىمكىن	kimkin
كىنو	kino
كىيمەك	kijmɛk
كىيىك	kijik
كىيىۋالغىنىنى	ʔøz
كىپەك	kipɛk
كىچىك	kitʃik
كيۇرىي	kjurij
كۆت	køt
كۆتۈرۈشى	køtyryʃi
كۆر	kør
كۆردى	kørdi
كۆرسىتىپ	mɑhɑrɛt
كۆرسەت	kørsɛt
كۆرسەم	kørsɛm
كۆركەم	mɛnzirɛ
كۆرگىلى	kørgili
كۆرۈش	køryʃ
كۆرۈك	køryk
كۆرۈپ	køryp
كۆرۈپ	turup
كۆرە	gɛp
كۆرەي	kørɛj
كۆرەڭلەپ	ʔømɛrbaj
كۆز	jutup
كۆز	køz
كۆزلىرىمىز	køzlirimiz
كۆزلىرىمگە	køzlirimgɛ
كۆزلەرنى	køzlɛrni
كۆزىگە	u
كۆزگۈ	køzgy
كۆزۈم	bilɛn
كۆسەينى	køsɛjni
كۆك	køk
كۆكس	køks
كۆكسى	køksi
كۆكىدە	køkidɛ
كۆل	køl
كۆللەر	køllɛr
كۆلى	køli
كۆلىمى	kølimi
كۆمۈر	kømyr
كۆمەك	kømɛk
كۆن	køn
كۆندى	køndi
كۆي	køj
كۆيدۈرسە	ʔot
كۆينەك	køjnɛk
كۆيگەن	køjgɛn
كۆپ	jɛp
كۆپ	køp
كۆپرەك	køpræk
كۆپلەپ	køplɛp
كۆپۈك	køpyk
كۆپۈپ	køpip
كۆچ	køtʃ
كۆچكۈن	køtʃkyn
كۆچكەن	køtʃkɑn
كۆچمە	køtʃmɛ
كۆچمەك	køtʃmɛk
كۆچمەن	køtʃmɛn
كۆچۈشكە	køtʃiʃkɛ
كۆڭلى	køŋli
كۆڭۈل	køŋyl
كۇتۇپخانا	kutupχɑnɑ
كۇرسى	kursi
كۇپايە	kupɑjɛ
كۈتۈش	kytyʃ
كۈرەش	kyrɛʃ
كۈرەشنى	kyrɛʃni
كۈز	kyz
كۈل	kyl
كۈلپەت	kylpɛt
كۈلگە	kylgɛ
كۈلۈپتۇ	bɑj
كۈمۈش	kymyʃ
كۈن	kyn
كۈنجۈت	kyndʒyt
كۈندۈزى	kyndyzi
كۈنلەر	kynlɛr
كۈنگەي	kyngɛj
كۈنەس	kynɛs
كۈپ	kyp
كېتىمىز	ketimiz
كېتىپ	ketɪp
كېرەك	kirɑk
كېسىلى	kisɪli
كېسىپ	kesip
كېسەل	kesɛl
كېلىدۇ	kelɪdu
كېلىشى	keliʃɪ
كېلىن	kelin
كېلىپ	ʔot
كېلەر	kelɛr
كېمىرمەك	kemirmɛk
كېمىچى	kemitʃi
كېيىن	kejin
كېيىنچە	tʃoqum
كېپىل	kepil
كېپەن	kepɛn
كېچا	ketʃɑ
كېچە	ketʃɛ
كېچەر	ketʃɛr
كەت	kɛt
كەتتى	kɛttɪ
كەتتىم	tɛp
كەتسەم	kɛtsɛm
كەتكەن	kætkɛn
كەررە	kɛrrɛ
كەس	kɛs
كەسكىن	kɛskin
كەسىر	kɛsir
كەسىپ	kɛsɪp
كەسپى	kɛspi
كەشتە	keʃtɛ
كەشنىز	kɛʃniz
كەشپ	kɛʃp
كەكلىك	kɛklik
كەلدى	bu
كەلدى	kɛldi
كەلدىلا	bɑj
كەلدىم	kældim
كەلدىم	uni
كەلدىڭ	tɛp
كەلسۇن	kɛlsun
كەلسە	kelsɛ
كەلمىگەن	kɛlmɪgæn
كەلمەك	kʰæːmæk
كەلمەي	qɑldi
كەلمەيدۇ	kɛlmɛjtu
كەلمەي›	qɑldi
كەلگەندە	kælgændɛ
كەلگەي	kelgɛj
كەن	kɛn
كەنت	kɛnt
كەندىر	kɛndir
كەيپ	kɛjp
كەپتەر	kɛptɛr
كەپلا	kɛplɑ
كەچ	kɛtʃ
كەچۈرۈڭ	ketʃiriŋ
كەچۈرۈڭ	kɛtʃyryŋ
كەڭ	bolup
كەھرىبا	kɛhribɑ
كەۋسەر	kɛwsɛr
ل	l
ل	le
لاتا	lɑtɑ
لاتارىيە	lɑtɑrijɛ
لاتاپەت	lɑtɑpɛt
لازىم	lɑzim
لاك	lɑk
لال	lɑl
لامپا	lɑmpɑ
لانتان	lɑntɑn
لاي	lɑj
لايىھە	lɑjihɛ
لاپ	lɑp
لاچىن	lɑtʃin
لاڭتۇ	lɑŋtu
لاۋا	lɑwɑ
لاۋرېنتسىي	lɑwrentsij
لوقما	loqmɑ
لوم	lom
لوپ	lop
لوگارىفما	logɑrifmɑ
لىباس	libɑs
لىبېرال	liberɑl
لىتىي	litij
لىرىكا	lirika
لىفت	lift
لىللا	lillɑ
لىمون	limon
لىمونات	limonɑt
لىڭجەن	liŋdʒɛn
ليۇتېتسىي	ljutetsij
لۇغەت	luʁæt
لۈتۈپ	lytyp
لېزىز	leziz
لېكىن	lekin
لېۋەن	lewɛn
لەتىپە	lɛtipɛ
لەرزى	lɛrzi
لەززەت	lɛzzɛt
لەقەم	lɛqɛm
لەكلەك	lɛklɛk
لەنەت	lɛnɛt
لەيتەكس	lɛjtɛks
لەيلەپ	lɛjlɛp
لەپ	lɛp
لەڭمەن	læʁmɑn
لەڭگەر	lɛŋgɛr
لەگەن	lɛgɛn
لەھجە	lɛhdʒɛ
لەھزە	lɛhzɛ
لەھەت	lɛhɛt
لەۋ	lɛw
م	m
م	me
مائارىپ	mɑʔɑrip
مائاش	mɑʔɑʃ
مائاشنى	sɛl
مائاۋىن	mɑʔɑwin
ماتكا	mɑtkɑ
ماتور	mɑtor
ماتېماتىكا	mɑtemɑtikɑ
ماتەم	mɑtɛm
ماجال	mɑdʒɑl
ماختايدۇ	mɑxtɑjdu
ماددا	mɑddɑ
ماددىي	wɛ
مارافون	mɑrɑfon
ماراكەش	mɑrɑkɛʃ
مارال	mɑrɑl
مارت	mɑrt
مارجان	mɑrdʒɑn
مارشى	mɑrʃi
مارگانېتىس	mɑrgɑnetis
ماز	mɑz
مازار	mɑzɑr
مازاق	mɑzɑq
ماس	mas
ماشىنا	mɑʃinɑ
ماقال	mɑqɑl
ماقالا	mɑqɑlɑ
ماقالە	mɑqɑlɛ
ماقالەم	mɑqɑlɛm
ماقۇل	mɑqul
ماك	mɑk
مال	mɑl
مالال	mɑlɑl
ماللارنى	mɑllɑrni
مالى	mɑli
مالىيە	mɑlijɛ
مالچى	mɑltʃi
مالېكۇلا	mɑlekulɑ
مامكاپ	mamkap
مامونت	mɑmont
مانان	mɑnɑn
مانجىت	mɑndʒit
مانى	mɑni
مانىفېست	mɑnifest
مانچە	mɑntʃɛ
مانېۋىر	mɑnewir
ماي	mɑj
ماياك	mɑjɑk
مايمۇن	mɑjmun
مايمۇنچاق	mɑjmuntʃɑq
ماينى	mɑjni
ماڭ	maŋ
ماڭا	bɑlɑ
ماڭا	mɑŋa
ماڭساڭ	mɑŋsɑŋ
ماڭمامدۇ	mɑŋmɑmdu
ماڭماي	mɑŋmaj
ماگنىت	mɑgnit
ماگنىي	mɑgnij
ماگىستىر	magistir
ماھارەت	mɑhɑrɛt
ماھىيەت	mɑhijɛt
ماۋزۇ	mɑwzu
ماۋزۇر	mɑwzur
مو	mo
مودېل	model
مورفىن	morfin
مول	mol
موللا	mɔllɑ
موللاق	mollɑq
موللام	mɔllɑm
مولىبدېن	molibden
مولېكۇلا	molekula
موم	mom
موما	moma
موماي	momɑj
مومايمۇ	mɔmɑjmu
موماڭ	momaŋ
مومدىن	momdin
مونچاق	montʃɑq
مونەك	monek
موڭغۇلىيە	moŋʁulijɛ
مىخ	miχ
مىراس	mirɑs
مىرزا	mirzɑ
مىزان	mizɑn
مىس	mis
مىسال	misɑl
مىساللار	misɑllɑr
مىسالى	misɑli
مىسرا	misrɑ
مىسكىن	miskin
مىسىر	misir
مىسۋاك	miswɑk
مىقدار	miqdɑr
مىكرو	mikro
مىكروسكوپ	mikroskop
مىكروفون	mikrofon
مىكروپ	mikrop
مىكى	miki
مىل	mil
مىللەت	millɛt
مىلى	mili
مىليارد	miljɑrt
مىليون	miljon
مىلەپ	mɪlɑp
مىنا	minɑ
مىننەت	minnɛt
مىننەتدار	minnɛtdɑr
مىنىستىر	ministir
مىنگۇو	minguo
مىنگەن	mingɛn
مىنۇت	minut
مىنۇتتىن	minuttin
مىنۇس	minus
مىنېرال	minerɑl
مىڭ	miŋ
مۆجىزە	mødʒizɛ
مۆمىن	mømin
مۆڭ	møŋ
مۆھرى	møhri
مۆھۈر	møhyr
مۇئاش	muʔɑʃ
مۇئاھىدە	muʔɑhidɛ
مۇئەززەم	muʔɛzzɛm
مۇئەسسەسە	muʔɛssɛsɛ
مۇئەللىم	muʔɛllim
مۇئەمما	muʔɛmmɑ
مۇئەييەن	muʔɛjjɛn
مۇبارەك	mubɑrɛk
مۇبالىغە	mubɑliʁɛ
مۇت	mut
مۇتلەق	mutlɛq
مۇتەئەسسىپ	mutɛʔɛssip
مۇتەخەسسىس	mutɛχɛssis
مۇخالىپ	muχɑlip
مۇخبىر	muχbir
مۇختار	muχtɑr
مۇداپىە	mudɑpiɛ
مۇددەت	muddɛt
مۇدھىش	mudhiʃ
مۇراسىم	murɑsim
مۇرەككەپ	murɛkkɛp
مۇز	muz
مۇزاكىرە	muzɑkirɛ
مۇزلار	muzlar
مۇزېي	muzej
مۇسا	musɑ
مۇسابىقىسى	bigyn
مۇسابىقە	musɑbiqɛ
مۇساپىر	musɑpir
مۇسبەت	musbɛt
مۇستەسنا	mustɛsnɑ
مۇستەقىل	mustɛqil
مۇستەملىكە	mustɛmlikɛ
مۇستەھكەم	mustɛhkɛm
مۇسكۇل	muskul
مۇسىبەت	musibɛt
مۇسۇلمان	musulmɑn
مۇش	muʃ
مۇشت	muʃt
مۇشتى	muʃtɪ
مۇشتىنى	muʃtini
مۇشتۇمدەك	turup
مۇشۇ	muʃu
مۇشۇمۇ	kyn
مۇشۇنداق	muʃundɑq
مۇشەققەت	muʃɛqqɛt
مۇغەمبەر	køp
مۇقامى	muqɑmi
مۇقىم	muqim
مۇقەددەس	muqɛddɛs
مۇقەررەر	muqɛrrɛr
مۇكاپات	mukɑpɑt
مۇكەممەل	mukɛmmɛl
مۇلايىم	mulɑjim
مۇنازىرە	munɑzirɛ
مۇناسىپ	munɑsip
مۇناسىۋەت	munɑsiwɛt
مۇنبەر	munbɛr
مۇنتىزىم	muntizim
مۇنچا	muntʃa
مۇنۇلارنى	munularni
مۇنەججىم	munɛdʒdʒim
مۇيەسسەر	mujɛssɛr
مۇپتىلا	muptilɑ
مۇڭلۇق	muŋluq
مۇھاسىرە	muhɑsirɛ
مۇھتاج	muhtɑdʒ
مۇھتەرەم	muhtɛrɛm
مۇھىت	muhit
مۇھىم	muhim
مۇھىمى	muhimi
مۇھەببەت	muhɛbbɛt
مۇۋازىنەت	muwɑzinɛt
مۇۋاپىق	jol
مۇۋاپىق	muwɑpiq
مۇۋەققەت	muwɛqqɛt
مۇۋەپپەق	muwɛppɛq
مۇۋەپپەقىيەت	muwɛppɛqijɛt
مۈشكۈل	myʃkyl
مۈشۈك	myʃyk̚
مۈشۈك	ʔystidɛ
مۈلۈك	mylyk
مۈمكىن	mymkin
مېتان	metɑn
مېترو	metro
مېتود	metod
مېتىر	metir
مېدال	medɑl
مېردىيان	merdijɑn
مېركۇرى	merkuri
مېندېلېيېۋىي	mendelejewij
مېنى	meni
مېنىنگىت	meningit
مېنىڭ	meniŋ
مېنىڭ	sɨz
مېنىڭچە	meniŋtʃɛ
مېڭىپ	bɑqqɑn
مېھراپ	mehrɑp
مېھرى	mehri
مېھمان	mehmɑn
مېھنەت	mehnɛt
مېۋىگە	tojup
مېۋە	mewɛ
مەبلەغ	mɛblɛʁ
مەتبە	mɛtbɛ
مەجبۇر	mɛdʒbur
مەجلىس	mɛdʒlis
مەجنۇن	mɛdʒnun
مەجھۇل	mɛdʒhul
مەخلۇق	mɛχluq
مەدەت	mɛdɛt
مەدەن	mɛdɛn
مەدەنىي	mɛdɛnij
مەرت	mɛrt
مەرتىۋىگە	qɑrɑp
مەرتىۋە	mɛrtiwɛ
مەرد	mært
مەردنىڭ	ʔiʃi
مەركەز	mɛrkɛz
مەرمەر	mɛrmɛr
مەرھۇم	mɛrhum
مەرھەمەت	mɛrhɛmɛt
مەزلۇم	mɛzlum
مەزگىل	mɛzgɪl
مەزگىللىرىدە	bu
مەزگىلى	mɛzgili
مەزھەپ	mɛzhɛp
مەسئۇل	mɛsʔul
مەسئۇلىيىتى	hɛm
مەستلىك	mæstlik
مەسخىرە	mɛsχirɛ
مەسلىھەت	mɛslihɛt
مەسلەك	mɛslɛk
مەسىلەن	mɛsilɛn
مەسۇم	mɛsum
مەشغۇل	mɛʃʁul
مەشھۇر	bir
مەشھۇر	bɑr
مەشھۇر	mɛʃhur
مەغرۇر	mɛʁrur
مەغلۇپ	mɛʁlup
مەقئەت	mɛqʔɛt
مەقبۇل	mɛqbul
مەقسەت	mɛqsɛt
مەقسەتتە	bir
مەكتىپى	mɛktipi
مەكتۇپ	mɛktup
مەكتەپ	mɛktɛp
مەكتەپلەر	mextɛplɛr
مەلىكە	mælikɑ
مەلۇم	mɛlum
مەمنۇن	mɛmnun
مەمۇر	mɛmur
مەمۇرىي	mæmurij
مەن	berɪp
مەن	bigyn
مەن	bir
مەن	jirɑq
مەن	kitɑp
مەن	mæn
مەن	ʔøz
مەنتىق	mɛntiq
مەنزىرە	mɛnzirɛ
مەنزىل	mɛnzil
مەنزىلگە	mɛnzilgɛ
مەنسۇر	mænsur
مەنسۇپ	mɛnsup
مەنلا	tɑrtɑj
مەنمۇ	køp
مەنمۇ	mænmu
مەنىگە	mɛnigɛ
مەنپىي	mɛnpij
مەنپەئەت	mɛnpɛʔɛt
مەنچە	mɛntʃɛ
مەي	mɛj
مەيدان	mɛjdɑn
مەيداندا	mɛjdɑndɑ
مەينەت	mɛjnɛt
مەيىل	mɛjil
مەيۈس	mɛjys
مەڭزىگە	mɛŋzigɛ
مەھبۇس	mɛhbus
مەھرۇم	mɛhrum
مەھسۇل	mɛhsul
مەھكىمە	mɛhkimɛ
مەھكۇم	mɛhkum
مەھەممەت	mæmæt̚
مەھەممەت	mɛmɛt̚
مەۋسۈم	mɛwsym
مەۋھۈم	mɛwhym
ن	n
ن	ne
نائىل	nɑʔil
نائىلاج	nɑʔilɑdʒ
نائىنساپ	nɑʔinsɑp
نائىپ	nɑʔip
نائۇستا	nɑʔustɑ
نائۈمىت	nɑʔymit
ناترىي	nɑtrij
ناتسىست	nɑtsist
ناتوغرا	nɑtoʁrɑ
ناخشا	nɑxʃɑ
ناخشام	nɑxʃɑm
نادامەت	nɑdɑmɛt
نادان	nɑdɑn
نادىر	nɑdir
ناز	nɑz
نازارەت	nɑzɑrɛt
نازاكەت	nɑzɑkɛt
نازىم	nɑzim
نالايىق	nɑlɑjiq
نام	nɑm
ناماز	nɑmɑz
ناماقۇل	nɑmɑqul
نامايان	nɑmɑjɑn
نامايىش	nɑmɑjiʃ
نامزات	nɑmzɑt
نامۇس	nɑmus
نامە	nɑmɛ
نامەرت	nɑmɛrt
نامەلۇم	nɑmɛlum
نان	nɑn
نانكور	nɑnkor
ناپاك	nɑpɑk
ناچار	nɑtʃɑr
ناھىيە	nɑhijɛ
ناۋايمۇ	nɑwɑjmu
نوبېلىي	nobelij
نورمال	normɑl
نوغاي	noʁɑj
نوم	nom
نومۇر	nomur
نومۇس	nomus
نويابر	nojɑbr
نوپۇز	nopuz
نوپۇس	nopus
نى	ni
نىجات	nidʒɑt
نىجىس	nidʒis
نىداسى	nidɑsi
نىزام	nizɑm
نىسبەت	nisbɛt
نىسپىي	nispij
نىشان	niʃɑn
نىكا	nikɑ
نىكېل	nikel
نىل	nil
نىلۇپەر	nilupɛr
نىمەتۇ	bilɛn
نىوبىي	niobij
نىيەت	bir
نىيەت	nijɛt
نىگار	nigɑr
نۆشۈدۈر	nøʃydyr
نۆل	nøl
نۆل	nœl
نۆلدىن	nøldɪn
نۆلىنچى	nølintʃi
نۆلىنچى	nœlintʃi
نۆۋەت	nøwɛt
نۇتۇق	nutuq
نۇر	nur
نۇرانى	nurɑni
نۇرلار	nurlar
نۇسخە	nusχɛ
نۇسرەت	nusrɛt
نۇقسان	nuqsɑn
نېرى	bolup
نېرى	tur
نېرۋا	nerwɑ
نېسىپ	nesip
نېفىت	nefit
نېمىسى	bɑr
نېمىشقا	nemiʃqɑ
نېمىشقا	qoʁun
نېمىنى	nemini
نېمە	køz
نېمە	nemɛ
نېنىنى	nenini
نېودىم	neodim
نېون	neon
نېيترون	nejtron
نېپال	nepal
نېپتۇنىي	neptunij
نە	nɛ
نەبى	nɛbi
نەتىجە	nɛtidʒɛ
نەرسىنىڭ	nɛrsiniŋ
نەرسىگە	nɛrsigɛ
نەرە	nɛrɛ
نەزەر	nɛzɛr
نەزەرىدە	bɑj
نەس	nɛs
نەسىر	nɛsir
نەسىل	nɛsil
نەسىھەت	nɛsihɛt
نەشتەر	nɛʃtɛr
نەشر	nɛʃr
نەشپۈت	tʃilan
نەغمە	nɛʁmɛ
نەق	mɛjdɑn
نەق	nɛq
نەقلىيات	nɛqlijɑt
نەقىش	nɛqiʃ
نەقىل	nɛqil
نەم	nɛm
نەمۇنە	nɛmunɛ
نەي	nɛj
نەپ	nɛp
نەپرىتىگە	u
نەپرەت	nɛprɛt
نەپرەتتىن	nɛprɛttɪn
نەپرەتنى	qɪlip
نەپس	nɛps
نەپىس	nɛpis
نەپەس	nɛpɛs
نەپەستە	nɛpɛstɛ
نەپەقە	nɛpɛqɛ
نەگە	nɛgɛ
نەۋ	nɛw
ى	i
ى	ɪ
ى	ɯ
ي	j
ي	je
يا	jɑ
يات	jɑt
ياتىدۇ	jɑtidu
ياخشى	jɑχʃi
ياخشى	sɑp
ياخشىمۇ	jɑxʃimu
ياخشىمۇسىز	jɑχʃimusiz
ياخشىمۇسىلەر	jakʰʃimusilær
ياخشىمۇسىلەر	jakʰʃimusilɛr
ياخشىمۇسىلەر	jɑxʃimusilær
ياخشىمۇسىلەر	jɑxʃimusilɛr
ياد	jɑd
يادلاش	jɑdlɑʃ
يادلاپ	jɑdlɑp
يادىكار	jɑdikɑr
يار	jɑr
يارا	jɑrɑ
يارار	jɑrɑr
ياراپ	jɑrɑp
يارماقنىڭ	jɑrmɑqnɨŋ
يارىسى	jɑrɪsɪ
يارىشا	jɑriʃɑ
يارىشىپ	jɑrɪʃip
يارىم	jɑrɨm
يارەنلەر	jɑrɑnlɛr
ياز	jɑz
يازاي	jɑzɑj
يازايلى	jɑzɑjli
يازدا	jɑzdɑ
يازدەكلا	jɑzdɛklɑ
يازغۇچى	jɑzʁutʃi
يازلىق	jɑzlɪq
يازما	jɑzmɑ
يازمام	jɑzmɑm
يازماي	jɑzmɑj
يازمايدۇ	jɑzmɑjdu
يازمىلار	jazmilɑr
يازنى	jɑznɨ
ياساش	jɑsɑʃ
ياساپ	jɑsɑp
ياستۇق	jɑstuq
ياسىدى	jɑsɪdi
ياسىن	jɑsin
ياش	jɑʃ
ياشا	jaʃa
ياشاش	jɑʃɑʃ
ياشام	jaʃɑm
ياشايلى	jɑʃajli
ياشاپ	jɑʃɑp
ياشتا	jɑʃtɑ
ياشتىن	jɑʃtɪn
ياشلىق	jaʃlɪq
ياشمۇ	jaʃmu
ياشىساق	jɑʃisɑq
ياغ	jɑʁ
ياغاچ	jɑʁɑtʃ
ياق	jɑq
ياق	mæn
ياق	sɛn
ياقا	jɑqɑ
ياقماق	jɑqmɑq
ياقىدىكى	bir
ياقۇت	jɑqut
ياكور	jɑkor
يالاش	jɑlaʃ
يالاپ	jɑlɑp
يالاڭ	jɑlɑŋ
يالاڭئاياق	jɑlɑŋʔɑjɑq
يالغان	jɑlʁɑn
يالغۇز	jɑlʁuz
يالقۇن	jɑlqun
ياللاپ	jɑllɑp
يالمان	jɑlmɑn
يالپۇز	jɑlpuz
يالپۇزلار	jɑlpuzlɑr
يالۋۇرماق	jɑlwurmɑq
ياماق	jɑmɑq
يامان	jɑmɑn
ياماننى	jɑmɑnni
يامغۇر	jɑmʁur
يامىنى	jɑmini
يان	jɑn
يانار	jɑnɑr
ياناردا	jɑnɑrdɑ
ياندى	jandi
يانغىن	jɑnʁin
يانفون	jɑŋpon
يانماق	jɑnmɑq
يانچۇققا	tʃɑj
يانۋار	jɑnwɑr
يايار	jɑjɑr
يايراپ	jɑjrap
يايلاق	jɑjlɑq
يايلاقتا	jɑjlɑqtɑ
يايلاققا	jɑjlɑqqɑ
يايىلار	jɑjilɑr
ياپتى	jɑpti
ياپونىيە	jɑponijɛ
ياڭاق	jɑŋɑq
ياڭيۇ	jɑŋju
ياگاو	jɑgɑo
ياۋاش	jɑwɑʃ
ياۋروپا	jɑwropɑ
ياۋلارنى	jɑvlɑrni
ياۋۇز	jɑwuz
يوتقان	jotqɑn
يود	jod
يورۇقلۇق	joruqluq
يوشۇرۇن	joʃurun
يوغان	joʁɑn
يوق	joq
يوق	ulɑr
يوقال	joqɑl
يوقاپ	joqɑp
يوقلار	joqlɑr
يوقلاپ	joqlap
يول	jol
يولدا	joldɑ
يولداش	joldɑʃ
يولسىز	jolsiz
يوللاپ	jollɑp
يولىدا	jolɪdɑ
يولىنى	jolɨni
يولۋاس	jolwɑs
يوپىتېر	jopiter
يوپۇرماق	jopurmɑq
يىتىم	jitim
يىراق	jirɑq
يىراقلىق	jirɑqliq
يىرتماق	jirtmɑq
يىرىڭ	jiriŋ
يىغار	bɑlɑ
يىغلاپ	turuptu
يىل	jil
يىلان	jilɑn
يىلدا	jilda
يىللار	jillɑr
يىللىق	jillɪq
يىللىق	sɑmɑn
يىلى	jili
يىلىك	jilik
يىپ	jip
يىپتا	jiptɑ
يىپەك	jipɛk
يىڭنە	jiŋnɛ
يىگىت	jigit
يىگىتكە	mɑqul
يىگىرمە	jigirmæ
يىگىرمە	jigirmɛ
يۆتەل	jøtɛl
يۇتقۇنچاق	jutquntʃɑq
يۇتماق	jutmɑq
يۇتۇپ	jutup
يۇرت	jurt
يۇغۇرماق	juʁurmɑq
يۇققا	juqqɑ
يۇقۇرى	juquri
يۇلتۇز	jultuz
يۇلماق	julmɑq
يۇلۇپ	julup
يۇم	jum
يۇماق	jumɑq
يۇمشاق	jumʃɑq
يۇمماق	jummɑq
يۇمۇق	jumuq
يۇمۇلۇپ	jumulup
يۇمۇپ	jumup
يۇيۇپلا	jujuplɑ
يۇپقا	jupqɑ
يۇڭ	juŋ
يۇۋاش	juwɑʃ
يۈتمەك	jytmɛk
يۈردى	jyrdi
يۈرۈش	jyryʃ
يۈرۈپ	jyryp
يۈرە	jyrɛ
يۈرەك	jyrɛk
يۈرەكلىك	jyrɛklik
يۈز	jyz
يۈزىدە	jyzidɛ
يۈسۈپ	jysyp
يۈك	jyk
يۈكسىلىپ	jyksilɨp
يۈكسەك	hɛ
يۈكىنى	jykini
يۈگەن	jygɛn
يېتەرسىز	jetɛrsiz
يېتەرلىك	jetɛrlik
يېزىپ	jezip
يېسە	jisɑ
يېسەم	jisɛm
يېسەڭ	jesɛŋ
يېشى	jeʃi
يېشىل	jeʃil
يېشەر	jeʃɛr
يېقىلغۇ	jeqilʁu
يېمىگەننى	jimigɛnni
يېمە	jimɛ
يېنىك	jenik
يېپىشقاق	jepiʃqɑq
يېپىشماق	jepiʃmɑq
يېڭىلىش	bolup
يېڭىلىق	jeŋiliq
يېگەن	jigɛn
يېۋروپىي	jewropij
يەتتى	jɛtti
يەتتىنچى	jɛttintʃi
يەتتە	jættæ
يەتتە	jæt̚tæ
يەتتە	jɛttɛ
يەتتە	jɛt̚tɛ
يەتكۈزۈپ	sɨz
يەتمىش	jɛtmiʃ
يەتمەيدۇ	jɛtmɛjdu
يەر	jɛr
يەر-جاھان	jɛrdʒɑhɑn
يەردىكى	jɛrdikɨ
يەردىلا	jɛrdɪlɑ
يەردە	gɛp
يەردە	jɛrdɛ
يەردە	turup
يەرلىك	jɛrlik
يەرلەر	jɑrlɑr
يەرمۇ	jɛrmu
يەريۈزى	jɛrjyzi
يەرگە	jɛrgɑ
يەكشەنبە	jækʃæmbæ
يەكشەنبە	jæxʃæmbæ
يەكشەنبە	jɛkʃɛmbɛ
يەكشەنبە	jɛxʃɛmbɛ
يەكۈن	jɛkyn
يەل	jɛl
يەلدىن	jɛldin
يەلكەن	jɛlkɛn
يەللىك	jɛllik
يەلپۈنگەن	jɛlpyngɛn
يەم	jɛm
يەمدۇ	jɛmdu
يەمگە	jɛmgɛ
يەنى	jɛni
يەنىلا	jɛnilɑ
يەنە	bir
يەنە	jænɛ
يەنە	tɑjɑq
يەي	jej
يەيدىكەن	jɛjdikɛn
يەيدۇ	jɑmɑn
يەيمەن	jɛjmɛn
يەپ	jɛp
يەپتۇ	jɛptu
يەپلا	jɛplɑ
يەڭ	jɛŋ
يەڭگىل	jɛŋgil
يەھيا	jɛhjɑ
يەھۇدى	jɛhudi
پ	p
پ	pe
پات	pat
پار	pɑr
پاراخوت	pɑrɑχot
پارازىت	pɑrɑzit
پاراسەت	bilɛn
پاراشوت	pɑrɑʃot
پاراشوك	pɑrɑʃok
پاراكەندە	pɑrɑkɛndɛ
پاراڭ	pɑrɑŋ
پاراڭلار	parɑŋlɑr
پاراگىراپ	pɑrɑgirɑp
پاراۋوز	pɑrɑwoz
پارلاق	pɑrlɑq
پاسپورت	pɑsport
پاش	pɑʃ
پاشا	pɑʃɑ
پاششاپ	pɑʃʃɑp
پاقا	pɑqɑ
پاك	pɑk
پاكىت	pɑkit
پال	pɑl
پال-پال	pɑlpɑl
پالاتا	pɑlɑtɑ
پالاق	pɑlɑq
پالاقلاپ	pɑlɑqlɑp
پالاقنى	pɑlɑqni
پاناھ	pɑnɑh
پايتەخت	pɑjtɛχt
پايدا	pɑjdɑ
پايلار	pɑjlɑr
پاڭ	pɑŋ
پاڭمۇ	pɑŋmu
پاھ	pɑh
پاھىشە	pɑhiʃɛ
پروفېسسور	propessor
پوستى	posti
پوق	poq
پولات	polɑt
پولشا	polʃɑ
پويىز	pojiz
پوپ	pop
پىت	pit
پىرى	piri
پىش	piʃ
پىشاڭ	piʃɑŋ
پىشلاق	piʃlɑq
پىشماسمىش	piʃmasmiʃ
پىكاپ	pikap
پىكىرنى	pikirni
پىلدەك	pildɛk
پىلىك	pilik
پىلە	pilɛ
پىيادە	pijɑdɛ
پىچاق	pitʃɑq
پىچان	pitʃɑn
پۇت	put
پۇتاق	putɑq
پۇرسەت	pursɛt
پۇرچاق	purtʃɑq
پۇشايمان	puʃɑjmɑn
پۇقرا	puqrɑ
پۇقرالار	puqrɑlɑr
پۇل	gɛp
پۇل	pul
پۇلى	puli
پۈتكۈل	pytkyl
پۈتۈپ	pytyp
پېتىپ	petip
پېرۇ	peru
پېقىر	peqir
پەردە	pɛrdɛ
پەرمان	pɑrmɑn
پەرمۇدە	pɛrmudɛ
پەرۋانە	pɛrwɑnɛ
پەرەز	pɛrɛz
پەزىلەتنى	pɛzilɛtni
پەس	pɛs
پەستە	pɛstɛ
پەسىل	pɛsil
پەش	pɛʃ
پەلتو	pɛlto
پەلسەپە	pɛlsɛpɛ
پەن	pɛn
پەنجاب	pɛndʒɑb
پەند	pɛnd
پەيتى	pɛjtɪ
پەيدا	pejtɑ
پەيشەنبە	pæjʃænbæ
پەيشەنبە	pɛjʃɛnbɛ
پەيغەمبەر	pɛjʁɛmbɛr
چ	tʃ
چ	tʃe
چاتاق	tʃatɑq
چاتما	tʃɑtmɑ
چار	tʃɑr
چارشەنبە	tʃarʃænbæ
چارشەنبە	tʃarʃɛnbɛ
چارشەنبە	tʃɑrʃænbæ
چارشەنبە	tʃɑrʃɛnbɛ
چارچاپ	tʃɑrtʃɑp
چارچاپلا	tʃɑrtʃapla
چارۋىچىلىق	ʔɑsɑs
چارە	tʃɑrɛ
چارەك	tʃɑrɛk
چاشكا	tʃɑʃkɑ
چاغ	tʃaʁ
چاغدا	tʃɑʁdɑ
چاق	tʃɑq
چاقاي	tʃɑqɑj
چاقماقلار	tʃɑqmɑqlɑr
چاقچاق	tʃɑqtʃɑq
چالار	tʃɑlɑr
چالالايدۇ	tʃɑlɑlɑjdu
چالسام	tʃɑlsɑm
چالغۇلار	tʃalʁulɑr
چانا	tʃana
چاي	tʃɑj
چايان	tʃɑjɑn
چايقا	tʃajqɑ
چايقاپ	tʃɑjqɑp
چايناپ	tʃɑjnɑp
چاپ	tʃap
چاپتىم	tʃɑptɪm
چاپسام	tʃɑpsɑm
چاپقان	tʃɑpqɑn
چاپلىما	tʃɑplɨmɑ
چاچ	tʃɑtʃ
چاڭگا	tʃɑŋgɑ
چوشقا	tʃoʃqɑ
چوقۇلاپ	tʃoqulɑp
چوقۇم	tʃoqum
چوكا	tʃokɑ
چولاق	tʃolɑq
چولپان	tʃolpɑn
چوڭ	tʃoŋ
چوڭقۇر	tʃɔŋqur
چوڭلار	tʃoŋlɑr
چوڭلارمۇ	tʃoŋlɑrmu
چى	tʃi
چىداپ	tʃidap
چىراق	tʃirɑq
چىراي	tʃirɑj
چىرايلىق	bu
چىرايلىق	qɑr
چىرايلىقمەن	tʃirɑjlɪqmæn
چىش	tʃiʃ
چىشلىشەر	tʃiʃliʃɛr
چىقار	tʃiqɑr
چىقالمايدۇ	tʃiqɑlmɑjdu
چىقاي	tʃiqɑj
چىقتى	tʃiqtɪ
چىقساڭ	bolup
چىققان	bilɛn
چىققان	bir
چىقىدۇ	sɨz
چىقىدۇ	tʃɪqɪdu
چىقىرىپ	jɑʃɑʃ
چىقىرىپ	tʃiqirip
چىقىش	tʃiqɨʃ
چىقىم	tʃiqim
چىقىپ	qɑldi
چىقىپ	tʃiqɪp
چىقىپ	uni
چىكەتكە	tʃikɛtkɛ
چىلان	tʃilan
چىمەن	tʃimɛn
چىپ	tʃip
چىڭ	tʃiŋ
چىۋىن	tʃiwin
چۆرگىلەپ	tʃørgilɛp
چۆكمەكتە	tʃøkmɛktɛ
چۆل	tʃøl
چۆللۈكتىن	kældim
چۆلگە	tʃølgɛ
چۆمدى	tʃømdi
چۆمەتتى	tʃømɛttɪ
چۆپلەر	tʃøplɛr
چۆچەك	tʃøtʃɛk
چۆگۈن	tʃøgyn
چۇقان	tʃuqɑm
چۇلۋۇرىنى	sɛn
چۈش	tʃyʃ
چۈشۈرۈپ	tʃyʃyryp
چۈشۈپ	qɑlʁɑn
چۈشۈپ	tʃiʃyp
چۈشەر	tʃiʃɛr
چۈشەنمەي	turup
چېتىپ	tʃetip
چېتىگە	tʃetigɛ
چېركاۋ	tʃerkɑw
چېكى	tʃiki
چېلىپ	tʃelip
چېلەك	tʃelɛk
چېيى	tʃeji
چېچىلىپ	tʃetʃilip
چېچىم	tʃetʃim
چېچىپ	tʃetʃip
چېچەك	tʃetʃæk̚
چېچەك	tʃetʃɛk̚
چېچەكنى	jɑzdɑ
چەت	tʃɑt
چەتتە	tʃɛttɛ
چەش	tʃɛʃ
چەكتىم	tʃɛktɪm
چەكسىز	tʃæksiz
چەكلەش	tʃɑklɛʃ
چەكمەي	tʃɛkmɛj
چەمبەرگە	tʃæmbɛrgɛ
ژ	ʒ
ژ	ʒe
ژارگون	ʒɑrgon
ژاندارما	ʒɑndɑrmɑ
ژانىر	ʒɑnir
ژۇرنال	ʒurnɑl
ژېڭۋېي	ʒeŋwej
ڭ	ŋ
ڭ	ŋe
گ	g
گ	ge
گاباردىن	gɑbɑrdin
گادولىنىي	gɑdolinij
گاز	gɑz
گازنىڭ	gaznɪŋ
گازى	gɑzi
گاس	gɑs
گافنىي	gɑfnij
گال	gɑl
گاللىي	gɑllij
گاڭبى	gɑŋbi
گاڭپەن	gɑŋpɛn
گاھ	gɑh
گرېتسىيە	gretsijɛ
گول	gol
گوللاندىيە	gollɑndijɛ
گولمىي	golmij
گويا	gojɑ
گىتار	gitɑr
گىرانات	girɑnɑt
گىرانىت	girɑnit
گىرداپ	girdɑp
گىرىپ	girip
گىلاس	gilas
گىلەم	gilɛm
گىلەمدە	gɪlɛmdɛ
گىياھ	gijɑh
گىياھلار	ʔɑdʒɑjip
گۆرگە	gørgɛ
گۆش	gøʃ
گۆشكە	gøʃkɛ
گۆشلەر	gøʃlɛr
گۆشنى	gøʃni
گۆشنىڭ	bir
گۆشى	gøʃi
گۆھەر	bilɛn
گۆھەر	gøhɛr
گۆھەرگە	gøhɛrgɛ
گۇنا	gunɑ
گۇناھ	gunɑh
گۇگۇم	gugum
گۈرۈچ	gyrytʃ
گۈزەل	gyzɛl
گۈشە	gyʃɛ
گۈل	gyl
گۈلباغ	gylbɑʁ
گۈلباھار	gylbɑhɑr
گۈلخانا	gylχɑnɑ
گۈللەر	gyllær
گۈللەر	gyllæː
گۈللەر	gyllɛr
گۈلىستان	gylistɑn
گۈڭگۈرت	gyŋgyrt
گېرمانىي	germɑnij
گېزىت	gezit
گېزىتى	gezɨti
گېكتار	gektɑr
گېلىي	gelij
گېپى	gepi
گەدەن	gɛdɛn
گەر	gɛr
گەز	gɛz
گەپ	gɛp
گەپتۇ	gɛptu
گەپلىرى	gɛpliri
گەپلەر	gɛplɛr
گەپلەرگە	gɛplɛrgɛ
گەپمۇ	gɛpmu
گەپنى	gɛpni
ھ	h
ھ	he
ھارارەت	hɑrɑrɛt
ھاراق	haraq
ھارام	hɑrɑm
ھارۋا	ɦɑrwa
ھازا	hɑzɑ
ھازىر	ɦɑzɪr
ھازىرقى	ɦɑzɪrqɨ
ھاسا	hasa
ھاشىمنى	haʃimni
ھال	hɑl
ھالا	hɑlɑ
ھالال	hɑlɑl
ھالدا	hɑldɑ
ھالقىما	hɑlqɪmɑ
ھالى	hɑli
ھالىمىزمۇ	joq
ھالۋا	hɑlwɑ
ھايا	hɑjɑ
ھايات	hɑjɑt
ھاياتنىڭ	hɑjɑtniŋ
ھاياتى	hɑjɑti
ھاياتىم	ɦɑjɑtim
ھايال	ɦɑjɑl
ھاۋا	hɑwɑ
ھاۋادا	hɑwɑdɑ
ھاۋز	hɑwz
ھويلا	hojlɑ
ھىجران	hidʒran
ھىكايە	hikɑjɛ
ھىلال	hilɑl
ھىم	him
ھۆر	hør
ھۆرمەت	hørmɛt
ھۆكۈم	høkym
ھۆل	høl
ھۇجۇم	hudʒum
ھۇزۇر	huzur
ھۇي	huj
ھېس	his
ھېساب	hisɑp
ھېسسىيات	bɛdɛn
ھېكايە	hikɑjæ
ھېكمەتلەركەن	hikmɛtlɛrkɛn
ھېكىم	hikim
ھېلى	hili
ھېلىقى	bɑlɑ
ھە	hɛ
ھەئە	hɛʔɛ
ھەتتا	hɛttɑ
ھەجىم	hɛdʒim
ھەدىيە	hɛdijɛ
ھەدە	hɛdɛ
ھەر	hær
ھەر	hɑldɑ
ھەرگىز	hærgɪz
ھەرگىز	jol
ھەرگىزمۇ	hɛrgizmu
ھەزەر	hɛzær
ھەسسە	hɛssɛ
ھەسەل	hɛsɛl
ھەل	hɛl
ھەم	hɛm
ھەمدە	ɦɛmdɛ
ھەمدەم	hæmdɛm
ھەممىسى	hɛmmisɪ
ھەممىسى	tɑjɑq
ھەممە	hɛmmɛ
ھەي	hæj
ھەيكەل	hæjkæl
ھەپتە	hæptæ
ھەپتە	hæp̚tæ
ھەپتە	hɛptɛ
ھەپتە	hɛp̚tɛ
ھەپتە	ɦæptæ
ھەپتە	ɦæp̚tæ
ھەپتە	ɦɛptɛ
ھەپتە	ɦɛp̚tɛ
ۆ	ø
ۇ	u
ۈ	y
ۋ	v
ۋ	ve
ۋائىز	wɑʔiz
ۋابا	wɑbɑ
ۋادى	wɑdi
ۋاراق	wɑrɑq
ۋارىس	wɑris
ۋاز	wɑz
ۋاق	wɑq
ۋاقتى	wɑqti
ۋاقتىدىلا	wɑqtidilɑ
ۋاقىتتا	tɛr
ۋاقىتنى	wɑqitni
ۋاكسىنا	wɑksinɑ
ۋاي	wɑj
ۋاپا	wɑpɑ
ۋاڭ	wɑŋ
ۋاھە	wɑhɛ
ۋىرۇس	wirus
ۋۇجۇت	wudʒut
ۋېلسىپىت	welsipit
ۋېلىنېمەت	welinemɛt
ۋە	kʰilɑp
ۋە	rɑslɑp
ۋە	wɛ
ۋە	ʔinsɑn
ۋە	ʔiʃlɑr
ۋەتەن	wɛtɛn
ۋەدىگە	wɛtigɛ
ۋەدە	wɛdɛ
ۋەز	wɛz
ۋەزنى	wɛzni
ۋەزىپە	wɛzipɛ
ۋەسىقە	wɛsiqɛ
ۋەسىيەت	wɛsijɛt
ۋەسۋەسە	wɛswɛsɛ
ۋەكىلى	wɛkili
ۋەلسىپىت	wɛlsipit
ۋەلىئەھد	wɛliʔɛhd
ۋەھشەت	wɛhʃɛt
“مېنىڭ	meniŋ
‹يول	jol
